method,run,objective,tour_length,selected_costs,evaluations,improvements,final_selected,seed,duration_ms
steepest_intra:nodes_start:random,0,94943,43503,51440,1495014950,100001,193;108;93;117;143;183;0;46;198;43;149;162;63;1;101;16;175;171;113;31;196;81;90;165;40;119;185;145;78;179;92;129;167;23;68;22;181;184;112;127;70;135;62;15;186;137;12;94;189;182;123;84;177;54;34;160;41;115;72;133;79;121;100;26;86;53;154;180;151;118;116;65;131;97;57;106;178;14;144;102;49;148;109;42;5;139;191;80;152;44;120;75;2;52;55;124;176;51;59;18,6912172789976506609,40.537400
steepest_intra:nodes_start:random,1,109804,51266,58538,1495014950,100001,139;115;197;47;116;105;43;59;135;106;178;102;79;127;149;65;96;5;118;122;100;74;1;26;136;75;57;92;90;39;153;0;89;14;138;152;53;182;63;151;133;158;180;123;51;80;12;124;15;62;128;19;2;179;8;165;40;185;52;49;148;9;167;154;176;137;3;55;144;143;117;159;22;34;48;160;177;10;184;193;41;42;181;146;18;183;23;94;86;101;25;44;120;78;31;16;145;129;97;162,236262619095976738,40.354646
steepest_intra:nodes_start:random,2,118203,65257,52946,1495014950,100001,124;178;49;106;9;62;118;59;51;23;186;116;47;43;115;133;151;65;54;177;131;148;144;14;8;165;40;179;78;100;42;160;184;44;82;120;92;75;93;117;0;89;137;46;5;34;30;84;35;181;193;22;146;139;143;52;129;57;176;79;80;152;145;31;16;2;63;24;149;123;94;3;119;81;196;185;102;183;110;41;162;180;154;121;53;68;18;108;21;58;164;90;101;86;70;127;135;1;97;55,1451729959835398938,40.371466
steepest_intra:nodes_start:random,3,121689,63954,57735,1495014950,100001,44;111;137;23;124;94;176;80;130;113;175;86;115;96;193;139;46;143;93;140;183;89;18;105;123;59;118;116;0;170;153;42;48;103;34;148;145;16;31;171;75;101;158;177;104;195;181;43;65;102;178;40;144;14;62;33;152;151;162;41;184;35;54;160;84;112;29;127;194;133;63;154;53;25;92;15;163;159;146;22;47;106;7;164;49;1;2;120;185;165;52;196;78;129;3;167;180;70;135;97,5297552575367714986,40.382974
steepest_intra:nodes_start:random,4,106482,54019,52463,1495014950,100001,90;165;145;129;172;167;2;101;143;117;43;184;59;102;144;106;31;171;56;113;25;152;75;86;26;80;186;23;148;49;14;178;55;92;179;16;175;40;62;15;65;116;118;72;63;154;53;97;94;149;35;195;193;42;177;190;160;34;54;123;70;135;46;115;105;131;100;1;136;79;133;176;137;51;47;77;84;10;181;22;20;18;139;41;0;183;9;57;78;44;120;121;151;162;127;180;52;185;81;119,2440065927510866184,40.157348
steepest_intra:nodes_start:random,5,143224,76592,66632,1495014950,100001,144;148;70;43;181;10;48;112;90;165;152;1;158;151;118;101;75;78;179;145;119;153;93;149;131;109;176;51;42;24;32;49;14;73;62;41;193;116;124;63;136;180;164;7;21;198;110;54;4;120;168;13;175;92;137;89;0;139;115;186;23;52;130;79;135;167;128;154;34;160;189;94;80;47;103;159;183;185;169;40;3;106;16;171;113;56;31;2;97;133;45;29;126;123;59;65;105;77;53;44,7692448045752322298,40.505125
steepest_intra:nodes_start:random,6,106360,52522,53838,1495014950,100001,79;151;43;181;160;53;63;1;2;97;86;100;26;120;57;90;165;49;3;145;92;52;55;75;101;34;146;22;18;143;0;117;159;42;41;193;183;62;9;185;119;167;152;87;129;16;88;113;154;184;190;10;177;48;139;115;162;133;106;8;40;179;171;175;56;31;25;135;127;70;158;94;124;137;89;15;144;102;14;178;196;78;44;180;123;149;65;68;46;60;118;51;116;105;59;80;37;128;148;176,7528291843278382175,40.035869
steepest_intra:nodes_start:random,7,94650,44502,50148,1495014950,100001,79;72;59;118;109;51;68;108;18;117;80;100;97;78;145;92;26;53;158;70;135;127;194;180;154;162;123;149;116;65;176;55;52;106;185;31;113;175;171;16;75;86;101;1;120;44;25;2;152;167;178;49;62;9;148;137;46;41;159;22;146;184;112;4;84;35;0;143;183;89;57;129;94;151;43;160;54;30;48;42;5;115;139;191;193;181;34;177;10;165;40;90;21;114;15;102;144;14;63;133,6506843577140632345,40.014535
steepest_intra:nodes_start:random,8,204908,108389,96519,1495014950,100001,89;23;100;91;179;138;189;148;106;197;22;191;42;68;47;176;151;194;45;198;19;52;168;169;85;21;119;2;158;70;97;40;90;165;36;67;96;183;122;110;69;190;38;113;50;64;76;66;6;159;156;126;39;187;185;27;167;31;81;175;146;160;34;118;132;71;188;101;60;140;171;44;120;178;82;98;152;125;83;59;72;4;86;196;0;108;192;161;35;84;103;28;144;62;195;41;172;1;137;7,4367867693649711203,40.342833
steepest_intra:nodes_start:random,9,115773,62271,53502,1495014950,100001,185;176;51;118;151;133;183;89;148;94;2;101;26;19;79;112;10;177;34;22;143;23;137;108;20;41;139;58;164;95;157;175;171;136;72;59;135;70;75;121;162;5;184;190;43;105;65;180;53;1;3;49;14;165;52;92;25;44;145;57;55;106;178;152;86;80;37;186;0;18;69;93;153;114;138;90;27;40;31;113;16;154;123;160;42;116;68;46;159;193;62;9;144;115;131;63;97;82;120;78,3862342675336255059,41.272215
steepest_intra:nodes_start:random,10,93054,42201,50853,1495014950,100001,193;9;62;102;49;37;148;115;5;42;181;146;22;18;69;108;68;46;176;80;122;94;124;178;106;52;55;2;97;1;101;25;16;171;175;113;154;123;4;112;127;70;135;152;40;119;185;186;23;118;116;34;160;43;47;59;51;151;133;162;149;131;35;184;65;79;121;100;26;78;145;92;57;129;82;120;44;75;86;53;180;63;137;0;93;117;143;183;89;114;21;90;165;138;14;144;15;41;159;139,4615830668681632408,40.794235
steepest_intra:nodes_start:random,11,90782,41047,49735,1495014950,100001,79;63;94;148;15;114;186;89;76;23;152;97;26;86;101;1;2;129;52;106;178;3;49;65;184;54;177;84;180;120;44;25;75;70;127;112;123;162;133;151;59;118;115;68;93;117;143;0;153;183;62;102;9;137;46;139;69;108;18;22;146;34;160;135;154;53;31;56;157;196;138;14;144;51;116;193;159;41;42;43;185;119;40;165;90;81;113;175;171;16;78;145;179;92;57;55;167;124;176;80,781914402735864243,40.319772
steepest_intra:nodes_start:random,12,111885,58704,53181,1495014950,100001,144;3;14;106;94;176;109;59;116;65;5;43;35;112;123;110;139;46;78;171;31;115;41;193;160;34;180;179;90;39;40;145;25;16;2;101;120;124;12;79;63;44;113;175;186;183;140;68;118;51;80;162;149;105;72;121;158;86;196;169;165;185;55;152;1;97;52;57;75;154;135;127;70;133;184;42;181;151;129;92;100;53;137;143;0;108;69;18;22;148;102;62;15;23;89;114;9;49;138;178,6768536375442814524,40.262499
steepest_intra:nodes_start:random,13,92818,42796,50022,1495014950,100001,34;22;159;117;143;0;68;46;176;148;49;92;129;2;152;186;23;15;62;102;3;106;178;185;179;145;31;113;175;44;120;53;180;123;4;112;127;135;154;158;70;194;162;151;133;79;63;136;122;80;137;183;89;97;1;101;26;100;57;52;55;167;124;94;86;75;16;171;81;40;14;115;41;193;18;108;139;116;149;131;184;43;42;5;47;65;118;9;144;21;164;90;165;119;196;78;51;59;160;146,5936223313198859930,40.373660
steepest_intra:nodes_start:random,14,211609,123208,88401,1495014950,100001,119;198;84;28;36;156;102;63;181;182;158;4;95;174;175;35;80;53;78;168;9;26;167;128;159;162;177;183;59;69;163;115;141;87;120;185;75;180;19;190;170;93;131;2;55;113;97;74;82;44;85;187;8;130;149;105;139;116;112;171;58;169;32;76;89;34;18;42;184;118;106;166;135;196;81;21;138;20;191;122;40;124;65;123;127;5;114;108;133;66;10;24;153;52;46;195;193;110;194;134,5620771880081527223,40.322380
steepest_intra:nodes_start:random,15,98459,47885,50574,1495014950,100001,117;0;137;97;101;86;70;112;4;84;160;22;108;18;193;41;139;115;176;106;90;27;178;14;49;144;102;62;114;89;183;153;149;131;72;80;79;52;196;81;165;40;185;135;127;162;151;51;109;121;100;2;171;16;25;44;129;179;175;113;92;152;75;120;78;145;55;180;154;53;26;1;31;157;57;9;148;15;186;184;35;123;59;118;198;46;68;159;181;34;43;65;116;42;105;133;63;94;23;143,5087173252914323804,40.432432
steepest_intra:nodes_start:random,16,89255,39728,49527,1495014950,100001,9;144;14;49;62;89;183;23;186;165;39;90;196;145;78;2;97;1;100;86;158;154;180;79;137;153;143;0;68;42;181;18;108;140;93;117;178;185;40;106;115;41;193;139;198;46;151;162;133;53;121;26;101;75;70;177;54;160;43;116;65;149;59;51;176;167;55;52;57;129;120;25;44;31;113;171;16;175;56;157;179;92;152;94;124;122;80;118;159;22;146;34;184;4;112;123;135;63;148;102,967568198172197601,42.986348
steepest_intra:nodes_start:random,17,108594,54754,53840,1495014950,100001,133;154;53;155;144;51;59;118;139;193;5;46;93;117;89;37;2;44;101;79;94;179;31;25;185;55;1;152;186;183;143;181;48;42;105;77;162;129;82;16;113;175;56;171;92;178;9;148;12;80;176;102;106;40;124;63;180;182;151;41;22;18;69;43;135;70;86;97;75;120;62;15;23;0;68;137;14;138;49;52;78;145;196;157;57;26;123;149;184;190;177;54;34;160;65;115;116;28;35;112,5654594206156739164,40.179514
steepest_intra:nodes_start:random,18,95183,46351,48832,1495014950,100001,78;129;49;102;14;144;46;139;41;193;159;22;146;34;181;118;51;148;37;167;124;152;52;106;178;119;40;151;162;133;79;63;1;92;57;55;185;179;145;31;175;113;65;47;116;43;42;115;68;0;23;186;114;97;101;86;26;53;154;70;135;176;89;183;143;117;93;140;163;69;18;108;9;62;15;137;59;184;160;54;177;112;75;25;44;2;94;80;149;123;127;180;120;16;171;196;165;90;81;82,542917314391555233,40.468815
steepest_intra:nodes_start:random,19,106969,53461,53508,1495014950,100001,37;79;176;115;43;77;59;148;62;164;27;165;97;86;121;180;135;127;35;84;54;184;65;131;116;5;110;139;68;0;143;117;181;48;160;42;46;93;137;189;53;154;101;44;16;171;175;183;18;22;51;109;23;15;114;144;185;119;40;52;178;49;55;196;78;129;63;80;133;162;123;112;34;159;193;69;108;41;47;151;122;124;94;152;120;75;1;2;92;81;95;58;90;31;145;113;106;32;14;100,3156132313891691155,40.489224
steepest_intra:nodes_start:random,20,184986,98287,86699,1495014950,100001,44;18;59;72;195;110;192;54;50;31;157;188;113;98;186;154;130;114;32;91;5;4;135;80;189;170;22;115;141;51;176;137;191;68;147;184;65;48;0;96;159;93;133;23;45;112;102;64;123;194;124;49;62;182;97;100;86;95;187;107;89;152;38;33;52;172;19;101;14;145;103;10;179;78;92;175;90;40;165;61;185;7;132;148;121;106;3;129;94;178;119;169;16;173;126;151;111;144;63;43,3204468819779476153,39.917200
steepest_intra:nodes_start:random,21,127736,65920,61816,1495014950,100001,2;100;153;93;181;5;43;162;176;151;79;80;167;23;117;36;18;65;133;122;92;196;169;81;165;119;78;145;44;55;57;106;185;39;114;69;108;110;191;126;112;146;195;42;1;152;37;148;33;52;40;123;70;94;75;25;120;154;4;24;72;59;137;89;15;62;49;144;116;34;184;63;3;155;14;138;178;128;84;48;160;22;103;41;139;193;115;149;135;86;16;31;183;0;143;101;97;180;136;53,1333462027144105705,40.263787
steepest_intra:nodes_start:random,22,110986,57267,53719,1495014950,100001,68;110;197;162;180;158;135;127;4;112;0;183;89;186;15;92;120;75;1;176;109;118;108;18;20;22;53;100;101;196;185;9;62;49;70;84;10;30;160;116;137;148;111;152;2;16;171;31;113;178;139;191;198;47;65;52;57;129;44;78;145;63;79;51;149;54;177;184;121;86;26;97;94;80;143;46;115;41;159;193;181;34;59;151;45;123;154;40;165;90;164;21;14;144;106;55;124;133;43;42,8232293355476189951,40.314298
steepest_intra:nodes_start:random,23,173799,90236,83563,1495014950,100001,110;0;32;164;151;5;193;96;35;176;14;16;113;17;21;121;53;162;93;149;123;186;169;138;68;59;116;115;46;104;10;43;54;36;183;89;153;161;105;194;84;190;160;103;24;131;60;66;172;49;152;181;20;192;197;65;122;86;154;106;125;25;98;178;174;120;78;26;6;37;102;128;40;90;58;39;15;144;155;179;75;52;42;47;199;170;67;69;41;64;62;1;175;94;79;51;70;180;101;145,1907501030107449359,40.354721
steepest_intra:nodes_start:random,24,106858,56145,50713,1495014950,100001,184;160;35;49;138;90;119;81;185;52;129;16;171;2;94;80;151;72;59;22;146;42;65;51;57;179;145;78;92;167;111;70;135;162;133;148;62;9;15;183;93;68;117;23;144;14;165;40;178;43;34;48;177;180;158;53;149;159;108;18;69;46;137;124;152;75;86;1;120;44;106;55;37;143;0;139;116;115;193;41;123;154;97;26;101;25;31;113;175;186;89;118;109;176;79;63;100;121;131;54,7254877198772137011,40.137616
steepest_intra:nodes_start:random,25,110838,58970,51868,1495014950,100001,89;135;154;16;171;31;175;113;44;97;26;160;181;42;101;1;167;55;3;106;52;145;78;81;185;90;27;71;39;165;62;148;75;2;120;25;14;144;15;139;159;41;131;162;151;59;115;49;138;40;119;112;84;184;35;149;133;152;92;57;37;137;51;123;127;65;18;140;183;94;136;180;86;53;9;7;21;164;58;178;111;79;176;109;143;93;46;68;193;22;34;54;43;116;117;0;80;122;63;186,5193575791504356907,40.177145
steepest_intra:nodes_start:random,26,91665,42481,49184,1495014950,100001,21;164;90;52;55;57;152;97;1;101;100;26;63;122;80;0;143;117;93;68;46;124;2;44;120;70;127;123;112;84;184;42;5;43;47;65;116;115;51;137;148;37;62;9;102;49;165;40;185;178;94;162;177;54;135;154;79;23;186;15;106;92;145;78;129;176;139;18;22;34;160;181;159;193;41;96;131;149;180;53;86;75;16;171;175;113;56;31;81;196;133;151;72;59;118;89;183;144;14;7,4614353807617130512,40.104332
steepest_intra:nodes_start:random,27,100095,50432,49663,1495014950,100001,27;8;55;44;25;154;123;41;193;115;133;101;75;151;105;65;136;53;42;146;22;159;97;86;152;2;92;129;57;3;138;9;80;35;4;190;177;160;184;54;34;59;176;51;118;149;162;180;1;82;196;81;113;175;171;16;31;165;185;40;52;62;137;89;183;148;167;120;78;145;14;102;49;178;106;124;94;122;79;63;135;127;112;84;131;116;43;181;108;18;68;139;46;0;117;143;144;21;90;164,3277750315254302600,40.140134
steepest_intra:nodes_start:random,28,97001,48025,48976,1495014950,100001,185;119;40;160;34;181;139;140;68;46;133;53;57;55;162;65;115;18;69;108;93;117;0;137;176;51;151;121;26;97;63;79;62;9;49;144;14;138;106;165;39;164;7;21;148;124;94;80;22;146;42;123;154;158;180;183;89;186;15;52;92;25;44;120;101;86;75;78;145;31;16;171;175;113;81;196;129;2;118;59;135;70;127;112;4;184;43;131;149;47;116;193;41;143;23;1;152;167;178;90,5499134745869512038,40.078535
steepest_intra:nodes_start:random,29,101746,50060,51686,1495014950,100001,152;123;149;5;181;48;160;184;59;137;62;9;148;189;26;63;46;139;193;41;42;43;116;53;44;16;25;52;14;183;89;15;178;3;49;102;57;171;175;113;31;179;165;185;55;2;101;86;135;70;180;154;127;162;94;124;122;176;51;118;109;106;40;119;39;144;167;129;120;92;21;164;58;27;90;196;78;145;75;79;72;159;22;115;182;121;133;151;65;54;34;18;117;0;143;80;158;100;1;97,8611810646389894023,40.293769
steepest_intra:nodes_start:random,30,119944,63523,56421,1495014950,100001,185;59;65;93;139;115;151;176;133;122;189;97;152;1;121;154;158;101;106;178;14;138;52;25;44;75;129;3;49;144;9;23;137;193;41;53;171;175;16;79;80;148;62;78;38;113;180;4;190;54;48;184;166;116;149;143;170;0;183;186;51;110;159;34;160;42;69;18;68;46;66;2;145;56;120;100;162;96;195;22;108;163;112;123;135;92;57;55;136;63;94;167;31;90;58;71;81;165;40;43,7790043246028228998,40.192055
steepest_intra:nodes_start:random,31,127946,65266,62680,1495014950,100001,116;118;59;152;74;53;101;44;157;171;92;19;124;79;42;5;105;131;93;36;65;47;18;22;77;133;154;70;26;106;3;178;57;179;49;102;151;180;1;62;9;183;143;108;41;15;61;94;80;176;148;37;137;51;189;97;31;175;16;113;85;78;181;191;115;198;139;117;0;185;40;165;52;135;123;193;110;163;69;89;114;23;144;32;14;184;160;48;112;162;149;127;194;63;186;167;145;120;72;46,5726232482040864521,40.234628
steepest_intra:nodes_start:random,32,96514,44573,51941,1495014950,100001,42;181;34;22;41;193;139;78;16;171;175;113;90;165;14;49;62;9;167;180;158;154;79;144;21;138;3;55;196;31;145;57;23;89;143;117;59;123;127;70;135;86;120;44;97;189;133;151;162;149;131;184;160;54;177;4;112;65;116;115;46;0;186;185;119;40;52;1;53;136;100;26;148;37;122;80;63;182;121;101;75;2;92;129;152;124;94;176;51;109;118;68;140;93;183;106;178;102;137;43,8843004821564340805,40.157654
steepest_intra:nodes_start:random,33,96739,46666,50073,1495014950,100001,143;139;42;43;65;25;16;171;175;113;49;102;62;15;41;193;22;34;63;26;100;121;182;53;158;180;154;135;127;112;84;184;35;80;94;124;152;78;31;157;196;179;59;116;115;46;0;137;148;178;106;52;1;97;101;75;2;120;44;145;185;40;81;90;39;165;14;186;89;183;160;48;54;177;10;190;70;86;129;92;57;55;167;79;133;149;131;123;162;151;72;118;51;176;9;144;21;164;7;117,7903343268740836570,40.108054
steepest_intra:nodes_start:random,34,91229,41549,49680,1495014950,100001,101;100;26;167;102;49;144;9;62;176;80;51;59;5;34;54;177;48;160;43;42;22;146;181;184;84;133;63;121;120;44;113;175;171;16;70;127;4;112;135;94;124;148;186;114;15;14;138;79;151;162;123;149;131;118;137;23;89;143;117;0;183;21;7;164;27;90;196;145;78;53;154;180;116;65;115;46;68;139;193;159;41;106;185;119;40;165;178;52;55;2;75;86;97;152;57;179;92;129;1,3671019083670612325,40.233829
steepest_intra:nodes_start:random,35,108699,59184,49515,1495014950,100001,179;31;81;165;144;148;65;149;131;84;123;151;133;135;6;154;121;75;86;180;115;46;101;175;113;44;92;57;167;186;89;23;106;178;14;102;162;118;51;152;1;2;55;114;183;41;193;35;70;53;26;25;16;56;171;120;82;127;112;177;184;43;116;139;93;15;62;49;52;97;63;79;94;189;176;80;59;42;181;22;146;159;68;137;9;27;90;40;185;160;34;18;108;117;0;143;129;196;145;78,3530136829601868652,40.142385
steepest_intra:nodes_start:random,36,103196,51697,51499,1495014950,100001,54;112;135;97;2;92;57;148;0;143;115;4;156;29;127;26;1;55;52;185;138;14;144;186;89;183;137;176;116;22;18;117;9;102;62;100;86;75;44;25;120;80;46;41;159;193;96;118;59;72;162;151;51;109;133;79;123;84;190;10;177;34;42;43;70;31;113;175;171;16;145;90;40;78;101;180;154;149;184;35;65;114;21;165;129;152;189;121;53;63;122;94;124;167;106;178;49;139;181;160,2181862989214551757,40.186299
steepest_intra:nodes_start:random,37,93752,43772,49980,1495014950,100001,135;97;2;129;25;44;152;63;79;162;149;131;118;46;68;139;65;116;59;137;0;143;183;89;21;164;39;185;124;94;111;167;92;78;120;75;86;100;26;1;106;3;178;49;102;62;15;133;151;51;176;80;16;171;175;81;90;27;165;40;119;196;113;31;145;101;158;154;127;43;159;18;108;22;54;177;123;180;53;121;148;9;52;57;55;14;144;186;23;35;184;42;5;96;115;41;193;181;34;160,2099193958884809027,40.395699
steepest_intra:nodes_start:random,38,110615,59525,51090,1495014950,100001,47;75;86;180;154;94;129;92;57;55;80;176;15;106;78;31;171;145;2;152;124;123;70;133;59;118;191;139;193;22;159;41;96;116;54;184;160;143;117;21;185;52;148;183;89;186;23;137;79;122;63;90;7;27;113;25;120;196;40;178;49;9;35;112;4;190;10;34;42;43;65;100;26;1;44;16;175;62;108;18;0;144;119;165;14;167;151;162;72;51;115;46;60;135;53;101;97;149;131;127,2708086838128328398,40.039614
steepest_intra:nodes_start:random,39,117824,59034,58790,1495014950,100001,151;179;57;183;140;18;22;34;54;1;26;86;101;75;137;176;12;14;52;55;111;194;184;35;4;48;160;139;68;0;122;129;3;62;106;23;130;2;120;44;92;78;171;16;175;113;79;109;118;42;116;5;59;133;94;121;154;63;128;8;178;172;53;123;127;65;148;95;119;40;165;167;124;97;182;152;185;90;196;145;102;9;144;49;80;46;198;41;193;159;108;36;191;115;131;149;162;180;135;70,453892297430659038,40.184000
steepest_intra:nodes_start:random,40,105607,51192,54415,1495014950,100001,94;116;77;62;144;106;3;185;40;119;90;164;21;15;148;101;53;180;154;63;136;152;97;1;31;175;196;179;92;57;55;124;115;160;30;54;184;70;133;0;117;68;51;176;167;91;81;187;165;14;9;137;80;151;72;149;105;5;159;181;35;135;79;122;162;47;118;59;139;46;43;34;22;146;193;41;42;65;69;18;143;183;102;49;178;52;2;129;44;171;113;157;169;145;120;78;56;16;25;123,6843451673300116614,40.241566
steepest_intra:nodes_start:random,41,98930,47261,51669,1495014950,100001,143;68;63;97;1;189;122;115;43;127;135;62;9;94;149;131;77;47;100;2;120;25;145;92;57;178;138;144;114;23;186;137;151;162;133;26;55;52;35;177;190;54;160;34;22;139;140;93;117;183;89;129;78;171;175;113;31;16;44;75;101;121;180;79;80;176;51;109;118;198;46;193;41;42;184;112;70;49;102;14;21;165;27;90;40;185;106;152;86;53;154;123;65;116;59;124;167;148;15;0,3184166071426453383,40.146663
steepest_intra:nodes_start:random,42,122735,62652,60083,1495014950,100001,5;54;184;116;166;131;75;129;44;152;127;154;94;2;106;59;24;149;62;27;90;185;119;31;56;78;178;52;145;165;8;95;21;15;46;198;144;14;55;175;113;171;16;101;151;72;143;102;49;40;196;57;92;121;136;122;63;70;180;189;86;12;79;80;51;42;48;34;22;176;137;170;0;183;117;41;193;197;105;47;139;60;148;81;174;120;19;53;158;97;1;135;118;43;65;123;160;115;77;10,8004438639065516078,40.128662
steepest_intra:nodes_start:random,43,92782,43019,49763,1495014950,100001,177;10;34;22;159;18;69;108;140;68;46;178;106;165;27;90;81;196;31;157;179;57;115;193;41;139;92;78;56;113;175;171;16;145;52;55;185;40;14;144;148;124;176;72;47;65;116;43;162;53;86;63;79;80;94;120;44;25;75;70;127;123;5;42;9;62;49;129;2;97;26;154;135;180;137;23;89;183;143;0;51;118;59;149;131;112;4;84;151;133;122;189;152;1;101;184;160;48;54;30,6819305180991348463,40.148497
steepest_intra:nodes_start:random,44,104446,53220,51226,1495014950,100001,154;54;18;69;22;159;70;135;162;116;105;181;34;193;198;46;52;55;16;175;171;31;25;78;101;97;79;63;185;40;106;178;144;139;42;96;41;93;68;43;65;48;160;115;176;137;89;0;170;143;117;148;102;49;80;51;151;149;4;35;84;184;190;123;127;75;44;113;56;196;90;39;165;14;2;129;57;179;145;92;120;152;1;86;180;121;94;118;59;109;15;9;62;186;183;23;182;53;133;112,1700529634736108812,40.181612
steepest_intra:nodes_start:random,45,115196,61548,53648,1495014950,100001,18;40;157;31;113;13;56;16;171;175;78;120;44;75;84;54;41;139;137;62;102;119;39;27;90;185;127;160;184;92;145;129;79;133;162;194;151;80;26;86;101;140;93;68;117;143;23;186;94;130;124;2;52;55;106;178;57;63;122;180;158;182;95;164;14;144;148;176;116;42;181;193;46;0;9;8;165;183;89;51;59;118;115;65;149;123;53;121;154;70;135;136;97;1;152;100;43;34;22;49,8652091231774385500,40.214750
steepest_intra:nodes_start:random,46,91013,42454,48559,1495014950,100001,52;106;3;138;14;144;114;15;9;62;148;46;139;41;193;42;5;59;118;51;80;94;152;97;154;180;53;26;101;2;129;92;145;16;171;81;90;196;44;75;100;63;79;112;10;177;54;184;43;116;178;40;165;49;102;181;34;160;162;133;151;127;123;149;131;65;115;68;0;137;176;1;120;25;175;113;31;78;167;23;89;183;153;143;117;93;140;108;69;18;22;159;35;135;70;86;57;185;119;55,6217434099909374013,40.141558
steepest_intra:nodes_start:random,47,94610,43602,51008,1495014950,100001,55;53;158;80;176;51;68;46;102;49;162;43;34;22;18;139;198;115;118;59;149;35;184;54;160;181;159;193;41;96;116;72;151;152;129;145;196;81;90;165;40;78;25;92;57;52;14;144;15;183;143;0;89;137;100;26;97;1;31;113;175;171;16;44;120;62;9;148;122;79;133;63;136;180;154;70;112;177;190;4;101;75;86;135;127;123;131;42;5;65;167;185;179;2;189;94;12;124;178;106,2125366232667881583,40.062057
steepest_intra:nodes_start:random,48,120338,55089,65249,1495014950,100001,41;77;35;127;78;16;31;157;168;56;113;175;145;171;75;101;123;29;126;162;130;19;137;197;65;183;73;114;47;42;115;51;184;84;159;193;116;46;69;18;20;22;160;10;190;180;53;133;79;182;120;92;102;14;138;33;80;176;136;26;2;82;44;111;148;119;39;144;62;178;49;1;154;135;70;59;151;121;152;122;63;94;124;12;97;189;106;8;185;40;165;89;143;186;23;0;93;191;139;140,6447325569000548039,39.978633
steepest_intra:nodes_start:random,49,112939,59265,53674,1495014950,100001,15;183;18;22;193;196;31;42;160;184;43;176;80;62;148;152;2;16;175;171;113;81;90;92;1;121;151;51;137;114;102;144;9;186;133;161;45;162;72;65;59;198;115;39;165;40;185;55;106;46;117;170;143;140;116;84;4;112;3;49;52;179;78;44;25;101;100;26;97;63;136;180;86;178;164;7;21;118;131;149;123;127;70;75;120;129;145;53;135;154;94;124;122;79;41;139;68;0;89;14,2141555039573734765,40.113365
steepest_intra:nodes_start:random,50,108374,58396,49978,1495014950,100001,1;59;65;54;160;41;115;15;9;62;148;80;133;70;154;158;122;79;63;127;135;171;175;113;31;81;90;164;21;114;186;183;0;143;46;139;43;84;4;152;78;92;129;100;149;116;180;182;167;106;178;151;118;51;49;39;165;196;123;35;184;48;34;42;53;86;121;94;124;23;137;198;193;22;18;69;176;101;26;97;57;185;40;102;144;14;52;44;25;120;16;145;179;55;162;112;190;177;75;2,1711603354555548195,40.144323
steepest_intra:nodes_start:random,51,211576,117695,93881,1495014950,100001,10;19;129;50;119;187;53;89;163;108;35;62;17;66;82;171;120;178;173;140;33;31;2;94;74;26;149;4;48;5;30;142;162;133;103;28;153;7;76;148;164;91;121;44;61;0;86;151;193;118;95;90;150;88;157;182;175;100;106;154;77;63;85;196;38;186;176;161;131;136;158;135;130;167;183;1;145;71;123;160;18;199;146;195;184;105;47;147;99;110;8;132;52;152;14;55;60;111;137;16,6998022037986372178,40.165420
steepest_intra:nodes_start:random,52,94781,45703,49078,1495014950,100001,102;124;80;176;51;109;151;100;86;175;171;129;79;59;118;137;15;144;138;40;185;94;149;184;177;54;160;34;181;42;43;65;116;115;117;143;89;62;9;183;0;46;68;41;159;193;139;23;186;148;44;16;113;31;196;106;178;3;165;8;14;108;18;22;112;127;135;154;180;53;70;123;162;133;63;152;57;179;145;78;55;52;39;95;7;164;90;81;92;2;1;97;82;120;75;101;26;121;167;49,8832582174368992624,40.283001
steepest_intra:nodes_start:random,53,118582,62604,55978,1495014950,100001,143;184;116;162;194;63;49;39;165;106;2;120;57;14;62;137;59;65;139;198;46;60;115;193;18;159;41;0;51;151;100;150;1;26;92;145;25;44;75;97;94;189;196;40;178;148;79;158;135;182;80;176;101;86;152;78;21;144;68;160;54;24;154;53;180;5;48;181;42;123;127;70;55;52;185;8;183;93;69;22;35;84;112;43;28;177;190;149;133;102;7;90;81;175;113;16;129;111;153;34,6843273506841380927,40.171252
steepest_intra:nodes_start:random,54,120028,64724,55304,1495014950,100001,96;5;176;102;14;144;49;152;2;1;180;194;162;42;30;48;116;43;117;143;137;23;106;52;16;171;44;101;129;25;57;92;120;145;165;185;7;21;112;35;84;139;191;167;55;179;78;81;90;27;40;196;75;0;170;178;138;105;181;108;18;115;63;80;163;69;131;135;123;65;77;72;149;118;59;89;183;94;182;79;51;151;133;154;100;97;53;160;184;177;10;148;62;9;34;22;159;193;41;46,7664953046645175406,40.039678
steepest_intra:nodes_start:random,55,113456,58322,55134,1495014950,100001,190;135;154;194;35;184;131;51;57;92;65;42;115;133;86;1;151;43;105;195;146;22;34;54;149;2;129;185;40;145;75;26;101;97;120;16;31;78;102;144;9;15;176;109;46;68;139;159;181;160;79;148;49;62;183;89;0;153;137;118;72;143;117;23;63;100;53;18;108;163;41;193;90;58;164;7;95;167;124;80;94;152;44;55;178;52;106;165;39;14;12;59;116;123;162;161;180;70;4;112,1575420942084864994,40.098359
steepest_intra:nodes_start:random,56,95075,44992,50083,1495014950,100001,26;86;75;120;129;57;179;196;81;90;119;40;106;178;52;113;175;171;16;92;51;59;149;131;195;22;146;181;160;48;177;184;43;151;133;79;180;154;116;65;35;84;118;186;23;176;80;63;53;100;1;101;97;137;0;143;183;89;117;68;139;159;34;54;70;135;2;185;165;8;157;31;78;145;25;44;152;41;193;115;144;14;102;9;148;124;12;94;162;123;127;112;4;42;46;62;49;55;167;121,6155861258988580828,40.076846
steepest_intra:nodes_start:random,57,122172,64406,57766,1495014950,100001,113;55;62;0;198;51;66;59;193;159;22;68;36;115;41;139;110;118;72;184;54;4;114;148;52;178;129;149;65;112;131;151;63;26;86;121;102;14;78;44;92;75;1;79;103;34;190;97;179;196;145;169;90;165;31;175;16;171;40;3;8;49;186;23;137;94;57;91;185;80;46;160;42;43;105;135;154;152;2;173;123;156;127;162;176;143;183;106;32;144;9;53;180;133;93;108;116;122;101;120,3710348917739165035,40.083106
steepest_intra:nodes_start:random,58,97142,45020,52122,1495014950,100001,49;106;179;145;185;40;138;14;144;183;117;143;89;92;57;55;52;178;148;137;176;80;122;63;180;154;70;127;5;199;18;41;96;47;149;131;42;181;195;146;22;159;193;115;118;79;86;101;1;26;100;94;186;23;0;46;160;48;54;84;135;53;152;165;27;90;171;16;2;97;162;123;35;184;43;116;65;59;51;124;129;78;44;120;75;133;151;93;140;108;69;68;139;34;177;4;112;9;62;3,1278101628478557604,40.152186
steepest_intra:nodes_start:random,59,236733,138829,97904,1495014950,100001,184;130;119;44;145;103;69;93;199;116;177;85;13;187;2;0;161;131;151;1;104;134;33;57;165;164;169;92;15;40;64;97;143;43;16;135;129;102;71;100;155;25;138;193;89;108;22;5;115;195;19;101;96;160;190;189;148;139;179;78;36;173;170;79;172;87;59;11;121;56;8;20;166;109;107;61;127;128;17;37;111;47;144;182;38;180;73;162;80;176;141;188;196;158;154;88;72;140;23;157,8321061649446883497,40.277620
steepest_intra:nodes_start:random,60,97310,47905,49405,1495014950,100001,42;1;52;106;178;55;57;31;175;113;171;16;75;2;179;185;40;138;186;89;23;131;149;123;127;194;162;133;151;118;59;65;47;116;43;184;35;112;79;14;102;124;94;63;154;53;180;176;140;93;183;144;165;90;81;196;25;44;120;92;49;137;115;96;181;18;108;117;143;9;62;148;70;135;86;97;101;78;145;129;152;80;51;41;193;46;0;68;177;10;30;54;48;5;139;110;159;22;34;160,3653349544573591453,40.443900
steepest_intra:nodes_start:random,61,95884,46285,49599,1495014950,100001,68;15;62;186;23;42;160;34;181;22;117;143;0;46;198;115;70;154;53;158;180;135;133;51;176;80;26;97;1;86;121;63;79;9;144;137;118;59;47;65;116;43;184;54;177;10;75;81;90;27;40;14;89;93;108;18;69;183;102;49;148;152;2;129;120;16;171;175;31;78;145;57;55;52;124;94;122;151;162;149;131;84;4;112;123;127;101;44;25;92;185;165;39;164;95;106;178;139;41;193,9201428739199247245,40.160077
steepest_intra:nodes_start:random,62,121442,63333,58109,1495014950,100001,129;196;92;55;52;33;148;115;18;159;193;110;41;48;184;146;34;68;140;108;139;121;26;101;94;46;22;42;160;192;60;137;62;102;37;180;135;133;79;14;9;144;109;51;123;127;154;162;59;80;2;57;183;89;143;0;23;152;19;72;43;96;178;169;157;1;75;116;47;65;149;165;90;40;86;97;167;124;176;151;118;105;177;190;70;53;63;130;106;78;171;16;120;44;145;179;185;49;138;31,11772851815169881,40.303902
steepest_intra:nodes_start:random,63,102495,49044,53451,1495014950,100001,42;139;198;148;106;196;56;171;16;175;113;31;40;90;165;185;52;178;167;80;133;180;136;122;176;68;191;115;118;137;183;23;14;49;57;92;78;145;44;120;2;0;143;89;1;152;97;65;160;34;43;149;112;29;127;53;26;158;131;77;41;159;18;193;46;186;15;144;62;124;154;70;190;177;146;22;5;116;135;86;101;75;100;189;63;79;123;162;151;94;182;51;72;59;184;4;35;54;48;181,4218323259388010184,40.220153
steepest_intra:nodes_start:random,64,102785,49050,53735,1495014950,100001,80;79;12;148;9;15;94;176;65;149;121;52;119;40;165;27;90;92;82;25;57;129;167;143;0;160;54;177;48;34;137;23;183;62;102;49;179;31;113;145;78;16;44;120;158;135;70;162;123;4;112;184;115;198;46;89;178;55;3;106;186;139;110;118;51;68;18;22;146;181;59;100;75;101;63;116;43;5;193;41;159;42;96;151;133;182;136;53;154;180;26;86;97;2;1;152;185;138;144;14,2285720177197886200,40.164513
steepest_intra:nodes_start:random,65,98745,47217,51528,1495014950,100001,177;84;112;43;42;184;35;149;59;162;135;154;52;106;178;185;40;14;144;183;68;139;34;30;54;47;65;116;151;133;86;1;152;102;49;37;79;53;75;26;101;97;2;129;92;57;94;51;118;41;96;131;123;180;145;31;16;25;120;124;137;46;198;108;18;159;193;23;186;15;148;80;176;195;103;22;146;117;0;153;143;89;62;9;55;78;171;175;113;81;196;157;44;63;115;181;160;48;10;190,3013432018402459559,40.369777
steepest_intra:nodes_start:random,66,95841,46386,49455,1495014950,100001,52;148;23;137;51;118;42;5;193;41;139;115;43;84;4;112;70;100;97;26;158;154;35;184;10;177;54;160;34;181;46;0;186;144;14;138;57;129;120;44;16;171;78;62;89;183;68;22;159;49;178;179;145;92;152;1;121;79;72;59;116;47;65;151;63;53;180;162;149;131;123;127;135;133;176;80;122;94;9;21;164;81;31;113;90;27;165;40;185;2;75;101;86;18;108;93;117;143;106;55,6757281470107496633,40.571068
steepest_intra:nodes_start:random,67,100656,49026,51630,1495014950,100001,165;27;90;14;102;9;139;159;193;108;18;199;116;47;162;127;112;4;135;86;75;101;53;123;190;177;184;43;131;151;133;118;23;186;114;15;62;148;122;63;79;176;80;136;180;158;1;26;70;160;54;34;146;195;22;181;41;46;198;42;65;149;154;120;145;152;97;137;89;143;183;55;52;31;113;16;44;59;115;68;0;117;51;94;189;2;57;92;106;49;144;178;196;78;185;164;7;21;138;40,6448071016452755542,40.378731
steepest_intra:nodes_start:random,68,127140,65028,62112,1495014950,100001,108;46;177;30;34;195;184;4;135;1;97;194;116;43;22;181;143;186;73;7;165;12;80;51;151;137;15;37;40;81;52;196;31;113;175;90;49;118;59;133;75;25;91;14;144;178;145;157;8;185;95;98;17;148;23;149;131;193;115;166;29;123;72;77;42;48;54;65;176;102;62;44;120;82;92;57;152;74;94;101;86;2;53;136;180;154;122;55;138;106;63;24;160;103;41;78;56;171;16;139,5499961659061784748,40.587729
steepest_intra:nodes_start:random,69,110466,55061,55405,1495014950,100001,180;25;113;31;62;9;178;14;144;37;41;159;193;118;16;175;171;145;40;90;27;58;164;1;101;79;149;131;42;116;63;133;54;30;160;77;59;123;135;154;52;196;81;185;106;102;15;148;80;72;43;34;22;18;108;139;46;51;66;176;182;158;53;70;162;115;5;96;151;94;167;55;57;44;92;78;75;86;120;82;137;0;143;183;124;19;189;97;152;74;2;129;165;49;194;24;65;105;184;177,6927922317747230436,40.109826
steepest_intra:nodes_start:random,70,184842,95837,89005,1495014950,100001,117;194;198;153;56;107;164;187;94;170;69;192;15;83;4;181;30;47;134;108;159;146;112;115;48;147;177;118;52;71;2;97;53;63;100;85;81;196;180;176;193;182;173;151;133;79;99;17;50;175;113;16;102;106;1;35;160;65;66;165;25;172;62;148;9;163;191;75;178;55;3;90;138;166;59;109;21;49;128;74;169;40;70;28;121;87;44;124;156;11;131;116;23;39;57;86;78;92;161;127,7138014565672908427,40.211815
steepest_intra:nodes_start:random,71,114528,61007,53521,1495014950,100001,2;129;9;144;155;49;106;55;52;122;131;149;120;175;16;123;24;65;181;34;193;41;145;113;56;31;171;78;82;94;124;136;180;154;101;75;162;112;127;59;18;108;115;139;116;43;48;160;177;70;135;86;97;1;190;10;30;54;184;118;148;37;23;137;53;121;51;22;195;42;178;57;92;15;0;46;109;80;79;183;89;186;114;62;111;151;133;63;14;165;40;185;102;170;143;117;68;176;152;44,4111559062007955950,40.229585
steepest_intra:nodes_start:random,72,97313,45192,52121,1495014950,100001,133;177;54;30;160;43;148;102;9;62;139;159;146;22;195;181;34;42;116;124;55;52;57;92;179;49;144;186;137;118;198;68;46;109;51;176;66;153;0;170;143;23;14;185;165;40;167;162;149;131;65;193;41;199;18;108;69;115;59;151;79;121;154;180;53;26;101;75;25;44;120;1;140;93;117;183;89;106;178;78;31;171;175;16;113;145;129;2;152;86;70;123;184;112;135;97;94;63;122;80,6904406676434329176,40.259561
steepest_intra:nodes_start:random,73,100528,48511,52017,1495014950,100001,139;65;116;177;54;10;160;34;146;184;112;194;154;52;55;106;185;40;196;178;62;23;137;176;193;41;123;127;63;165;27;90;44;2;129;92;31;113;175;171;16;120;133;118;59;72;162;149;43;42;105;151;79;124;148;9;102;37;167;152;101;97;75;1;86;26;180;53;70;135;181;103;22;159;94;145;179;81;38;78;57;49;144;14;138;114;186;21;95;7;89;183;143;170;0;46;68;18;115;5,7041272605276748209,40.201135
steepest_intra:nodes_start:random,74,101210,49492,51718,1495014950,100001,54;177;10;190;34;181;41;193;139;121;53;63;108;18;68;46;42;43;75;78;145;55;14;144;114;89;153;143;183;138;40;81;57;129;167;102;62;9;21;165;179;92;196;90;27;119;185;37;148;44;25;16;113;171;120;2;79;0;117;93;140;199;159;146;22;160;184;162;133;12;124;154;180;65;149;123;135;152;52;106;178;49;176;115;116;105;59;118;51;186;23;137;80;1;86;101;97;94;151;35,2251766260923640618,40.197987
steepest_intra:nodes_start:random,75,94076,43404,50672,1495014950,100001,127;160;34;22;159;193;151;133;79;137;23;89;143;140;108;18;63;189;97;101;86;154;180;148;15;0;117;93;68;46;41;42;5;43;109;51;118;115;139;199;69;183;186;44;120;1;26;100;53;158;121;167;40;119;165;185;152;2;129;196;81;90;164;21;162;123;177;54;184;131;149;65;116;59;176;80;122;94;124;102;49;14;144;62;9;178;106;52;55;57;92;78;16;175;113;145;75;135;70;112,5329699775859450349,40.150590
steepest_intra:nodes_start:random,76,90079,40211,49868,1495014950,100001,102;178;145;78;16;171;175;113;31;44;120;180;135;123;116;5;42;181;34;160;65;59;121;101;75;86;53;136;133;162;149;131;151;52;185;40;92;2;1;158;127;35;184;41;193;139;198;68;93;140;43;4;112;70;154;129;57;55;106;49;9;186;89;23;15;144;14;138;165;90;81;196;167;148;137;176;80;79;63;100;26;97;152;94;51;118;115;46;0;143;117;159;146;22;18;69;108;183;114;62,3398371290902616484,40.374547
steepest_intra:nodes_start:random,77,125795,70258,55537,1495014950,100001,165;62;14;174;98;16;44;148;94;12;118;5;22;193;117;170;135;70;80;23;137;183;143;43;149;152;2;19;41;159;9;185;196;157;154;123;116;77;63;97;1;86;136;84;112;127;176;102;49;32;178;59;115;18;108;139;46;57;92;82;78;81;90;39;40;55;26;160;184;131;189;101;53;133;162;151;145;31;106;0;68;198;181;42;65;51;37;52;119;113;175;171;120;75;180;10;177;79;144;3,3280720486554855996,40.032766
steepest_intra:nodes_start:random,78,170838,89859,80979,1495014950,100001,196;3;108;139;115;46;43;126;127;150;31;106;39;187;52;44;120;138;144;114;148;128;89;118;76;55;21;151;116;155;49;102;62;42;133;188;85;152;92;99;101;169;13;56;119;129;78;145;168;90;8;67;163;51;123;112;59;117;41;185;71;19;86;1;57;186;143;97;182;74;75;53;77;66;63;79;6;26;167;180;70;96;142;176;0;93;134;18;94;100;195;10;184;34;35;30;20;199;149;183,2765845691257902188,40.316325
steepest_intra:nodes_start:random,79,115270,58549,56721,1495014950,100001,170;117;51;100;52;119;81;86;180;101;44;75;57;129;78;120;133;65;43;34;22;68;143;153;176;122;94;161;162;131;115;0;89;15;62;113;50;56;171;16;175;157;55;124;135;154;79;37;165;39;8;97;139;159;41;193;160;54;4;53;1;49;102;151;59;42;28;184;112;123;70;2;92;40;185;106;32;3;138;14;21;144;80;63;152;9;183;186;23;137;148;145;31;178;167;118;116;197;46;93,3233356800193170838,40.330648
steepest_intra:nodes_start:random,80,99999,48619,51380,1495014950,100001,100;5;42;43;65;116;123;70;135;127;54;177;190;154;94;148;62;72;47;77;131;149;137;186;183;89;112;4;84;184;34;160;0;117;139;193;18;22;41;162;180;53;167;49;14;138;185;55;9;15;143;93;68;46;51;80;122;63;176;118;59;23;144;40;119;165;106;178;52;79;151;133;158;101;2;57;129;152;26;86;189;124;92;179;31;175;171;16;44;25;113;56;196;145;78;120;75;1;97;115,7057291710026267389,40.123271
steepest_intra:nodes_start:random,81,171917,88728,83189,1495014950,100001,28;139;82;119;81;40;43;112;6;122;2;32;21;114;145;16;171;157;113;185;184;84;41;197;59;79;3;92;91;52;168;174;164;107;58;29;54;53;120;13;179;176;141;66;45;127;75;124;5;30;63;130;0;117;94;152;85;31;57;46;115;109;137;61;144;95;49;64;26;97;167;86;65;193;69;110;159;76;9;138;165;62;183;89;56;38;196;78;98;50;10;48;181;20;23;133;161;123;135;101,4105719290070759343,40.113973
steepest_intra:nodes_start:random,82,87428,38909,48519,1495014950,100001,162;123;127;135;129;57;55;52;178;106;185;81;196;49;102;167;152;121;53;158;154;180;176;137;144;14;119;40;165;39;27;90;179;124;193;159;22;18;108;117;143;0;68;46;94;92;78;25;120;2;1;97;100;26;101;86;63;118;5;160;54;34;181;42;43;116;65;47;131;149;59;115;139;41;184;177;10;4;112;70;75;44;16;171;175;113;31;145;79;133;51;183;89;186;15;9;62;148;80;151,5585187319783690408,39.994327
steepest_intra:nodes_start:random,83,102245,50438,51807,1495014950,100001,189;97;124;94;90;164;7;165;49;102;144;138;178;106;3;145;129;2;154;135;70;51;115;139;193;68;46;65;149;4;112;47;118;59;122;152;57;55;167;148;15;183;93;117;143;0;136;180;160;22;69;163;108;18;140;89;114;186;23;137;151;162;79;63;80;43;96;41;181;42;116;123;133;100;120;171;31;78;44;25;53;127;48;34;184;176;52;185;40;175;16;1;86;26;75;92;14;9;62;101,7414186376238931974,40.155965
steepest_intra:nodes_start:random,84,124436,64411,60025,1495014950,100001,62;51;59;47;151;79;106;185;44;57;90;40;189;158;70;180;122;18;108;103;160;184;54;48;42;116;131;127;154;81;187;165;169;92;100;65;34;20;159;49;52;78;145;196;14;138;178;198;139;146;104;10;133;86;2;148;167;111;114;186;89;115;193;41;181;199;22;192;43;177;30;105;170;143;183;176;80;53;97;121;124;135;123;75;120;16;85;56;113;175;171;31;101;35;4;162;23;94;63;137,485756234595359186,40.277538
steepest_intra:nodes_start:random,85,106077,54793,51284,1495014950,100001,75;181;42;0;183;152;2;178;106;92;78;52;40;39;144;186;68;18;22;146;135;1;101;86;62;15;109;51;118;116;105;77;65;143;117;93;139;115;5;46;176;124;148;165;90;82;44;171;175;120;180;154;133;149;131;43;184;177;10;112;127;53;63;79;122;94;55;57;129;145;81;185;196;31;16;113;14;49;9;80;162;123;70;89;76;137;23;114;153;54;160;48;34;41;193;59;151;97;26;100,6868494032917028720,40.216193
steepest_intra:nodes_start:random,86,171778,86332,85446,1495014950,100001,3;101;190;48;199;110;20;134;28;80;94;151;149;161;60;139;140;181;194;24;57;92;16;75;26;1;55;129;172;8;39;109;176;111;152;97;125;53;70;85;78;130;173;162;6;164;40;185;9;138;59;198;84;54;4;35;104;34;22;195;96;67;108;122;33;12;2;120;186;197;51;14;144;189;193;77;175;31;21;191;43;118;141;37;63;136;145;168;44;62;15;49;105;41;154;180;178;64;137;0,2304821742830446740,40.290769
steepest_intra:nodes_start:random,87,94750,46087,48663,1495014950,100001,135;84;35;180;53;2;129;101;26;4;10;177;54;48;160;184;131;133;94;124;185;119;106;167;176;80;79;63;86;75;120;44;25;16;78;145;92;57;178;49;62;9;143;0;68;139;42;43;115;46;51;97;1;100;151;72;118;59;65;116;41;193;159;18;108;22;34;181;137;90;27;144;186;23;183;89;114;15;148;152;121;162;149;123;127;70;171;175;113;31;196;81;40;165;138;14;52;55;154;112,8274625618181965546,40.159937
steepest_intra:nodes_start:random,88,95388,47058,48330,1495014950,100001,102;178;40;119;165;185;196;81;90;27;164;7;21;144;181;34;160;42;5;193;159;22;18;108;151;135;75;120;145;31;78;52;148;186;137;176;80;124;55;57;25;16;171;175;113;44;133;51;68;46;115;43;184;127;154;53;121;100;86;101;26;1;152;2;129;92;117;139;41;54;177;84;112;79;94;62;9;167;97;63;180;162;47;65;118;59;131;116;77;149;123;70;106;49;89;143;0;183;15;14,2817969842529750669,40.026966
steepest_intra:nodes_start:random,89,90326,39914,50412,1495014950,100001,86;151;149;65;59;137;15;148;167;129;57;14;144;114;93;108;18;159;22;146;30;54;184;43;47;116;42;160;34;181;5;118;51;176;80;100;26;121;0;46;115;139;68;117;23;186;9;178;106;52;55;185;196;179;92;120;101;135;127;123;162;133;79;63;136;53;158;180;154;112;4;177;48;193;41;143;183;89;21;164;90;165;40;2;152;1;97;189;94;124;62;102;49;145;78;175;171;16;44;75,8394058501077425454,40.099446
steepest_intra:nodes_start:random,90,97432,46862,50570,1495014950,100001,139;46;143;176;63;94;89;183;117;0;186;9;62;165;40;185;92;25;82;129;2;101;1;26;100;53;158;180;57;145;78;44;86;184;177;190;54;48;131;47;149;65;151;79;133;162;24;123;112;84;160;42;41;18;193;159;22;34;181;116;124;55;52;154;135;127;70;137;23;144;102;167;120;16;171;31;75;97;152;49;178;106;3;179;175;113;196;90;95;14;15;51;109;118;59;37;148;80;43;115,6437161192362860346,40.290125
steepest_intra:nodes_start:random,91,213856,119983,93873,1495014950,100001,175;125;87;63;135;71;37;182;123;199;30;28;194;114;156;29;139;103;184;53;73;129;75;32;121;12;9;27;164;141;104;16;106;131;77;54;69;92;132;170;133;90;102;66;67;59;4;44;100;180;190;191;198;43;115;23;61;62;105;150;124;46;193;189;145;78;119;56;31;26;159;20;99;49;161;173;122;15;33;81;74;72;22;146;6;196;171;85;19;84;112;89;183;176;79;165;40;58;24;192,4773921201879406051,40.180626
steepest_intra:nodes_start:random,92,98135,48195,49940,1495014950,100001,159;42;5;47;135;44;171;175;56;16;185;178;3;179;145;97;133;115;68;140;117;93;108;22;18;89;15;148;57;92;120;75;152;176;137;23;186;114;9;144;138;165;40;113;31;78;129;101;180;162;151;51;46;198;139;34;160;53;86;14;21;7;90;27;39;106;49;183;0;143;118;59;65;116;131;149;123;2;52;55;94;124;62;102;1;26;63;80;79;154;70;127;112;84;4;184;54;43;41;193,8922617722040908041,40.138003
steepest_intra:nodes_start:random,93,88203,39162,49041,1495014950,100001,193;159;146;22;18;69;108;117;0;46;42;181;34;160;184;162;133;180;154;158;53;63;122;186;15;21;164;90;81;196;55;52;106;178;49;51;149;131;65;59;118;115;139;41;5;43;151;79;152;97;1;101;86;75;25;78;145;92;129;80;176;137;143;183;89;23;2;120;44;16;171;175;113;31;123;54;177;112;70;135;57;185;40;165;39;138;14;144;102;62;9;37;148;124;94;189;26;100;121;116,7455203149373247912,40.486141
steepest_intra:nodes_start:random,94,116433,56912,59521,1495014950,100001,159;199;18;0;143;118;149;135;189;8;7;164;90;165;119;55;148;23;117;46;115;41;103;34;30;48;65;80;133;116;197;47;86;82;92;2;63;79;146;22;43;44;78;185;40;57;129;62;15;49;1;101;100;136;123;112;70;180;121;97;124;106;178;3;14;21;144;122;51;45;162;151;59;193;42;184;52;145;16;120;75;158;154;130;12;183;137;176;74;152;94;19;53;24;160;181;177;54;195;139,4290878894305303891,40.168227
steepest_intra:nodes_start:random,95,98333,49584,48749,1495014950,100001,138;127;123;47;65;92;145;196;81;40;185;179;152;26;100;53;151;118;59;51;176;12;124;167;52;55;57;129;2;97;121;122;63;135;70;86;1;75;101;133;131;149;162;78;113;175;171;46;193;41;159;22;34;181;160;184;48;54;177;10;112;154;180;189;94;23;89;183;186;14;178;120;44;16;31;106;49;137;108;18;93;117;143;0;139;42;43;116;115;80;148;9;62;144;21;164;27;90;165;79,3827236257949858508,40.363992
steepest_intra:nodes_start:random,96,110736,56689,54047,1495014950,100001,159;199;22;101;44;25;196;81;113;175;145;57;152;94;193;5;118;176;137;153;0;178;185;40;165;180;154;53;121;133;151;72;24;131;43;139;140;143;117;23;15;9;79;63;184;160;34;48;54;30;70;75;129;78;92;127;4;112;177;105;65;51;80;167;111;148;102;62;183;89;186;49;32;144;155;14;95;164;46;68;41;115;135;1;97;120;171;16;31;55;52;106;59;116;42;47;162;123;149;18,543855100953384661,40.362464
steepest_intra:nodes_start:random,97,101748,50306,51442,1495014950,100001,159;54;177;160;193;41;80;79;51;46;93;117;0;183;15;9;137;118;123;154;180;100;52;165;21;14;49;102;178;106;111;12;124;3;138;144;62;37;167;55;40;119;185;90;81;196;25;120;53;162;42;43;135;70;127;112;131;149;184;34;181;68;140;108;18;69;143;148;145;78;31;16;75;94;176;59;139;115;72;63;121;182;65;116;151;44;175;171;2;152;101;97;1;92;57;129;86;158;133;22,1520727631859751537,40.099049
steepest_intra:nodes_start:random,98,126552,62618,63934,1495014950,100001,58;49;138;27;90;167;176;124;148;9;46;42;181;5;121;86;6;70;173;180;144;64;51;59;79;154;149;34;160;118;133;128;172;152;74;123;198;115;151;137;33;37;15;62;106;119;40;185;19;94;55;31;113;16;78;145;75;63;127;53;135;114;23;0;117;191;139;43;116;65;109;153;143;108;18;22;193;35;166;52;3;97;1;101;120;25;44;89;183;178;57;92;111;80;84;184;11;162;14;165,7484682714488637824,40.031965
steepest_intra:nodes_start:random,99,103106,51453,51653,1495014950,100001,100;133;181;146;22;159;193;41;176;63;1;82;120;44;145;57;92;152;97;123;84;48;160;54;34;15;148;167;162;42;43;59;118;51;75;129;106;52;37;9;62;155;144;68;108;18;80;94;121;101;2;25;175;16;55;178;49;14;40;119;112;4;190;177;184;35;77;65;116;5;47;131;149;127;135;154;158;86;26;79;115;139;117;143;183;102;185;165;31;113;171;78;23;137;89;0;46;151;180;53,4441112968381260799,40.149850
steepest_intra:nodes_start:random,100,90500,40468,50032,1495014950,100001,183;14;178;165;39;90;40;185;1;100;136;51;118;151;133;79;94;124;148;102;62;9;15;186;137;116;43;42;5;96;139;46;121;26;101;75;120;25;78;145;179;106;49;23;89;0;117;93;68;176;152;92;57;55;52;129;2;97;189;63;122;80;115;41;193;159;181;184;135;154;180;158;53;86;44;16;171;175;113;31;59;65;131;149;162;123;127;112;4;10;177;54;48;160;34;22;18;108;143;144,3903207270262902164,40.102736
steepest_intra:nodes_start:random,101,86066,35683,50383,1495014950,100001,65;68;93;117;46;198;139;115;5;59;118;51;151;162;123;127;112;184;160;193;41;154;86;75;44;16;81;90;165;40;119;185;196;31;113;175;171;9;62;148;152;120;78;145;92;57;55;52;106;178;129;2;101;1;97;26;80;176;137;0;170;143;183;89;186;23;149;35;177;54;34;146;22;18;159;195;181;42;133;79;63;136;180;158;53;100;102;144;14;49;167;124;94;70;135;131;77;43;47;116,2231781803215333989,40.159430
steepest_intra:nodes_start:random,102,111847,57486,54361,1495014950,100001,86;75;40;185;164;90;165;102;144;143;0;9;52;14;49;178;78;44;82;1;176;18;108;41;146;22;103;42;105;149;154;120;171;175;92;46;117;68;89;138;32;12;137;51;193;139;118;133;182;101;97;152;106;3;167;62;15;186;66;162;151;72;35;84;177;135;180;123;184;43;116;183;23;65;160;181;34;115;59;19;26;94;124;63;37;148;80;79;53;100;2;57;55;31;113;25;145;38;16;129,5856265438790248428,39.950507
steepest_intra:nodes_start:random,103,123199,63576,59623,1495014950,100001,65;151;180;63;79;80;176;23;137;144;14;138;57;52;167;97;100;189;124;12;94;130;118;184;199;69;159;193;133;120;75;1;92;129;55;2;121;152;44;38;78;25;145;165;164;58;90;111;41;115;116;131;84;123;154;26;46;0;191;139;143;9;196;113;171;16;47;59;51;117;93;135;6;178;106;53;162;20;18;140;119;40;185;49;183;68;181;195;103;22;34;42;198;37;148;102;62;86;101;158,7040135644551751300,40.167300
steepest_intra:nodes_start:random,104,234346,132468,101878,1495014950,100001,146;197;154;110;20;122;81;143;18;174;1;155;63;40;98;72;124;138;163;43;158;5;24;79;22;117;133;136;153;70;39;71;15;31;96;46;156;109;67;45;175;130;103;41;76;162;61;55;49;173;69;36;34;192;9;12;170;19;42;60;148;33;107;17;44;14;123;29;128;25;111;77;147;10;93;102;87;86;51;35;149;144;165;27;58;2;196;8;74;167;83;80;73;54;30;59;66;191;84;62,5288985259062990254,40.395727
steepest_intra:nodes_start:random,105,102639,51550,51089,1495014950,100001,16;171;113;175;31;185;178;49;124;94;106;81;90;7;58;164;21;14;138;165;40;92;42;184;48;54;116;183;89;117;140;181;41;59;51;109;47;77;65;160;34;146;22;193;159;199;18;68;2;152;100;75;97;86;186;114;15;148;12;26;70;123;133;162;154;135;180;182;53;79;80;176;118;115;139;46;143;0;43;177;190;112;127;63;101;1;78;145;55;151;72;62;52;57;44;120;137;23;9;144,6028146087882469843,40.241356
steepest_intra:nodes_start:random,106,111270,55508,55762,1495014950,100001,193;139;79;26;1;2;152;94;136;154;12;148;9;102;37;62;92;145;53;127;34;48;30;54;160;103;22;110;163;108;69;18;41;159;116;123;135;133;80;155;144;21;49;137;176;97;101;100;162;51;140;93;183;120;78;40;119;39;165;138;14;90;27;31;44;75;149;47;59;118;46;42;184;167;57;157;113;171;180;151;143;0;73;132;7;164;58;81;175;16;106;178;185;52;55;129;63;65;43;115,7856902018521102650,40.387922
steepest_intra:nodes_start:random,107,93629,41937,51692,1495014950,100001,82;78;90;27;165;14;144;7;164;81;31;16;88;171;145;57;55;21;95;39;40;196;157;56;113;175;25;44;94;80;43;42;149;131;127;135;162;59;18;108;143;183;137;176;66;109;51;79;63;180;154;112;4;84;116;65;118;151;133;123;35;184;160;34;53;86;75;2;129;92;52;106;3;185;119;178;152;100;26;1;148;62;15;0;117;68;46;139;41;193;159;22;115;23;9;102;49;97;101;120,5502409326576698967,40.060530
steepest_intra:nodes_start:random,108,86104,37116,48988,1495014950,100001,131;42;5;41;193;139;46;137;2;129;92;78;145;179;196;81;40;185;101;86;133;151;51;118;160;48;34;146;22;195;96;59;123;162;79;63;94;124;152;55;52;14;144;102;49;53;158;180;54;177;10;4;112;127;70;154;135;184;181;159;18;108;93;143;183;89;23;186;15;148;9;62;138;39;27;90;165;106;3;178;57;31;113;175;171;16;44;120;75;1;97;80;176;0;117;115;116;65;149;43,3617892438817609171,40.471882
steepest_intra:nodes_start:random,109,101978,51208,50770,1495014950,100001,106;133;194;154;26;2;178;3;49;14;52;179;78;171;16;175;120;53;151;68;108;18;22;193;41;46;176;122;121;94;189;86;44;81;90;31;113;56;145;129;152;167;148;9;62;124;59;118;165;185;40;196;92;97;80;109;115;139;198;79;55;57;75;1;100;101;182;180;131;43;116;65;149;162;51;0;143;183;89;23;137;184;84;127;135;70;112;190;177;10;54;48;42;181;34;160;123;144;102;63,8635243108708957655,40.223576
steepest_intra:nodes_start:random,110,124898,67044,57854,1495014950,100001,93;118;139;46;24;184;190;112;120;175;16;94;133;154;180;159;193;34;127;15;164;165;106;40;90;95;71;78;145;3;137;0;117;68;41;116;149;131;151;162;115;142;199;198;65;176;51;48;30;84;123;135;70;156;177;160;5;80;79;62;186;89;148;31;44;14;52;55;152;97;171;113;56;49;178;32;185;57;92;1;100;53;63;101;189;191;22;108;67;18;20;146;37;144;77;43;42;143;183;59,5354246978482379817,40.116617
steepest_intra:nodes_start:random,111,153113,81846,71267,1495014950,100001,0;89;183;14;95;32;178;40;167;52;58;27;98;82;120;75;101;148;91;17;157;81;111;123;151;109;65;59;176;79;180;76;23;137;41;108;18;172;119;179;145;128;94;87;135;131;47;45;63;53;97;158;193;54;55;49;102;8;90;165;74;184;30;10;42;152;175;106;186;48;160;144;39;136;162;133;80;117;159;34;185;78;168;92;139;36;153;70;154;121;86;44;2;1;173;51;197;115;191;62,1644901270332763512,40.229705
steepest_intra:nodes_start:random,112,107616,55601,52015,1495014950,100001,94;148;106;14;73;144;40;179;92;145;44;129;3;167;74;2;122;143;0;68;108;18;193;59;137;15;49;165;39;119;185;16;113;171;90;58;21;52;55;178;152;116;43;41;198;46;78;175;31;56;196;102;62;80;51;118;66;9;57;25;53;70;135;34;22;103;160;184;112;149;65;42;54;177;123;23;89;183;117;181;159;139;115;121;86;100;101;63;154;151;133;162;180;189;120;75;97;1;79;176,5898113258515473728,40.278049
steepest_intra:nodes_start:random,113,109583,58685,50898,1495014950,100001,185;183;143;93;68;139;48;177;184;80;176;137;46;41;193;108;18;116;65;195;103;34;53;182;154;78;145;49;62;148;94;79;63;86;1;101;75;120;171;113;31;196;165;40;152;151;59;118;57;55;52;178;102;186;114;9;144;64;15;23;72;35;112;123;44;16;56;179;92;129;149;160;181;43;42;115;51;162;133;2;90;81;85;175;97;131;159;199;22;146;54;10;70;135;180;0;117;89;14;106,6201466546893033065,40.815998
steepest_intra:nodes_start:random,114,125351,66762,58589,1495014950,100001,127;70;86;145;31;16;101;177;54;160;96;43;118;80;94;124;23;183;198;139;193;137;37;12;176;184;48;190;84;89;186;102;148;151;116;34;181;115;49;165;138;9;62;144;100;97;106;178;41;69;108;18;59;111;167;53;123;35;117;153;66;51;46;68;0;121;26;133;45;162;63;57;40;185;119;90;171;113;75;194;135;60;143;14;78;82;44;154;42;5;65;149;180;136;1;2;120;152;79;122,6851592810158073416,39.967571
steepest_intra:nodes_start:random,115,137591,71017,66574,1495014950,100001,137;45;162;43;123;1;97;124;49;185;151;72;80;182;148;118;59;65;47;66;139;193;96;41;195;142;110;46;77;116;102;52;94;26;135;180;194;176;89;114;103;22;122;113;171;88;16;57;120;138;21;183;143;117;115;109;55;40;81;145;42;177;34;104;184;9;73;15;14;2;131;166;154;44;78;86;53;12;79;63;133;93;140;62;106;157;56;91;178;3;92;125;152;75;101;100;149;84;54;160,2188042048899579803,40.341176
steepest_intra:nodes_start:random,116,118843,63259,55584,1495014950,100001,63;118;59;162;75;2;101;193;18;143;40;196;81;145;92;129;152;86;26;167;14;106;178;148;66;42;43;77;149;94;124;158;135;112;123;46;68;34;48;53;180;154;0;170;117;5;160;30;190;1;164;27;90;144;41;191;139;195;22;183;89;137;79;133;51;109;115;96;105;151;97;82;185;8;55;52;57;120;44;31;78;16;171;165;3;80;54;10;177;184;116;47;176;186;15;49;62;9;19;65,1476182510642302225,40.288142
steepest_intra:nodes_start:random,117,93444,42994,50450,1495014950,100001,40;175;171;16;145;52;62;183;143;0;137;152;1;101;86;100;121;41;193;139;198;115;9;49;14;144;114;89;117;46;68;18;159;22;34;160;54;177;184;43;149;131;154;180;80;176;51;109;122;26;97;3;95;39;165;178;106;55;57;92;129;179;196;81;90;119;118;116;65;135;70;127;123;162;133;53;75;44;25;78;31;113;56;120;2;5;42;59;151;79;63;94;124;148;186;23;15;102;138;185,6985193091085965423,40.154872
steepest_intra:nodes_start:random,118,106003,54547,51456,1495014950,100001,149;65;123;70;53;101;56;113;90;39;178;49;86;26;121;94;89;183;0;143;137;25;44;129;40;106;97;1;46;159;195;103;184;160;181;42;115;116;5;139;93;117;23;186;73;102;179;145;78;57;114;15;9;3;185;2;120;152;189;158;154;135;162;79;124;14;165;16;31;175;171;75;100;151;118;41;193;18;22;34;54;148;144;62;80;182;180;127;112;131;176;167;52;55;92;63;133;51;59;43,5006526370398821802,40.022069
steepest_intra:nodes_start:random,119,104920,53485,51435,1495014950,100001,165;81;113;175;171;196;185;111;159;193;18;22;59;80;26;97;101;86;129;57;106;55;178;145;92;100;158;70;135;127;123;54;48;34;184;160;181;65;149;186;9;144;183;143;0;117;131;35;112;109;148;52;78;16;31;2;1;94;79;154;47;43;42;5;116;118;198;46;63;120;44;75;53;180;133;176;12;152;40;90;62;23;153;108;69;199;41;139;115;68;93;72;151;162;51;137;15;14;49;164,7887599678855300167,40.344268
steepest_intra:nodes_start:random,120,106210,52434,53776,1495014950,100001,48;47;151;133;80;129;171;175;113;78;149;112;123;53;75;44;82;176;139;68;137;16;31;185;106;9;51;109;72;148;8;40;57;55;52;178;165;138;49;144;183;0;143;153;117;140;93;46;23;12;94;122;162;65;116;43;5;42;96;59;154;180;121;26;14;21;164;71;90;81;145;179;102;62;167;79;63;114;15;124;97;152;2;92;120;1;100;86;101;115;41;193;22;160;184;70;135;127;84;34,6930550586359122320,40.164688
steepest_intra:nodes_start:random,121,98552,48281,50271,1495014950,100001,101;124;12;94;79;112;184;43;65;68;139;5;42;116;162;152;31;113;78;2;135;127;70;3;106;165;185;178;167;51;109;59;115;22;146;159;193;41;118;151;92;145;90;39;138;144;14;49;52;55;100;121;53;148;9;15;143;117;108;18;140;46;149;131;123;75;120;44;25;16;171;175;81;40;119;102;62;63;154;180;182;133;181;160;54;177;34;0;183;89;137;176;80;189;129;57;1;97;26;86,1386670135790964944,40.422434
steepest_intra:nodes_start:random,122,109519,52079,57440,1495014950,100001,51;198;46;8;165;52;55;57;78;31;171;16;162;41;115;191;69;108;18;193;59;176;94;189;26;101;2;196;81;90;107;27;86;121;44;120;75;97;152;123;116;65;47;117;23;137;102;9;62;49;138;32;106;40;185;92;145;179;129;5;96;135;133;151;53;1;100;136;180;154;63;124;167;148;79;0;143;93;139;22;160;30;10;177;54;42;34;159;142;68;183;178;3;144;14;28;184;43;105;80,2236166726724871743,40.348354
steepest_intra:nodes_start:random,123,90864,40008,50856,1495014950,100001,54;34;103;146;22;159;193;0;143;183;23;101;1;97;189;79;118;65;116;59;148;119;40;185;52;55;92;57;49;9;62;102;144;14;165;196;31;175;16;129;2;152;167;106;178;3;15;114;186;41;181;160;131;100;26;121;80;46;139;115;176;124;94;63;133;151;51;137;39;27;90;81;113;171;78;145;25;44;120;75;86;127;112;4;162;158;53;180;154;135;70;194;123;149;43;42;184;177;190;10,3214038025017681386,40.054493
steepest_intra:nodes_start:random,124,111306,57226,54080,1495014950,100001,123;112;162;180;154;59;116;65;55;52;57;129;148;15;9;62;183;143;117;14;178;49;22;146;195;41;94;152;92;165;40;119;106;167;177;190;184;5;68;153;89;23;186;0;198;191;139;46;137;144;138;185;179;145;25;44;16;175;171;78;2;101;42;160;34;97;120;75;1;176;51;118;151;133;63;79;121;26;43;181;159;69;199;193;131;149;86;100;18;108;115;72;80;122;53;158;136;70;135;4,3181481969458418331,40.192270
steepest_intra:nodes_start:random,125,90378,40557,49821,1495014950,100001,138;14;102;80;151;123;162;133;180;135;127;22;146;160;184;35;149;131;41;159;193;115;116;43;5;42;181;34;54;177;70;154;53;86;124;94;79;63;100;26;97;1;2;165;39;90;81;196;120;75;101;152;21;164;95;40;119;157;56;113;175;171;16;44;25;145;179;55;52;178;106;148;176;59;65;118;109;51;183;89;15;49;62;9;23;143;46;139;18;108;0;137;129;78;38;31;92;57;185;144,5071032673195854604,40.014396
steepest_intra:nodes_start:random,126,194439,108406,86033,1495014950,100001,98;59;194;70;176;80;21;164;95;84;28;86;133;111;62;89;68;117;143;93;186;52;100;158;75;165;128;27;113;13;39;40;79;125;53;152;171;157;188;35;46;181;87;12;15;193;43;104;5;139;184;149;65;109;32;37;64;103;198;168;120;17;187;54;118;148;56;31;58;106;150;180;135;147;177;34;178;16;60;77;156;63;162;94;57;124;112;110;140;23;73;169;179;183;153;115;189;2;145;48,8013680137434019376,40.227991
steepest_intra:nodes_start:random,127,102271,52862,49409,1495014950,100001,55;184;160;54;34;22;108;18;193;68;63;86;100;53;135;127;59;51;151;133;94;152;2;129;62;9;15;23;89;183;186;180;154;70;194;0;117;93;143;189;26;1;101;97;46;139;5;42;43;137;49;185;165;57;92;178;106;14;37;118;116;84;4;112;75;145;31;90;144;102;25;44;171;175;16;120;124;176;80;79;162;123;131;149;65;115;41;159;195;146;181;78;56;113;157;196;81;40;52;148,7825084810511999062,40.325858
steepest_intra:nodes_start:random,128,115175,61307,53868,1495014950,100001,46;116;47;180;86;44;171;81;106;3;9;62;94;135;72;51;162;161;151;143;0;140;198;133;75;120;2;97;152;42;34;160;70;127;123;68;93;18;22;184;35;154;1;92;52;148;139;193;181;41;159;57;165;40;185;138;178;78;145;101;53;112;84;54;4;24;105;131;137;15;23;183;89;144;21;55;63;79;80;109;59;118;43;149;45;176;114;73;164;39;49;14;90;31;56;113;175;16;115;65,7750279478972199478,40.330386
steepest_intra:nodes_start:random,129,116535,63720,52815,1495014950,100001,42;34;30;177;54;18;108;41;131;51;178;106;44;145;9;62;148;144;94;189;167;152;97;1;86;25;78;49;14;21;165;31;113;175;16;171;176;162;123;151;133;183;143;139;159;193;198;68;116;135;154;40;119;196;169;129;120;124;65;59;101;2;182;117;0;137;63;158;180;4;184;43;138;52;75;121;80;79;122;172;55;92;58;71;95;46;115;90;81;185;57;26;100;53;112;190;48;160;181;22,2453698015041322550,40.094035
steepest_intra:nodes_start:random,130,131438,66576,64862,1495014950,100001,62;92;175;171;44;63;122;130;121;180;3;106;144;59;43;181;160;54;34;48;77;151;176;80;133;53;101;1;152;56;38;182;46;68;116;177;84;195;18;162;99;2;158;135;154;136;51;115;65;16;78;120;13;31;145;4;41;22;193;96;118;73;39;196;12;137;89;183;170;140;139;42;123;97;189;94;111;49;113;85;98;91;14;55;129;40;138;179;187;90;27;185;57;167;79;102;119;165;81;25,9131400776606123475,40.081825
steepest_intra:nodes_start:random,131,114302,60393,53909,1495014950,100001,199;18;22;72;86;75;2;129;92;119;40;46;68;181;42;43;65;16;171;175;120;54;30;34;146;159;41;167;57;78;31;196;145;101;53;154;63;176;9;49;37;186;183;170;153;117;143;137;62;106;52;116;160;193;15;155;102;144;148;149;184;177;112;25;113;56;44;1;80;139;115;59;51;109;118;127;123;162;79;94;124;97;152;180;135;151;133;185;165;178;14;114;23;76;89;0;140;96;5;108,1108503193878117178,40.250309
steepest_intra:nodes_start:random,132,116251,61591,54660,1495014950,100001,183;159;184;190;112;35;5;65;109;118;59;149;123;145;31;82;154;133;139;163;142;42;115;46;9;49;55;52;57;25;120;143;108;199;41;193;18;68;151;162;51;66;130;92;179;129;2;1;53;135;70;26;152;175;171;16;63;182;97;167;196;78;75;101;100;106;165;40;44;86;180;127;79;80;176;62;14;144;178;185;27;90;21;117;140;195;34;43;116;84;4;160;181;96;137;148;124;94;89;22,1798110223898187700,40.211161
steepest_intra:nodes_start:random,133,103242,50728,52514,1495014950,100001,160;42;43;59;51;80;109;118;116;65;47;181;159;199;18;117;143;183;186;119;40;185;178;52;55;92;74;152;16;56;171;144;102;145;25;2;89;23;137;94;124;97;101;86;75;26;1;129;57;106;138;176;133;151;84;35;162;81;90;165;9;62;167;128;148;79;63;180;182;154;53;70;135;184;34;146;22;41;193;139;198;46;0;115;149;131;5;68;78;113;175;95;164;14;49;31;44;120;127;123,3664444349227069551,40.181600
steepest_intra:nodes_start:random,134,104484,52026,52458,1495014950,100001,81;40;185;196;78;113;171;145;167;124;148;165;8;90;119;186;23;178;106;0;159;193;115;123;126;112;70;133;122;80;151;63;79;94;12;194;127;24;41;108;18;42;160;195;22;184;109;176;102;49;52;57;92;97;158;154;180;26;1;75;175;16;25;55;37;62;14;9;183;143;117;68;43;131;149;46;139;116;65;34;54;177;10;135;162;59;51;137;15;144;179;44;152;100;2;129;120;53;86;101,1431040539719327705,40.289108
steepest_intra:nodes_start:random,135,87521,38797,48724,1495014950,100001,51;116;42;43;131;123;149;41;159;22;146;193;139;68;46;183;89;144;14;90;81;31;78;145;179;9;62;102;49;3;178;106;52;152;97;1;92;185;40;119;165;59;65;35;84;112;4;10;177;54;34;160;48;184;53;100;120;25;44;2;124;94;122;79;80;176;0;143;117;93;108;18;115;118;151;63;121;26;101;129;57;55;167;133;162;127;70;135;154;180;158;86;75;16;171;175;113;148;23;137,3047612078437938537,40.219834
steepest_intra:nodes_start:random,136,98208,49072,49136,1495014950,100001,25;92;57;55;179;129;1;97;2;16;171;78;120;44;31;175;113;56;81;40;185;180;135;154;53;158;100;94;124;152;167;148;37;115;193;159;84;4;112;52;90;165;138;14;106;178;49;183;18;22;34;30;48;43;89;9;62;144;15;114;137;184;35;181;41;139;68;117;0;143;118;65;131;149;123;127;70;176;186;23;46;5;160;54;177;26;101;86;79;151;133;80;51;59;42;116;162;63;75;145,4171748362110656562,40.101890
steepest_intra:nodes_start:random,137,102969,54156,48813,1495014950,100001,196;14;102;148;79;180;135;184;54;140;93;143;117;0;153;23;185;31;56;113;9;62;49;144;137;176;151;80;53;86;152;2;120;44;25;75;101;26;97;1;133;43;22;159;108;18;41;116;162;154;129;92;78;57;106;114;186;89;183;68;181;34;131;94;124;40;90;165;39;138;55;52;16;175;171;65;47;42;160;48;177;84;112;46;139;193;149;123;127;70;63;178;3;167;118;59;115;51;145;81,3560105191288603069,40.307879
steepest_intra:nodes_start:random,138,149131,77399,71732,1495014950,100001,162;149;184;84;116;123;115;41;28;29;45;5;42;54;177;194;24;156;112;146;118;59;63;55;73;14;102;80;133;151;49;178;56;157;78;189;121;148;37;152;53;154;131;93;143;110;198;144;39;8;57;9;190;34;99;101;92;120;44;33;183;108;22;158;87;62;176;130;196;98;113;175;171;17;3;106;1;136;94;122;10;160;119;185;52;137;139;65;147;30;193;117;97;180;159;96;105;43;135;75,1549295168209015976,40.121809
steepest_intra:nodes_start:random,139,179724,94749,84975,1495014950,100001,86;96;68;138;52;95;42;22;77;105;99;178;135;127;48;158;97;166;41;112;162;157;16;78;130;110;163;159;139;170;183;62;145;63;180;74;13;56;101;59;43;0;186;14;106;164;7;73;21;64;15;144;39;196;113;58;49;66;192;54;149;195;193;36;156;6;182;4;123;94;85;17;75;179;174;55;155;38;129;120;119;185;100;19;109;23;114;197;115;60;111;61;2;176;34;65;53;173;154;108,6672432009686293491,40.120349
steepest_intra:nodes_start:random,140,94924,44097,50827,1495014950,100001,116;96;5;42;152;2;101;86;133;65;193;108;18;22;34;160;149;102;49;178;106;185;165;40;81;196;78;145;120;44;171;113;85;157;179;129;121;131;184;4;112;177;181;159;41;115;46;23;186;124;94;158;180;53;100;26;1;97;176;51;118;59;135;154;63;80;79;75;25;16;175;56;31;92;62;148;70;127;123;162;151;89;183;0;143;117;139;198;68;137;15;9;144;14;138;52;55;57;167;43,1314722223506889581,40.057645
steepest_intra:nodes_start:random,141,107756,58676,49080,1495014950,100001,35;52;106;49;178;3;145;78;179;92;44;120;2;53;34;22;139;14;21;164;7;62;23;143;93;68;137;9;102;144;15;72;131;65;116;47;115;41;159;108;117;183;89;79;133;151;51;118;42;160;54;10;177;184;43;63;152;129;124;80;176;94;26;97;1;86;154;149;123;135;180;101;75;40;185;16;175;171;56;113;31;57;167;148;0;140;18;199;193;46;198;59;162;81;90;165;70;127;112;55,6834634820926164631,40.159821
steepest_intra:nodes_start:random,142,141817,71954,69863,1495014950,100001,171;180;158;151;133;162;149;159;139;153;89;130;53;75;136;111;62;37;9;49;3;52;160;34;54;112;4;45;51;41;67;93;18;142;193;110;117;115;131;77;176;137;106;178;145;78;44;31;128;24;11;123;179;169;196;17;185;33;146;22;183;101;1;56;168;2;135;154;6;184;65;116;148;63;94;97;120;82;165;189;152;26;66;42;181;43;48;143;81;13;113;16;175;187;40;92;70;29;59;129,482600706127336674,40.185825
steepest_intra:nodes_start:random,143,212663,113350,99313,1495014950,100001,54;24;84;166;167;165;164;7;128;142;69;131;116;160;30;74;70;93;64;95;123;80;143;134;22;195;192;181;55;176;189;146;109;62;120;175;144;15;71;17;11;10;66;183;140;0;94;171;31;38;37;3;58;56;125;113;88;188;33;182;141;161;41;163;178;180;121;53;100;150;12;135;76;124;136;138;91;75;197;156;67;114;122;149;103;137;185;198;43;126;193;118;139;18;6;99;36;28;72;186,2291824040873299331,40.237241
steepest_intra:nodes_start:random,144,97304,47065,50239,1495014950,100001,55;52;167;137;0;143;183;89;186;15;138;165;7;164;90;81;196;157;171;16;25;78;57;106;49;37;148;176;123;112;54;34;146;22;18;139;68;140;93;117;129;175;113;31;145;92;2;101;100;53;94;124;80;118;115;116;131;127;135;154;180;149;42;5;41;43;65;152;120;44;40;185;70;4;35;59;151;178;3;14;102;155;144;9;62;46;193;181;160;184;109;51;162;133;86;75;1;63;79;97,8881412058720217339,40.134454
steepest_intra:nodes_start:random,145,101435,52280,49155,1495014950,100001,37;124;123;112;184;54;34;160;181;41;139;129;31;56;113;165;138;14;3;106;52;178;49;102;185;175;171;92;57;78;16;25;44;53;154;22;18;108;46;121;152;55;179;196;145;75;26;97;94;0;93;68;59;162;151;176;80;12;167;164;7;21;144;2;1;100;180;133;51;118;43;116;65;115;117;143;114;15;62;9;186;23;89;183;137;63;79;135;70;120;81;90;40;101;86;42;5;159;193;148,8184782114834729381,40.149098
steepest_intra:nodes_start:random,146,142645,70003,72642,1495014950,100001,178;92;62;3;106;179;57;100;63;35;181;68;67;18;19;189;23;103;20;142;46;22;41;5;192;159;42;116;1;86;136;65;161;176;151;141;69;193;198;115;80;148;49;129;2;123;29;131;139;36;108;84;184;130;94;44;78;25;70;154;122;59;127;135;97;172;14;165;119;40;185;81;157;55;144;32;145;120;101;152;138;52;125;150;75;77;149;95;8;180;6;53;182;89;183;93;143;0;153;113,122371693574136165,40.102564
steepest_intra:nodes_start:random,147,113752,57983,55769,1495014950,100001,176;51;151;133;79;158;180;94;12;0;143;96;43;193;159;9;49;92;74;152;1;97;137;153;68;108;18;146;22;30;54;34;53;154;35;42;184;112;135;101;75;57;25;129;196;90;14;32;144;106;52;8;185;21;183;77;160;11;123;194;86;120;145;78;148;23;198;41;139;46;118;116;65;149;162;115;60;178;165;31;171;16;44;26;100;62;102;55;179;119;40;81;2;63;84;177;4;127;80;59,7928142199179626721,40.326211
steepest_intra:nodes_start:random,148,117011,61288,55723,1495014950,100001,118;177;10;160;5;42;43;114;186;167;75;101;86;180;51;60;0;140;117;143;46;22;96;135;162;133;151;65;116;59;124;178;106;57;26;70;123;35;149;131;176;80;112;184;84;4;24;115;193;47;63;94;185;56;31;81;92;44;78;175;113;16;120;154;194;79;148;52;179;152;97;111;137;183;89;62;2;129;55;49;21;27;157;145;139;41;8;40;165;90;95;58;144;102;14;1;53;189;72;34,8639359578034294079,40.143776
steepest_intra:nodes_start:random,149,213450,122842,90608,1495014950,100001,78;63;119;57;129;188;88;170;77;83;70;31;126;86;152;62;193;125;100;164;162;123;76;72;59;3;58;107;130;15;144;9;114;148;14;24;131;84;132;7;37;33;2;89;102;49;158;117;139;134;110;133;25;176;0;29;92;138;90;39;17;40;101;109;120;115;103;35;42;34;146;192;4;184;147;183;189;172;179;190;161;46;13;150;44;80;22;141;54;20;142;135;198;199;27;196;145;51;137;48,4165166315427056838,40.085890
steepest_intra:nodes_start:random,150,114561,57482,57079,1495014950,100001,72;161;127;70;112;181;41;5;166;184;146;193;159;18;139;42;65;77;34;22;108;163;46;44;113;81;157;176;59;0;183;62;9;37;14;165;185;52;120;100;75;92;78;25;31;91;55;137;54;30;177;94;178;40;106;63;79;149;43;68;60;116;115;198;118;51;80;135;194;123;162;151;131;105;160;10;190;16;171;175;179;2;152;1;53;133;124;128;49;102;57;145;3;138;144;148;101;97;154;180,8269665407099475307,40.222093
steepest_intra:nodes_start:random,151,135813,69118,66695,1495014950,100001,189;172;49;106;57;44;16;81;145;25;78;144;14;58;90;113;82;183;114;165;7;164;71;40;24;42;193;41;133;75;101;1;148;102;97;87;137;73;37;55;152;99;63;69;146;181;151;86;182;123;11;190;139;76;89;176;46;59;122;167;185;8;178;62;136;26;120;100;65;54;184;84;35;177;4;118;162;135;53;19;154;180;79;109;112;131;51;116;115;34;160;30;5;192;28;15;92;121;94;70,6181352072575321648,40.051338
steepest_intra:nodes_start:random,152,102610,51158,51452,1495014950,100001,21;179;57;92;167;94;53;180;121;55;52;81;90;39;165;138;62;9;15;143;117;68;46;139;69;18;108;93;140;186;49;3;178;106;133;35;30;54;34;160;42;59;118;79;63;135;70;86;101;97;1;123;65;116;44;16;171;14;144;148;80;176;183;89;23;137;51;115;159;146;22;181;43;105;77;184;190;177;149;151;129;78;145;40;185;120;154;112;4;127;75;2;152;26;100;136;162;41;193;0,1890324353510583738,40.487082
steepest_intra:nodes_start:random,153,214442,120256,94186,1495014950,100001,78;23;129;88;178;16;133;186;7;58;189;19;35;76;165;102;39;125;11;112;154;119;2;199;68;21;132;18;117;61;118;105;111;55;44;150;72;53;28;166;198;32;14;49;121;86;144;36;43;22;20;130;52;75;38;51;139;91;157;187;31;100;155;122;170;162;66;168;25;120;182;114;3;74;33;73;195;84;163;148;27;69;156;184;30;116;99;59;97;9;185;40;94;137;142;193;41;15;89;127,7796738449442850194,40.316085
steepest_intra:nodes_start:random,154,88987,38851,50136,1495014950,100001,120;129;167;148;15;186;114;49;40;119;185;57;2;75;97;1;101;86;135;154;180;53;26;100;121;133;46;139;159;22;18;108;93;68;144;95;39;165;178;106;138;14;3;52;55;179;145;196;81;90;164;21;102;62;9;37;124;152;82;31;113;78;92;59;5;181;34;160;43;116;65;162;151;23;89;183;143;117;0;137;94;63;122;79;80;176;51;118;115;193;41;42;184;112;123;16;175;171;25;44,427896884471740468,40.296559
steepest_intra:nodes_start:random,155,108051,53913,54138,1495014950,100001,116;139;46;57;78;86;97;1;129;25;120;133;162;177;54;184;77;149;115;0;51;80;135;35;65;165;40;185;90;27;81;113;175;31;56;171;16;44;136;180;154;143;93;41;59;118;72;151;123;24;159;22;181;160;190;10;84;43;63;49;92;145;196;14;144;62;137;23;89;186;183;193;195;34;103;20;18;42;30;112;122;94;189;124;167;111;37;148;55;52;106;178;2;75;121;53;152;101;176;110,5672828923747867156,40.482487
steepest_intra:nodes_start:random,156,102566,50879,51687,1495014950,100001,102;94;79;51;109;43;115;139;41;193;159;108;69;18;20;22;181;5;42;184;190;10;177;123;194;133;80;55;165;185;40;90;39;144;124;176;162;127;4;112;70;75;16;175;171;78;152;136;182;63;53;2;113;56;31;129;59;46;68;0;153;117;143;52;179;145;44;151;65;149;118;23;89;183;186;189;86;101;178;106;116;34;160;137;49;57;92;120;1;97;135;158;154;180;26;167;148;62;9;14,7657756118383708375,40.073348
steepest_intra:nodes_start:random,157,95568,44370,51198,1495014950,100001,143;0;117;68;46;176;82;16;171;75;70;135;79;80;9;62;57;179;92;129;3;178;144;14;97;53;180;127;131;47;59;118;65;116;184;84;4;112;162;151;193;41;105;149;194;154;86;81;90;27;165;120;44;25;145;78;31;175;56;113;196;40;185;106;52;55;49;137;43;5;48;160;181;146;34;30;54;10;177;96;139;115;51;133;123;35;159;22;42;63;94;189;1;101;26;152;2;167;148;183,3299886585902639881,40.341501
steepest_intra:nodes_start:random,158,96807,48112,48695,1495014950,100001,92;57;55;52;117;140;93;26;86;1;97;152;53;122;59;118;51;23;15;62;9;89;183;65;47;116;0;143;108;18;22;159;193;41;43;112;70;135;79;176;80;151;133;2;120;44;171;113;175;145;106;178;167;94;148;14;138;165;119;185;40;78;16;31;39;27;90;81;196;129;42;115;139;162;180;154;63;137;186;144;49;102;124;131;149;184;177;54;160;181;34;103;146;68;46;123;127;75;101;179,3593593258035723335,40.143228
steepest_intra:nodes_start:random,159,114626,63349,51277,1495014950,100001,138;106;62;137;148;124;176;116;42;59;0;143;108;18;22;145;27;71;52;152;51;68;117;170;1;16;31;179;94;80;122;79;180;53;70;127;123;135;86;113;175;171;120;151;47;43;115;133;63;129;196;7;21;186;89;183;46;160;34;54;184;84;112;4;35;149;65;77;105;162;97;101;57;49;144;73;15;9;14;39;165;55;44;75;26;154;41;139;178;185;40;81;90;119;92;78;2;100;193;159,7539232870126905626,40.025187
steepest_intra:nodes_start:random,160,125505,62990,62515,1495014950,100001,114;46;1;74;152;97;94;133;53;101;15;49;185;52;55;129;25;44;120;16;171;31;154;112;84;59;65;22;18;67;139;146;193;116;166;24;181;48;14;106;3;21;186;115;195;118;162;51;34;190;35;156;109;137;130;63;151;80;180;79;135;30;42;5;92;145;78;91;196;62;9;89;153;170;176;100;189;182;148;155;144;178;90;165;40;167;184;11;160;28;43;149;70;123;41;36;117;0;183;143,6383817348116846101,40.234075
steepest_intra:nodes_start:random,161,120101,63360,56741,1495014950,100001,178;176;72;47;117;170;143;96;131;65;93;183;0;46;51;118;179;145;31;81;39;40;52;133;194;53;2;62;141;59;34;160;184;105;116;127;189;94;15;64;114;80;139;159;41;22;193;43;115;23;186;49;144;124;123;24;112;190;84;162;79;9;14;63;180;1;75;120;90;185;106;151;109;18;108;69;137;148;55;44;25;92;78;157;165;57;97;74;152;101;86;154;135;28;42;16;113;175;171;82,4633123527627320715,40.134634
steepest_intra:nodes_start:random,162,99942,47742,52200,1495014950,100001,43;5;193;41;139;23;49;55;92;152;189;53;158;154;162;65;105;116;57;185;138;14;133;4;112;190;177;184;160;34;22;18;108;93;140;51;79;63;180;182;62;144;102;3;106;178;9;59;118;80;165;90;40;81;145;120;151;131;149;115;198;68;0;143;89;183;137;12;124;94;97;101;1;75;16;171;175;44;2;86;26;70;135;127;123;109;176;167;52;179;78;31;56;113;148;46;159;181;42;47,2184999377699694900,40.262912
steepest_intra:nodes_start:random,163,104908,52241,52667,1495014950,100001,127;149;35;112;4;92;145;52;165;40;90;81;171;16;113;175;57;186;89;183;62;102;138;185;9;37;137;51;151;100;120;44;152;124;176;65;116;131;43;42;144;14;178;167;94;135;70;162;181;146;193;115;148;49;55;106;12;84;160;54;177;123;129;31;38;78;25;86;182;122;63;26;1;101;75;2;97;53;154;121;158;133;41;68;46;143;117;0;139;22;195;103;34;184;28;59;118;80;79;180,2224983673470280952,40.243686
steepest_intra:nodes_start:random,164,93069,44631,48438,1495014950,100001,137;80;151;162;123;131;149;184;177;10;4;112;181;22;18;69;108;117;183;89;116;65;47;43;160;48;54;34;115;59;176;148;15;114;23;0;143;124;189;86;101;97;1;121;79;133;135;180;63;9;62;49;106;178;25;44;120;152;94;51;118;46;68;102;14;179;145;2;26;100;154;53;82;92;129;139;41;159;193;42;127;70;75;16;175;171;185;165;40;52;55;57;78;113;31;196;81;90;144;186,4153148313383042227,40.078393
steepest_intra:nodes_start:random,165,100621,47720,52901,1495014950,100001,94;137;23;89;183;115;65;42;43;59;151;162;122;63;12;124;106;185;179;25;44;129;55;178;102;144;14;31;85;157;169;196;90;95;164;143;18;22;69;108;139;176;80;186;15;148;49;145;168;78;81;165;119;40;52;62;9;57;92;82;75;123;160;34;154;86;26;79;51;116;193;159;181;41;68;117;0;46;133;53;70;135;4;112;127;180;100;16;56;171;175;113;120;2;152;1;97;101;189;158,2165620036185108918,40.322020
steepest_intra:nodes_start:random,166,95306,47251,48055,1495014950,100001,90;81;196;123;35;184;176;148;9;62;186;89;183;143;117;68;181;34;160;48;54;177;70;44;113;31;78;145;115;41;193;139;46;94;152;97;162;43;42;159;22;18;108;0;137;175;171;16;25;120;65;116;51;80;79;122;63;121;26;101;1;100;53;180;133;151;118;59;131;149;154;86;75;2;129;92;57;55;52;49;102;14;165;119;40;185;106;178;3;167;124;84;4;112;127;135;144;21;164;27,7818019371027123361,40.167005
steepest_intra:nodes_start:random,167,95339,44995,50344,1495014950,100001,175;56;113;31;78;101;180;53;40;185;179;55;26;86;44;145;92;196;81;27;90;154;135;70;127;116;184;84;112;35;160;159;22;146;47;75;16;171;25;133;162;123;131;149;65;118;151;59;43;42;48;34;181;139;69;108;18;117;183;89;23;143;170;0;93;140;68;115;5;193;41;46;62;14;144;15;137;51;176;148;37;52;57;82;129;120;2;97;1;152;80;79;63;94;49;3;106;178;165;157,8881295693803612692,40.162056
steepest_intra:nodes_start:random,168,100762,49588,51174,1495014950,100001,148;65;79;100;86;53;154;180;75;129;57;55;106;49;62;102;144;21;95;27;90;113;175;171;16;92;15;114;23;109;118;59;0;143;153;137;94;124;51;139;193;41;43;149;63;121;97;1;135;70;133;80;176;122;182;26;101;2;152;189;117;170;183;89;120;44;78;196;185;52;42;160;34;54;184;112;123;162;151;115;159;22;18;68;46;186;9;3;178;145;31;81;40;119;7;164;39;165;14;116,2046873037216737324,40.043828
steepest_intra:nodes_start:random,169,101512,50421,51091,1495014950,100001,38;81;27;90;179;175;171;113;56;16;101;160;34;22;181;131;149;123;184;48;54;177;112;86;152;186;23;137;122;79;51;41;18;108;183;144;138;40;185;15;193;159;42;43;116;65;180;100;78;145;49;143;0;46;68;115;118;178;106;52;57;25;44;120;1;26;97;94;151;133;63;121;158;135;70;59;139;198;162;75;2;129;92;55;167;148;37;12;176;80;154;53;124;62;9;14;165;196;157;31,2283016231224817028,40.061245
steepest_intra:nodes_start:random,170,95257,46210,49047,1495014950,100001,159;22;146;48;54;184;84;112;123;94;144;21;7;165;179;92;2;152;1;53;158;154;162;149;43;96;5;105;116;25;16;171;175;113;31;78;145;57;52;55;23;117;93;140;139;193;181;34;160;42;115;0;143;89;9;62;14;40;185;106;178;102;49;129;44;120;97;180;177;190;86;75;101;63;122;79;133;135;70;127;131;41;18;108;183;90;81;196;148;137;68;46;176;80;151;51;118;59;65;47,8119319617750837287,40.055110
steepest_intra:nodes_start:random,171,107352,55033,52319,1495014950,100001,55;15;22;181;34;103;160;180;148;102;62;80;51;79;151;41;159;18;117;0;176;3;106;133;149;35;109;137;9;111;124;46;59;65;42;115;116;118;94;167;14;138;129;2;75;25;16;175;44;145;90;165;119;8;40;152;19;63;184;54;30;146;193;139;143;89;183;189;86;101;97;53;70;112;10;177;190;127;123;162;135;154;1;92;120;31;85;196;81;171;113;56;78;82;178;144;49;57;52;185,251564507237990735,40.246356
steepest_intra:nodes_start:random,172,97083,48937,48146,1495014950,100001,78;100;154;70;135;180;1;2;120;44;25;101;75;86;93;117;143;0;89;49;40;196;31;175;16;112;4;184;131;162;133;151;79;63;97;152;94;80;65;43;41;115;92;57;55;52;178;138;14;144;9;148;167;106;3;62;15;186;137;118;59;116;51;176;124;26;53;127;123;42;160;54;177;34;22;18;108;146;195;159;193;139;183;21;7;58;164;90;165;102;23;68;46;185;81;171;113;56;145;129,4375611543207488039,40.124249
steepest_intra:nodes_start:random,173,96198,46069,50129,1495014950,100001,2;152;176;51;42;181;48;177;54;5;96;41;193;159;18;22;123;113;56;31;145;78;75;86;53;154;180;158;16;171;175;44;120;151;46;139;84;112;184;160;34;43;149;131;118;109;80;79;63;135;70;127;162;59;72;133;179;81;196;52;138;3;9;148;62;15;137;94;100;101;25;82;92;55;106;178;23;89;183;143;0;117;115;116;65;144;27;90;165;40;185;57;1;26;97;167;14;102;49;129,3728882691367511065,40.172544
steepest_intra:nodes_start:random,174,130623,66499,64124,1495014950,100001,129;55;194;162;63;130;148;9;49;115;142;41;34;193;112;156;177;54;59;176;133;40;31;188;157;145;171;16;151;109;94;97;1;101;86;53;152;178;137;65;42;43;28;149;92;44;175;78;120;106;52;119;183;117;69;18;5;139;191;46;144;155;104;30;10;184;23;62;185;169;17;113;70;135;158;180;79;80;122;123;146;160;4;116;108;93;153;143;7;58;71;14;165;8;32;138;57;82;26;154,80298226764707926,40.038129
steepest_intra:nodes_start:random,175,96005,46783,49222,1495014950,100001,119;31;113;175;171;16;92;89;183;143;65;116;41;159;193;115;151;180;53;26;52;55;167;148;144;14;102;9;62;137;0;117;68;46;63;179;145;78;25;44;1;97;106;138;39;165;178;3;15;176;80;49;21;164;27;90;196;35;30;54;112;123;127;79;133;149;160;48;177;10;190;84;184;43;42;181;22;34;70;154;135;162;118;59;198;139;51;94;152;129;82;120;2;75;86;101;57;185;40;81,2637015946554112658,40.197806
steepest_intra:nodes_start:random,176,107028,53340,53688,1495014950,100001,145;113;175;52;62;114;15;152;74;189;128;49;102;151;72;180;100;26;97;148;89;41;18;108;118;80;63;53;158;75;1;101;86;154;135;35;84;184;181;54;34;160;47;106;185;90;81;40;165;95;39;31;78;162;149;4;10;177;42;146;103;139;183;83;23;198;115;22;193;117;0;143;186;9;37;137;59;65;116;123;133;79;176;46;68;51;94;55;92;57;129;2;44;171;16;179;14;144;178;120,1316263983723682967,40.126324
steepest_intra:nodes_start:random,177,99797,50547,49250,1495014950,100001,18;159;22;184;4;112;133;79;86;101;152;124;94;80;51;59;118;65;116;47;149;162;135;123;160;34;10;190;177;193;139;68;117;46;115;151;176;106;178;55;31;175;171;90;14;41;42;43;131;70;97;113;157;40;119;52;49;62;9;145;16;44;2;129;185;165;81;196;179;138;144;102;78;25;120;75;26;1;167;148;186;89;183;153;143;137;23;15;92;57;100;53;136;154;180;63;21;7;164;0,6104762757161501533,40.249823
steepest_intra:nodes_start:random,178,107888,55230,52658,1495014950,100001,65;35;184;34;54;177;190;112;133;94;189;53;154;180;135;4;10;160;47;116;114;186;148;26;1;97;100;70;127;149;123;79;124;37;144;102;80;151;46;159;139;59;122;63;137;170;0;18;108;140;93;117;143;167;92;57;89;23;183;115;198;15;106;185;165;40;101;86;75;120;171;175;16;49;14;43;42;22;146;193;41;162;121;152;2;51;118;109;178;3;62;9;52;55;145;78;44;129;176;68,8600081924882577658,40.202988
steepest_intra:nodes_start:random,179,113270,61982,51288,1495014950,100001,0;46;57;119;185;144;114;198;115;176;55;178;40;52;100;26;1;75;120;25;97;162;149;159;22;18;108;68;117;183;15;62;9;94;59;118;133;44;113;145;78;106;14;165;90;89;137;79;136;180;127;116;43;5;41;193;96;24;123;154;92;129;167;80;70;135;63;86;152;124;102;49;196;175;56;16;112;4;84;35;184;30;34;160;53;101;2;151;65;47;146;181;42;51;148;171;31;82;143;139,7117904514193758229,39.960891
steepest_intra:nodes_start:random,180,89001,37467,51534,1495014950,100001,82;75;101;137;23;89;183;59;35;184;54;177;112;127;79;94;167;106;178;52;55;57;92;120;44;25;16;171;175;113;56;31;2;1;97;124;186;114;15;62;102;49;40;185;65;116;47;133;63;189;100;26;122;118;193;22;146;34;160;181;42;43;5;115;143;0;68;41;139;46;121;86;53;158;180;154;70;135;194;123;149;131;162;151;72;51;176;80;148;9;144;14;165;90;81;196;145;78;129;152,9123962751250112551,40.361427
steepest_intra:nodes_start:random,181,104373,51475,52898,1495014950,100001,39;44;120;1;97;101;82;78;92;106;178;167;46;193;22;34;177;54;10;190;183;114;15;137;176;51;72;122;124;52;185;90;40;138;0;143;93;140;162;194;123;77;43;65;133;79;94;152;2;75;86;135;47;116;160;48;184;42;181;195;146;159;68;18;108;139;41;59;148;49;145;31;55;102;144;14;9;62;63;70;154;121;80;118;110;191;115;151;127;149;35;180;53;129;16;171;113;175;165;81,4954134777873285353,40.281843
steepest_intra:nodes_start:random,182,154257,71347,82910,1495014950,100001,78;63;190;177;192;99;157;98;71;90;9;155;12;148;89;59;118;139;110;153;0;117;133;1;111;97;154;72;66;92;106;32;39;8;178;49;37;144;130;137;62;145;44;141;170;143;124;91;7;164;58;85;175;113;16;151;47;140;67;20;5;166;54;109;51;53;6;70;146;142;163;36;108;159;158;135;60;183;93;176;75;101;26;2;87;82;120;168;152;94;180;123;77;195;193;160;48;34;181;86,1999907845452574546,40.108059
steepest_intra:nodes_start:random,183,180044,92373,87671,1495014950,100001,6;33;154;45;148;197;80;70;136;63;125;75;11;54;46;118;104;51;139;47;43;72;36;108;20;89;1;144;172;138;92;3;153;83;77;159;193;26;169;38;8;185;196;40;165;119;106;187;182;10;84;195;145;91;113;79;190;65;93;115;116;109;158;44;120;86;152;9;178;186;176;180;100;94;191;103;147;149;131;137;155;49;71;95;78;167;27;107;90;114;128;150;151;192;59;41;53;25;13;143,3381635525355737473,40.514502
steepest_intra:nodes_start:random,184,140470,70780,69690,1495014950,100001,63;144;14;106;52;152;53;48;160;139;183;137;65;105;5;59;0;153;114;119;164;107;145;16;175;171;135;126;181;155;7;55;172;2;97;158;45;162;161;180;100;89;64;186;12;182;94;111;72;42;46;115;47;96;193;79;101;120;75;70;29;154;56;85;31;157;143;159;22;195;77;84;62;148;80;51;141;165;185;128;184;4;35;116;151;133;123;127;19;129;92;78;178;40;187;90;49;124;176;118,5299525556767209178,40.020127
steepest_intra:nodes_start:random,185,102348,51829,50519,1495014950,100001,101;100;79;80;51;193;41;139;183;89;186;57;92;25;44;86;70;112;35;24;162;14;49;133;194;135;127;149;131;65;47;116;0;117;143;23;94;97;26;121;63;122;124;148;62;144;164;90;81;196;40;119;59;43;160;42;115;46;176;180;154;152;178;9;137;118;184;48;54;177;84;120;113;56;31;78;82;129;179;165;185;106;151;123;4;190;10;34;22;181;53;16;171;175;145;55;52;2;75;1,173988986435193122,40.276448
steepest_intra:nodes_start:random,186,95079,44314,50765,1495014950,100001,81;78;79;116;65;43;42;115;68;117;93;118;51;137;21;164;95;62;9;185;196;145;179;52;124;176;80;148;167;102;14;144;23;108;18;22;159;41;193;139;96;5;131;162;151;59;160;184;35;133;86;101;55;178;106;49;89;183;143;170;0;46;149;123;112;127;70;135;175;113;56;171;16;25;1;97;152;2;129;92;82;120;44;75;53;180;154;121;94;122;63;26;100;57;40;165;39;27;90;31,5664708734013127506,40.108445
steepest_intra:nodes_start:random,187,92590,44245,48345,1495014950,100001,3;52;55;57;26;112;4;149;59;109;137;114;15;23;186;89;183;143;117;42;181;43;65;133;16;171;175;113;31;75;86;100;70;135;127;123;35;84;184;190;177;54;34;160;131;162;151;46;68;139;115;118;51;176;80;79;63;94;120;25;44;53;154;180;1;78;145;9;62;116;47;122;152;2;129;92;101;97;193;41;159;146;22;18;0;148;178;106;165;40;185;196;81;90;164;21;144;49;102;14,1983892505898583434,40.090217
steepest_intra:nodes_start:random,188,124789,60849,63940,1495014950,100001,100;101;82;57;49;155;23;65;47;123;135;127;70;86;75;97;1;2;148;33;9;3;132;186;69;108;18;42;41;193;139;183;40;171;16;44;25;78;92;14;180;79;133;162;176;94;106;119;8;178;63;53;196;90;185;165;15;64;144;102;194;29;177;4;184;116;115;118;60;109;152;172;55;52;179;157;187;81;5;96;160;43;117;68;89;62;61;37;48;34;146;59;137;151;154;122;80;167;120;145,3354466596002444996,40.252684
steepest_intra:nodes_start:random,189,101976,50236,51740,1495014950,100001,160;34;159;18;193;42;43;131;115;139;46;68;151;63;97;1;8;185;196;57;178;94;133;59;116;101;75;26;121;148;49;9;62;144;21;179;82;86;53;65;118;80;79;122;158;136;124;23;183;143;153;0;117;89;186;114;15;137;127;70;189;152;2;78;25;44;175;56;113;171;16;31;164;71;52;180;162;184;84;123;135;154;92;165;40;119;81;90;27;39;14;106;55;129;145;120;176;51;41;22,10594871503791004,40.023850
steepest_intra:nodes_start:random,190,93518,43582,49936,1495014950,100001,180;53;26;86;44;120;101;143;0;152;1;63;115;193;146;22;159;139;93;117;21;90;119;165;14;62;51;118;59;43;184;42;116;65;47;137;23;89;183;114;186;97;75;2;129;57;55;49;176;80;79;94;124;167;148;9;102;185;40;196;145;31;113;175;171;16;78;92;52;106;178;138;144;15;72;149;131;77;198;68;46;151;133;162;123;69;108;18;41;160;34;54;177;190;10;112;70;135;154;158,4359419058977120279,40.234662
steepest_intra:nodes_start:random,191,100707,44676,56031,1495014950,100001,101;121;158;154;180;131;77;43;5;159;199;18;108;68;117;46;118;185;90;165;162;184;177;4;112;123;53;75;120;78;145;135;194;133;63;79;80;148;114;186;23;183;89;137;94;152;2;92;57;55;52;151;149;35;84;47;116;65;59;109;51;0;143;42;181;34;160;193;41;22;103;146;139;15;144;138;119;40;106;3;178;14;49;102;9;62;167;1;97;86;100;70;127;10;54;115;176;12;124;26,5932209492160464999,40.369034
steepest_intra:nodes_start:random,192,92029,43439,48590,1495014950,100001,41;162;121;100;26;53;180;123;131;47;116;65;151;94;124;167;49;14;144;15;137;176;133;135;70;154;101;1;97;149;160;34;181;115;186;102;178;106;165;40;81;90;21;183;143;0;117;68;46;89;23;80;79;122;63;86;75;16;171;175;92;129;57;55;52;185;179;145;78;113;31;196;62;9;37;148;51;118;5;42;43;35;184;48;54;177;112;127;44;25;120;2;152;139;108;18;22;159;193;59,6658792721839017350,40.072461
steepest_intra:nodes_start:random,193,108748,54793,53955,1495014950,100001,86;113;175;56;171;101;1;75;120;82;133;116;42;184;35;123;149;54;34;139;185;81;31;78;92;57;55;129;2;74;152;115;18;108;0;102;49;148;53;180;26;100;44;157;196;40;165;14;73;186;114;183;23;15;9;144;62;94;63;79;51;198;46;93;117;176;135;70;41;193;160;177;190;65;59;80;122;182;154;137;143;170;153;89;138;178;106;162;131;47;43;118;151;124;52;179;145;25;97;16,4449152400649008913,40.242924
steepest_intra:nodes_start:random,194,93053,42327,50726,1495014950,100001,3;14;167;121;53;154;180;80;176;89;183;137;124;94;63;79;133;65;54;177;10;190;84;35;184;160;34;103;181;42;152;25;31;113;175;56;81;196;179;78;120;82;129;57;119;40;90;165;185;178;118;116;105;47;131;149;162;123;127;70;135;75;44;16;171;145;92;2;101;86;100;26;1;97;55;52;151;43;146;22;159;59;51;21;7;164;144;62;148;115;41;193;139;46;0;143;9;49;106;138,3779010074201164279,40.184859
steepest_intra:nodes_start:random,195,88578,40072,48506,2332200,155,100;53;63;79;133;151;162;135;127;123;59;118;51;148;178;106;185;40;119;165;138;14;49;167;152;97;1;120;44;25;57;55;52;9;89;183;143;117;68;139;115;46;176;16;171;175;113;31;80;116;5;193;159;195;22;146;34;181;42;43;47;149;131;184;160;54;177;112;70;2;78;145;92;129;124;94;121;86;75;101;137;0;108;69;18;41;65;154;180;62;144;21;7;164;95;27;90;81;196;26,5248873841288929093,0.062002
steepest_intra:nodes_start:random,196,105419,53565,51854,1495014950,100001,112;123;97;120;52;49;102;167;106;178;75;53;135;70;79;63;62;14;8;119;81;196;185;40;55;92;57;145;179;90;95;144;137;65;47;139;18;69;108;199;159;22;146;198;15;9;148;149;84;48;54;34;41;193;5;43;116;151;86;16;171;175;31;44;2;94;80;162;59;176;26;152;181;42;184;131;133;101;1;136;180;154;51;118;115;117;0;143;183;23;186;129;78;165;164;71;27;46;96;160,4797965699878681197,40.324390
steepest_intra:nodes_start:random,197,88972,39147,49825,1495014950,100001,49;102;148;133;151;162;131;149;123;127;112;4;184;160;34;54;177;84;35;43;116;65;47;59;55;52;196;179;92;2;1;86;75;101;97;100;26;53;122;137;23;186;144;14;138;152;121;42;5;139;115;118;167;178;106;185;40;165;90;81;31;113;175;16;120;124;0;117;143;183;89;114;15;9;62;129;25;44;78;145;57;94;80;176;51;109;46;68;108;18;22;159;193;41;79;63;154;70;135;180,8364744943220819429,40.148344
steepest_intra:nodes_start:random,198,101411,49497,51914,1495014950,100001,63;154;97;75;101;120;44;145;179;165;40;178;52;196;81;90;164;8;185;55;106;138;14;144;15;183;89;1;152;37;62;49;2;86;149;131;137;9;124;94;53;180;162;159;18;69;108;140;93;117;153;143;0;115;5;42;96;181;59;151;80;79;46;68;41;193;113;175;31;78;129;148;23;186;118;47;43;4;127;135;123;160;34;103;22;146;139;176;167;57;92;112;177;54;184;105;116;65;51;133,9040475876148687634,40.219121
steepest_intra:nodes_start:random,199,94008,44776,49232,1495014950,100001,25;16;171;175;167;46;108;69;18;22;34;160;177;4;112;86;1;152;2;129;120;44;75;101;97;137;143;0;59;162;127;123;35;184;181;193;41;42;43;185;40;119;90;165;138;14;144;102;49;106;178;183;117;68;139;115;118;51;176;80;124;94;133;149;131;70;135;154;180;26;100;53;158;121;148;9;62;55;57;179;145;157;81;196;52;186;23;89;114;15;92;78;31;56;113;79;151;65;116;63,1240180408447250721,40.013824
steepest_intra:nodes_start:greedy,0,71620,23493,48127,1495014950,100001,46;117;143;183;89;186;23;137;176;80;79;63;94;124;152;97;1;101;2;120;82;129;57;92;55;52;49;102;148;9;62;144;14;138;178;106;185;165;40;90;81;196;179;145;78;31;56;113;175;171;16;25;44;75;86;26;100;121;53;180;154;135;70;127;123;162;133;151;51;118;59;65;116;43;184;84;112;4;190;10;177;54;48;160;34;146;22;18;108;69;159;181;42;5;115;41;193;139;68;0,741855903246969584,40.268432
steepest_intra:nodes_start:greedy,1,72020,23542,48478,1495014950,100001,152;101;75;86;53;154;70;135;180;63;79;133;51;118;59;115;46;0;143;117;93;140;68;139;193;41;5;42;181;159;69;108;18;22;146;34;160;48;54;177;190;184;43;116;65;149;123;127;162;151;80;176;137;23;183;89;186;114;15;9;62;144;14;138;165;40;185;90;81;196;179;145;78;31;56;113;175;171;16;25;44;120;2;129;92;57;55;52;106;178;49;102;148;124;94;189;100;26;97;1,4225616066630830836,40.204772
steepest_intra:nodes_start:greedy,2,71704,23378,48326,1495014950,100001,2;129;92;57;55;52;49;102;148;9;62;144;14;138;178;106;185;165;40;90;81;196;179;145;78;31;56;113;175;171;16;25;44;120;75;86;26;189;94;63;79;80;176;133;151;51;118;59;115;46;0;137;23;186;89;183;143;117;93;140;68;139;193;41;5;42;181;159;69;108;18;22;146;34;160;48;54;177;10;190;84;184;43;116;65;131;149;162;123;127;70;135;154;180;53;100;101;1;97;152,6697214135735561711,40.285445
steepest_intra:nodes_start:greedy,3,72338,23934,48404,1495014950,100001,165;14;144;62;9;148;102;49;178;106;52;55;57;92;129;2;152;97;1;101;100;53;180;154;135;70;127;123;162;149;131;65;116;43;184;84;190;10;177;54;48;160;34;146;22;18;108;69;159;181;42;5;41;193;139;68;140;93;117;143;183;89;186;23;137;0;46;115;59;118;51;151;133;176;80;79;63;94;189;26;86;75;120;44;25;16;171;175;113;56;31;78;145;179;196;81;90;185;40;3,6790357063587963675,40.075846
steepest_intra:nodes_start:greedy,4,71443,23266,48177,119600,7,4;190;10;177;54;48;34;160;42;181;146;22;18;108;69;159;193;41;139;68;46;115;118;59;65;116;43;184;35;131;149;123;162;133;151;51;0;117;143;183;89;23;137;176;80;79;63;94;124;152;97;1;101;2;120;82;129;92;57;55;52;49;102;148;9;62;144;14;3;178;106;185;40;165;90;81;196;179;145;78;31;56;113;175;171;16;25;44;75;86;26;100;121;53;180;154;135;70;127;112,1417566342975368788,0.003000
steepest_intra:nodes_start:greedy,5,71456,23087,48369,1495014950,100001,42;43;116;65;149;123;127;162;151;133;135;70;154;180;53;121;100;26;86;75;44;25;16;171;175;113;56;31;78;145;179;196;81;90;165;40;185;106;178;138;14;144;62;9;148;102;49;52;55;57;92;129;82;120;2;101;1;97;152;124;94;63;79;80;176;137;23;186;89;183;143;117;0;51;118;59;115;46;68;139;41;193;159;69;108;18;22;146;181;34;160;48;54;177;10;190;4;84;184;5,8732890323673967306,40.186427
steepest_intra:nodes_start:greedy,6,72050,23480,48570,1495014950,100001,158;154;53;121;100;26;86;75;101;1;97;152;94;124;148;102;49;178;106;52;55;57;92;129;2;120;44;25;16;171;175;113;56;31;78;145;179;196;81;90;185;40;165;138;14;144;62;9;15;114;186;89;183;23;137;176;80;151;162;127;123;149;65;116;43;184;177;54;48;160;34;146;22;18;108;69;159;181;42;5;41;193;139;68;140;93;117;143;0;46;115;59;118;51;133;79;63;180;70;135,2709669152969157333,40.246986
steepest_intra:nodes_start:greedy,7,72352,24178,48174,1495014950,100001,7;21;144;62;9;148;102;49;14;178;106;52;55;185;165;40;179;145;78;92;57;129;2;152;97;1;101;100;53;180;154;135;70;127;123;162;149;65;116;43;184;177;54;48;160;34;146;22;18;108;69;159;181;42;5;41;193;139;68;140;93;117;143;183;89;23;137;0;46;115;59;118;51;151;133;176;80;79;63;94;124;26;86;75;120;44;25;16;171;175;113;56;31;157;196;81;90;27;71;164,8631991747453338000,40.192674
steepest_intra:nodes_start:greedy,8,71661,23200,48461,1495014950,100001,39;165;40;185;90;81;196;179;145;78;31;56;113;175;171;16;25;44;120;75;86;26;189;94;63;79;80;176;133;151;51;118;59;115;46;0;137;23;186;89;183;143;117;93;140;68;139;193;41;5;42;181;159;69;108;18;22;146;34;160;48;54;177;10;190;184;43;116;65;131;149;162;123;127;70;135;154;180;53;100;101;1;97;152;2;129;92;57;55;52;106;178;49;102;148;9;62;144;14;138,2574925631321316815,40.281851
steepest_intra:nodes_start:greedy,9,71291,23229,48062,89700,5,9;148;102;49;178;106;52;55;57;92;129;2;101;1;97;26;100;53;180;154;135;70;127;123;162;149;131;65;116;43;184;84;190;10;177;54;48;160;34;146;22;18;108;69;159;181;42;5;41;193;139;68;140;93;117;143;183;89;186;23;137;0;46;115;59;118;51;151;133;176;80;79;63;94;124;152;86;75;120;44;25;16;171;175;113;56;31;78;145;179;196;81;90;165;40;185;138;14;144;62,6759996473274084039,0.003003
steepest_intra:nodes_start:greedy,10,71677,23578,48099,1495014950,100001,10;190;4;112;127;70;135;154;180;53;121;100;26;86;75;44;25;16;171;175;113;56;31;78;145;179;196;81;90;165;40;185;106;178;138;14;144;62;9;148;102;49;52;55;57;92;129;82;120;2;101;1;97;152;124;94;63;79;80;176;137;23;89;183;143;117;0;51;133;151;162;123;149;131;35;184;43;65;116;59;118;115;46;68;139;193;41;159;69;108;18;22;146;181;42;160;34;48;54;177,3959770234465409383,40.130543
steepest_intra:nodes_start:greedy,11,72245,23998,48247,1495014950,100001,149;35;84;4;112;127;123;162;151;133;135;70;154;180;53;121;100;26;86;75;44;25;16;171;175;113;56;31;78;145;179;196;81;90;40;165;185;106;178;138;14;144;62;9;148;102;49;52;55;92;57;129;82;120;2;101;1;97;152;124;94;63;79;80;176;137;23;186;89;183;143;117;0;51;118;59;115;139;68;46;65;116;43;42;5;41;193;159;69;108;18;22;146;181;34;160;48;54;177;184,4547284410024354711,40.265458
steepest_intra:nodes_start:greedy,12,72443,23476,48967,1495014950,100001,124;94;152;97;1;101;2;120;82;129;57;92;179;145;78;31;56;113;175;171;16;25;44;75;86;26;100;121;53;158;154;70;135;180;63;79;133;51;118;59;115;46;0;143;117;93;140;68;139;193;41;5;42;181;159;69;108;18;22;146;34;160;48;54;177;184;43;116;65;149;123;162;151;80;176;137;23;183;89;186;114;15;9;62;144;14;138;165;90;81;196;40;185;55;52;106;178;49;102;148,2047245237505480038,40.375803
steepest_intra:nodes_start:greedy,13,72352,23851,48501,1495014950,100001,157;31;145;78;92;179;196;81;90;40;165;185;106;178;138;14;144;62;9;148;102;49;52;55;57;129;2;152;97;1;101;100;53;180;154;135;70;127;123;162;149;131;65;116;43;184;190;10;177;54;48;160;34;146;22;18;108;69;159;181;42;5;41;193;139;68;140;93;117;143;183;89;186;23;137;0;46;115;59;118;51;151;133;176;80;79;63;94;189;26;86;75;120;44;25;16;171;175;113;56,6354574185474921217,40.488261
steepest_intra:nodes_start:greedy,14,71651,23589,48062,1495014950,100001,138;144;62;9;148;102;49;178;106;52;55;57;92;129;2;152;97;1;101;100;53;180;154;135;70;127;123;162;149;131;65;116;43;184;84;190;10;177;54;48;160;34;146;22;18;108;69;159;181;42;5;41;193;139;68;140;93;117;143;183;89;186;23;137;0;46;115;59;118;51;151;133;176;80;79;63;94;124;26;86;75;120;44;25;16;171;175;113;56;31;78;145;179;196;81;90;165;40;185;14,2082241167774312910,40.210751
steepest_intra:nodes_start:greedy,15,71714,23428,48286,1495014950,100001,148;144;14;138;165;40;185;90;81;196;179;145;78;31;56;113;175;171;16;25;44;120;75;86;26;189;94;63;79;80;176;133;151;51;118;59;115;46;0;137;23;186;89;183;143;117;93;140;68;139;193;41;5;42;181;159;69;108;18;22;146;34;160;48;54;177;10;190;184;43;116;65;131;149;162;123;127;70;135;154;180;53;100;101;1;97;152;2;129;92;57;55;52;106;178;49;102;62;9;15,6304710490343438806,40.184941
steepest_intra:nodes_start:greedy,16,71686,23624,48062,1495014950,100001,16;25;44;120;75;86;26;124;94;63;79;80;176;133;151;51;118;59;115;46;0;137;23;186;89;183;143;117;93;140;68;139;193;41;5;42;181;159;69;108;18;22;146;34;160;48;54;177;10;190;84;184;43;116;65;131;149;162;123;127;70;135;154;180;53;100;101;1;97;152;2;129;57;55;52;49;102;148;9;62;144;14;138;178;106;185;40;165;90;81;196;179;92;145;78;31;56;113;175;171,5849453125538688081,40.131891
steepest_intra:nodes_start:greedy,17,73364,24148,49216,1495014950,100001,169;196;81;90;27;71;164;7;95;39;165;40;185;106;178;138;14;144;62;9;148;102;49;52;55;57;129;92;179;145;78;82;2;152;97;1;101;53;180;154;135;70;127;123;162;149;65;116;43;184;177;54;48;160;34;146;22;18;108;159;181;42;41;193;139;68;140;93;117;143;183;89;23;137;0;46;115;59;118;51;151;133;176;80;79;63;94;26;86;75;120;44;25;16;171;175;113;56;31;157,2744287314917987248,40.126926
steepest_intra:nodes_start:greedy,18,71735,23239,48496,1495014950,100001,69;22;146;159;193;41;5;42;181;34;160;48;54;177;10;190;4;84;184;43;116;65;149;123;127;162;151;133;135;70;154;180;53;121;100;26;86;75;44;25;16;171;175;113;56;31;78;145;179;196;81;90;165;40;185;106;178;138;14;144;62;9;148;102;49;52;55;57;92;129;82;120;2;101;1;97;152;124;94;63;79;80;176;137;51;118;59;115;139;46;68;0;89;183;143;117;93;140;108;18,8054236968386342685,40.244084
steepest_intra:nodes_start:greedy,19,71945,22885,49060,1495014950,100001,189;94;124;148;102;49;178;106;52;55;57;92;129;2;120;44;25;16;171;175;113;56;31;78;145;179;196;81;90;185;40;165;138;14;144;62;9;15;114;186;89;183;23;137;176;80;151;162;123;149;65;116;43;184;177;54;48;160;34;146;22;18;108;69;159;181;42;5;41;193;139;68;140;93;117;143;0;46;115;59;118;51;133;79;63;180;135;70;154;158;53;121;100;26;86;75;101;1;97;152,6551488451539225260,40.364750
steepest_intra:nodes_start:greedy,20,71950,23050,48900,1495014950,100001,199;22;146;159;193;41;5;42;181;34;160;48;54;177;10;190;84;184;43;116;65;149;123;127;162;151;133;135;70;154;180;53;121;100;26;86;75;44;25;16;171;175;113;56;31;78;145;179;196;81;90;165;40;185;106;178;138;14;144;62;9;148;102;49;52;55;57;92;129;82;120;2;101;1;97;152;124;94;63;79;80;176;137;51;118;59;115;139;46;68;0;89;183;143;117;93;140;108;69;18,5272029391555387176,40.293156
steepest_intra:nodes_start:greedy,21,72267,24098,48169,1495014950,100001,144;14;138;165;40;185;90;81;196;179;145;78;31;56;113;175;171;16;25;44;120;75;86;26;189;94;63;79;80;176;133;151;51;118;59;115;46;0;137;23;186;89;183;143;117;93;140;68;139;193;41;5;42;181;159;69;108;18;22;146;34;160;48;54;177;10;190;184;43;116;65;131;149;162;123;127;70;135;154;180;53;100;101;1;97;152;2;129;92;57;55;52;106;178;49;102;148;9;62;21,1203007200982024426,40.302979
steepest_intra:nodes_start:greedy,22,72082,24187,47895,1495014950,100001,18;146;181;34;160;48;54;177;10;190;4;112;84;184;42;43;116;65;149;123;127;162;151;133;135;70;154;180;53;121;100;26;86;75;44;25;16;171;175;113;56;31;78;145;179;196;81;90;165;40;185;106;178;138;14;144;62;9;148;102;49;52;55;57;92;129;82;120;2;101;1;97;152;124;94;63;79;80;176;137;23;186;89;183;143;117;0;51;118;59;115;46;68;139;41;193;159;69;108;22,4921682510267018437,40.242091
steepest_intra:nodes_start:greedy,23,71124,22997,48127,1495014950,100001,186;137;176;80;79;63;94;124;152;97;1;101;2;120;82;129;57;92;55;52;49;102;148;9;62;144;14;138;178;106;185;165;40;90;81;196;179;145;78;31;56;113;175;171;16;25;44;75;86;26;100;121;53;180;154;135;70;127;123;162;133;151;51;118;59;65;116;43;184;84;112;4;190;10;177;54;48;160;34;146;22;18;108;69;159;181;42;5;115;41;193;139;68;46;0;117;143;183;89;23,7020581770156637407,40.184821
steepest_intra:nodes_start:greedy,24,71674,23190,48484,1495014950,100001,131;149;65;116;43;184;84;190;10;177;54;48;160;34;146;22;18;108;69;159;181;42;5;41;193;139;68;46;115;59;118;51;0;117;143;183;89;186;23;137;176;80;79;63;94;124;152;97;1;101;2;120;82;129;92;57;55;52;49;102;148;9;62;144;14;138;178;106;185;40;165;90;81;196;179;145;78;31;56;113;175;171;16;25;44;75;86;26;100;121;53;180;154;70;135;133;151;162;127;123,2372711363126241432,40.223016
steepest_intra:nodes_start:greedy,25,72302,23976,48326,1495014950,100001,16;44;120;75;86;26;189;94;63;79;80;176;133;151;51;118;59;115;46;0;137;23;186;89;183;143;117;93;140;68;139;193;41;5;42;181;159;69;108;18;22;146;34;160;48;54;177;10;190;84;184;43;116;65;131;149;162;123;127;70;135;154;180;53;100;101;1;97;152;2;129;92;57;55;52;49;102;148;9;62;144;14;138;178;106;185;40;165;90;81;196;179;145;78;31;56;113;175;171;25,7528032421549106252,39.992008
steepest_intra:nodes_start:greedy,26,71474,23448,48026,1495014950,100001,26;97;1;101;75;86;53;154;70;135;180;63;79;133;51;118;59;115;46;0;143;117;93;140;68;139;193;41;5;42;181;159;69;108;18;22;146;34;160;48;54;177;10;190;184;43;116;65;149;123;127;162;151;80;176;137;23;183;89;186;114;15;9;62;144;14;138;185;40;165;90;81;196;179;145;78;31;56;113;175;171;16;25;44;120;2;129;92;57;55;52;106;178;49;102;148;124;94;152;100,1740032111914091790,40.156257
steepest_intra:nodes_start:greedy,27,72394,23866,48528,1495014950,100001,90;71;164;7;95;39;165;138;14;144;62;9;148;102;49;178;106;52;55;57;92;129;2;152;97;1;101;100;53;180;154;135;70;127;123;162;149;65;116;43;184;177;54;48;160;34;146;22;18;108;69;159;181;42;5;41;193;139;68;140;93;117;143;183;89;23;137;0;46;115;59;118;51;151;133;176;80;79;63;94;26;86;75;120;44;25;16;171;175;113;56;31;78;145;179;196;81;185;40;27,8381872192596256391,40.154122
steepest_intra:nodes_start:greedy,28,72266,23737,48529,1495014950,100001,35;43;65;116;131;149;123;127;162;151;133;135;70;154;180;53;121;100;26;86;75;44;25;16;171;175;113;56;31;78;145;179;196;81;90;40;165;185;106;178;138;14;144;62;9;148;102;49;52;55;92;57;129;82;120;2;101;1;97;152;124;94;63;79;80;176;137;23;186;89;183;143;117;0;51;59;118;115;46;68;139;193;41;5;42;181;159;69;108;18;22;146;34;160;48;54;177;10;190;184,667567076089528446,40.238245
steepest_intra:nodes_start:greedy,29,72724,23827,48897,1495014950,100001,127;112;4;84;35;184;177;54;48;160;34;181;146;22;18;108;69;159;193;41;5;42;43;116;65;46;68;139;115;59;118;51;0;117;143;183;89;186;23;137;176;80;79;63;94;124;152;97;1;101;2;120;82;129;57;92;55;52;49;102;148;9;62;144;14;138;178;106;185;165;40;90;81;196;179;145;78;31;56;113;175;171;16;25;44;75;86;26;100;121;53;180;154;70;135;133;151;162;123;29,9088086806899553901,40.206832
steepest_intra:nodes_start:greedy,30,72687,24162,48525,1495014950,100001,34;54;177;10;190;84;184;43;65;116;59;118;115;46;0;51;151;133;162;123;127;70;135;154;180;53;121;100;26;86;75;44;25;16;171;175;113;56;31;78;145;179;196;81;90;40;165;185;106;178;138;14;144;62;9;148;102;49;52;55;92;57;129;82;120;2;101;1;97;152;124;94;63;79;80;176;137;23;186;89;183;143;117;93;140;68;139;193;41;159;69;108;18;22;146;195;42;181;160;30,1008445271993810582,40.402944
steepest_intra:nodes_start:greedy,31,71912,23772,48140,1495014950,100001,56;78;145;92;179;196;81;90;165;40;185;106;178;3;14;144;62;9;148;102;49;52;55;57;129;2;152;97;1;101;100;53;180;154;135;70;127;123;162;149;131;65;116;43;184;84;190;10;177;54;48;160;34;146;22;18;108;69;159;181;42;5;41;193;139;68;140;93;117;143;183;89;186;23;137;0;46;115;59;118;51;151;133;176;80;79;63;94;124;26;86;75;120;44;25;16;171;175;113;31,7560566411531279234,40.151534
steepest_intra:nodes_start:greedy,32,72140,23814,48326,1495014950,100001,185;14;144;62;9;148;102;49;178;106;52;55;57;92;129;2;152;97;1;101;100;53;180;154;135;70;127;123;162;149;131;65;116;43;184;84;190;10;177;54;48;160;34;146;22;18;108;69;159;181;42;5;41;193;139;68;140;93;117;143;183;89;186;23;137;0;46;115;59;118;51;151;133;176;80;79;63;94;189;26;86;75;120;44;25;16;171;175;113;56;31;78;145;179;196;81;90;165;40;138,8589780809761985457,40.185851
steepest_intra:nodes_start:greedy,33,71679,23015,48664,1495014950,100001,37;102;49;178;106;52;55;57;92;129;2;152;97;1;101;100;53;180;154;135;70;127;123;162;149;131;65;116;43;184;190;10;177;54;48;160;34;146;22;18;108;69;159;181;42;5;41;193;139;68;140;93;117;143;183;89;186;23;137;0;46;115;59;118;51;151;133;176;80;79;63;94;189;26;86;75;120;44;25;16;171;175;113;56;31;78;145;179;196;81;90;185;40;165;138;14;144;62;9;148,3264223905474078350,40.385263
steepest_intra:nodes_start:greedy,34,71480,23585,47895,1495014950,100001,160;181;146;22;18;108;69;159;193;41;139;68;46;115;59;118;51;0;117;143;183;89;186;23;137;176;80;79;63;94;124;152;97;1;101;2;120;82;129;57;92;55;52;49;102;148;9;62;144;14;138;178;106;185;165;40;90;81;196;179;145;78;31;56;113;175;171;16;25;44;75;86;26;100;121;53;180;154;70;135;133;151;162;127;123;149;65;116;43;42;184;84;112;4;190;10;177;54;48;34,1142501837516585210,40.188330
steepest_intra:nodes_start:greedy,35,72102,23773,48329,1495014950,100001,184;84;4;112;127;123;162;151;133;135;70;154;180;53;121;100;26;86;75;44;25;16;171;175;113;56;31;78;145;179;196;81;90;40;165;185;106;178;138;14;144;62;9;148;102;49;52;55;92;57;129;82;120;2;101;1;97;152;124;94;63;79;80;176;137;23;186;89;183;143;117;0;51;118;59;115;139;68;46;65;116;43;42;5;41;193;159;69;108;18;22;146;181;34;160;48;54;177;190;35,3122724105475223202,40.316071
steepest_intra:nodes_start:greedy,36,72254,23086,49168,1495014950,100001,140;108;69;18;22;146;159;193;41;5;42;181;34;160;48;54;177;10;190;84;184;43;116;65;149;123;127;162;151;133;135;70;154;180;53;121;100;26;86;75;44;25;16;171;175;113;56;31;78;145;179;196;81;90;165;40;185;106;178;3;14;144;62;9;148;102;49;52;55;57;92;129;82;120;2;101;1;97;152;124;94;63;79;80;176;137;51;118;59;115;139;68;46;0;89;183;143;117;93;36,7939916150448263528,40.288484
steepest_intra:nodes_start:greedy,37,71693,23029,48664,1495014950,100001,148;102;49;178;106;52;55;57;92;129;2;152;97;1;101;100;53;180;154;135;70;127;123;162;149;131;65;116;43;184;190;10;177;54;48;160;34;146;22;18;108;69;159;181;42;5;41;193;139;68;140;93;117;143;183;89;186;23;137;0;46;115;59;118;51;151;133;176;80;79;63;94;189;26;86;75;120;44;25;16;171;175;113;56;31;78;145;179;196;81;90;185;40;165;138;14;144;62;9;37,4085165530065689273,40.179113
steepest_intra:nodes_start:greedy,38,72176,23675,48501,1495014950,100001,157;145;78;92;179;196;81;90;40;165;185;106;178;138;14;144;62;9;148;102;49;52;55;57;129;2;152;97;1;101;100;53;180;154;135;70;127;123;162;149;131;65;116;43;184;190;10;177;54;48;160;34;146;22;18;108;69;159;181;42;5;41;193;139;68;140;93;117;143;183;89;186;23;137;0;46;115;59;118;51;151;133;176;80;79;63;94;189;26;86;75;120;44;25;16;171;175;113;56;31,1856166495771817036,40.242891
steepest_intra:nodes_start:greedy,39,72283,23813,48470,1495014950,100001,165;95;7;164;27;90;40;185;81;196;179;145;78;31;56;113;175;171;16;25;44;120;75;86;26;189;94;63;79;80;176;133;151;51;118;59;115;46;0;137;23;89;183;143;117;93;140;68;139;193;41;5;42;181;159;69;108;18;22;146;34;160;48;54;177;184;43;116;65;149;162;123;127;70;135;154;180;53;100;101;1;97;152;2;129;92;57;55;52;106;178;49;102;148;9;62;144;14;138;39,5076298455115245096,40.315038
steepest_intra:nodes_start:greedy,40,71461,23135,48326,1495014950,100001,185;165;138;14;144;62;9;148;102;49;178;106;52;55;57;92;129;2;152;97;1;101;100;53;180;154;135;70;127;123;162;149;131;65;116;43;184;84;190;10;177;54;48;160;34;146;22;18;108;69;159;181;42;5;41;193;139;68;140;93;117;143;183;89;186;23;137;0;46;115;59;118;51;151;133;176;80;79;63;94;189;26;86;75;120;44;25;16;171;175;113;56;31;78;145;179;196;81;90;40,2528080609554324096,40.165441
steepest_intra:nodes_start:greedy,41,71500,23455,48045,1495014950,100001,41;5;42;181;159;69;108;18;22;146;34;160;48;54;177;10;190;4;112;184;43;116;65;149;123;127;162;151;133;135;70;154;180;53;121;100;26;86;75;44;25;16;171;175;113;56;31;78;145;179;196;81;90;165;40;185;106;178;138;14;144;62;9;148;102;49;52;55;57;92;129;82;120;2;101;1;97;152;124;94;63;79;80;176;137;23;186;89;183;143;117;0;51;118;59;115;46;68;139;193,5637110051522339120,40.250664
steepest_intra:nodes_start:greedy,42,71746,23377,48369,1495014950,100001,42;5;41;193;139;68;46;115;59;118;51;0;117;143;183;89;186;23;137;176;80;79;63;94;124;152;97;1;101;2;120;82;129;92;57;55;52;49;102;148;9;62;144;14;138;178;106;185;165;40;90;81;196;179;145;78;31;56;113;175;171;16;25;44;75;86;26;100;121;53;180;154;70;135;133;151;162;127;123;149;65;116;43;184;84;4;190;10;177;54;48;160;34;146;22;18;108;69;159;181,8693638268580754056,40.235466
steepest_intra:nodes_start:greedy,43,71882,23460,48422,1495014950,100001,43;65;116;59;118;115;46;0;51;151;133;162;123;127;70;135;154;180;53;121;100;26;86;75;44;25;16;171;175;113;56;31;78;145;179;196;81;90;40;165;185;106;178;138;14;144;62;9;148;102;49;52;55;57;92;129;82;120;2;101;1;97;152;124;94;63;79;80;176;137;23;186;89;183;143;117;93;140;68;139;193;41;5;42;181;159;69;108;18;22;146;34;160;48;54;177;10;190;84;184,5864687863166665419,40.309579
steepest_intra:nodes_start:greedy,44,71764,23438,48326,1495014950,100001,120;25;16;171;175;113;56;31;78;145;179;196;81;90;165;40;185;106;178;138;14;144;62;9;148;102;49;52;55;57;92;129;2;152;97;1;101;100;53;180;154;135;70;127;123;162;149;131;65;116;43;184;84;190;10;177;54;48;160;34;146;22;18;108;69;159;181;42;5;41;193;139;68;140;93;117;143;183;89;186;23;137;0;46;115;59;118;51;151;133;176;80;79;63;94;189;26;86;75;44,6547246547327538002,40.298651
steepest_intra:nodes_start:greedy,45,73091,24285,48806,1495014950,100001,194;162;133;135;70;154;180;53;121;100;26;86;75;44;25;16;171;175;113;56;31;78;145;179;196;81;90;40;165;185;106;178;138;14;144;62;9;148;102;49;52;55;92;57;129;82;120;2;101;1;97;152;124;94;63;79;80;176;137;23;186;89;183;143;117;0;51;118;59;115;46;68;139;193;41;5;42;181;159;69;108;18;22;146;34;160;48;54;177;10;190;84;184;43;116;65;149;123;127;151,7289919790624927564,40.390679
steepest_intra:nodes_start:greedy,46,72115,23746,48369,1495014950,100001,68;115;59;118;51;0;117;143;183;89;186;23;137;176;80;79;63;94;124;152;97;1;101;2;120;82;129;57;92;55;52;49;102;148;9;62;144;14;138;178;106;185;165;40;90;81;196;179;145;78;31;56;113;175;171;16;25;44;75;86;26;100;121;53;180;154;70;135;133;151;162;127;123;149;65;116;43;184;84;4;190;10;177;54;48;160;34;146;22;18;108;69;159;181;42;5;41;193;139;46,2782189223005858198,40.385104
steepest_intra:nodes_start:greedy,47,71645,23161,48484,1495014950,100001,65;116;43;184;84;190;10;177;54;48;160;34;146;22;18;108;69;159;181;42;5;41;193;139;68;46;115;59;118;51;0;117;143;183;89;186;23;137;176;80;79;63;94;124;152;97;1;101;2;120;82;129;92;57;55;52;49;102;148;9;62;144;14;138;178;106;185;40;165;90;81;196;179;145;78;31;56;113;175;171;16;25;44;75;86;26;100;121;53;180;154;70;135;133;151;162;127;123;149;131,3041932777670398388,39.936742
steepest_intra:nodes_start:greedy,48,71774,23288,48486,1495014950,100001,48;34;160;42;181;195;146;22;18;108;69;159;41;193;139;68;140;93;117;143;183;89;186;23;137;176;80;79;63;94;124;152;97;1;101;2;120;82;129;92;57;55;52;49;102;148;9;62;144;14;138;178;106;185;40;165;90;81;196;179;145;78;31;56;113;175;171;16;25;44;75;86;26;100;121;53;180;154;135;70;127;123;162;133;151;51;0;46;115;118;59;116;65;43;184;84;190;10;177;54,256751403011281809,40.172613
steepest_intra:nodes_start:greedy,49,71486,23424,48062,1495014950,100001,102;178;106;52;55;57;92;129;2;152;97;1;101;100;53;180;154;135;70;127;123;162;149;131;65;116;43;184;84;190;10;177;54;48;160;34;146;22;18;108;69;159;181;42;5;41;193;139;68;140;93;117;143;183;89;186;23;137;0;46;115;59;118;51;151;133;176;80;79;63;94;124;26;86;75;120;44;25;16;171;175;113;56;31;78;145;179;196;81;90;165;40;185;138;14;144;62;9;148;49,5282190543749320301,40.354326
steepest_intra:nodes_start:greedy,50,72674,24173,48501,1495014950,100001,157;175;171;16;25;44;120;75;86;26;189;94;63;79;80;176;133;151;51;118;59;115;46;0;137;23;186;89;183;143;117;93;140;68;139;193;41;5;42;181;159;69;108;18;22;146;34;160;48;54;177;10;190;184;43;116;65;131;149;162;123;127;70;135;154;180;53;100;101;1;97;152;2;129;57;55;52;49;102;148;9;62;144;14;138;178;106;185;165;40;90;81;196;179;92;78;145;31;56;113,89979554781898949,40.164582
steepest_intra:nodes_start:greedy,51,73212,24843,48369,1495014950,100001,0;118;59;115;46;68;139;193;41;5;42;181;159;69;108;18;22;146;34;160;48;54;177;10;190;4;84;184;43;116;65;149;123;127;162;151;133;135;70;154;180;53;121;100;26;86;75;44;25;16;171;175;113;56;31;78;145;179;196;81;90;40;165;185;106;178;138;14;144;62;9;148;102;49;52;55;92;57;129;82;120;2;101;1;97;152;124;94;63;79;80;176;137;23;186;89;183;143;117;51,7485612657043686236,40.295157
steepest_intra:nodes_start:greedy,52,71338,23276,48062,1495014950,100001,52;106;178;49;102;148;9;62;144;14;138;185;40;165;90;81;196;179;145;78;31;56;113;175;171;16;25;44;120;75;86;26;124;94;63;79;80;176;133;151;51;118;59;115;46;0;137;23;186;89;183;143;117;93;140;68;139;193;41;5;42;181;159;69;108;18;22;146;34;160;48;54;177;10;190;84;184;43;116;65;131;149;162;123;127;70;135;154;180;53;100;101;1;97;152;2;129;92;57;55,6976407938775698309,40.219438
steepest_intra:nodes_start:greedy,53,71633,23063,48570,1495014950,100001,53;158;154;70;135;180;63;79;133;51;118;59;115;46;0;143;117;93;140;68;139;193;41;5;42;181;159;69;108;18;22;146;34;160;48;54;177;184;43;116;65;149;123;127;162;151;80;176;137;23;183;89;186;114;15;9;62;144;14;138;185;40;165;90;81;196;179;145;78;31;56;113;175;171;16;25;44;120;2;129;92;57;55;52;106;178;49;102;148;124;94;152;97;1;101;75;86;26;100;121,941406239709576669,40.218307
steepest_intra:nodes_start:greedy,54,71643,23157,48486,1495014950,100001,54;48;34;160;42;181;195;146;22;18;108;69;159;193;41;139;68;140;93;117;143;183;89;186;23;137;176;80;79;63;94;124;152;97;1;101;2;120;82;129;92;57;55;52;49;102;148;9;62;144;14;138;178;106;185;40;165;90;81;196;179;145;78;31;56;113;175;171;16;25;44;75;86;26;100;121;53;180;154;135;70;127;123;162;133;151;51;0;46;115;118;59;65;116;43;184;84;190;10;177,8479340198629149605,40.291157
steepest_intra:nodes_start:greedy,55,71338,23276,48062,1495014950,100001,55;52;106;178;49;102;148;9;62;144;14;138;185;40;165;90;81;196;179;145;78;31;56;113;175;171;16;25;44;120;75;86;26;124;94;63;79;80;176;133;151;51;118;59;115;46;0;137;23;186;89;183;143;117;93;140;68;139;193;41;5;42;181;159;69;108;18;22;146;34;160;48;54;177;10;190;84;184;43;116;65;131;149;162;123;127;70;135;154;180;53;100;101;1;97;152;2;129;92;57,5924103305488931296,40.439926
steepest_intra:nodes_start:greedy,56,71780,23640,48140,1495014950,100001,113;31;78;145;92;179;196;81;90;165;40;185;106;178;3;14;144;62;9;148;102;49;52;55;57;129;2;152;97;1;101;100;53;180;154;135;70;127;123;162;149;131;65;116;43;184;84;190;10;177;54;48;160;34;146;22;18;108;69;159;181;42;5;41;193;139;68;140;93;117;143;183;89;186;23;137;0;46;115;59;118;51;151;133;176;80;79;63;94;124;26;86;75;120;44;25;16;171;175;56,881806877039908379,40.305197
steepest_intra:nodes_start:greedy,57,71557,23231,48326,1495014950,100001,57;55;52;49;102;148;9;62;144;14;138;178;106;185;40;165;90;81;196;179;145;78;31;56;113;175;171;16;25;44;120;75;86;26;189;94;63;79;80;176;133;151;51;118;59;115;46;0;137;23;186;89;183;143;117;93;140;68;139;193;41;5;42;181;159;69;108;18;22;146;34;160;48;54;177;10;190;84;184;43;116;65;131;149;162;123;127;70;135;154;180;53;100;101;1;97;152;2;129;92,4948080874586290940,40.426909
steepest_intra:nodes_start:greedy,58,72588,24092,48496,1495014950,100001,164;71;27;90;81;196;157;31;56;113;175;171;16;25;44;120;75;86;26;94;63;79;80;176;133;151;51;118;59;115;46;0;137;23;89;183;143;117;93;140;68;139;193;41;5;42;181;159;69;108;18;22;146;34;160;48;54;177;184;43;116;65;149;162;123;127;70;135;154;180;53;100;101;1;97;152;2;129;57;92;78;145;179;40;165;185;55;52;106;178;14;49;102;148;9;62;144;21;7;58,7139270788886598528,40.312024
steepest_intra:nodes_start:greedy,59,71746,23377,48369,1495014950,100001,59;115;46;68;139;193;41;5;42;181;159;69;108;18;22;146;34;160;48;54;177;10;190;4;84;184;43;116;65;149;123;127;162;151;133;135;70;154;180;53;121;100;26;86;75;44;25;16;171;175;113;56;31;78;145;179;196;81;90;40;165;185;106;178;138;14;144;62;9;148;102;49;52;55;57;92;129;82;120;2;101;1;97;152;124;94;63;79;80;176;137;23;186;89;183;143;117;0;51;118,5494753911368816770,40.433305
steepest_intra:nodes_start:greedy,60,72302,23933,48369,1495014950,100001,68;46;115;139;193;41;5;42;181;159;69;108;18;22;146;34;160;48;54;177;10;190;4;84;184;43;116;65;149;123;127;162;151;133;135;70;154;180;53;121;100;26;86;75;44;25;16;171;175;113;56;31;78;145;179;196;81;90;40;165;185;106;178;138;14;144;62;9;148;102;49;52;55;92;57;129;82;120;2;101;1;97;152;124;94;63;79;80;176;137;23;186;89;183;143;117;0;51;59;118,8882093820890700068,40.204828
steepest_intra:nodes_start:greedy,61,71602,23316,48286,1495014950,100001,15;144;14;138;165;40;185;90;81;196;179;145;78;31;56;113;175;171;16;25;44;120;75;86;26;189;94;63;79;80;176;133;151;51;118;59;115;46;0;137;23;186;89;183;143;117;93;140;68;139;193;41;5;42;181;159;69;108;18;22;146;34;160;48;54;177;10;190;184;43;116;65;131;149;162;123;127;70;135;154;180;53;100;101;1;97;152;2;129;92;57;55;52;106;178;49;102;62;9;148,6938964559867415884,40.214680
steepest_intra:nodes_start:greedy,62,71291,23229,48062,89700,5,62;144;14;138;185;40;165;90;81;196;179;145;78;31;56;113;175;171;16;25;44;120;75;86;152;124;94;63;79;80;176;133;151;51;118;59;115;46;0;137;23;186;89;183;143;117;93;140;68;139;193;41;5;42;181;159;69;108;18;22;146;34;160;48;54;177;10;190;84;184;43;116;65;131;149;162;123;127;70;135;154;180;53;100;26;97;1;101;2;129;92;57;55;52;106;178;49;102;148;9,6879754134902748518,0.003000
steepest_intra:nodes_start:greedy,63,71633,23063,48570,1495014950,100001,63;180;135;70;154;158;53;121;100;26;86;75;101;1;97;152;94;124;148;102;49;178;106;52;55;57;92;129;2;120;44;25;16;171;175;113;56;31;78;145;179;196;81;90;165;40;185;138;14;144;62;9;15;114;186;89;183;23;137;176;80;151;162;127;123;149;65;116;43;184;177;54;48;160;34;146;22;18;108;69;159;181;42;5;41;193;139;68;140;93;117;143;0;46;115;59;118;51;133;79,1021276863025535882,40.139993
steepest_intra:nodes_start:greedy,64,72539,23020,49519,1495014950,100001,15;114;186;89;183;23;137;176;80;151;162;123;149;65;116;43;184;177;54;48;160;34;146;22;18;108;69;159;181;42;5;41;193;139;68;140;93;117;143;0;46;115;59;118;51;133;79;63;180;135;70;154;158;53;121;100;26;86;75;101;1;97;152;94;124;148;9;62;102;49;178;106;52;55;57;92;129;2;120;44;25;16;171;175;113;56;31;78;145;179;196;81;90;185;40;165;138;14;144;64,165490873203782147,40.699476
steepest_intra:nodes_start:greedy,65,71500,23455,48045,1495014950,100001,65;149;123;127;162;151;133;135;70;154;180;53;121;100;26;86;75;44;25;16;171;175;113;56;31;78;145;179;196;81;90;165;40;185;106;178;138;14;144;62;9;148;102;49;52;55;57;92;129;82;120;2;101;1;97;152;124;94;63;79;80;176;137;23;186;89;183;143;117;0;51;118;59;115;46;68;139;193;41;5;42;181;159;69;108;18;22;146;34;160;48;54;177;10;190;4;112;184;43;116,5694980396679451790,40.284781
steepest_intra:nodes_start:greedy,66,73120,23923,49197,1495014950,100001,137;51;118;59;115;46;0;89;183;143;117;93;140;68;139;193;41;5;42;181;159;69;108;18;22;146;34;160;48;54;177;10;190;84;184;43;116;65;149;123;127;162;151;133;135;70;154;180;53;121;100;26;86;75;44;25;16;171;175;113;56;31;78;145;179;196;81;90;40;165;185;106;178;138;14;144;62;9;148;102;49;52;55;92;57;129;82;120;2;101;1;97;152;124;94;63;79;80;176;66,1451947746376240783,40.038411
steepest_intra:nodes_start:greedy,67,72068,22900,49168,1495014950,100001,36;108;69;18;22;146;159;193;41;5;42;181;34;160;48;54;177;10;190;84;184;43;116;65;149;123;127;162;151;133;135;70;154;180;53;121;100;26;86;75;44;25;16;171;175;113;56;31;78;145;179;196;81;90;165;40;185;106;178;3;14;144;62;9;148;102;49;52;55;57;92;129;82;120;2;101;1;97;152;124;94;63;79;80;176;137;51;118;59;115;139;68;46;0;89;183;143;117;93;140,7248134643880927171,40.118416
steepest_intra:nodes_start:greedy,68,72249,23880,48369,1495014950,100001,139;46;115;59;118;51;0;117;143;183;89;186;23;137;176;80;79;63;94;124;152;97;1;101;2;120;82;129;57;92;55;52;49;102;148;9;62;144;14;138;178;106;185;165;40;90;81;196;179;145;78;31;56;113;175;171;16;25;44;75;86;26;100;121;53;180;154;70;135;133;151;162;127;123;149;65;116;43;184;84;4;190;10;177;54;48;160;34;146;22;18;108;69;159;181;42;5;41;193;68,7028108526266160904,40.254874
steepest_intra:nodes_start:greedy,69,73077,24240,48837,1495014950,100001,139;108;18;20;22;146;159;193;41;5;42;181;34;160;48;54;177;10;190;84;184;43;116;65;149;123;127;162;151;133;135;70;154;180;53;121;100;26;86;75;44;25;16;171;175;113;56;31;78;145;179;196;81;90;40;165;185;106;178;138;14;144;62;9;148;102;49;52;55;92;57;129;82;120;2;101;1;97;152;124;94;63;79;80;176;137;23;186;89;183;143;117;0;51;118;59;115;46;68;69,1301960970271613544,40.129966
steepest_intra:nodes_start:greedy,70,71768,23198,48570,1495014950,100001,135;154;158;53;121;100;26;86;75;101;1;97;152;94;124;148;102;49;178;106;52;55;57;92;129;2;120;44;25;16;171;175;113;56;31;78;145;179;196;81;90;185;40;165;138;14;144;62;9;15;114;186;89;183;23;137;176;80;151;162;127;123;149;65;116;43;184;177;54;48;160;34;146;22;18;108;69;159;181;42;5;41;193;139;68;140;93;117;143;0;46;115;59;118;51;133;79;63;180;70,7433502269205993969,40.368673
steepest_intra:nodes_start:greedy,71,72613,24085,48528,1495014950,100001,27;164;7;95;39;165;138;14;144;62;9;148;102;49;178;106;52;55;57;92;129;2;152;97;1;101;100;53;180;154;135;70;127;123;162;149;65;116;43;184;177;54;48;160;34;146;22;18;108;69;159;181;42;5;41;193;139;68;140;93;117;143;183;89;23;137;0;46;115;59;118;51;151;133;176;80;79;63;94;26;86;75;120;44;25;16;171;175;113;56;31;78;145;179;196;81;185;40;90;71,2433534540121167377,40.051981
steepest_intra:nodes_start:greedy,72,72176,23426,48750,1495014950,100001,72;51;0;117;143;183;89;186;23;137;176;80;79;63;94;124;152;97;1;101;2;120;82;129;92;57;55;52;49;102;148;9;62;144;14;138;178;106;185;165;40;90;81;196;179;145;78;31;56;113;175;171;16;25;44;75;86;26;100;121;53;180;154;70;135;133;151;162;127;123;149;65;116;43;184;84;190;10;177;54;48;160;34;146;22;18;108;69;159;181;42;5;41;193;139;68;46;115;118;59,7510236995078402129,40.380180
steepest_intra:nodes_start:greedy,73,72712,23810,48902,1495014950,100001,144;15;148;9;62;102;49;178;106;52;55;57;92;129;2;152;97;1;101;100;53;180;154;135;70;127;123;162;149;131;65;116;43;184;190;177;54;48;160;34;146;22;18;108;69;159;181;42;5;41;193;139;68;140;93;117;143;183;89;186;23;137;0;46;115;59;118;51;151;133;176;80;79;63;94;189;26;86;75;120;44;25;16;171;175;113;56;31;78;145;179;196;81;90;185;40;165;138;14;73,1961300673879507617,40.286139
steepest_intra:nodes_start:greedy,74,72211,23570,48641,1495014950,100001,152;1;101;75;86;53;154;70;135;180;63;79;133;51;118;59;115;46;0;143;117;93;140;68;139;193;41;5;42;181;159;69;108;18;22;146;34;160;48;54;177;184;43;116;65;149;123;127;162;151;80;176;137;23;183;89;186;114;15;9;62;144;14;138;185;40;165;90;81;196;179;145;78;31;56;113;175;171;16;25;44;120;2;129;92;57;55;52;106;178;49;102;148;124;94;189;100;26;97;121,714786086368926343,40.356446
steepest_intra:nodes_start:greedy,75,71792,23528,48264,1495014950,100001,75;44;25;16;171;175;113;56;31;78;145;179;196;81;90;165;40;185;106;178;138;14;144;62;9;148;102;49;52;55;57;92;129;82;120;2;152;97;1;101;100;53;180;154;135;70;127;123;162;149;131;65;116;43;184;190;10;177;54;48;160;34;146;22;18;108;69;159;181;42;5;41;193;139;68;140;93;117;143;183;89;186;23;137;0;46;115;59;118;51;151;133;176;80;79;63;94;124;26;86,1327002424788167093,40.513798
steepest_intra:nodes_start:greedy,76,72529,23546,48983,1495014950,100001,153;176;80;151;162;127;123;149;65;116;43;184;190;177;54;48;160;34;146;22;18;108;69;159;181;42;5;41;193;139;68;46;115;59;118;51;133;79;63;180;135;70;154;158;53;121;100;26;86;75;101;1;97;152;94;124;148;102;49;178;106;52;55;57;92;129;2;120;44;25;16;171;175;113;56;31;78;145;179;196;81;90;185;40;165;138;14;144;62;9;15;114;186;137;23;89;183;143;117;0,4976438502790659346,40.244381
steepest_intra:nodes_start:greedy,77,72149,23809,48340,1495014950,100001,149;43;184;190;10;177;54;48;160;34;146;22;18;108;69;159;181;42;5;41;193;139;68;140;93;117;143;183;89;186;23;137;176;80;79;63;94;124;152;97;1;101;2;120;82;129;57;92;55;52;49;102;148;9;62;144;14;138;178;106;185;165;40;90;81;196;179;145;78;31;56;113;175;171;16;25;44;75;86;26;100;121;53;180;154;135;70;127;123;162;133;151;51;0;46;115;118;59;116;65,3722237289298027956,40.316994
steepest_intra:nodes_start:greedy,78,71733,23407,48326,1495014950,100001,145;31;56;113;175;171;16;25;44;120;75;86;26;189;94;63;79;80;176;133;151;51;118;59;115;46;0;137;23;186;89;183;143;117;93;140;68;139;193;41;5;42;181;159;69;108;18;22;146;34;160;48;54;177;10;190;84;184;43;116;65;131;149;162;123;127;70;135;154;180;53;100;101;1;97;152;2;129;92;57;55;52;49;102;148;9;62;144;14;138;178;106;185;40;165;90;81;196;179;78,3297264248617544447,40.213160
steepest_intra:nodes_start:greedy,79,72177,23369,48808,1495014950,100001,63;80;176;133;151;51;118;59;115;46;0;137;23;186;89;183;143;117;93;140;68;139;193;41;5;42;181;159;69;108;18;22;146;34;160;48;54;177;184;43;116;65;131;149;162;123;127;70;135;180;154;158;53;121;100;26;86;75;44;25;16;171;175;113;56;31;78;145;179;196;81;90;165;40;185;106;178;138;14;144;62;9;148;102;49;52;55;57;92;129;82;120;2;101;1;97;152;124;94;79,5934572817516797070,40.336891
steepest_intra:nodes_start:greedy,80,71887,23403,48484,1495014950,100001,176;79;63;94;124;152;97;1;101;2;120;82;129;92;57;55;52;49;102;148;9;62;144;14;138;178;106;185;40;165;90;81;196;179;145;78;31;56;113;175;171;16;25;44;75;86;26;100;121;53;180;154;135;70;127;123;162;133;151;149;131;65;116;43;184;84;190;10;177;54;48;160;34;146;22;18;108;69;159;181;42;5;41;193;139;68;46;115;59;118;51;0;117;143;183;89;186;23;137;80,5208553549452275075,40.320778
steepest_intra:nodes_start:greedy,81,72149,23823,48326,1495014950,100001,90;196;40;185;179;145;78;31;56;113;175;171;16;25;44;120;75;86;26;189;94;63;79;80;176;133;151;51;118;59;115;46;0;137;23;186;89;183;143;117;93;140;68;139;193;41;5;42;181;159;69;108;18;22;146;34;160;48;54;177;10;190;84;184;43;116;65;131;149;162;123;127;70;135;154;180;53;100;101;1;97;152;2;129;92;57;55;52;106;178;49;102;148;9;62;144;14;138;165;81,2766623346232920350,40.617671
steepest_intra:nodes_start:greedy,82,72335,23807,48528,1495014950,100001,120;2;75;86;26;189;94;63;79;80;176;133;151;51;118;59;115;46;0;137;23;186;89;183;143;117;93;140;68;139;193;41;5;42;181;159;69;108;18;22;146;34;160;48;54;177;10;190;184;43;116;65;131;149;162;123;127;70;135;154;180;53;100;101;1;97;152;129;57;92;55;52;49;102;148;9;62;144;14;138;178;106;185;165;40;90;81;196;179;145;78;31;56;113;175;171;16;25;44;82,8575794875169926716,41.829133
steepest_intra:nodes_start:greedy,83,71578,23036,48542,1495014950,100001,114;89;183;143;117;0;46;68;139;193;41;115;5;42;181;159;69;108;18;22;146;34;160;48;54;177;10;190;4;84;184;43;116;65;59;118;51;151;133;162;123;127;70;135;154;180;53;121;100;26;86;75;44;25;16;171;175;113;56;31;78;145;179;196;81;90;40;165;185;106;178;138;14;144;62;9;148;102;49;52;55;92;57;129;82;120;2;101;1;97;152;124;94;63;79;80;176;137;23;186,7658745591330967588,40.127079
steepest_intra:nodes_start:greedy,84,71758,23429,48329,1495014950,100001,35;4;112;127;123;162;151;133;135;70;154;180;53;121;100;26;86;75;44;25;16;171;175;113;56;31;78;145;179;196;81;90;165;40;185;106;178;138;14;144;62;9;148;102;49;52;55;57;92;129;82;120;2;101;1;97;152;124;94;63;79;80;176;137;23;186;89;183;143;117;0;51;118;59;115;139;68;46;65;116;43;42;5;41;193;159;69;108;18;22;146;181;34;160;48;54;177;190;184;84,6003095834166802930,40.040824
steepest_intra:nodes_start:greedy,85,72102,23601,48501,1495014950,100001,157;145;179;196;81;90;165;40;185;106;178;138;14;144;62;9;148;102;49;52;55;57;92;129;2;152;97;1;101;100;53;180;154;135;70;127;123;162;149;131;65;116;43;184;190;10;177;54;48;160;34;146;22;18;108;69;159;181;42;5;41;193;139;68;140;93;117;143;183;89;186;23;137;0;46;115;59;118;51;151;133;176;80;79;63;94;189;26;86;75;120;44;25;78;31;16;171;175;113;56,1438887625371413450,40.187842
steepest_intra:nodes_start:greedy,86,71633,23063,48570,1495014950,100001,86;75;101;1;97;152;94;124;148;102;49;178;106;52;55;57;92;129;2;120;44;25;16;171;175;113;56;31;78;145;179;196;81;90;165;40;185;138;14;144;62;9;15;114;186;89;183;23;137;176;80;151;162;127;123;149;65;116;43;184;177;54;48;160;34;146;22;18;108;69;159;181;42;5;41;193;139;68;140;93;117;143;0;46;115;59;118;51;133;79;63;180;135;70;154;158;53;121;100;26,3734169106802316310,40.231637
steepest_intra:nodes_start:greedy,87,72550,24045,48505,1495014950,100001,121;2;120;82;129;92;57;55;52;49;102;148;9;62;144;14;3;178;106;185;40;165;90;81;196;179;145;78;31;56;113;175;171;16;25;44;75;86;26;124;94;63;79;80;176;133;151;51;118;59;115;46;0;137;23;186;89;183;143;117;93;140;68;139;193;41;5;42;181;159;69;108;18;22;146;34;160;48;54;177;10;184;43;116;65;131;149;162;123;127;70;135;154;180;53;100;101;1;97;152,2406446667902781429,40.230468
steepest_intra:nodes_start:greedy,88,72494,23966,48528,1495014950,100001,82;25;44;120;75;86;26;189;94;63;79;80;176;133;151;51;118;59;115;46;0;137;23;186;89;183;143;117;93;140;68;139;193;41;5;42;181;159;69;108;18;22;146;34;160;48;54;177;10;190;184;43;116;65;131;149;162;123;127;70;135;154;180;53;100;101;1;97;152;2;129;57;55;52;49;102;148;9;62;144;14;138;178;106;185;165;40;90;81;196;179;92;78;145;31;56;113;175;171;16,73887379461030879,40.219222
steepest_intra:nodes_start:greedy,89,70730,22308,48422,1495014950,100001,89;186;23;137;176;80;79;63;94;124;152;97;1;101;2;120;82;129;92;57;55;52;49;102;148;9;62;144;14;138;178;106;185;40;165;90;81;196;179;145;78;31;56;113;175;171;16;25;44;75;86;26;100;121;53;180;154;135;70;127;123;162;133;151;51;118;59;65;116;43;184;84;190;10;177;54;48;160;34;146;22;18;108;69;159;181;42;5;41;193;139;115;46;68;140;93;117;0;143;183,8561033579395159322,40.011515
steepest_intra:nodes_start:greedy,90,71806,23480,48326,1495014950,100001,165;40;185;81;196;179;145;78;31;56;113;175;171;16;25;44;120;75;86;26;189;94;63;79;80;176;133;151;51;118;59;115;46;0;137;23;186;89;183;143;117;93;140;68;139;193;41;5;42;181;159;69;108;18;22;146;34;160;48;54;177;10;190;84;184;43;116;65;131;149;162;123;127;70;135;154;180;53;100;101;1;97;152;2;129;92;57;55;52;106;178;49;102;148;9;62;144;14;138;90,7734442844847060434,40.172597
steepest_intra:nodes_start:greedy,91,71940,23439,48501,1495014950,100001,196;179;145;78;31;56;113;175;171;16;25;44;120;75;86;26;189;94;63;79;80;176;133;151;51;118;59;115;46;0;137;23;186;89;183;143;117;93;140;68;139;193;41;5;42;181;159;69;108;18;22;146;34;160;48;54;177;10;190;184;43;116;65;131;149;162;123;127;70;135;154;180;53;100;101;1;97;152;2;129;92;57;55;52;49;102;148;9;62;144;14;138;178;106;185;40;165;90;81;157,830309075659333200,39.927897
steepest_intra:nodes_start:greedy,92,71758,23432,48326,1495014950,100001,92;55;52;49;102;148;9;62;144;14;138;178;106;185;40;165;90;81;196;179;145;78;31;56;113;175;171;16;25;44;120;75;86;26;189;94;63;79;80;176;133;151;51;118;59;115;46;0;137;23;186;89;183;143;117;93;140;68;139;193;41;5;42;181;159;69;108;18;22;146;34;160;48;54;177;10;190;84;184;43;116;65;131;149;162;123;127;70;135;154;180;53;100;101;1;97;152;2;129;57,1779717940971738650,40.086157
steepest_intra:nodes_start:greedy,93,71475,23225,48250,1495014950,100001,93;140;108;69;18;22;146;159;193;41;5;42;181;34;160;48;54;177;10;190;4;112;184;43;116;65;149;123;127;162;151;133;135;70;154;180;53;121;100;26;86;75;44;25;16;171;175;113;56;31;78;145;179;196;81;90;165;40;185;106;178;3;14;144;62;9;148;102;49;52;55;57;92;129;82;120;2;101;1;97;152;124;94;63;79;80;176;137;51;118;59;115;139;68;46;0;89;183;143;117,5375363340320968622,40.163918
steepest_intra:nodes_start:greedy,94,71861,23291,48570,1495014950,100001,124;152;97;1;101;75;86;26;100;121;53;158;154;70;135;180;63;79;133;51;118;59;115;46;0;143;117;93;140;68;139;193;41;5;42;181;159;69;108;18;22;146;34;160;48;54;177;184;43;116;65;149;123;127;162;151;80;176;137;23;183;89;186;114;15;9;62;144;14;138;165;40;185;90;81;196;179;145;78;31;56;113;175;171;16;25;44;120;2;129;92;57;55;52;106;178;49;102;148;94,3694117570371628013,40.210702
steepest_intra:nodes_start:greedy,95,72632,24104,48528,1495014950,100001,39;7;164;71;27;90;40;185;81;196;179;145;78;31;56;113;175;171;16;25;44;120;75;86;26;94;63;79;80;176;133;151;51;118;59;115;46;0;137;23;89;183;143;117;93;140;68;139;193;41;5;42;181;159;69;108;18;22;146;34;160;48;54;177;184;43;116;65;149;162;123;127;70;135;154;180;53;100;101;1;97;152;2;129;92;57;55;52;106;178;49;102;148;9;62;144;14;138;165;95,2696689002036713857,40.174545
steepest_intra:nodes_start:greedy,96,71409,23040,48369,1495014950,100001,5;43;116;65;149;123;127;162;151;133;135;70;154;180;53;121;100;26;86;75;44;25;16;171;175;113;56;31;78;145;179;196;81;90;165;40;185;106;178;138;14;144;62;9;148;102;49;52;55;57;92;129;82;120;2;101;1;97;152;124;94;63;79;80;176;137;23;186;89;183;143;117;0;51;118;59;115;46;68;139;41;193;159;69;108;18;22;146;181;34;160;48;54;177;10;190;4;84;184;42,5644316751482982556,40.221955
steepest_intra:nodes_start:greedy,97,71666,23477,48189,1495014950,100001,97;152;1;101;75;86;53;154;70;135;180;63;79;133;51;118;59;115;46;0;143;117;93;140;68;139;193;41;5;42;181;159;69;108;18;22;146;34;160;48;54;177;10;184;43;116;65;149;123;127;162;151;80;176;137;23;183;89;186;114;15;9;62;144;14;138;185;40;165;90;81;196;179;145;78;31;56;113;175;171;16;25;44;120;2;129;92;57;55;52;106;178;49;102;148;124;94;121;100;26,3018775326233435031,40.154350
steepest_intra:nodes_start:greedy,98,73298,24108,49190,1495014950,100001,196;81;90;27;164;39;165;40;185;106;178;138;14;144;62;9;148;102;49;52;55;57;129;92;179;145;78;82;2;152;97;1;101;100;53;180;154;135;70;127;123;162;149;65;116;43;184;177;54;48;160;34;146;22;18;108;69;159;181;42;5;41;193;139;68;140;93;117;143;183;89;23;137;0;46;115;59;118;51;151;133;176;80;79;63;94;26;86;75;120;44;25;16;171;175;113;56;31;157;98,6619188265396864192,40.034490
steepest_intra:nodes_start:greedy,99,72108,23538,48570,1495014950,100001,53;97;26;100;86;75;101;1;152;94;124;148;102;49;178;106;52;55;57;92;129;2;120;44;25;16;171;175;113;56;31;78;145;179;196;81;90;165;40;185;138;14;144;62;9;15;114;186;89;183;23;137;176;80;151;162;127;123;149;65;116;43;184;177;54;48;160;34;146;22;18;108;69;159;181;42;5;41;193;139;68;140;93;117;143;0;46;115;59;118;51;133;79;63;180;135;70;154;158;121,7130351502362523274,40.116308
steepest_intra:nodes_start:greedy,100,71633,23063,48570,1495014950,100001,100;26;86;75;101;1;97;152;94;124;148;102;49;178;106;52;55;57;92;129;2;120;44;25;16;171;175;113;56;31;78;145;179;196;81;90;165;40;185;138;14;144;62;9;15;114;186;89;183;23;137;176;80;151;162;127;123;149;65;116;43;184;177;54;48;160;34;146;22;18;108;69;159;181;42;5;41;193;139;68;140;93;117;143;0;46;115;59;118;51;133;79;63;180;135;70;154;158;53;121,1707005102546204483,40.140896
steepest_intra:nodes_start:greedy,101,72023,23545,48478,1495014950,100001,75;1;152;97;26;100;189;94;124;148;102;49;178;106;52;55;57;92;129;2;120;44;25;16;171;175;113;56;31;78;145;179;196;81;90;185;40;165;138;14;144;62;9;15;114;186;89;183;23;137;176;80;151;162;127;123;149;65;116;43;184;190;177;54;48;160;34;146;22;18;108;69;159;181;42;5;41;193;139;68;140;93;117;143;0;46;115;59;118;51;133;79;63;180;135;70;154;53;86;101,6006617475048708174,40.291710
steepest_intra:nodes_start:greedy,102,71486,23424,48062,1495014950,100001,49;148;9;62;144;14;138;185;40;165;90;81;196;179;145;78;31;56;113;175;171;16;25;44;120;75;86;26;124;94;63;79;80;176;133;151;51;118;59;115;46;0;137;23;186;89;183;143;117;93;140;68;139;193;41;5;42;181;159;69;108;18;22;146;34;160;48;54;177;10;190;84;184;43;116;65;131;149;162;123;127;70;135;154;180;53;100;101;1;97;152;2;129;92;57;55;52;106;178;102,7763514855620442004,39.957839
steepest_intra:nodes_start:greedy,103,71385,23490,47895,1495014950,100001,181;34;160;48;54;177;10;190;4;112;84;184;42;43;116;65;149;123;127;162;151;133;135;70;154;180;53;121;100;26;86;75;44;25;16;171;175;113;56;31;78;145;179;196;81;90;40;165;185;106;178;138;14;144;62;9;148;102;49;52;55;92;57;129;82;120;2;101;1;97;152;124;94;63;79;80;176;137;23;186;89;183;143;117;0;51;118;59;115;46;68;139;41;193;159;69;108;18;22;146,837255376438752417,40.113850
steepest_intra:nodes_start:greedy,104,71786,23206,48580,1495014950,100001,30;54;48;34;160;42;181;195;146;22;18;108;69;159;41;193;139;68;140;93;117;143;183;89;186;23;137;176;80;79;63;94;124;152;97;1;101;2;120;82;129;92;57;55;52;49;102;148;9;62;144;14;138;178;106;185;40;165;90;81;196;179;145;78;31;56;113;175;171;16;25;44;75;86;26;100;121;53;180;154;135;70;127;123;162;133;151;51;0;46;115;118;59;116;65;43;184;190;10;177,3399914055349242498,39.920587
steepest_intra:nodes_start:greedy,105,72008,23524,48484,1495014950,100001,131;116;43;184;84;190;10;177;54;48;160;34;146;22;18;108;69;159;181;42;5;41;193;139;68;46;115;59;118;51;0;117;143;183;89;186;23;137;176;80;79;63;94;124;152;97;1;101;2;120;82;129;92;57;55;52;49;102;148;9;62;144;14;138;178;106;185;40;165;90;81;196;179;145;78;31;56;113;175;171;16;25;44;75;86;26;100;121;53;180;154;70;135;133;151;162;127;123;149;65,8136434902735592779,39.992593
steepest_intra:nodes_start:greedy,106,71665,23603,48062,1495014950,100001,52;178;49;102;148;9;62;144;14;138;185;40;165;90;81;196;179;145;78;31;56;113;175;171;16;25;44;120;75;86;26;124;94;63;79;80;176;133;151;51;118;59;115;46;0;137;23;186;89;183;143;117;93;140;68;139;193;41;5;42;181;159;69;108;18;22;146;34;160;48;54;177;10;190;84;184;43;116;65;131;149;162;123;127;70;135;154;180;53;100;101;1;97;152;2;129;92;57;55;106,4695694981053593205,40.081379
steepest_intra:nodes_start:greedy,107,72613,24085,48528,1495014950,100001,71;27;164;7;95;39;165;138;14;144;62;9;148;102;49;178;106;52;55;57;92;129;2;152;97;1;101;100;53;180;154;135;70;127;123;162;149;65;116;43;184;177;54;48;160;34;146;22;18;108;69;159;181;42;5;41;193;139;68;140;93;117;143;183;89;23;137;0;46;115;59;118;51;151;133;176;80;79;63;94;26;86;75;120;44;25;16;171;175;113;56;31;78;145;179;196;81;185;40;90,5575565923839630034,40.209277
steepest_intra:nodes_start:greedy,108,72413,23576,48837,1495014950,100001,18;69;139;68;46;115;59;118;51;0;117;143;183;89;186;23;137;176;80;79;63;94;124;152;97;1;101;2;120;82;129;57;92;55;52;49;102;148;9;62;144;14;138;178;106;185;165;40;90;81;196;179;145;78;31;56;113;175;171;16;25;44;75;86;26;100;121;53;180;154;70;135;133;151;162;127;123;149;65;116;43;184;84;190;10;177;54;48;160;34;181;42;5;41;193;159;146;22;20;108,1651177042855495028,40.062439
steepest_intra:nodes_start:greedy,109,71925,23079,48846,1495014950,100001,51;118;115;46;68;139;193;41;5;42;181;159;69;108;18;22;146;34;160;48;54;177;10;190;4;84;184;43;65;116;59;151;133;162;123;127;70;135;154;180;53;121;100;26;86;75;44;25;16;171;175;113;56;31;78;145;179;196;81;90;165;40;185;106;178;138;14;144;62;9;148;102;49;52;55;57;92;129;82;120;2;101;1;97;152;124;94;63;79;80;176;137;23;186;89;183;143;117;0;109,9150586539591455052,40.025973
steepest_intra:nodes_start:greedy,110,72126,23405,48721,1495014950,100001,139;193;41;5;42;181;159;69;108;18;22;146;34;160;48;54;177;10;190;84;184;43;116;65;149;123;127;162;151;133;135;70;154;180;53;121;100;26;86;75;44;25;16;171;175;113;56;31;78;145;179;196;81;90;40;165;185;106;178;138;14;144;62;9;148;102;49;52;55;57;92;129;82;120;2;101;1;97;152;124;94;63;79;80;176;137;23;186;89;183;143;117;0;51;118;59;115;46;68;198,5481041127564862220,40.187016
steepest_intra:nodes_start:greedy,111,72508,23912,48596,1495014950,100001,167;148;9;62;102;144;14;49;178;106;165;39;95;164;27;90;81;196;40;185;52;55;57;129;92;179;145;78;31;56;113;175;171;16;25;44;120;2;152;97;1;101;75;86;26;100;121;53;158;154;70;135;180;63;79;133;51;118;59;115;46;0;89;183;143;117;93;140;68;139;193;41;5;42;181;159;69;108;18;22;146;34;160;48;54;177;184;43;116;65;149;123;127;162;151;80;176;137;94;124,8468776839952451352,40.595509
steepest_intra:nodes_start:greedy,112,72645,24316,48329,1495014950,100001,127;4;84;35;184;190;177;54;48;160;34;181;146;22;18;108;69;159;193;41;5;42;43;116;65;46;68;139;115;59;118;51;0;117;143;183;89;186;23;137;176;80;79;63;94;124;152;97;1;101;2;120;82;129;57;92;55;52;49;102;148;9;62;144;14;138;178;106;185;165;40;90;81;196;179;145;78;31;56;113;175;171;16;25;44;75;86;26;100;121;53;180;154;70;135;133;151;162;123;112,5135934309170300990,40.126646
steepest_intra:nodes_start:greedy,113,71948,23622,48326,1495014950,100001,175;56;31;78;145;92;179;196;81;90;165;40;185;106;178;138;14;144;62;9;148;102;49;52;55;57;129;2;152;97;1;101;100;53;180;154;135;70;127;123;162;149;131;65;116;43;184;84;190;10;177;54;48;160;34;146;22;18;108;69;159;181;42;5;41;193;139;68;140;93;117;143;183;89;186;23;137;0;46;115;59;118;51;151;133;176;80;79;63;94;189;26;86;75;120;44;25;16;171;113,5466499923452710376,40.151442
steepest_intra:nodes_start:greedy,114,71962,23392,48570,1495014950,100001,15;186;89;183;23;137;176;80;151;162;127;123;149;65;116;43;184;177;54;48;160;34;146;22;18;108;69;159;181;42;5;41;193;139;68;140;93;117;143;0;46;115;59;118;51;133;79;63;180;135;70;154;158;53;121;100;26;86;75;101;1;97;152;94;124;148;9;62;102;49;178;106;52;55;57;92;129;2;120;44;25;16;171;175;113;56;31;78;145;179;196;81;90;185;40;165;138;14;144;114,7513351004235230799,40.119843
steepest_intra:nodes_start:greedy,115,72298,23929,48369,1495014950,100001,46;59;118;51;0;117;143;183;89;186;23;137;176;80;79;63;94;124;152;97;1;101;2;120;82;129;57;92;55;52;49;102;148;9;62;144;14;138;178;106;185;165;40;90;81;196;179;145;78;31;56;113;175;171;16;25;44;75;86;26;100;121;53;180;154;70;135;133;151;162;127;123;149;65;116;43;184;84;4;190;10;177;54;48;160;34;146;22;18;108;69;159;181;42;5;41;193;139;68;115,7440407484796625210,40.244056
steepest_intra:nodes_start:greedy,116,71500,23455,48045,1495014950,100001,116;43;184;112;4;190;10;177;54;48;160;34;146;22;18;108;69;159;181;42;5;41;193;139;68;46;115;59;118;51;0;117;143;183;89;186;23;137;176;80;79;63;94;124;152;97;1;101;2;120;82;129;92;57;55;52;49;102;148;9;62;144;14;138;178;106;185;40;165;90;81;196;179;145;78;31;56;113;175;171;16;25;44;75;86;26;100;121;53;180;154;70;135;133;151;162;127;123;149;65,4217464619719953607,40.301359
steepest_intra:nodes_start:greedy,117,71284,23157,48127,1495014950,100001,143;0;46;68;139;193;41;115;5;42;181;159;69;108;18;22;146;34;160;48;54;177;10;190;4;112;84;184;43;116;65;59;118;51;151;133;162;123;127;70;135;154;180;53;121;100;26;86;75;44;25;16;171;175;113;56;31;78;145;179;196;81;90;40;165;185;106;178;138;14;144;62;9;148;102;49;52;55;92;57;129;82;120;2;101;1;97;152;124;94;63;79;80;176;137;23;186;89;183;117,7854579462032799507,40.131706
steepest_intra:nodes_start:greedy,118,71805,23436,48369,1495014950,100001,118;115;46;68;139;193;41;5;42;181;159;69;108;18;22;146;34;160;48;54;177;10;190;4;84;184;43;116;65;149;123;127;162;151;133;135;70;154;180;53;121;100;26;86;75;44;25;16;171;175;113;56;31;78;145;179;196;81;90;40;165;185;106;178;138;14;144;62;9;148;102;49;52;55;57;92;129;82;120;2;101;1;97;152;124;94;63;79;80;176;137;23;186;89;183;143;117;0;51;59,5420473695629093023,40.361905
steepest_intra:nodes_start:greedy,119,71375,22916,48459,1495014950,100001,119;40;165;90;81;196;179;145;78;31;56;113;175;171;16;25;44;120;75;86;26;189;94;63;79;80;176;133;151;51;118;59;115;46;0;137;23;186;89;183;143;117;93;140;68;139;193;41;5;42;181;159;69;108;18;22;146;34;160;48;54;177;10;190;184;43;116;65;131;149;162;123;127;70;135;154;180;53;100;101;1;97;152;2;129;92;57;55;52;106;178;49;102;148;9;62;144;14;138;185,5072041810918007532,40.182443
steepest_intra:nodes_start:greedy,120,71764,23438,48326,1495014950,100001,44;75;86;26;189;94;63;79;80;176;133;151;51;118;59;115;46;0;137;23;186;89;183;143;117;93;140;68;139;193;41;5;42;181;159;69;108;18;22;146;34;160;48;54;177;10;190;84;184;43;116;65;131;149;162;123;127;70;135;154;180;53;100;101;1;97;152;2;129;92;57;55;52;49;102;148;9;62;144;14;138;178;106;185;40;165;90;81;196;179;145;78;31;56;113;175;171;16;25;120,8853475204363841706,40.124547
steepest_intra:nodes_start:greedy,121,71750,23180,48570,1495014950,100001,121;100;26;97;86;75;101;1;152;94;124;148;102;49;178;106;52;55;57;92;129;2;120;44;25;16;171;175;113;56;31;78;145;179;196;81;90;165;40;185;138;14;144;62;9;15;114;186;89;183;23;137;176;80;151;162;127;123;149;65;116;43;184;177;54;48;160;34;146;22;18;108;69;159;181;42;5;41;193;139;68;140;93;117;143;0;46;115;59;118;51;133;79;63;180;135;70;154;158;53,5123440322462572199,40.119369
steepest_intra:nodes_start:greedy,122,72375,23243,49132,1495014950,100001,122;176;80;79;133;151;51;118;59;115;46;0;137;23;89;183;143;117;93;140;68;139;193;41;5;42;181;159;69;108;18;22;146;34;160;48;54;177;184;43;116;65;131;149;162;123;127;70;135;180;154;158;53;121;100;26;86;75;44;25;16;171;175;113;56;31;78;145;179;196;81;90;40;165;185;106;178;138;14;144;62;9;148;102;49;52;55;57;92;129;82;120;2;101;1;97;152;124;94;63,2447785180528336160,40.278263
steepest_intra:nodes_start:greedy,123,71924,23440,48484,1495014950,100001,127;162;133;151;149;131;65;116;43;184;84;190;10;177;54;48;160;34;146;22;18;108;69;159;181;42;5;41;193;139;68;46;115;59;118;51;0;117;143;183;89;186;23;137;176;80;79;63;94;124;152;97;1;101;2;120;82;129;92;57;55;52;49;102;148;9;62;144;14;138;178;106;185;40;165;90;81;196;179;145;78;31;56;113;175;171;16;25;44;75;86;26;100;121;53;180;154;135;70;123,841665243442862181,40.109997
steepest_intra:nodes_start:greedy,124,71750,23180,48570,1495014950,100001,94;152;97;1;101;75;86;26;100;121;53;158;154;70;135;180;63;79;133;51;118;59;115;46;0;143;117;93;140;68;139;193;41;5;42;181;159;69;108;18;22;146;34;160;48;54;177;184;43;116;65;149;123;127;162;151;80;176;137;23;183;89;186;114;15;9;62;144;14;138;165;40;185;90;81;196;179;145;78;31;56;113;175;171;16;25;44;120;2;129;92;57;55;52;106;178;49;102;148;124,7520737542602752186,39.999074
steepest_intra:nodes_start:greedy,125,72991,23953,49038,1495014950,100001,189;2;120;82;129;92;57;179;145;78;31;56;113;175;171;16;25;44;75;86;53;154;70;135;180;63;79;133;51;118;59;115;46;0;143;117;93;140;68;139;193;41;5;42;181;159;69;108;18;22;146;34;160;48;54;177;184;43;116;65;149;123;162;151;80;176;137;23;183;89;186;114;15;9;62;144;14;138;165;90;81;196;40;185;55;52;106;178;49;102;148;124;94;121;100;26;101;1;97;152,4303425789588245203,39.933448
steepest_intra:nodes_start:greedy,126,72985,23956,49029,1495014950,100001,127;112;4;84;35;184;177;54;48;160;34;181;146;22;18;108;69;159;193;41;5;42;43;116;65;46;68;139;115;59;118;51;0;117;143;183;89;186;23;137;176;80;79;63;94;124;152;97;1;101;2;120;82;129;57;92;55;52;49;102;148;9;62;144;14;138;178;106;185;165;40;90;81;196;179;145;78;31;56;113;175;171;16;25;44;75;86;26;100;121;53;180;154;70;135;133;151;162;123;126,268613870991652523,40.131057
steepest_intra:nodes_start:greedy,127,72177,23593,48584,1495014950,100001,123;70;135;154;180;53;121;100;26;86;75;44;25;16;171;175;113;56;31;78;145;179;196;81;90;165;40;185;106;178;138;14;144;62;9;148;102;49;52;55;57;92;129;82;120;2;101;1;97;152;124;94;63;79;80;176;133;151;51;118;59;115;46;0;137;23;186;89;183;143;117;93;140;68;139;193;41;5;42;181;159;69;108;18;22;146;34;160;48;54;177;190;184;43;116;65;131;149;162;127,3934326034575981150,40.099060
steepest_intra:nodes_start:greedy,128,71929,23496,48433,1495014950,100001,55;167;148;9;62;102;144;14;49;178;106;185;40;165;90;81;196;179;145;78;31;56;113;175;171;16;25;44;120;75;86;26;189;94;63;79;80;176;133;151;51;118;59;115;46;0;137;23;186;89;183;143;117;93;140;68;139;193;41;5;42;181;159;69;108;18;22;146;34;160;48;54;177;10;190;184;43;116;65;131;149;162;123;127;70;135;154;180;53;100;101;1;97;152;2;129;92;57;52;3,1435318154206406491,39.926217
steepest_intra:nodes_start:greedy,129,71489,23427,48062,1495014950,100001,129;92;57;55;52;49;102;148;9;62;144;14;138;178;106;185;40;165;90;81;196;179;145;78;31;56;113;175;171;16;25;44;120;75;86;26;124;94;63;79;80;176;133;151;51;118;59;115;46;0;137;23;186;89;183;143;117;93;140;68;139;193;41;5;42;181;159;69;108;18;22;146;34;160;48;54;177;10;190;84;184;43;116;65;131;149;162;123;127;70;135;154;180;53;100;101;1;97;152;2,51555366893608150,40.097765
steepest_intra:nodes_start:greedy,130,71750,23180,48570,1495014950,100001,124;148;102;49;178;106;52;55;57;92;129;2;120;44;25;16;171;175;113;56;31;78;145;179;196;81;90;185;40;165;138;14;144;62;9;15;114;186;89;183;23;137;176;80;151;162;127;123;149;65;116;43;184;177;54;48;160;34;146;22;18;108;69;159;181;42;5;41;193;139;68;140;93;117;143;0;46;115;59;118;51;133;79;63;180;135;70;154;158;53;121;100;26;86;75;101;1;97;152;94,3495240514589240569,40.189727
steepest_intra:nodes_start:greedy,131,72008,23524,48484,1495014950,100001,65;149;123;127;162;151;133;135;70;154;180;53;121;100;26;86;75;44;25;16;171;175;113;56;31;78;145;179;196;81;90;165;40;185;106;178;138;14;144;62;9;148;102;49;52;55;57;92;129;82;120;2;101;1;97;152;124;94;63;79;80;176;137;23;186;89;183;143;117;0;51;118;59;115;46;68;139;193;41;5;42;181;159;69;108;18;22;146;34;160;48;54;177;10;190;84;184;43;116;131,8918390207674981054,40.201520
steepest_intra:nodes_start:greedy,132,71988,23819,48169,1495014950,100001,21;14;138;165;40;185;90;81;196;179;145;78;31;56;113;175;171;16;25;44;120;75;86;26;189;94;63;79;80;176;133;151;51;118;59;115;46;0;137;23;186;89;183;143;117;93;140;68;139;193;41;5;42;181;159;69;108;18;22;146;34;160;48;54;177;10;190;184;43;116;65;131;149;162;123;127;70;135;154;180;53;100;101;1;97;152;2;129;92;57;55;52;106;178;49;102;148;9;62;144,6991163770109728770,40.051383
steepest_intra:nodes_start:greedy,133,72524,23940,48584,1495014950,100001,176;151;51;118;59;115;46;0;137;23;186;89;183;143;117;93;140;68;139;193;41;5;42;181;159;69;108;18;22;146;34;160;48;54;177;190;184;43;116;65;131;149;162;123;127;70;135;154;180;53;121;100;26;86;75;44;25;16;171;175;113;56;31;78;145;179;196;81;90;40;165;185;106;178;138;14;144;62;9;148;102;49;52;55;92;57;129;82;120;2;101;1;97;152;124;94;63;79;80;133,6961740260722802038,40.234103
steepest_intra:nodes_start:greedy,134,72723,23510,49213,1495014950,100001,199;108;18;69;139;68;46;115;59;118;51;0;117;143;183;89;186;23;137;176;80;79;63;94;124;152;97;1;101;2;120;82;129;57;92;55;52;49;102;148;9;62;144;14;138;178;106;185;165;40;90;81;196;179;145;78;31;56;113;175;171;16;25;44;75;86;26;100;121;53;180;154;70;135;133;151;162;127;123;149;65;116;43;184;190;10;177;54;48;160;34;181;42;5;41;193;159;146;22;20,2186827221262095048,40.255963
steepest_intra:nodes_start:greedy,135,71633,23063,48570,1495014950,100001,135;70;154;158;53;121;100;26;86;75;101;1;97;152;94;124;148;102;49;178;106;52;55;57;92;129;2;120;44;25;16;171;175;113;56;31;78;145;179;196;81;90;165;40;185;138;14;144;62;9;15;114;186;89;183;23;137;176;80;151;162;127;123;149;65;116;43;184;177;54;48;160;34;146;22;18;108;69;159;181;42;5;41;193;139;68;140;93;117;143;0;46;115;59;118;51;133;79;63;180,6945302307905806349,40.353808
steepest_intra:nodes_start:greedy,136,72605,23837,48768,1495014950,100001,53;121;100;26;86;75;44;25;16;171;175;113;56;31;78;145;179;196;81;90;40;165;185;106;178;138;14;144;62;9;148;102;49;52;55;92;57;129;82;120;2;101;1;97;152;124;94;63;79;80;176;137;23;186;89;183;143;117;0;51;118;59;115;46;68;139;193;41;5;42;181;159;69;108;18;22;146;34;160;48;54;177;10;190;84;184;43;116;65;149;123;127;162;151;133;180;135;70;154;136,1461494846380021388,40.213196
steepest_intra:nodes_start:greedy,137,71633,23063,48570,1495014950,100001,137;23;183;89;186;114;15;9;62;144;14;138;185;40;165;90;81;196;179;145;78;31;56;113;175;171;16;25;44;120;2;129;92;57;55;52;106;178;49;102;148;124;94;152;97;1;101;75;86;26;100;121;53;158;154;70;135;180;63;79;133;51;118;59;115;46;0;143;117;93;140;68;139;193;41;5;42;181;159;69;108;18;22;146;34;160;48;54;177;184;43;116;65;149;123;127;162;151;80;176,2131891744694548425,40.124631
steepest_intra:nodes_start:greedy,138,71406,23080,48326,1495014950,100001,138;14;144;62;9;148;102;49;178;106;52;55;57;92;129;2;152;97;1;101;100;53;180;154;135;70;127;123;162;149;131;65;116;43;184;84;190;10;177;54;48;160;34;146;22;18;108;69;159;181;42;5;41;193;139;68;140;93;117;143;183;89;186;23;137;0;46;115;59;118;51;151;133;176;80;79;63;94;189;26;86;75;120;44;25;16;171;175;113;56;31;78;145;179;196;81;90;165;40;185,4888565103091643970,40.197920
steepest_intra:nodes_start:greedy,139,72098,23729,48369,1495014950,100001,193;68;46;115;59;118;51;0;117;143;183;89;186;23;137;176;80;79;63;94;124;152;97;1;101;2;120;82;129;92;57;55;52;49;102;148;9;62;144;14;138;178;106;185;40;165;90;81;196;179;145;78;31;56;113;175;171;16;25;44;75;86;26;100;121;53;180;154;70;135;133;151;162;127;123;149;65;116;43;184;84;4;190;10;177;54;48;160;34;146;22;18;108;69;159;181;42;5;41;139,7199436977025943832,40.269062
steepest_intra:nodes_start:greedy,140,71475,23225,48250,1495014950,100001,140;108;69;18;22;146;159;193;41;5;42;181;34;160;48;54;177;10;190;4;112;184;43;116;65;149;123;127;162;151;133;135;70;154;180;53;121;100;26;86;75;44;25;16;171;175;113;56;31;78;145;179;196;81;90;165;40;185;106;178;3;14;144;62;9;148;102;49;52;55;57;92;129;82;120;2;101;1;97;152;124;94;63;79;80;176;137;51;118;59;115;139;68;46;0;89;183;143;117;93,3164901163616461281,39.906376
steepest_intra:nodes_start:greedy,141,72098,23003,49095,1495014950,100001,66;23;186;89;183;143;0;117;93;140;68;46;115;139;193;41;5;42;181;159;69;108;18;22;146;34;160;48;54;177;10;190;184;43;116;65;59;118;51;151;133;162;123;127;70;135;154;180;53;121;100;26;86;75;44;25;16;171;175;113;56;31;78;145;179;196;81;90;40;165;185;106;178;138;14;144;62;9;148;102;49;52;55;57;92;129;82;120;2;101;1;97;152;124;94;63;79;80;176;137,5905604689761932473,40.275984
steepest_intra:nodes_start:greedy,142,72451,23730,48721,1495014950,100001,198;139;68;46;115;59;118;51;0;117;143;183;89;186;23;137;176;80;79;63;94;124;152;97;1;101;2;120;82;129;57;92;55;52;49;102;148;9;62;144;14;138;178;106;185;165;40;90;81;196;179;145;78;31;56;113;175;171;16;25;44;75;86;26;100;121;53;180;154;70;135;133;151;162;127;123;149;65;116;43;184;84;190;10;177;54;48;160;34;146;22;18;108;69;159;181;42;5;41;193,98731629486457720,40.279787
steepest_intra:nodes_start:greedy,143,70708,22581,48127,1495014950,100001,143;117;0;46;68;139;115;41;193;5;42;181;159;69;108;18;22;146;34;160;48;54;177;10;190;4;112;84;184;43;116;65;59;118;51;151;133;162;123;127;70;135;154;180;53;121;100;26;86;75;44;25;16;171;175;113;56;31;78;145;179;196;81;90;165;40;185;106;178;138;14;144;62;9;148;102;49;52;55;57;92;129;82;120;2;101;1;97;152;124;94;63;79;80;176;137;23;186;89;183,7608396695465764333,40.270339
steepest_intra:nodes_start:greedy,144,71406,23080,48326,1495014950,100001,144;14;138;185;40;165;90;81;196;179;145;78;31;56;113;175;171;16;25;44;120;75;86;26;189;94;63;79;80;176;133;151;51;118;59;115;46;0;137;23;186;89;183;143;117;93;140;68;139;193;41;5;42;181;159;69;108;18;22;146;34;160;48;54;177;10;190;84;184;43;116;65;131;149;162;123;127;70;135;154;180;53;100;101;1;97;152;2;129;92;57;55;52;106;178;49;102;148;9;62,9182349799357045107,40.320376
steepest_intra:nodes_start:greedy,145,71733,23407,48326,1495014950,100001,78;179;196;81;90;165;40;185;106;178;138;14;144;62;9;148;102;49;52;55;57;92;129;2;152;97;1;101;100;53;180;154;135;70;127;123;162;149;131;65;116;43;184;84;190;10;177;54;48;160;34;146;22;18;108;69;159;181;42;5;41;193;139;68;140;93;117;143;183;89;186;23;137;0;46;115;59;118;51;151;133;176;80;79;63;94;189;26;86;75;120;44;25;16;171;175;113;56;31;145,8567061906089949889,40.260235
steepest_intra:nodes_start:greedy,146,71366,23471,47895,1495014950,100001,22;181;34;160;48;54;177;10;190;4;112;84;184;42;43;116;65;149;123;127;162;151;133;135;70;154;180;53;121;100;26;86;75;44;25;16;171;175;113;56;31;78;145;179;196;81;90;165;40;185;106;178;138;14;144;62;9;148;102;49;52;55;57;92;129;82;120;2;101;1;97;152;124;94;63;79;80;176;137;23;186;89;183;143;117;0;51;118;59;115;46;68;139;41;193;159;69;108;18;146,947778986160925075,40.319076
steepest_intra:nodes_start:greedy,147,71786,23206,48580,1495014950,100001,30;177;10;190;184;43;65;116;59;118;115;46;0;51;151;133;162;123;127;70;135;154;180;53;121;100;26;86;75;44;25;16;171;175;113;56;31;78;145;179;196;81;90;165;40;185;106;178;138;14;144;62;9;148;102;49;52;55;57;92;129;82;120;2;101;1;97;152;124;94;63;79;80;176;137;23;186;89;183;143;117;93;140;68;139;193;41;159;69;108;18;22;146;195;181;42;160;34;48;54,2319658100757742777,39.859195
steepest_intra:nodes_start:greedy,148,71565,23239,48326,1495014950,100001,9;102;49;178;106;52;55;57;92;129;2;152;97;1;101;100;53;180;154;135;70;127;123;162;149;131;65;116;43;184;84;190;10;177;54;48;160;34;146;22;18;108;69;159;181;42;5;41;193;139;68;140;93;117;143;183;89;186;23;137;0;46;115;59;118;51;151;133;176;80;79;63;94;189;26;86;75;120;44;25;16;171;175;113;56;31;78;145;179;196;81;90;185;40;165;138;14;144;62;148,9027319918871952631,40.194920
steepest_intra:nodes_start:greedy,149,71894,23771,48123,1495014950,100001,65;123;127;162;151;133;135;70;154;180;53;121;100;26;86;75;44;25;16;171;175;113;56;31;78;145;179;196;81;90;165;40;185;106;178;3;14;144;62;9;148;102;49;52;55;57;92;129;82;120;2;101;1;97;152;124;94;63;79;80;176;137;23;186;89;183;143;117;0;51;118;59;115;46;68;139;193;41;5;42;181;159;69;108;18;22;146;34;160;48;54;177;10;190;4;112;184;43;116;149,2107638781264260702,40.106071
steepest_intra:nodes_start:greedy,150,73159,24121,49038,1495014950,100001,121;75;44;25;16;171;175;113;56;31;78;145;179;92;57;129;82;120;2;1;152;97;26;100;189;94;124;148;102;49;178;106;52;55;185;40;196;81;90;165;138;14;144;62;9;15;114;186;89;183;23;137;176;80;151;162;123;149;65;116;43;184;177;54;48;160;34;146;22;18;108;69;159;181;42;5;41;193;139;68;140;93;117;143;0;46;115;59;118;51;133;79;63;180;135;70;154;53;86;101,3346654522911066365,40.103845
steepest_intra:nodes_start:greedy,151,72640,24156,48484,1495014950,100001,149;133;162;123;127;70;135;154;180;53;121;100;26;86;75;44;25;16;171;175;113;56;31;78;145;179;196;81;90;165;40;185;106;178;138;14;144;62;9;148;102;49;52;55;57;92;129;82;120;2;101;1;97;152;124;94;63;79;80;176;137;23;186;89;183;143;117;0;51;118;59;115;46;68;139;193;41;5;42;181;159;69;108;18;22;146;34;160;48;54;177;10;190;84;184;43;116;65;131;151,7143772736867488052,39.958246
steepest_intra:nodes_start:greedy,152,71981,23503,48478,1495014950,100001,97;1;101;75;86;53;154;70;135;180;63;79;133;51;118;59;115;46;0;143;117;93;140;68;139;193;41;5;42;181;159;69;108;18;22;146;34;160;48;54;177;190;184;43;116;65;149;123;127;162;151;80;176;137;23;183;89;186;114;15;9;62;144;14;138;165;40;185;90;81;196;179;145;78;31;56;113;175;171;16;25;44;120;2;129;92;57;55;52;106;178;49;102;148;124;94;189;100;26;152,5125829890704606101,40.085191
steepest_intra:nodes_start:greedy,153,72499,23692,48807,1495014950,100001,46;0;117;143;183;89;186;23;137;176;80;79;63;94;124;152;97;1;101;2;120;82;129;57;92;55;52;49;102;148;9;62;144;14;138;178;106;185;165;40;90;81;196;179;145;78;31;56;113;175;171;16;25;44;75;86;26;100;121;53;180;154;135;70;127;123;162;133;151;51;118;59;65;116;43;184;84;4;190;10;177;54;48;160;34;146;22;18;108;69;159;181;42;5;115;41;193;139;68;153,392242023031077068,39.817400
steepest_intra:nodes_start:greedy,154,72127,23557,48570,1495014950,100001,70;158;53;121;100;26;86;75;101;1;97;152;94;124;148;102;49;178;106;52;55;57;92;129;2;120;44;25;16;171;175;113;56;31;78;145;179;196;81;90;185;40;165;138;14;144;62;9;15;114;186;89;183;23;137;176;80;151;162;127;123;149;65;116;43;184;177;54;48;160;34;146;22;18;108;69;159;181;42;5;41;193;139;68;140;93;117;143;0;46;115;59;118;51;133;79;63;180;135;154,411975038556504333,40.312521
steepest_intra:nodes_start:greedy,155,71648,23362,48286,1495014950,100001,144;14;138;185;40;165;90;81;196;179;145;78;31;56;113;175;171;16;25;44;120;75;86;26;189;94;63;79;80;176;133;151;51;118;59;115;46;0;137;23;186;89;183;143;117;93;140;68;139;193;41;5;42;181;159;69;108;18;22;146;34;160;48;54;177;10;190;184;43;116;65;131;149;162;123;127;70;135;154;180;53;100;101;1;97;152;2;129;92;57;55;52;106;178;49;102;148;9;62;15,464292121522848840,40.262310
steepest_intra:nodes_start:greedy,156,72957,23934,49023,1495014950,100001,127;112;4;84;35;184;177;54;48;160;34;181;146;22;18;108;69;159;193;41;5;42;43;116;65;46;68;139;115;59;118;51;0;117;143;183;89;186;23;137;176;80;79;63;94;124;152;97;1;101;2;120;82;129;57;92;55;52;49;102;148;9;62;144;14;138;178;106;185;165;40;90;81;196;179;145;78;31;56;113;175;171;16;25;44;75;86;26;100;121;53;180;154;70;135;133;151;162;123;156,2802119058475957463,40.209412
steepest_intra:nodes_start:greedy,157,72129,23892,48237,1495014950,100001,31;196;81;90;165;40;185;106;178;138;14;144;62;9;148;102;49;52;55;179;145;78;92;57;129;2;152;97;1;101;100;53;180;154;135;70;127;123;162;149;131;65;116;43;184;190;10;177;54;48;160;34;146;22;18;108;69;159;181;42;5;41;193;139;68;140;93;117;143;183;89;186;23;137;0;46;115;59;118;51;151;133;176;80;79;63;94;124;26;86;75;120;44;25;16;171;175;113;56;157,9168527981403061583,40.025072
steepest_intra:nodes_start:greedy,158,71633,23063,48570,1495014950,100001,158;154;70;135;180;63;79;133;51;118;59;115;46;0;143;117;93;140;68;139;193;41;5;42;181;159;69;108;18;22;146;34;160;48;54;177;184;43;116;65;149;123;127;162;151;80;176;137;23;183;89;186;114;15;9;62;144;14;138;185;40;165;90;81;196;179;145;78;31;56;113;175;171;16;25;44;120;2;129;92;57;55;52;106;178;49;102;148;124;94;152;97;1;101;75;86;26;100;121;53,8310268879728528273,40.239734
steepest_intra:nodes_start:greedy,159,71521,23349,48172,1495014950,100001,159;146;22;18;69;108;140;93;117;143;183;89;0;68;46;139;115;59;118;51;137;176;80;79;63;94;124;152;97;1;101;2;120;82;129;92;57;55;52;49;102;148;9;62;144;14;138;178;106;185;40;165;90;81;196;179;145;78;31;56;113;175;171;16;25;44;75;86;26;100;121;53;180;154;70;135;133;151;162;127;123;149;65;116;43;184;112;4;190;10;177;54;48;160;34;181;42;5;41;193,6693352987062425021,40.123076
steepest_intra:nodes_start:greedy,160,71480,23585,47895,1495014950,100001,34;48;54;177;10;190;4;112;84;184;42;43;116;65;149;123;127;162;151;133;135;70;154;180;53;121;100;26;86;75;44;25;16;171;175;113;56;31;78;145;179;196;81;90;40;165;185;106;178;138;14;144;62;9;148;102;49;52;55;92;57;129;82;120;2;101;1;97;152;124;94;63;79;80;176;137;23;186;89;183;143;117;0;51;118;59;115;46;68;139;41;193;159;69;108;18;22;146;181;160,7837247035404945104,40.190990
steepest_intra:nodes_start:greedy,161,72699,23991,48708,1495014950,100001,127;133;135;70;180;154;158;53;121;100;26;86;75;44;25;16;171;175;113;56;31;78;145;179;196;81;90;40;165;185;106;178;138;14;144;62;9;148;102;49;52;55;92;57;129;82;120;2;101;1;97;152;124;94;63;79;80;176;137;23;186;89;183;143;117;0;51;118;59;115;46;68;139;193;41;5;42;181;159;69;108;18;22;146;34;160;48;54;177;10;190;184;43;116;65;131;149;151;162;123,6908149534214809640,39.928225
steepest_intra:nodes_start:greedy,162,72472,24103,48369,1495014950,100001,127;151;133;135;70;154;180;53;121;100;26;86;75;44;25;16;171;175;113;56;31;78;145;179;196;81;90;40;165;185;106;178;138;14;144;62;9;148;102;49;52;55;92;57;129;82;120;2;101;1;97;152;124;94;63;79;80;176;137;23;186;89;183;143;117;0;51;118;59;115;46;68;139;193;41;5;42;181;159;69;108;18;22;146;34;160;48;54;177;10;190;4;84;184;43;116;65;149;123;162,6843282364309890895,40.246518
steepest_intra:nodes_start:greedy,163,72218,23381,48837,1495014950,100001,69;139;68;46;115;59;118;51;0;117;143;183;89;186;23;137;176;80;79;63;94;124;152;97;1;101;2;120;82;129;57;92;55;52;49;102;148;9;62;144;14;138;178;106;185;165;40;90;81;196;179;145;78;31;56;113;175;171;16;25;44;75;86;26;100;121;53;180;154;70;135;133;151;162;127;123;149;65;116;43;184;84;190;10;177;54;48;160;34;181;42;5;41;193;159;146;22;20;18;108,8553705130771862154,40.294826
steepest_intra:nodes_start:greedy,164,72583,24055,48528,1495014950,100001,71;7;95;39;165;138;14;144;62;9;148;102;49;178;106;52;55;57;92;129;2;152;97;1;101;100;53;180;154;135;70;127;123;162;149;65;116;43;184;177;54;48;160;34;146;22;18;108;69;159;181;42;5;41;193;139;68;140;93;117;143;183;89;23;137;0;46;115;59;118;51;151;133;176;80;79;63;94;26;86;75;120;44;25;16;171;175;113;56;31;78;145;179;196;81;185;40;90;27;164,3725763668690490807,40.015510
steepest_intra:nodes_start:greedy,165,71406,23080,48326,1495014950,100001,185;40;165;90;81;196;179;145;78;31;56;113;175;171;16;25;44;120;75;86;26;189;94;63;79;80;176;133;151;51;118;59;115;46;0;137;23;186;89;183;143;117;93;140;68;139;193;41;5;42;181;159;69;108;18;22;146;34;160;48;54;177;10;190;84;184;43;116;65;131;149;162;123;127;70;135;154;180;53;100;101;1;97;152;2;129;92;57;55;52;106;178;49;102;148;9;62;144;14;138,3724118700918679395,40.023525
steepest_intra:nodes_start:greedy,166,72210,23743,48467,1495014950,100001,35;184;190;10;177;54;48;160;34;146;22;18;108;69;159;181;42;5;41;193;139;68;140;93;117;143;183;89;186;23;137;176;80;79;63;94;124;152;97;1;101;2;120;82;129;57;92;55;52;49;102;148;9;62;144;14;138;178;106;185;165;40;90;81;196;179;145;78;31;56;113;175;171;16;25;44;75;86;26;100;121;53;180;154;135;70;127;123;162;133;151;51;0;46;115;118;59;116;65;43,7023999497914223137,40.105790
steepest_intra:nodes_start:greedy,167,73179,24603,48576,1495014950,100001,124;148;9;62;102;144;14;49;178;106;165;39;95;7;164;71;27;90;81;196;40;185;52;55;57;129;92;179;145;78;31;56;113;175;171;16;25;44;120;2;75;101;1;97;152;26;100;86;53;154;70;135;180;63;79;133;51;118;59;115;46;0;89;183;143;117;93;140;68;139;193;41;5;42;181;159;69;108;18;22;146;34;160;48;54;177;184;43;116;65;149;123;127;162;151;80;176;137;94;167,4542706628961863678,40.169971
steepest_intra:nodes_start:greedy,168,72459,23958,48501,1495014950,100001,157;145;179;196;81;90;40;165;185;106;178;138;14;144;62;9;148;102;49;52;55;92;57;129;2;152;97;1;101;100;53;180;154;135;70;127;123;162;149;131;65;116;43;184;190;10;177;54;48;160;34;146;22;18;108;69;159;181;42;5;41;193;139;68;140;93;117;143;183;89;186;23;137;0;46;115;59;118;51;151;133;176;80;79;63;94;189;26;86;75;120;44;25;16;171;175;113;56;31;78,8660798208515226021,40.083654
steepest_intra:nodes_start:greedy,169,71416,22957,48459,1495014950,100001,119;40;185;165;138;14;144;62;9;148;102;49;178;106;52;55;57;92;129;2;152;97;1;101;100;53;180;154;135;70;127;123;162;149;131;65;116;43;184;190;10;177;54;48;160;34;146;22;18;108;69;159;181;42;5;41;193;139;68;140;93;117;143;183;89;186;23;137;0;46;115;59;118;51;151;133;176;80;79;63;94;189;26;86;75;120;44;25;16;171;175;113;56;31;78;145;179;196;81;90,7813248993084106334,39.920654
steepest_intra:nodes_start:greedy,170,71257,22711,48546,1495014950,100001,143;117;0;46;68;139;115;41;193;5;42;181;159;69;108;18;22;146;34;160;48;54;177;10;190;4;112;184;43;116;65;59;118;51;151;133;162;123;127;70;135;154;180;53;121;100;26;86;75;44;25;16;171;175;113;56;31;78;145;179;196;81;90;165;40;185;106;178;138;14;144;62;9;148;102;49;52;55;57;92;129;82;120;2;101;1;97;152;124;94;63;79;80;176;137;23;186;89;183;170,6210179962295455183,40.146338
steepest_intra:nodes_start:greedy,171,71686,23624,48062,1495014950,100001,171;175;113;56;31;78;145;92;179;196;81;90;165;40;185;106;178;138;14;144;62;9;148;102;49;52;55;57;129;2;152;97;1;101;100;53;180;154;135;70;127;123;162;149;131;65;116;43;184;84;190;10;177;54;48;160;34;146;22;18;108;69;159;181;42;5;41;193;139;68;140;93;117;143;183;89;186;23;137;0;46;115;59;118;51;151;133;176;80;79;63;94;124;26;86;75;120;44;25;16,2399320453060568544,40.341493
steepest_intra:nodes_start:greedy,172,72029,23432,48597,1495014950,100001,124;167;148;9;62;102;144;14;49;178;106;165;39;27;90;81;196;40;185;52;55;57;129;92;179;145;78;31;56;113;175;171;16;25;44;120;2;75;86;26;189;94;63;79;80;176;133;151;51;118;59;115;46;0;137;23;186;89;183;143;117;93;140;68;139;193;41;5;42;181;159;69;108;18;22;146;34;160;48;54;177;184;43;116;65;131;149;162;123;127;70;135;154;180;53;100;101;1;97;152,3972063974402641690,39.993175
steepest_intra:nodes_start:greedy,173,72055,23485,48570,1495014950,100001,127;135;70;154;158;53;121;100;26;86;75;101;1;97;152;94;124;148;102;49;178;106;52;55;57;92;129;2;120;44;25;16;171;175;113;56;31;78;145;179;196;81;90;185;40;165;138;14;144;62;9;15;114;186;89;183;23;137;176;80;151;162;123;149;65;116;43;184;177;54;48;160;34;146;22;18;108;69;159;181;42;5;41;193;139;68;140;93;117;143;0;46;115;59;118;51;133;79;63;180,5672634019352633894,40.142542
steepest_intra:nodes_start:greedy,174,71630,23304,48326,1495014950,100001,196;40;185;179;145;78;31;56;113;175;171;16;25;44;120;75;86;26;189;94;63;79;80;176;133;151;51;118;59;115;46;0;137;23;186;89;183;143;117;93;140;68;139;193;41;5;42;181;159;69;108;18;22;146;34;160;48;54;177;10;190;84;184;43;116;65;131;149;162;123;127;70;135;154;180;53;100;101;1;97;152;2;129;92;57;55;52;106;178;49;102;148;9;62;144;14;138;165;90;81,5504736752337853575,40.162111
steepest_intra:nodes_start:greedy,175,71883,23557,48326,1495014950,100001,171;113;56;31;78;145;92;179;196;81;90;165;40;185;106;178;138;14;144;62;9;148;102;49;52;55;57;129;2;152;97;1;101;100;53;180;154;135;70;127;123;162;149;131;65;116;43;184;84;190;10;177;54;48;160;34;146;22;18;108;69;159;181;42;5;41;193;139;68;140;93;117;143;183;89;186;23;137;0;46;115;59;118;51;151;133;176;80;79;63;94;189;26;86;75;120;44;25;16;175,5236520587384915117,40.225682
steepest_intra:nodes_start:greedy,176,72351,23867,48484,1495014950,100001,137;80;79;63;94;124;152;97;1;101;2;120;82;129;92;57;55;52;49;102;148;9;62;144;14;138;178;106;185;40;165;90;81;196;179;145;78;31;56;113;175;171;16;25;44;75;86;26;100;121;53;180;154;135;70;127;123;162;133;151;149;131;65;116;43;184;84;190;10;177;54;48;160;34;146;22;18;108;69;159;181;42;5;41;193;139;68;46;115;59;118;51;0;117;143;183;89;186;23;176,9019592296944411020,40.027109
steepest_intra:nodes_start:greedy,177,71774,23288,48486,1495014950,100001,177;54;48;34;160;42;181;195;146;22;18;108;69;159;41;193;139;68;140;93;117;143;183;89;186;23;137;176;80;79;63;94;124;152;97;1;101;2;120;82;129;92;57;55;52;49;102;148;9;62;144;14;138;178;106;185;40;165;90;81;196;179;145;78;31;56;113;175;171;16;25;44;75;86;26;100;121;53;180;154;135;70;127;123;162;133;151;51;0;46;115;118;59;116;65;43;184;84;190;10,8227254352426372182,40.264684
steepest_intra:nodes_start:greedy,178,71405,23343,48062,1495014950,100001,106;49;102;148;9;62;144;14;138;185;40;165;90;81;196;179;145;78;31;56;113;175;171;16;25;44;120;75;86;26;124;94;63;79;80;176;133;151;51;118;59;115;46;0;137;23;186;89;183;143;117;93;140;68;139;193;41;5;42;181;159;69;108;18;22;146;34;160;48;54;177;10;190;84;184;43;116;65;131;149;162;123;127;70;135;154;180;53;100;101;1;97;152;2;129;92;57;55;52;178,4710524064619826047,40.048086
steepest_intra:nodes_start:greedy,179,71557,23231,48326,1495014950,100001,179;145;78;31;56;113;175;171;16;25;44;120;75;86;26;189;94;63;79;80;176;133;151;51;118;59;115;46;0;137;23;186;89;183;143;117;93;140;68;139;193;41;5;42;181;159;69;108;18;22;146;34;160;48;54;177;10;190;84;184;43;116;65;131;149;162;123;127;70;135;154;180;53;100;101;1;97;152;2;129;92;57;55;52;49;102;148;9;62;144;14;138;178;106;185;40;165;90;81;196,6080351334418252616,40.143934
steepest_intra:nodes_start:greedy,180,72238,23668,48570,1495014950,100001,63;135;70;154;158;53;121;100;26;86;75;101;1;97;152;94;124;148;102;49;178;106;52;55;57;92;129;2;120;44;25;16;171;175;113;56;31;78;145;179;196;81;90;185;40;165;138;14;144;62;9;15;114;186;89;183;23;137;176;80;151;162;127;123;149;65;116;43;184;177;54;48;160;34;146;22;18;108;69;159;181;42;5;41;193;139;68;140;93;117;143;0;46;115;59;118;51;133;79;180,165761983546847792,40.088126
steepest_intra:nodes_start:greedy,181,71712,23817,47895,1495014950,100001,146;34;160;48;54;177;10;190;4;112;84;184;42;43;116;65;149;123;127;162;151;133;135;70;154;180;53;121;100;26;86;75;44;25;16;171;175;113;56;31;78;145;179;196;81;90;40;165;185;106;178;138;14;144;62;9;148;102;49;52;55;92;57;129;82;120;2;101;1;97;152;124;94;63;79;80;176;137;23;186;89;183;143;117;0;51;118;59;115;46;68;139;41;193;159;69;108;18;22;181,3104501163618062100,40.104041
steepest_intra:nodes_start:greedy,182,72130,23388,48742,1495014950,100001,53;121;100;26;86;75;101;1;97;152;94;124;148;102;49;178;106;52;55;57;92;129;2;120;44;25;16;171;175;113;56;31;78;145;179;196;81;90;185;40;165;138;14;144;62;9;15;114;186;89;183;23;137;176;80;151;162;127;123;149;65;116;43;184;177;54;48;160;34;146;22;18;108;69;159;181;42;5;41;193;139;68;140;93;117;143;0;46;115;59;118;51;133;79;63;180;135;70;154;182,2371336649394405793,40.094985
steepest_intra:nodes_start:greedy,183,70708,22581,48127,1495014950,100001,183;89;186;23;137;176;80;79;63;94;124;152;97;1;101;2;120;82;129;92;57;55;52;49;102;148;9;62;144;14;138;178;106;185;40;165;90;81;196;179;145;78;31;56;113;175;171;16;25;44;75;86;26;100;121;53;180;154;135;70;127;123;162;133;151;51;118;59;65;116;43;184;84;112;4;190;10;177;54;48;160;34;146;22;18;108;69;159;181;42;5;193;41;115;139;68;46;0;117;143,5533119148476111110,40.133339
steepest_intra:nodes_start:greedy,184,72332,23910,48422,1495014950,100001,84;43;65;116;59;118;115;46;0;51;151;133;162;123;127;70;135;154;180;53;121;100;26;86;75;44;25;16;171;175;113;56;31;78;145;179;196;81;90;40;165;185;106;178;138;14;144;62;9;148;102;49;52;55;92;57;129;82;120;2;101;1;97;152;124;94;63;79;80;176;137;23;186;89;183;143;117;93;140;68;139;193;41;5;42;181;159;69;108;18;22;146;34;160;48;54;177;10;190;184,6541545266272362763,40.164388
steepest_intra:nodes_start:greedy,185,71461,23135,48326,1495014950,100001,40;90;81;196;179;145;78;31;56;113;175;171;16;25;44;120;75;86;26;189;94;63;79;80;176;133;151;51;118;59;115;46;0;137;23;186;89;183;143;117;93;140;68;139;193;41;5;42;181;159;69;108;18;22;146;34;160;48;54;177;10;190;84;184;43;116;65;131;149;162;123;127;70;135;154;180;53;100;101;1;97;152;2;129;92;57;55;52;106;178;49;102;148;9;62;144;14;138;165;185,8984849032409099910,40.156143
steepest_intra:nodes_start:greedy,186,71124,22997,48127,1495014950,100001,23;89;183;143;117;0;46;68;139;193;41;115;5;42;181;159;69;108;18;22;146;34;160;48;54;177;10;190;4;112;84;184;43;116;65;59;118;51;151;133;162;123;127;70;135;154;180;53;121;100;26;86;75;44;25;16;171;175;113;56;31;78;145;179;196;81;90;40;165;185;106;178;138;14;144;62;9;148;102;49;52;55;92;57;129;82;120;2;101;1;97;152;124;94;63;79;80;176;137;186,2970840338967946521,40.436940
steepest_intra:nodes_start:greedy,187,71787,23418,48369,1495014950,100001,27;81;196;40;185;179;145;78;31;56;113;175;171;16;25;44;120;75;86;26;189;94;63;79;80;176;133;151;51;118;59;115;46;0;137;23;186;89;183;143;117;93;140;68;139;193;41;5;42;181;159;69;108;18;22;146;34;160;48;54;177;10;190;184;43;116;65;131;149;162;123;127;70;135;154;180;53;100;101;1;97;152;2;129;92;57;55;52;106;178;49;102;148;9;62;144;14;138;165;90,7944727801867544879,40.016006
steepest_intra:nodes_start:greedy,188,72352,23851,48501,1495014950,100001,157;31;145;78;92;179;196;81;90;40;165;185;106;178;138;14;144;62;9;148;102;49;52;55;57;129;2;152;97;1;101;100;53;180;154;135;70;127;123;162;149;131;65;116;43;184;190;10;177;54;48;160;34;146;22;18;108;69;159;181;42;5;41;193;139;68;140;93;117;143;183;89;186;23;137;0;46;115;59;118;51;151;133;176;80;79;63;94;189;26;86;75;120;44;25;16;171;175;113;56,6570734788888620423,40.213645
steepest_intra:nodes_start:greedy,189,72189,23129,49060,1495014950,100001,152;94;124;148;102;49;178;106;52;55;57;92;129;2;120;44;25;16;171;175;113;56;31;78;145;179;196;81;90;185;40;165;138;14;144;62;9;15;114;186;89;183;23;137;176;80;151;162;123;149;65;116;43;184;177;54;48;160;34;146;22;18;108;69;159;181;42;5;41;193;139;68;140;93;117;143;0;46;115;59;118;51;133;79;63;180;135;70;154;158;53;121;100;26;86;75;101;1;97;189,3116975140576658875,40.021462
steepest_intra:nodes_start:greedy,190,71443,23266,48177,1495014950,100001,190;10;177;54;48;34;160;42;181;146;22;18;108;69;159;193;41;139;68;46;115;118;59;65;116;43;184;35;131;149;123;162;133;151;51;0;117;143;183;89;23;137;176;80;79;63;94;124;152;97;1;101;2;120;82;129;92;57;55;52;49;102;148;9;62;144;14;3;178;106;185;40;165;90;81;196;179;145;78;31;56;113;175;171;16;25;44;75;86;26;100;121;53;180;154;135;70;127;112;4,4243835681040995992,40.099854
steepest_intra:nodes_start:greedy,191,72103,23382,48721,1495014950,100001,198;193;41;5;42;181;159;69;108;18;22;146;34;160;48;54;177;10;190;84;184;43;116;65;149;123;127;162;151;133;135;70;154;180;53;121;100;26;86;75;44;25;16;171;175;113;56;31;78;145;179;196;81;90;165;40;185;106;178;138;14;144;62;9;148;102;49;52;55;57;92;129;82;120;2;101;1;97;152;124;94;63;79;80;176;137;23;186;89;183;143;117;0;51;118;59;115;46;68;139,6815774562857984355,40.190715
steepest_intra:nodes_start:greedy,192,72518,23749,48769,1495014950,100001,96;42;5;41;193;139;68;140;93;117;143;183;89;186;23;137;176;80;79;63;94;124;152;97;1;101;2;120;82;129;57;92;55;52;49;102;148;9;62;144;14;138;178;106;185;165;40;90;81;196;179;145;78;31;56;113;175;171;16;25;44;75;86;26;100;121;53;180;154;135;70;127;123;162;133;151;51;0;46;115;118;59;116;65;43;184;190;10;177;54;48;160;34;146;22;18;108;69;159;181,4813520332961340615,40.065193
steepest_intra:nodes_start:greedy,193,71500,23455,48045,1495014950,100001,193;139;68;46;115;59;118;51;0;117;143;183;89;186;23;137;176;80;79;63;94;124;152;97;1;101;2;120;82;129;92;57;55;52;49;102;148;9;62;144;14;138;178;106;185;40;165;90;81;196;179;145;78;31;56;113;175;171;16;25;44;75;86;26;100;121;53;180;154;70;135;133;151;162;127;123;149;65;116;43;184;112;4;190;10;177;54;48;160;34;146;22;18;108;69;159;181;42;5;41,5198760696025408015,40.368525
steepest_intra:nodes_start:greedy,194,72004,23111,48893,1495014950,100001,194;127;123;162;133;151;149;131;65;116;43;184;190;10;177;54;48;160;34;146;22;18;108;69;159;181;42;5;41;193;139;68;46;115;59;118;51;0;117;143;183;89;186;23;137;176;80;79;63;94;124;152;97;1;101;2;120;82;129;92;57;55;52;49;102;148;9;62;144;14;138;178;106;185;40;165;90;81;196;179;145;78;31;56;113;175;171;16;25;44;75;86;26;100;121;53;180;154;70;135,8090610717184761558,40.046654
steepest_intra:nodes_start:greedy,195,71517,23084,48433,1495014950,100001,146;181;34;160;48;54;177;10;190;4;84;184;42;43;116;65;149;123;127;162;151;133;135;70;154;180;53;121;100;26;86;75;44;25;16;171;175;113;56;31;78;145;179;196;81;90;165;40;185;106;178;138;14;144;62;9;148;102;49;52;55;57;92;129;82;120;2;101;1;97;152;124;94;63;79;80;176;137;23;186;89;183;143;117;0;51;118;59;115;46;68;139;41;193;159;69;108;18;22;195,3283435223119243525,40.071478
steepest_intra:nodes_start:greedy,196,72230,23370,48860,1495014950,100001,196;81;90;165;40;185;106;178;138;14;144;62;9;148;102;49;52;55;57;129;92;179;145;78;82;2;152;97;1;101;100;53;180;154;135;70;127;123;162;149;131;65;116;43;184;190;177;54;48;160;34;146;22;18;108;69;159;181;42;5;41;193;139;68;140;93;117;143;183;89;186;23;137;0;46;115;59;118;51;151;133;176;80;79;63;94;189;26;86;75;120;44;25;16;171;175;113;56;31;157,975118903680407456,39.973206
steepest_intra:nodes_start:greedy,197,71891,23170,48721,1495014950,100001,198;46;68;139;193;41;5;42;181;159;69;108;18;22;146;34;160;48;54;177;10;190;84;184;43;116;65;149;123;127;162;151;133;135;70;154;180;53;121;100;26;86;75;44;25;16;171;175;113;56;31;78;145;179;196;81;90;165;40;185;106;178;138;14;144;62;9;148;102;49;52;55;57;92;129;82;120;2;101;1;97;152;124;94;63;79;80;176;137;23;186;89;183;143;117;0;51;118;59;115,2194695094419482587,40.072934
steepest_intra:nodes_start:greedy,198,71947,23578,48369,1495014950,100001,68;46;115;59;118;51;0;117;143;183;89;186;23;137;176;80;79;63;94;124;152;97;1;101;2;120;82;129;57;92;55;52;49;102;148;9;62;144;14;138;178;106;185;165;40;90;81;196;179;145;78;31;56;113;175;171;16;25;44;75;86;26;100;121;53;180;154;70;135;133;151;162;127;123;149;65;116;43;184;84;4;190;10;177;54;48;160;34;146;22;18;108;69;159;181;42;5;41;193;139,2716697271923323362,40.079243
steepest_intra:nodes_start:greedy,199,72062,23289,48773,1495014950,100001,199;139;68;46;115;59;118;51;0;117;143;183;89;186;23;137;176;80;79;63;94;124;152;97;1;101;2;120;82;129;92;57;55;52;49;102;148;9;62;144;14;138;178;106;185;165;40;90;81;196;179;145;78;31;56;113;175;171;16;25;44;75;86;26;100;121;53;180;154;70;135;133;151;162;127;123;149;65;116;43;184;84;190;10;177;54;48;160;34;181;42;5;41;193;159;146;22;18;108;69,8890570818524247277,40.274264
steepest_intra:edges_start:random,0,73267,23042,50225,2018250,134,131;149;47;65;116;41;193;159;22;18;69;108;93;117;143;170;0;46;68;139;115;59;118;51;80;176;137;23;183;89;186;114;15;148;9;62;144;49;14;138;3;178;106;52;55;57;92;78;145;179;196;185;40;119;165;27;90;81;157;31;113;175;171;16;25;44;120;129;2;1;101;75;86;26;97;152;94;53;158;154;70;135;180;63;79;133;151;162;123;112;184;54;160;34;146;195;181;42;43;77,3291939193442203718,0.046212
steepest_intra:edges_start:random,1,73628,24606,49022,2048150,136,177;54;34;181;41;193;159;22;18;108;140;68;46;139;115;59;118;109;51;80;176;137;0;117;143;183;89;23;186;15;148;9;62;144;21;164;90;81;40;185;165;138;14;102;49;3;178;106;52;55;179;196;145;78;31;113;175;171;16;25;44;120;75;86;121;100;26;101;1;97;152;2;129;92;57;167;111;124;94;79;63;53;180;154;135;70;127;123;162;133;151;149;131;47;65;116;43;42;160;184,1585922513353157857,0.045861
steepest_intra:edges_start:random,2,73428,24046,49382,2093000,139,186;114;15;37;148;124;167;9;62;102;144;14;49;178;106;52;185;40;165;39;27;90;81;145;78;31;113;175;171;16;44;120;129;92;57;2;1;101;75;86;100;26;97;152;94;79;63;53;180;154;135;70;127;123;162;149;131;43;42;181;184;84;112;4;177;54;160;34;103;146;22;159;41;193;18;69;108;140;93;117;143;0;68;46;198;139;115;116;65;59;118;51;151;133;80;176;137;23;183;89,1677231889541740301,0.046331
steepest_intra:edges_start:random,3,72815,22586,50229,1973400,131,89;183;143;0;117;93;140;68;46;139;115;59;118;109;51;137;176;80;122;63;79;133;151;162;123;149;131;47;65;116;43;42;181;41;193;159;69;108;18;199;22;146;103;34;160;48;54;177;10;184;112;127;70;135;154;180;158;53;86;100;26;97;1;101;75;120;44;25;16;171;175;113;31;78;145;196;81;90;27;165;40;185;106;3;178;52;55;57;92;152;94;124;148;9;62;102;49;14;144;186,4218132637386183817,0.042964
steepest_intra:edges_start:random,4,74666,22508,52158,2018250,134,86;75;101;1;97;94;152;2;120;44;16;171;175;78;145;92;129;57;55;52;185;40;165;106;178;49;14;144;102;62;9;148;15;186;89;183;23;137;176;51;59;118;0;143;117;93;140;68;46;198;139;115;5;42;181;41;193;159;199;69;108;18;22;146;34;160;48;54;30;177;10;4;112;84;184;43;105;116;65;47;131;149;123;127;162;151;133;79;80;122;63;180;154;135;70;158;53;121;100;26,4560341778824504041,0.045000
steepest_intra:edges_start:random,5,72569,23385,49184,1958450,130,137;23;89;183;143;117;0;46;115;139;41;193;159;69;108;18;22;146;34;48;54;177;4;112;84;35;184;160;181;42;5;43;116;65;131;149;123;127;194;162;151;59;118;109;51;133;135;70;154;180;53;100;26;86;75;101;1;97;152;167;178;106;52;55;57;129;2;120;92;179;145;78;25;44;16;171;175;113;56;31;81;90;165;40;185;138;14;144;49;102;62;9;15;148;124;94;63;79;80;176,7134078369241860375,0.042999
steepest_intra:edges_start:random,6,71578,22799,48779,2033200,135,117;93;140;108;18;139;68;46;115;118;59;65;47;116;43;42;5;41;193;159;22;146;181;34;160;54;177;10;190;4;112;84;184;131;149;162;151;51;176;80;79;133;123;127;70;135;154;180;158;53;121;63;94;26;86;75;101;1;97;152;2;120;44;25;78;16;171;175;113;56;31;157;196;81;90;27;165;119;40;185;145;92;129;57;55;52;106;178;3;49;14;144;62;9;148;137;89;183;143;0,5895699003960089304,0.045000
steepest_intra:edges_start:random,7,74344,23798,50546,1988350,132,22;18;108;140;93;117;0;143;183;89;23;137;148;37;167;124;94;189;152;2;129;92;145;40;185;106;178;49;102;9;62;144;14;165;39;27;90;81;196;31;56;113;175;171;16;78;25;44;120;75;101;1;97;86;26;100;121;136;53;158;180;154;135;70;127;123;112;4;177;184;35;131;149;43;116;47;65;59;162;151;133;79;63;80;176;51;118;115;46;68;139;41;193;159;181;42;160;54;34;146,1674834884127783937,0.043035
steepest_intra:edges_start:random,8,75702,24082,51620,1973400,131,86;100;26;189;94;122;80;176;51;151;133;79;63;121;53;180;154;135;70;127;162;123;112;4;10;177;184;160;42;43;116;65;59;115;41;193;22;18;139;46;68;117;0;143;183;89;114;186;23;137;12;124;167;129;92;57;55;52;106;178;3;49;102;62;9;37;148;15;144;21;14;138;185;40;119;165;39;27;90;81;196;157;179;145;78;31;113;175;171;16;25;44;120;82;2;152;97;1;101;75,3862222055363558288,0.043999
steepest_intra:edges_start:random,9,74553,22554,51999,1853800,123,100;121;136;180;133;162;151;176;80;79;63;94;124;167;52;55;57;92;129;2;75;120;44;25;16;171;175;113;31;78;145;196;40;165;185;106;178;3;49;14;144;62;9;148;137;23;186;89;183;143;117;93;108;69;18;199;22;146;195;181;159;193;41;96;115;139;68;46;118;59;149;131;47;65;116;43;5;42;184;160;34;48;54;177;4;112;123;127;194;135;70;154;158;53;86;101;1;152;97;26,1523281471432981522,0.040627
steepest_intra:edges_start:random,10,75873,24597,51276,2137850,142,120;44;82;129;92;57;179;145;78;25;16;171;175;113;56;31;38;157;81;196;169;185;40;119;165;39;90;27;95;164;7;21;138;106;52;55;178;3;49;102;14;144;62;148;89;183;143;117;93;0;137;176;51;118;59;65;47;116;115;46;139;193;41;5;43;42;181;159;108;18;22;146;34;160;54;177;184;84;112;123;127;70;135;162;72;151;133;80;79;63;180;154;53;86;75;101;1;97;152;2,491198745253859342,0.047044
steepest_intra:edges_start:random,11,74521,23534,50987,1943500,129,184;84;112;149;65;116;43;115;139;68;46;118;59;51;151;162;123;127;70;135;133;79;180;154;158;53;121;152;1;97;26;100;86;101;75;2;120;44;25;16;171;175;113;31;78;145;179;92;82;129;57;55;52;178;3;106;185;40;119;165;90;27;95;164;7;21;138;14;144;155;49;102;62;9;15;37;148;124;94;63;122;80;176;137;23;89;183;143;117;108;18;193;41;22;146;34;181;42;160;54,3103199206213281190,0.043263
steepest_intra:edges_start:random,12,72404,24331,48073,1958450,130,176;51;137;23;89;183;143;0;117;93;140;108;18;68;46;198;139;41;193;159;22;146;195;5;42;181;34;160;54;177;10;4;112;84;184;43;47;65;116;115;118;59;149;131;123;127;162;151;133;135;70;154;180;53;86;101;75;120;44;25;78;16;171;175;113;31;196;81;40;185;165;90;27;164;7;21;14;144;62;9;148;102;49;178;106;52;55;57;145;92;129;2;1;97;152;94;63;122;79;80,4045511107086794264,0.043322
steepest_intra:edges_start:random,13,74166,21603,52563,1958450,130,40;185;55;52;106;178;3;49;138;14;144;102;62;9;15;37;148;124;94;63;79;133;80;176;137;89;183;143;0;117;108;18;22;146;34;160;48;54;177;184;112;127;123;149;131;47;65;116;43;42;41;193;139;115;59;51;151;162;194;135;70;6;154;180;158;53;136;182;121;100;26;97;152;1;101;86;75;2;120;44;25;129;92;57;179;145;78;16;171;175;113;56;31;157;196;81;90;27;165;119,4832589226155343579,0.042476
steepest_intra:edges_start:random,14,72666,23551,49115,2107950,140,9;186;23;89;183;137;51;176;80;63;79;133;151;162;59;118;115;46;68;0;143;117;93;140;139;41;193;159;69;108;18;22;146;181;34;160;48;54;177;10;184;42;5;43;116;65;47;131;149;123;135;154;180;53;94;124;148;167;152;1;97;26;100;86;101;75;2;129;92;57;55;52;179;145;78;120;44;25;16;171;175;113;31;196;81;90;27;165;119;40;185;138;106;178;3;49;14;144;102;62,5321665227304499922,0.048037
steepest_intra:edges_start:random,15,73687,23138,50549,2063100,137,121;100;26;97;1;101;86;75;120;44;25;78;16;171;175;113;56;31;145;179;196;81;90;27;39;165;8;119;40;185;55;52;106;178;14;144;49;102;62;9;15;186;89;183;23;137;148;37;167;57;92;129;2;152;124;94;63;79;80;176;51;118;59;115;198;46;0;143;117;93;68;139;41;42;181;193;159;69;108;18;22;146;103;34;160;54;184;43;116;65;123;162;151;133;135;70;154;180;158;53,8337838065503882208,0.045995
steepest_intra:edges_start:random,16,71514,23858,47656,1853800,123,159;69;108;18;22;146;34;181;42;116;65;47;43;184;160;54;177;4;112;84;35;149;123;127;70;135;154;180;53;63;79;133;151;162;59;118;51;176;80;94;26;86;75;101;1;97;152;2;129;82;120;44;25;78;16;171;175;113;31;196;179;145;92;57;55;52;178;106;185;165;119;40;81;90;27;164;7;21;138;14;144;49;102;62;9;148;137;23;89;183;143;0;117;93;68;46;115;139;41;193,4034976571209991403,0.041002
steepest_intra:edges_start:random,17,75117,24800,50317,2063100,137,4;10;177;184;149;59;65;116;43;5;42;181;160;34;22;18;108;159;193;41;139;115;46;0;183;89;186;114;15;148;37;9;62;102;144;14;49;3;178;106;52;55;57;92;185;138;21;7;164;39;165;119;40;90;81;196;145;78;31;56;113;175;171;16;25;44;120;129;2;75;86;101;1;152;97;26;100;121;53;154;180;63;122;94;124;23;137;176;80;79;133;51;151;162;194;135;70;127;123;112,754257859492338073,0.044967
steepest_intra:edges_start:random,18,74046,22632,51414,2063100,137,63;94;124;189;19;152;97;1;101;86;75;2;129;55;178;3;106;52;57;92;145;78;25;120;44;16;171;175;113;56;31;196;81;90;27;165;119;40;185;8;138;14;144;49;102;62;9;148;137;23;89;183;143;117;0;46;139;115;116;65;59;118;109;51;176;80;79;133;151;162;123;149;43;42;181;41;193;159;18;22;34;160;54;177;184;84;4;112;127;194;135;70;154;180;158;53;100;26;121;182,8303248093743423475,0.046031
steepest_intra:edges_start:random,19,73923,22406,51517,2018250,134,78;25;44;16;171;175;113;31;81;90;27;164;39;165;40;185;106;178;3;14;49;102;144;62;9;148;124;94;63;122;79;133;162;149;131;47;77;43;116;65;59;118;109;51;72;151;80;176;137;23;89;183;143;0;117;93;140;68;108;69;18;199;22;146;159;193;41;139;198;46;115;5;42;181;34;160;184;84;112;123;127;70;135;154;180;53;26;97;152;1;101;86;75;120;129;92;57;55;52;145,5348924615895553545,0.044967
steepest_intra:edges_start:random,20,74040,23986,50054,1913600,127,39;90;27;164;14;144;62;9;148;49;3;178;106;52;55;57;129;2;152;124;94;122;79;133;151;162;149;131;65;59;118;51;80;176;137;23;89;183;143;117;0;46;115;139;68;140;108;69;18;22;146;195;159;193;41;116;43;42;181;34;160;54;184;84;112;123;127;194;135;70;154;180;63;53;26;97;1;101;86;75;120;44;92;145;78;16;171;175;113;56;31;157;81;196;91;179;185;40;119;165,336933122727874013,0.045000
steepest_intra:edges_start:random,21,74712,23893,50819,2018250,134,26;100;121;53;158;180;154;70;135;194;127;123;149;131;35;184;10;177;54;48;34;103;146;22;18;108;69;159;193;41;5;42;181;160;43;116;65;59;118;115;139;198;46;68;140;93;117;143;183;89;137;176;80;51;151;162;133;79;63;94;124;152;2;129;92;52;106;178;49;148;15;9;62;144;14;185;40;165;39;95;21;7;164;27;90;81;31;113;175;171;16;78;145;44;120;75;86;101;1;97,4700569018996908249,0.044033
steepest_intra:edges_start:random,22,73434,24252,49182,2033200,135,80;63;79;133;151;59;149;131;65;116;115;46;0;143;117;68;139;41;193;159;18;22;146;181;42;43;35;184;48;160;34;30;54;177;112;123;127;70;135;154;180;53;86;75;101;1;97;26;100;94;124;152;2;120;44;25;16;171;175;113;56;31;157;78;145;92;129;57;179;185;196;81;90;27;164;39;165;40;138;14;144;102;49;3;178;106;52;55;167;148;9;62;15;114;186;89;183;23;137;176,6730301824509874342,0.045996
steepest_intra:edges_start:random,23,73624,23964,49660,1958450,130,75;86;158;70;135;154;180;53;121;100;26;101;1;97;152;94;63;122;79;133;151;162;123;149;59;65;116;43;42;184;112;4;10;177;54;160;34;146;22;159;193;41;115;198;139;18;108;117;143;170;0;68;46;118;51;80;176;137;23;183;89;186;15;144;14;49;62;9;37;148;167;55;52;178;106;185;40;119;165;27;90;81;196;157;56;113;175;171;16;31;78;145;179;57;92;129;25;44;120;2,4125194031249159484,0.044005
steepest_intra:edges_start:random,24,75267,23203,52064,1988350,132,1;101;97;63;122;79;133;151;162;59;118;51;80;176;137;23;89;183;153;0;143;117;68;46;198;115;139;41;193;159;18;22;34;54;177;184;160;181;42;43;116;65;149;131;35;84;4;112;123;127;135;154;180;53;86;75;120;44;25;16;171;175;113;56;85;31;38;157;81;90;27;165;138;14;49;102;144;62;148;94;124;167;55;52;106;178;3;185;119;40;169;196;179;145;78;92;57;129;2;152,464649472993764649,0.044000
steepest_intra:edges_start:random,25,73673,23947,49726,1973400,131,79;133;176;80;122;94;124;152;1;97;26;100;86;101;75;2;129;120;44;25;16;171;175;113;31;196;145;78;92;57;55;52;178;106;185;165;119;40;81;90;27;164;21;14;144;102;49;167;148;37;9;62;15;137;89;183;143;0;117;68;46;198;139;18;22;159;193;41;42;181;34;160;184;48;54;177;10;4;112;123;149;131;47;65;116;105;43;115;59;118;109;51;151;162;135;70;154;180;53;63,472808328235440891,0.042661
steepest_intra:edges_start:random,26,75464,23961,51503,1943500,129,2;75;101;1;152;97;26;100;86;158;53;121;124;94;63;122;80;79;133;180;154;135;70;127;112;4;177;184;160;34;181;42;139;41;193;159;22;18;108;117;143;183;89;153;0;46;115;116;65;47;43;77;131;149;123;194;162;151;72;59;118;51;176;137;23;148;9;62;102;49;14;144;21;164;27;90;39;165;119;40;185;138;3;178;106;52;55;57;92;145;78;31;56;113;175;171;16;44;120;129,6138012203310707074,0.042001
steepest_intra:edges_start:random,27,72298,22943,49355,2137850,142,154;180;158;53;121;100;26;97;152;1;101;86;75;2;120;44;25;129;92;57;179;145;78;31;16;171;175;113;81;90;27;164;95;39;165;119;40;185;55;52;106;178;14;144;49;102;62;9;148;137;89;183;143;0;117;93;108;69;18;199;110;139;68;46;115;59;51;176;80;94;63;79;133;151;162;149;131;65;116;43;42;5;41;193;159;22;146;181;34;160;54;177;10;184;84;112;123;127;70;135,5609271662564918502,0.046999
steepest_intra:edges_start:random,28,71948,23507,48441,2122900,141,21;138;14;144;49;102;62;9;148;124;94;63;79;80;176;137;23;89;183;143;0;46;198;115;41;193;139;68;140;108;18;159;22;34;54;177;10;190;84;4;112;127;70;135;123;149;131;35;184;160;181;42;43;116;47;65;59;118;51;151;162;133;180;154;53;26;86;75;101;1;97;152;2;120;44;25;16;171;175;113;56;31;196;179;145;78;92;129;57;55;52;178;106;185;40;165;90;27;164;7,4741196758629125666,0.047627
steepest_intra:edges_start:random,29,74063,23657,50406,1913600,127,79;63;94;152;2;120;75;86;101;1;97;26;53;180;154;135;70;127;123;29;112;4;190;10;177;54;34;146;22;159;193;41;96;5;43;42;181;160;184;84;35;131;149;65;116;59;51;118;115;46;68;139;69;18;108;140;93;117;0;170;143;183;89;23;137;9;62;144;14;3;178;106;185;40;119;165;27;90;81;196;145;31;56;113;175;171;16;78;92;57;55;52;49;102;148;176;80;151;162;133,3166477454773123611,0.042965
steepest_intra:edges_start:random,30,72128,23062,49066,1973400,131,84;4;112;123;127;70;135;194;162;151;133;180;154;53;100;26;86;75;101;1;97;152;2;120;44;25;78;16;171;175;113;31;145;179;92;129;57;55;52;106;178;3;185;40;119;165;90;27;164;21;14;49;102;144;62;9;148;124;94;63;79;80;176;137;23;89;183;143;117;0;46;118;109;51;72;59;65;116;43;5;115;139;68;108;18;193;41;159;22;146;34;181;42;160;48;54;177;10;190;184,9191778175875430462,0.044037
steepest_intra:edges_start:random,31,72940,23293,49647,2033200,135,114;186;137;23;89;183;153;0;143;117;93;140;108;18;68;46;118;59;72;109;51;176;80;122;63;79;133;151;162;149;131;65;116;43;184;48;160;42;5;115;139;41;193;22;34;54;177;4;112;123;127;70;135;154;180;53;94;124;152;2;101;1;97;26;100;86;75;120;44;25;16;171;175;113;56;31;196;81;90;27;165;40;185;145;78;92;129;57;55;52;106;178;14;144;49;102;62;9;148;15,3289905218494284044,0.045123
steepest_intra:edges_start:random,32,76295,24033,52262,1958450,130,180;154;135;70;127;112;4;84;35;123;162;72;151;133;79;63;94;124;122;80;176;51;118;46;115;59;116;65;149;131;184;177;54;48;160;34;22;159;193;41;181;42;43;5;96;139;68;69;18;108;117;143;0;153;183;89;23;137;186;114;15;148;9;62;102;49;144;14;3;178;106;52;55;185;40;119;165;90;81;57;92;145;78;171;16;44;120;129;2;152;97;1;101;75;86;26;100;121;53;158,8916150318662602632,0.042871
steepest_intra:edges_start:random,33,72507,23063,49444,1988350,132,112;123;149;131;65;116;59;118;51;176;80;122;63;79;133;151;162;135;70;154;180;158;53;121;100;26;97;1;101;86;75;120;44;25;16;171;175;113;31;81;90;27;39;165;119;40;185;179;145;78;92;57;129;2;152;94;124;55;52;106;178;3;49;14;144;62;9;148;15;186;137;23;89;183;143;0;117;68;46;115;96;5;43;42;159;193;41;139;108;18;22;146;34;160;54;177;10;190;184;84,5820542357552724598,0.043002
steepest_intra:edges_start:random,34,72976,23122,49854,1823900,121,165;119;40;185;52;55;57;92;179;145;78;31;113;175;171;16;25;44;120;82;129;2;75;1;152;97;26;101;86;53;158;154;180;121;94;63;122;79;133;80;176;51;151;162;135;127;123;149;131;65;116;59;118;5;42;43;184;84;112;4;10;177;54;160;34;181;146;22;159;41;193;18;108;139;115;46;68;140;93;117;0;170;143;183;89;23;137;148;9;62;144;14;102;49;178;106;138;39;27;90,2473532047740689955,0.040969
steepest_intra:edges_start:random,35,72375,23631,48744,1973400,131,165;40;185;14;144;62;9;102;49;178;106;52;55;57;92;145;78;129;2;1;97;152;124;94;63;79;80;176;137;23;148;15;186;89;183;143;0;117;93;140;68;46;198;139;115;43;42;5;96;41;193;159;69;108;18;22;146;181;34;160;54;177;10;190;184;84;112;123;127;70;135;162;149;65;116;59;118;109;51;151;133;180;154;53;100;26;86;101;75;120;44;25;16;171;175;113;56;31;81;90,2193872389628219906,0.043030
steepest_intra:edges_start:random,36,71550,21648,49902,2137850,142,54;177;10;190;4;112;123;127;135;154;180;53;100;26;86;75;101;1;97;152;2;120;44;25;16;171;175;113;31;78;145;92;57;55;52;196;81;90;165;40;185;106;178;49;14;144;102;62;9;148;124;94;63;79;133;151;162;59;118;51;80;176;137;23;89;183;143;0;117;93;140;68;46;115;139;163;108;69;18;199;22;146;103;34;160;181;159;193;41;96;5;42;43;116;65;47;149;131;35;184,258021725018988925,0.048044
steepest_intra:edges_start:random,37,74480,23635,50845,2033200,135,4;112;84;35;123;127;70;135;162;151;51;176;80;133;79;122;63;94;124;152;19;189;121;136;180;154;158;53;86;100;26;97;1;101;75;2;120;44;25;16;171;175;113;31;78;145;179;92;82;129;57;55;52;178;106;185;40;81;90;165;14;49;102;144;62;9;148;137;89;183;143;0;118;59;149;131;47;65;116;115;139;46;68;140;108;18;159;22;146;34;160;181;193;41;5;42;43;184;177;10,4865424230210276721,0.045001
steepest_intra:edges_start:random,38,73179,23956,49223,1988350,132,101;75;86;97;26;100;53;94;63;180;154;135;70;127;123;131;35;84;112;4;190;10;177;54;48;160;184;42;5;43;116;65;149;162;151;133;79;122;80;176;137;23;51;118;59;115;46;139;41;193;159;181;34;146;22;18;117;0;143;183;89;186;15;148;9;62;144;21;7;164;27;90;39;165;119;40;185;138;14;102;49;3;178;106;52;55;57;92;145;78;31;113;175;171;16;44;120;2;152;1,8436329608506339891,0.042763
steepest_intra:edges_start:random,39,74719,24165,50554,2033200,135,146;103;34;160;48;54;177;10;184;84;4;112;149;131;43;116;47;65;59;162;151;133;79;63;94;180;135;123;70;154;53;121;152;1;97;26;100;86;101;75;2;120;44;16;171;175;113;31;78;145;92;57;55;52;185;40;90;27;164;7;95;39;165;106;178;14;144;49;102;62;9;148;15;186;89;183;143;0;137;176;80;51;109;118;46;68;140;108;69;18;22;159;193;41;139;115;96;5;42;181,5510907802106219103,0.044998
steepest_intra:edges_start:random,40,74713,23132,51581,1988350,132,123;162;72;59;118;109;51;151;133;79;122;80;176;137;148;167;124;94;63;180;154;53;121;100;26;86;75;101;1;97;152;74;2;129;82;120;44;25;78;16;171;175;113;56;31;145;179;92;57;55;52;49;178;106;185;196;81;90;40;119;165;164;7;21;14;144;102;62;9;15;114;186;23;89;183;143;0;46;115;139;41;193;159;22;146;34;160;54;177;184;42;43;116;65;47;149;131;112;127;135,5688567503940299620,0.044683
steepest_intra:edges_start:random,41,73368,22634,50734,2018250,134,148;15;9;62;144;21;164;27;90;165;119;40;185;106;178;3;138;14;102;49;52;55;57;129;92;179;145;78;31;113;175;171;16;25;44;120;2;152;97;1;101;75;86;26;100;53;180;154;135;127;123;162;149;131;184;190;10;177;54;48;34;103;146;195;181;160;42;5;96;43;116;65;59;118;115;46;139;41;193;159;22;18;108;93;117;0;143;183;89;23;137;176;151;133;79;63;94;124;167;37,3278846514387560098,0.045866
steepest_intra:edges_start:random,42,75206,23368,51838,1838850,122,143;183;89;148;9;62;144;102;49;14;138;32;3;178;106;52;55;185;40;119;165;39;95;7;164;27;90;81;196;179;57;129;92;145;78;175;171;16;44;120;2;75;101;1;152;97;26;100;86;53;158;180;154;135;123;149;131;47;65;116;43;42;184;35;84;112;4;10;177;30;54;48;160;34;181;41;139;193;159;22;18;108;140;68;46;115;59;162;151;133;79;63;94;124;122;80;176;137;0;117,1383919631570367475,0.040029
steepest_intra:edges_start:random,43,73119,23066,50053,1973400,131,144;102;62;9;15;137;89;183;143;0;46;115;139;68;108;18;22;193;41;181;34;160;48;54;30;177;10;190;4;112;184;42;43;116;47;65;59;118;51;151;176;80;122;63;79;133;162;149;123;127;135;154;180;158;53;121;94;124;148;37;167;152;1;97;26;100;86;101;75;2;129;92;57;179;145;78;120;44;25;16;171;175;113;56;31;196;81;90;27;165;119;40;185;55;52;106;178;49;138;14,7212898349878157460,0.043969
steepest_intra:edges_start:random,44,74743,22471,52272,2107950,140,48;160;34;181;42;43;105;116;65;47;77;131;149;162;133;151;72;51;109;118;59;115;5;41;193;159;22;18;139;46;0;143;183;137;176;80;79;122;63;94;152;97;1;2;82;129;167;148;15;9;62;144;102;49;14;138;165;90;40;185;106;3;178;52;55;57;92;179;145;78;31;113;175;171;16;44;120;75;101;86;26;100;53;158;180;154;135;70;127;123;112;4;84;35;184;177;190;10;30;54,3614536046792963156,0.047033
steepest_intra:edges_start:random,45,72991,23545,49446,1913600,127,89;183;143;117;93;108;18;22;146;34;160;184;177;10;4;112;127;123;162;135;70;154;180;158;53;100;26;86;75;101;1;97;152;2;129;57;92;82;120;44;25;16;171;175;113;31;157;81;196;78;145;179;55;52;185;40;119;165;90;164;21;14;138;106;178;49;102;144;62;9;148;94;63;79;133;151;72;59;149;131;47;65;116;43;42;181;159;193;41;139;46;115;118;109;51;80;176;137;23;186,2877419237473821919,0.042134
steepest_intra:edges_start:random,46,72586,22916,49670,2048150,136,35;84;112;127;123;162;151;133;135;70;154;180;158;53;86;75;101;1;97;152;2;120;129;92;145;78;44;16;171;175;113;31;196;81;90;27;165;40;185;55;52;106;178;3;138;14;144;49;102;62;9;186;89;183;23;137;148;124;94;63;79;80;176;51;109;118;59;149;65;116;43;42;5;96;41;193;139;115;198;46;68;0;143;117;93;140;108;18;159;22;146;181;34;160;48;54;177;10;190;184,937232097400215436,0.044833
steepest_intra:edges_start:random,47,74447,24528,49919,1719250,114,112;123;162;133;79;63;94;124;189;121;180;135;154;158;53;100;26;97;152;1;101;86;75;2;129;82;120;44;25;78;92;57;179;145;31;16;171;175;113;90;27;164;21;14;165;40;185;55;52;106;178;49;102;144;62;9;148;15;114;186;23;89;183;137;176;80;151;51;118;59;115;116;65;43;42;5;41;193;159;139;68;46;0;170;143;117;93;140;108;18;22;195;146;103;34;181;160;54;177;184,661399862278662173,0.036998
steepest_intra:edges_start:random,48,73136,23309,49827,2257450,150,46;68;139;115;59;118;51;151;133;79;63;122;80;176;137;23;183;89;186;114;15;144;14;138;21;7;164;95;27;90;39;165;119;40;185;52;106;178;49;102;62;9;148;124;94;152;2;129;55;57;92;78;145;196;81;157;31;56;113;175;171;16;44;120;75;86;101;1;97;26;53;180;154;135;127;123;149;131;65;116;43;35;112;84;184;160;34;181;42;41;193;159;22;18;108;140;93;117;143;0,5239512658616276530,0.050001
steepest_intra:edges_start:random,49,72649,23652,48997,2152800,143,82;2;152;189;94;124;167;49;3;178;106;52;55;185;40;119;165;90;27;164;7;21;14;144;62;9;148;15;186;137;23;89;183;143;117;0;46;115;139;108;18;22;159;193;41;96;5;42;43;184;160;181;34;54;177;10;190;4;112;123;65;116;59;118;51;176;80;63;79;133;151;162;135;154;180;53;121;100;26;97;1;101;86;75;120;44;25;16;171;175;113;31;81;196;78;145;179;57;92;129,125560481986850835,0.050002
steepest_intra:edges_start:random,50,74166,21251,52915,2078050,138,157;196;81;90;27;165;119;40;185;106;178;3;32;138;14;144;155;49;102;62;9;148;124;94;152;97;1;101;26;100;121;182;63;79;80;176;137;23;186;89;183;143;0;117;93;108;18;22;146;34;160;184;112;127;123;149;65;116;43;42;41;193;139;46;115;59;118;51;151;133;162;161;194;135;70;154;180;158;53;86;75;2;120;44;25;82;129;92;57;55;52;179;145;78;16;171;175;113;56;31,3440562899835573367,0.045581
steepest_intra:edges_start:random,51,75276,24070,51206,2107950,140,149;184;177;4;112;123;162;151;127;70;135;154;180;158;53;121;100;26;86;75;101;1;97;152;111;167;49;138;3;178;106;52;55;57;92;129;2;120;44;16;171;175;113;31;78;145;196;81;40;119;185;165;90;27;164;7;21;14;155;144;102;62;9;15;37;148;124;94;189;63;122;79;133;80;176;137;23;89;183;143;0;118;59;115;139;46;68;108;18;22;159;193;41;181;34;160;42;43;116;65,8354057554761804017,0.046031
steepest_intra:edges_start:random,52,74170,23767,50403,1988350,132,41;193;159;18;69;108;140;68;46;51;176;137;23;183;89;186;62;9;148;167;55;52;106;178;3;49;102;144;14;21;7;164;27;90;39;165;185;119;40;81;196;157;31;56;113;175;171;16;25;44;120;82;78;145;179;57;92;129;2;152;97;1;101;75;86;100;26;124;94;80;79;63;53;180;154;135;133;151;162;59;116;65;149;123;112;84;184;177;54;160;34;146;22;195;181;42;43;115;198;139,7866157723947763761,0.044997
steepest_intra:edges_start:random,53,73417,23125,50292,2033200,135,146;103;34;160;54;184;84;112;123;127;194;135;70;154;180;53;63;79;133;151;162;59;118;109;51;176;80;122;94;124;167;2;152;97;1;101;26;100;86;75;120;44;25;78;31;16;171;175;113;56;196;81;90;165;40;185;179;145;92;129;57;55;52;106;178;49;14;144;62;9;148;137;23;186;89;183;143;170;0;117;68;46;115;116;65;149;131;43;42;181;5;96;139;41;193;159;69;108;18;22,5060062294070641791,0.044002
steepest_intra:edges_start:random,54,73271,23345,49926,1749150,116,43;42;160;181;193;41;139;46;115;59;118;109;51;151;162;127;70;135;154;180;53;86;75;101;100;26;97;1;152;2;129;57;92;120;44;25;16;171;175;113;56;85;31;157;78;145;185;196;81;90;40;119;165;138;14;144;62;49;178;106;52;55;148;124;94;63;122;79;133;80;176;137;23;89;183;143;170;0;117;93;140;108;18;159;22;146;34;48;54;177;10;184;84;4;112;123;149;131;65;116,578028093325635623,0.039001
steepest_intra:edges_start:random,55,72595,23364,49231,2063100,137,9;62;144;14;49;178;106;52;185;40;119;165;39;164;27;90;81;196;31;113;175;171;16;25;44;120;78;145;179;55;57;92;129;2;1;97;101;75;86;26;100;121;53;158;180;154;135;127;123;112;184;177;54;34;160;42;43;65;116;115;46;139;41;193;181;146;22;159;18;69;108;140;93;117;143;170;0;153;183;89;186;23;137;176;80;51;118;59;149;162;151;133;79;122;63;94;124;152;167;148,4375322651872653082,0.045043
steepest_intra:edges_start:random,56,78423,22941,55482,1823900,121,37;148;124;94;63;122;80;176;137;23;186;89;183;143;117;0;46;139;41;193;34;160;184;43;131;149;123;127;70;135;162;65;116;42;115;59;118;51;151;133;79;180;154;158;53;136;182;121;189;19;152;97;1;101;26;100;86;75;2;129;120;44;25;145;78;16;88;171;175;113;56;85;31;157;81;196;179;92;57;55;52;185;40;119;165;90;164;21;138;14;144;49;3;178;106;167;102;62;9;15,7103105827884405517,0.040124
steepest_intra:edges_start:random,57,72286,22431,49855,2048150,136,25;78;16;171;175;113;56;31;157;196;81;90;165;119;40;185;179;145;92;57;55;52;106;178;49;14;144;62;9;148;167;124;94;63;122;80;176;137;23;186;89;183;143;0;117;93;140;108;69;18;22;146;159;193;41;139;198;68;46;115;59;149;131;47;65;116;43;5;42;181;34;160;184;177;10;4;112;123;162;72;118;51;151;133;79;135;70;154;180;53;26;97;152;1;101;86;75;2;120;44,1689736905873945339,0.046003
steepest_intra:edges_start:random,58,74064,23247,50817,2212600,147,0;117;143;183;89;23;148;9;62;144;14;49;178;106;52;55;57;185;40;119;165;27;90;81;196;157;56;113;175;171;16;31;78;145;92;129;25;44;120;75;86;101;97;1;2;152;94;122;79;63;53;180;154;70;135;194;127;123;149;131;35;112;4;177;54;184;160;34;181;42;43;77;105;47;65;116;5;41;193;159;146;22;18;69;108;68;46;139;115;59;118;109;51;72;151;162;133;80;176;137,6378370726524267071,0.048000
steepest_intra:edges_start:random,59,73862,22809,51053,1883700,125,84;35;184;10;177;54;48;160;34;181;195;146;22;18;108;140;93;68;139;159;193;41;5;42;43;77;105;116;115;198;46;0;143;183;89;23;137;51;176;80;79;63;94;124;148;9;62;144;14;102;49;3;178;106;52;55;57;92;185;40;165;27;90;81;145;78;31;113;175;171;16;44;120;2;75;86;101;1;152;97;53;158;180;154;70;135;162;133;151;72;118;59;65;47;131;149;123;127;112;4,896944856248036876,0.041000
steepest_intra:edges_start:random,60,75649,24630,51019,2018250,134,193;159;108;18;22;146;34;160;48;54;177;10;190;4;112;84;35;184;43;116;65;131;149;123;162;133;151;59;118;51;176;80;79;63;180;135;70;154;53;100;26;86;75;101;97;1;2;129;92;120;44;16;171;78;145;179;57;55;52;167;152;94;124;148;102;49;32;3;178;106;185;119;40;81;90;165;138;14;21;144;62;9;15;114;186;137;23;89;183;143;0;117;68;46;115;139;41;5;42;181,4565818267213547476,0.046000
steepest_intra:edges_start:random,61,74919,24314,50605,1958450,130,63;121;189;94;124;137;0;143;183;89;23;186;144;14;49;102;62;9;148;129;57;55;52;178;3;106;185;40;119;165;27;90;113;175;171;16;31;78;145;92;44;120;75;2;152;97;1;101;86;26;100;53;180;154;135;70;127;123;112;4;190;10;177;54;48;184;160;34;103;146;22;18;108;159;193;41;181;42;5;115;139;68;46;118;59;116;65;47;43;131;149;162;151;72;109;51;176;80;133;79,4170439390919143117,0.043999
steepest_intra:edges_start:random,62,73612,24419,49193,1988350,132,0;46;139;115;118;59;65;116;42;41;193;159;108;18;22;146;34;160;54;177;10;4;112;184;43;131;149;123;127;135;154;180;79;133;162;151;51;176;80;63;53;121;100;26;97;1;101;86;75;120;44;25;82;129;2;152;94;124;148;9;62;102;49;178;106;52;55;57;92;179;91;145;78;16;171;175;113;56;31;157;196;81;90;27;164;39;165;119;40;185;138;14;21;144;15;137;89;183;143;117,5738829235275541956,0.043000
steepest_intra:edges_start:random,63,74934,23719,51215,1958450,130,135;154;180;63;158;53;121;189;19;26;100;86;75;101;1;97;152;94;124;167;178;106;52;55;57;179;145;78;92;129;2;120;44;25;16;171;175;113;56;31;38;157;196;81;40;119;185;165;90;164;7;21;138;14;49;144;62;9;148;137;183;143;117;0;46;68;139;108;18;193;41;159;22;146;181;34;160;54;184;43;149;65;116;42;5;115;59;118;109;51;176;80;122;79;133;151;162;123;127;70,183406817337475756,0.043005
steepest_intra:edges_start:random,64,75316,23452,51864,2182700,145,144;21;164;27;90;81;40;185;165;39;138;14;49;3;178;106;52;55;57;92;179;145;78;113;175;171;16;44;120;75;86;100;26;189;121;136;53;158;180;154;135;70;127;123;112;131;149;47;65;116;59;118;115;5;42;43;184;54;160;181;34;103;146;22;159;193;41;139;46;68;117;0;143;183;89;23;137;51;151;162;133;176;80;79;63;94;124;152;97;1;101;2;129;167;37;148;15;9;62;102,127746828991787508,0.048747
steepest_intra:edges_start:random,65,73275,23549,49726,1958450,130,145;196;81;31;56;113;175;171;16;25;44;120;129;2;152;97;1;101;75;86;26;100;53;121;189;124;94;122;79;63;180;154;135;162;151;133;80;176;51;109;118;59;115;43;116;65;131;149;123;112;184;54;160;34;181;42;41;193;159;22;18;69;108;140;93;117;68;139;46;0;143;183;89;186;23;137;148;9;62;102;144;21;164;27;90;39;165;40;185;138;14;49;3;178;106;52;55;57;92;78,2529419716095929361,0.043997
steepest_intra:edges_start:random,66,76031,23503,52528,2018250,134,22;146;103;34;30;54;48;160;184;177;10;190;4;112;123;162;151;133;135;154;180;53;86;75;120;44;16;171;175;113;31;78;145;179;92;129;57;55;52;178;3;106;185;40;165;39;90;27;95;164;7;21;138;14;144;49;102;62;9;89;183;137;148;94;152;2;101;1;97;26;100;121;182;63;79;80;176;51;59;46;68;139;198;115;96;5;116;65;149;43;42;181;41;193;69;108;18;199;159;195,2979173657474270151,0.044997
steepest_intra:edges_start:random,67,73590,24125,49465,2078050,138,86;53;180;154;135;70;127;29;112;4;84;35;184;177;54;48;160;34;146;22;18;108;117;0;143;183;89;23;137;46;115;139;41;193;159;181;42;43;47;65;116;118;59;149;131;123;162;151;51;176;80;133;79;63;148;124;94;121;100;26;97;1;152;2;82;129;57;55;52;106;178;49;37;15;9;62;102;144;14;138;185;40;165;90;81;196;92;145;78;31;56;113;175;171;16;25;44;120;75;101,3010129678339834582,0.046518
steepest_intra:edges_start:random,68,75650,25117,50533,1958450,130,167;148;15;9;62;144;102;49;52;106;178;3;32;138;14;21;7;164;95;39;165;8;185;40;119;90;81;145;78;31;113;175;171;16;25;44;120;82;92;57;55;129;2;75;101;86;26;53;180;154;70;127;135;63;79;80;176;51;118;59;65;116;43;77;47;131;149;151;133;162;123;112;4;84;184;177;54;34;160;42;115;46;139;41;193;159;146;22;18;108;117;0;143;183;137;124;94;97;1;152,1331444711563266009,0.044983
steepest_intra:edges_start:random,69,74013,23358,50655,2003300,133,153;183;89;23;137;186;114;15;144;14;21;7;164;27;90;165;40;185;92;145;78;31;113;175;171;16;44;120;2;129;57;55;52;106;178;49;102;62;9;148;152;97;1;101;75;86;26;100;53;121;94;124;176;80;79;63;180;154;135;127;123;162;133;151;51;118;59;115;198;46;68;139;96;5;42;43;116;65;149;131;35;184;54;160;34;146;22;159;181;41;193;18;69;108;140;93;117;143;170;0,3088560169223892277,0.044029
steepest_intra:edges_start:random,70,74617,24591,50026,1853800,123,56;113;175;171;16;78;145;179;92;129;44;120;2;75;86;101;1;97;26;53;180;154;135;133;151;162;127;123;149;131;184;10;177;54;34;146;22;18;159;193;41;139;68;117;0;143;183;89;23;186;114;15;9;148;137;46;115;5;181;160;42;43;116;47;65;59;118;72;109;51;176;80;79;122;63;94;152;57;55;52;106;178;49;102;62;144;14;138;185;40;119;165;39;95;7;164;90;81;196;31,4115861872229645762,0.041012
steepest_intra:edges_start:random,71,72861,22828,50033,1853800,123,75;86;101;1;2;152;97;26;100;121;53;180;154;135;127;123;162;133;151;51;59;46;68;139;193;41;115;116;65;43;5;42;184;112;4;190;10;177;54;160;34;146;22;18;108;93;117;143;183;89;186;23;137;176;80;79;63;94;124;148;15;9;62;102;49;144;14;138;3;178;106;165;39;95;7;164;58;71;27;90;81;196;40;119;185;52;55;57;129;92;179;145;78;31;113;175;171;16;44;120,8311481032530918477,0.040997
steepest_intra:edges_start:random,72,73358,23782,49576,2048150,136,146;103;34;181;42;5;43;116;65;149;160;54;177;10;190;184;84;112;123;127;70;135;154;180;158;53;100;26;97;152;1;101;86;75;2;120;44;25;16;171;175;113;56;31;78;145;92;57;55;52;185;40;81;90;27;164;39;165;106;178;49;14;144;62;9;15;148;167;124;94;121;63;122;79;133;80;176;137;23;89;183;153;0;143;117;93;140;108;18;139;46;118;51;151;59;115;41;193;159;22,4040343328547215572,0.046000
steepest_intra:edges_start:random,73,72825,23823,49002,1913600,127,44;25;16;171;175;113;56;31;78;145;92;129;57;55;52;106;178;3;138;165;119;40;185;179;196;81;90;27;164;7;21;144;14;49;102;62;9;37;148;15;186;89;183;137;51;176;80;79;133;151;162;59;118;46;0;170;143;117;68;139;115;116;65;43;42;181;41;193;159;108;18;22;34;160;54;177;184;84;4;112;123;127;194;135;70;154;180;158;53;63;94;152;1;97;26;86;101;75;2;120,580700360416463475,0.043000
steepest_intra:edges_start:random,74,73536,24007,49529,1868750,124,56;31;81;90;27;165;138;14;144;62;9;102;49;178;106;52;55;185;119;40;196;179;145;92;57;129;2;1;152;167;148;124;94;63;79;80;176;133;162;151;118;51;137;183;143;0;117;93;68;46;198;139;115;59;149;131;47;65;116;43;42;181;41;193;159;18;22;146;34;160;184;48;54;30;177;10;4;112;123;127;194;135;70;154;180;158;53;86;26;97;101;75;120;44;25;78;16;171;175;113,2092580660519852285,0.041001
steepest_intra:edges_start:random,75,71980,23569,48411,1868750,124,78;145;179;57;92;129;44;120;2;1;101;75;86;100;26;97;152;124;94;63;79;80;176;51;151;162;133;180;53;158;154;135;70;127;123;112;4;10;177;54;34;146;22;181;160;184;42;43;116;65;59;115;41;193;159;18;108;139;198;46;68;140;93;117;0;143;183;89;23;137;186;15;148;9;62;102;144;14;138;49;3;178;106;52;55;185;165;39;27;90;119;40;81;196;31;113;175;171;16;25,1180359022341726399,0.041969
steepest_intra:edges_start:random,76,73620,22485,51135,1988350,132,31;157;196;81;90;27;165;40;185;106;178;49;14;144;62;9;148;137;23;186;89;183;143;0;117;93;140;36;108;69;18;22;146;34;160;184;48;54;30;177;10;190;4;112;127;123;149;131;47;65;116;105;43;5;42;181;159;193;41;139;68;46;115;59;162;151;133;176;80;79;63;94;152;1;101;97;26;100;121;136;53;180;154;135;70;158;86;75;2;129;57;92;145;78;120;44;16;171;175;113,3764397922643162361,0.043609
steepest_intra:edges_start:random,77,73681,23373,50308,2137850,142,36;108;18;69;163;68;139;41;193;159;22;146;195;181;34;160;48;54;177;10;4;112;84;184;42;5;96;115;43;116;65;59;162;123;135;154;180;53;86;75;120;44;78;145;31;16;171;175;113;56;157;196;81;90;27;165;119;40;185;106;178;14;144;15;148;9;62;102;49;52;55;57;92;129;2;1;101;100;26;97;152;94;63;79;133;151;51;80;176;137;23;186;89;183;143;0;46;117;93;140,3663408772169589541,0.046998
steepest_intra:edges_start:random,78,75024,25434,49590,1943500,129,159;193;41;5;42;116;65;47;43;160;34;30;54;48;184;28;35;84;177;10;190;4;112;131;149;123;135;154;180;53;26;86;75;101;1;97;152;2;120;44;78;145;92;57;55;52;106;178;3;185;165;40;196;31;16;171;175;113;81;90;164;21;138;14;144;102;49;167;148;9;62;186;89;183;137;94;63;79;133;162;151;80;176;51;118;59;115;46;0;143;117;68;139;69;108;18;22;146;195;181,4130635695347279918,0.042640
steepest_intra:edges_start:random,79,73586,23950,49636,1868750,124,94;176;80;79;63;180;154;70;135;162;133;151;51;109;118;59;65;116;43;47;131;149;123;112;4;190;10;177;184;54;48;160;34;181;42;41;193;159;22;18;108;139;115;198;46;68;117;0;143;183;89;23;137;186;114;15;148;167;152;97;1;2;92;57;55;52;49;62;144;14;3;178;106;185;40;119;165;39;95;164;27;90;81;196;179;145;78;31;113;175;171;16;44;120;75;101;86;26;53;121,3396148592588475852,0.041668
steepest_intra:edges_start:random,80,75695,23875,51820,2018250,134,2;129;92;145;78;31;113;175;171;16;44;120;75;86;101;1;97;26;100;53;180;154;70;135;194;127;112;4;84;184;177;54;48;160;42;41;181;34;103;146;22;195;159;193;139;18;108;140;68;115;46;0;117;143;183;89;186;15;144;14;138;165;90;40;185;55;52;106;178;49;62;9;148;137;176;80;151;72;51;118;59;65;47;116;105;43;131;149;123;162;133;79;122;63;182;121;189;94;124;152,958737300736237173,0.044998
steepest_intra:edges_start:random,81,72390,23834,48556,2302300,153,135;70;127;123;112;4;10;177;54;48;184;160;34;181;195;146;22;159;18;108;93;117;143;0;68;46;115;139;193;41;5;42;43;116;65;149;59;118;51;151;162;133;79;63;122;80;176;137;183;89;23;148;9;62;144;102;49;55;52;106;178;14;21;7;164;27;90;165;185;119;40;81;196;31;113;175;171;16;44;120;78;145;92;129;2;152;97;1;101;75;86;100;26;189;124;94;121;53;180;154,6994532395851730667,0.051157
steepest_intra:edges_start:random,82,74376,23206,51170,2033200,135,91;179;92;129;82;120;44;25;78;145;31;16;171;175;113;56;157;196;81;187;90;27;39;165;119;40;185;138;14;144;102;62;9;37;148;15;186;23;137;176;51;118;59;65;116;43;42;159;193;41;139;115;46;0;89;183;143;117;108;18;22;146;34;160;184;54;177;4;112;123;162;151;133;79;80;122;63;135;154;180;53;121;100;26;86;75;101;1;2;152;97;94;124;167;49;178;106;52;55;57,58346807634897081,0.045553
steepest_intra:edges_start:random,83,77520,24165,53355,1958450,130,165;39;164;21;14;138;3;178;106;52;55;128;167;111;124;94;152;1;97;63;79;133;151;80;176;137;148;37;9;62;102;49;144;15;114;186;23;89;183;153;143;117;0;46;115;118;59;162;149;65;116;43;42;41;193;139;68;108;18;22;34;160;184;84;112;123;135;154;180;53;86;101;75;2;120;44;82;129;92;57;179;91;145;78;25;16;171;175;113;56;31;38;157;196;81;90;27;119;40;185,6593239075255747674,0.043030
steepest_intra:edges_start:random,84,74871,23181,51690,2137850,142,55;185;40;119;165;39;164;27;90;81;196;157;91;179;145;78;31;56;113;175;171;16;25;44;120;82;92;57;129;2;75;86;101;1;152;97;26;100;121;53;180;154;135;70;127;123;162;149;131;184;177;54;160;34;181;42;43;65;116;115;139;41;193;159;146;22;18;108;140;68;46;59;118;109;51;176;80;151;133;79;122;63;189;94;124;167;148;137;183;89;9;62;144;49;14;138;3;178;106;52,2886767577507589612,0.048001
steepest_intra:edges_start:random,85,74441,24588,49853,2003300,133,80;151;51;176;137;0;117;170;143;183;89;23;94;124;111;167;148;9;62;144;102;49;14;138;165;39;164;27;90;81;196;40;185;106;3;178;52;55;57;145;78;31;113;175;171;16;44;120;92;129;2;152;97;1;101;75;86;26;100;121;53;158;180;154;135;70;127;123;112;4;177;184;43;42;5;115;41;193;181;160;54;34;146;22;18;108;139;68;46;118;59;116;65;47;131;149;162;133;79;63,5620592665012544692,0.043998
steepest_intra:edges_start:random,86,73895,23527,50368,1943500,129,22;146;159;193;41;115;139;68;46;59;65;47;116;43;5;42;181;34;160;54;177;10;4;112;84;184;35;131;149;123;127;135;154;180;53;63;79;133;151;176;80;94;124;189;152;1;97;26;100;86;101;75;2;129;92;57;55;52;185;179;145;78;82;120;44;25;16;171;175;113;56;85;31;157;196;81;40;165;90;27;164;14;106;178;49;102;144;62;9;148;137;183;143;0;117;93;140;108;69;18,6306493020258773361,0.042043
steepest_intra:edges_start:random,87,75461,22978,52483,2137850,142,108;69;18;199;193;159;22;146;103;195;181;34;160;48;54;177;10;4;112;84;184;131;149;123;127;70;135;154;180;133;79;63;158;53;121;100;26;97;1;101;86;75;2;152;189;94;124;148;9;62;102;49;3;178;106;52;55;57;92;129;120;44;25;16;171;175;113;31;78;145;185;40;165;14;144;89;183;0;46;115;118;51;137;176;80;151;162;59;65;47;116;43;42;5;96;41;139;198;68;140,8839599789083749813,0.047004
steepest_intra:edges_start:random,88,74392,23352,51040,2167750,144,149;123;112;4;10;177;54;34;181;146;22;18;108;69;159;193;41;5;96;115;139;46;0;117;143;183;89;137;176;80;94;124;129;92;57;55;52;106;178;3;49;102;37;148;9;62;144;14;138;185;40;119;165;27;90;81;145;78;31;113;175;171;16;44;120;2;152;97;1;101;75;86;26;100;121;63;53;158;180;154;135;70;127;194;161;162;133;79;151;51;118;59;65;116;43;42;160;184;35;131,786703567804886040,0.048999
steepest_intra:edges_start:random,89,73380,24389,48991,2093000,139,86;100;121;53;63;180;154;135;123;149;131;65;116;43;184;84;112;4;10;177;54;160;34;146;22;181;42;5;115;59;118;46;139;41;193;159;18;69;108;140;93;117;0;143;183;137;176;80;51;72;151;162;133;79;122;94;26;97;1;101;2;152;148;15;9;62;102;49;14;144;21;7;164;95;27;90;81;196;185;40;165;106;178;52;55;57;129;92;145;78;31;56;113;175;171;16;25;44;120;75,8552401971504104195,0.045998
steepest_intra:edges_start:random,90,74264,22470,51794,1853800,123,196;81;165;39;90;27;164;7;21;144;155;14;138;106;178;3;49;102;62;9;148;124;94;80;176;137;89;183;143;0;117;93;68;46;198;115;139;41;193;159;22;146;195;181;34;160;48;54;30;177;10;190;184;42;5;96;43;116;65;149;59;118;51;72;151;162;123;127;70;135;133;79;63;180;154;158;53;26;97;152;1;101;86;75;2;129;120;44;16;171;175;113;78;145;92;57;55;52;185;40,5518960762102962089,0.042040
steepest_intra:edges_start:random,91,76816,24160,52656,1898650,126,47;149;131;35;112;123;127;70;135;154;180;63;158;53;121;100;26;86;75;101;1;97;152;2;120;44;16;171;175;78;145;92;129;57;55;49;3;178;106;52;179;196;185;40;165;90;27;39;138;14;144;102;62;9;15;148;124;94;122;79;133;162;72;151;80;176;137;23;89;183;51;59;118;46;0;143;117;93;108;69;18;22;146;159;193;41;139;68;198;115;5;42;181;34;160;184;43;105;116;65,3883665626029548723,0.045001
steepest_intra:edges_start:random,92,74868,23882,50986,2048150,136,43;131;149;65;59;118;109;51;176;137;183;89;186;9;62;102;49;144;14;138;21;7;164;58;95;39;165;185;40;119;27;90;81;196;157;31;56;113;175;171;16;78;145;179;92;25;44;120;2;129;57;55;52;106;178;3;167;148;124;80;79;122;63;94;152;1;101;75;86;97;26;100;53;180;154;70;135;133;151;162;123;112;184;177;54;160;34;181;42;5;41;193;159;22;18;108;139;46;115;116,8977361949482505069,0.045009
steepest_intra:edges_start:random,93,73772,24180,49592,1988350,132,177;54;34;181;195;146;22;159;193;18;69;108;117;143;183;89;137;15;9;62;102;49;144;14;178;106;52;55;57;92;78;145;179;185;40;119;165;39;164;27;90;81;196;157;31;56;113;175;171;16;25;44;120;82;129;2;167;37;148;124;94;152;97;26;1;101;75;86;53;180;154;135;123;112;4;84;35;184;43;116;65;149;59;162;151;133;79;63;80;176;51;118;115;46;68;139;41;42;160;48,9220411013139733383,0.044030
steepest_intra:edges_start:random,94,72735,22474,50261,2048150,136,137;176;80;79;133;151;51;118;115;139;198;46;68;93;140;108;69;18;199;22;146;195;159;193;41;5;42;181;34;160;184;48;54;177;10;190;4;112;35;43;116;65;59;162;123;127;70;135;154;180;158;53;63;94;124;148;167;152;97;26;100;86;75;101;1;2;120;44;25;16;171;175;113;56;31;78;145;92;129;57;55;52;178;106;185;40;81;90;165;14;49;102;144;62;9;15;186;23;89;183,3228980202601656422,0.045002
steepest_intra:edges_start:random,95,73570,24080,49490,1913600,127,183;143;0;46;139;41;193;159;18;22;146;195;181;34;160;48;54;177;10;184;112;127;135;123;149;131;65;116;43;42;115;59;118;109;51;151;162;133;79;80;176;122;63;94;124;148;152;97;26;53;180;154;86;75;101;1;2;129;82;120;44;25;78;145;31;16;171;175;113;56;157;81;196;179;92;57;55;52;178;3;106;185;40;119;165;90;27;164;21;14;49;102;144;62;9;15;186;137;23;89,8113387591579163151,0.042000
steepest_intra:edges_start:random,96,72914,23171,49743,1973400,131,93;117;0;143;183;89;186;23;137;176;80;51;109;118;59;162;151;133;79;122;63;94;124;167;148;9;62;49;14;144;21;7;164;27;90;165;40;185;106;178;52;55;57;92;145;196;81;31;113;175;171;16;78;44;120;2;75;86;101;1;152;97;26;100;121;53;158;180;154;135;123;112;4;10;177;54;184;131;149;47;65;116;43;5;42;181;160;34;22;18;108;69;199;159;193;41;139;115;46;68,7914245239617211090,0.044002
steepest_intra:edges_start:random,97,73849,23611,50238,1943500,129,193;41;159;22;146;181;34;160;184;48;54;30;177;10;4;112;131;149;47;65;116;43;42;5;115;139;46;118;59;51;137;176;80;63;79;133;151;162;123;127;70;135;154;180;158;53;26;97;86;101;1;152;94;124;148;9;62;102;49;178;106;52;55;57;129;120;44;16;171;175;113;31;78;145;92;179;185;196;81;187;90;27;164;39;165;119;40;138;14;144;186;89;183;143;0;117;93;108;69;18,4600181993326194689,0.042998
steepest_intra:edges_start:random,98,73947,23320,50627,2063100,137,54;177;184;84;112;35;131;149;162;123;127;70;135;154;180;158;53;136;121;86;101;75;2;152;1;97;26;100;94;124;148;9;62;102;49;52;55;57;92;145;78;120;44;25;16;171;175;113;31;196;81;90;165;40;185;106;178;14;144;15;137;183;143;0;117;93;68;46;198;139;115;118;51;176;80;63;79;133;151;72;59;65;47;116;105;43;5;42;181;195;159;41;193;69;108;18;22;146;34;160,3110137543008636850,0.045001
steepest_intra:edges_start:random,99,73199,23526,49673,1928550,128,65;149;43;184;160;48;54;177;4;112;123;127;70;135;162;133;79;63;180;154;158;53;100;26;97;152;1;101;86;75;2;120;44;16;171;175;113;31;78;145;179;92;129;57;55;52;178;3;106;185;40;165;90;164;21;138;14;144;49;102;62;9;148;124;94;122;80;176;151;51;109;118;59;115;198;139;68;46;137;89;183;143;0;117;93;140;108;69;18;22;159;193;41;195;146;34;181;42;5;116,7474229883636156659,0.043617
steepest_intra:edges_start:random,100,72970,23958,49012,2167750,144,183;143;117;0;137;176;80;63;79;133;151;51;118;59;162;149;131;65;116;43;184;160;42;115;139;41;193;159;18;22;146;181;34;48;54;30;177;10;4;112;123;127;135;154;180;53;100;26;97;1;101;86;75;120;44;25;16;171;175;113;56;31;157;196;81;90;27;164;21;14;144;62;9;102;49;3;178;106;138;39;165;119;40;185;52;55;57;179;145;78;92;129;2;152;94;124;167;148;23;89,8737823230065558631,0.048002
steepest_intra:edges_start:random,101,73499,23924,49575,1943500,129,184;160;48;54;177;10;190;4;112;127;70;135;154;180;158;53;100;26;86;101;75;2;129;92;57;179;145;78;120;44;25;16;171;175;113;31;196;81;90;165;40;185;3;178;106;52;55;152;1;97;94;148;62;49;14;144;89;183;137;51;176;80;63;79;133;151;162;123;24;149;131;65;116;59;118;115;198;139;68;46;0;143;117;93;140;108;18;22;146;34;181;195;159;193;41;96;5;42;43;35,198427518284480712,0.043001
steepest_intra:edges_start:random,102,73152,23445,49707,2048150,136,106;178;3;49;9;62;144;14;21;7;164;27;90;81;196;157;31;56;113;175;171;16;25;44;120;75;101;97;26;100;86;53;158;180;154;70;135;162;133;151;51;59;116;65;47;131;149;123;127;112;4;84;190;10;177;54;48;184;43;42;160;34;181;41;193;159;146;22;18;108;139;115;46;0;117;143;183;137;176;80;79;63;94;152;1;2;129;92;78;145;91;179;57;55;52;185;40;119;165;138,6110638496089309119,0.044995
steepest_intra:edges_start:random,103,73004,23743,49261,2018250,134,78;145;196;179;57;55;52;185;119;40;81;90;27;39;165;106;178;3;49;14;144;102;62;9;15;148;167;152;1;101;97;26;100;121;94;137;23;89;183;143;0;117;108;18;22;146;34;181;193;41;139;46;115;118;109;51;176;80;63;79;133;151;162;59;149;131;65;116;43;42;184;160;48;54;177;10;190;84;4;112;123;127;135;154;180;53;86;75;2;129;92;82;120;44;25;16;171;175;113;31,516262396474550008,0.044008
steepest_intra:edges_start:random,104,74117,22798,51319,2063100,137,149;131;65;116;43;42;181;41;193;22;34;160;54;177;184;84;112;123;127;70;135;154;180;158;53;86;75;101;97;26;100;121;189;152;1;2;82;120;44;25;16;171;175;113;56;31;78;145;196;179;92;129;57;55;52;167;124;148;37;9;62;102;49;3;178;106;185;40;90;165;138;14;144;15;137;23;89;183;153;0;143;117;93;140;68;46;139;115;59;118;51;176;80;94;63;122;79;133;151;162,304472719243895338,0.046172
steepest_intra:edges_start:random,105,74548,24566,49982,1973400,131,1;101;75;86;26;100;53;180;154;135;123;112;4;84;184;10;177;54;160;34;146;22;18;108;69;159;181;42;5;43;116;47;131;149;65;59;118;109;51;72;151;162;133;79;63;80;176;137;46;198;115;41;193;139;68;93;117;0;143;183;89;148;9;62;49;14;144;21;7;164;39;165;90;81;40;119;185;106;178;52;57;129;92;78;145;179;196;157;31;56;113;175;171;16;44;120;2;152;94;97,3624211693706137977,0.042865
steepest_intra:edges_start:random,106,73502,23002,50500,2018250,134,160;34;48;54;177;184;131;149;65;116;43;5;96;41;193;139;46;115;59;118;51;151;176;80;79;133;162;123;127;70;135;154;180;53;121;182;136;63;122;94;124;152;97;1;101;26;100;86;75;2;120;44;16;171;175;113;31;78;145;92;57;55;52;179;196;81;90;27;164;95;39;165;40;185;106;178;49;14;144;102;62;9;148;15;186;23;137;183;143;0;117;108;69;18;22;146;195;159;181;42,8839434333549408543,0.045218
steepest_intra:edges_start:random,107,73825,23326,50499,1973400,131,162;151;133;135;70;154;180;158;53;100;26;97;101;86;75;120;44;25;16;171;175;113;56;31;78;145;92;185;40;165;106;178;52;55;57;129;2;1;152;167;124;94;189;121;182;63;79;80;176;137;148;9;62;102;49;14;144;15;186;89;183;143;117;0;46;51;118;59;115;139;68;93;140;108;69;18;199;22;146;159;193;41;5;116;65;149;131;43;42;181;34;160;54;177;184;84;4;112;127;123,3173712136989668505,0.043749
steepest_intra:edges_start:random,108,73083,22644,50439,1973400,131,16;25;44;120;2;152;97;1;101;86;53;158;180;154;135;70;127;123;194;162;133;79;63;94;124;80;176;151;72;51;118;59;116;65;47;149;131;112;4;84;35;184;177;54;160;34;181;146;22;159;193;41;5;42;43;115;139;198;46;68;18;108;140;93;117;0;143;183;89;23;137;148;9;62;144;102;49;178;106;138;14;21;7;164;27;90;165;40;185;52;55;57;92;145;78;31;56;113;175;171,2836306251769465253,0.045031
steepest_intra:edges_start:random,109,73347,24066,49281,1883700,125,159;41;193;18;108;140;68;46;139;115;116;65;131;149;59;118;0;143;183;89;23;137;148;9;62;144;102;49;178;106;52;55;185;40;165;39;138;14;21;7;164;90;81;196;157;31;56;113;175;171;16;25;44;120;82;78;145;179;57;92;129;2;75;86;121;100;26;101;1;97;152;124;94;176;80;79;122;63;53;180;154;135;133;151;162;123;112;4;190;10;177;54;48;184;43;42;181;160;34;22,872995883383023,0.041750
steepest_intra:edges_start:random,110,74677,22930,51747,1913600,127,120;75;86;121;100;26;101;1;97;152;2;82;129;92;57;55;52;167;124;94;122;63;136;53;158;154;180;79;133;162;135;70;127;123;149;131;35;184;84;112;4;10;177;54;160;42;181;34;146;22;159;193;41;139;140;93;68;46;115;96;5;43;116;65;59;118;51;151;80;176;137;23;183;89;186;15;148;37;9;62;102;144;14;49;178;106;185;40;165;90;81;31;113;175;171;16;78;145;25;44,3266426663664569844,0.040910
steepest_intra:edges_start:random,111,73660,24153,49507,1988350,132,40;119;185;165;90;164;21;144;14;49;102;62;9;15;186;89;183;143;0;137;51;176;80;133;151;59;115;139;46;68;117;93;140;108;69;18;22;159;193;41;42;181;34;160;48;54;177;10;4;112;84;184;43;116;65;131;149;162;123;127;70;135;154;180;79;63;53;86;101;1;97;152;94;124;148;167;3;178;106;52;55;57;129;92;179;145;78;120;44;25;16;171;175;113;56;85;31;157;196;81,2143797041658368869,0.044001
steepest_intra:edges_start:random,112,73326,24064,49262,1973400,131,16;78;145;25;44;120;82;129;92;57;55;52;106;178;3;167;37;148;124;94;152;2;75;86;101;1;97;26;100;53;180;154;135;127;123;112;4;177;54;34;160;48;184;131;149;162;151;133;79;63;80;176;51;59;65;116;43;42;115;41;193;159;146;22;18;108;69;139;68;46;0;93;117;143;153;183;89;23;137;186;114;15;9;62;102;49;144;21;14;138;185;40;165;90;81;196;31;113;175;171,1863317637217487132,0.043001
steepest_intra:edges_start:random,113,73305,23248,50057,1853800,123,41;193;159;146;22;199;18;69;108;140;93;117;0;143;183;89;23;137;176;80;133;79;63;94;124;148;37;15;9;62;144;14;102;49;178;138;21;7;164;95;39;27;90;81;157;31;56;113;175;171;16;44;25;78;145;196;40;119;165;185;106;52;55;57;92;129;120;2;152;97;1;101;86;53;180;154;135;127;123;162;151;51;118;59;149;184;10;177;54;160;34;181;42;43;47;65;116;115;46;139,7283110579053817396,0.042000
steepest_intra:edges_start:random,114,73052,23199,49853,2093000,139,115;139;198;46;68;0;143;117;18;22;146;181;159;193;41;42;116;65;47;149;131;43;184;48;160;34;30;54;177;4;112;123;127;70;135;154;180;158;53;86;100;26;97;1;101;75;2;152;189;94;124;148;9;62;49;52;55;57;179;145;78;92;129;82;120;44;25;16;171;175;113;56;31;157;196;81;90;165;119;40;185;106;178;14;144;186;89;183;137;176;80;122;63;79;133;162;151;51;118;59,1167801221993870296,0.045997
steepest_intra:edges_start:random,115,74329,23109,51220,2003300,133,117;0;143;183;89;23;137;186;15;144;102;49;14;3;178;106;52;185;40;165;90;145;31;113;175;171;16;44;120;25;78;92;129;57;55;167;62;9;37;148;124;94;152;97;1;2;75;101;86;26;100;53;180;154;135;127;123;162;133;79;63;122;80;176;151;51;118;59;149;131;47;65;116;43;42;5;96;41;193;159;195;181;184;177;54;160;34;146;22;18;69;108;163;139;115;198;46;68;140;93,4082750909707167793,0.044040
steepest_intra:edges_start:random,116,73747,22621,51126,2137850,142,144;155;49;102;62;9;15;186;89;183;23;137;148;167;124;94;63;122;79;133;162;151;80;176;51;118;59;65;116;43;42;5;96;115;46;68;139;108;18;22;159;193;41;181;34;160;54;177;184;35;131;149;123;127;70;135;154;180;53;26;86;75;101;1;97;152;2;120;44;25;129;92;145;78;16;171;175;113;56;31;196;179;57;55;52;106;178;3;14;138;185;40;119;165;39;90;27;164;7;21,7411651117234310307,0.047044
steepest_intra:edges_start:random,117,77512,24050,53462,1958450,130,62;102;148;167;57;55;52;106;178;3;49;14;144;21;90;165;40;185;196;179;145;31;113;175;171;16;78;25;44;120;92;129;2;74;152;97;1;101;75;86;100;26;19;124;12;94;189;121;182;63;79;80;133;180;53;158;154;70;135;162;151;65;116;5;42;43;47;131;149;123;112;184;177;54;160;34;146;22;193;41;139;68;93;117;143;170;0;46;115;59;118;109;51;176;137;183;89;186;15;9,5769100896774262791,0.043112
steepest_intra:edges_start:random,118,73621,23711,49910,2003300,133,170;0;153;183;89;23;186;114;15;148;37;9;62;102;144;14;138;49;178;106;52;55;57;129;92;179;185;40;119;165;39;95;164;27;90;81;196;56;113;175;171;16;31;145;78;44;120;2;75;101;1;152;97;26;100;86;53;180;154;135;133;79;63;94;124;80;176;137;51;151;162;123;149;59;118;65;116;43;5;42;181;160;184;112;4;177;54;34;22;18;159;193;41;139;115;46;68;93;117;143,5540484907125683062,0.044099
steepest_intra:edges_start:random,119,75862,26593,49269,1898650,126,139;115;118;59;65;116;5;41;193;159;22;34;48;54;177;10;184;160;181;42;43;47;149;131;35;112;123;162;151;51;133;79;63;180;154;135;70;158;53;121;86;75;101;1;2;129;82;120;44;25;31;16;171;175;113;81;90;27;119;40;196;145;78;92;57;179;185;165;164;21;144;62;9;148;49;14;3;178;106;52;55;152;97;26;100;189;124;94;80;176;137;183;143;0;117;108;18;69;68;46,5740005816373060554,0.041916
steepest_intra:edges_start:random,120,73952,23464,50488,1883700,125,65;47;131;149;123;127;70;135;194;162;72;59;118;109;51;151;133;79;63;180;154;53;86;75;101;1;97;152;2;120;44;25;129;57;92;145;78;31;16;171;175;113;56;81;196;55;52;185;40;165;39;90;27;164;21;144;14;106;178;49;102;62;9;148;124;94;122;80;176;137;89;183;143;0;46;68;140;108;18;22;159;193;41;139;115;42;181;34;160;48;54;177;4;112;84;184;43;77;105;116,4480591092059263177,0.042000
steepest_intra:edges_start:random,121,73391,24191,49200,1988350,132,120;44;16;171;175;113;31;196;81;90;27;165;40;185;138;14;49;102;144;62;9;186;89;183;23;137;176;51;109;72;118;59;149;65;116;43;42;181;5;96;115;46;0;143;117;93;108;18;69;139;41;193;159;22;146;34;160;54;177;10;184;112;123;127;70;135;162;151;133;79;80;122;63;180;154;53;86;75;2;152;97;1;101;26;94;124;148;167;3;178;106;52;55;57;129;92;179;145;78;25,3154259042500068212,0.044002
steepest_intra:edges_start:random,122,72281,22706,49575,2033200,135,113;56;31;78;145;92;129;57;55;52;106;185;40;119;165;90;27;164;21;14;3;178;49;102;144;62;9;148;15;186;23;137;183;143;117;0;46;115;139;41;193;159;69;108;18;22;146;103;34;48;54;177;10;4;112;84;184;160;181;42;43;116;65;131;149;123;127;70;135;194;162;133;151;72;59;118;51;176;80;79;63;180;154;53;121;94;26;100;86;75;101;1;97;152;2;120;44;16;171;175,7982643412949042965,0.045000
steepest_intra:edges_start:random,123,73143,23887,49256,2063100,137,145;31;113;175;171;16;78;25;44;120;82;2;129;92;57;55;52;106;178;49;62;9;148;167;111;124;94;189;152;97;1;101;75;86;26;100;121;53;158;70;135;154;180;63;79;133;80;176;51;151;162;123;127;112;149;131;43;116;65;59;115;46;68;139;193;41;42;160;184;177;54;34;181;146;22;159;18;69;108;93;117;0;143;183;89;23;137;15;144;14;21;7;164;27;90;165;119;40;185;179,6601323810931012530,0.045001
steepest_intra:edges_start:random,124,72538,23024,49514,2093000,139,145;179;157;196;81;90;164;7;95;39;165;119;40;185;106;14;144;62;9;148;49;178;52;55;57;92;129;152;94;63;79;133;80;176;137;183;143;117;0;46;68;93;140;108;69;18;22;146;195;159;193;41;139;115;5;42;181;34;160;48;54;177;10;190;184;35;131;149;43;116;65;59;118;51;151;162;123;135;154;180;158;53;100;26;97;1;101;86;75;2;120;44;25;16;171;175;113;56;31;78,3059651286117837549,0.046997
steepest_intra:edges_start:random,125,74126,22810,51316,1988350,132,78;25;44;16;171;175;113;56;31;196;81;90;27;164;39;165;119;40;185;8;138;14;32;106;178;3;49;102;144;62;9;148;186;23;89;183;143;0;117;68;46;139;115;116;65;47;43;42;41;193;22;34;160;48;54;177;184;84;4;112;127;123;131;149;59;118;109;51;137;176;151;162;133;79;80;94;63;180;154;135;70;158;53;86;100;26;97;152;1;101;75;2;120;129;92;57;55;52;179;145,6968700352000320049,0.045454
steepest_intra:edges_start:random,126,72629,23423,49206,2107950,140,183;89;137;176;80;79;122;63;94;124;148;9;62;102;49;14;144;21;164;27;90;165;40;185;106;3;178;52;55;57;92;78;145;196;81;31;113;175;171;16;25;44;120;2;152;97;1;101;75;86;26;100;121;53;158;180;154;70;135;133;151;59;162;123;127;112;4;10;177;54;184;35;131;149;47;65;116;43;42;115;139;41;193;159;181;160;34;146;22;18;69;108;140;93;68;198;46;0;117;143,8533456401990821781,0.048004
steepest_intra:edges_start:random,127,73041,22706,50335,1943500,129,122;94;26;100;86;75;101;1;97;152;2;129;120;44;25;16;171;175;113;56;31;38;157;196;81;90;27;165;119;40;185;179;145;78;92;57;55;52;106;178;3;49;14;144;62;9;148;89;183;137;176;80;133;151;162;59;118;46;0;143;117;93;108;69;18;159;193;41;139;115;42;160;181;22;146;34;48;54;177;10;4;112;84;35;184;43;116;65;47;131;149;123;127;135;154;180;158;53;63;79,2003307659399374409,0.046997
steepest_intra:edges_start:random,128,73554,23583,49971,2347150,156,196;81;157;31;56;113;175;171;16;78;145;179;25;44;120;75;86;100;26;97;101;1;152;2;129;92;57;55;52;167;124;94;122;63;53;180;154;70;135;194;127;123;162;151;133;79;80;176;51;59;115;139;41;193;159;181;42;43;116;65;149;131;112;84;184;177;54;160;34;146;22;18;108;117;0;143;183;89;137;148;9;62;102;49;144;14;3;178;106;138;21;164;27;90;39;165;119;40;185;169,3539071694645285610,0.053228
steepest_intra:edges_start:random,129,73003,23145,49858,2033200,135,55;52;185;40;81;90;165;106;178;14;144;49;102;62;9;37;148;15;186;23;89;183;153;143;0;137;176;80;151;51;118;59;65;116;43;42;159;193;41;139;115;46;68;117;93;140;108;18;22;146;34;160;54;177;10;190;4;112;84;184;35;131;149;123;127;162;133;79;63;182;136;180;154;135;70;158;53;121;94;152;97;1;101;26;100;86;75;120;44;25;16;171;175;113;31;78;145;92;129;57,6311748083165125888,0.046030
steepest_intra:edges_start:random,130,72516,23818,48698,1853800,123,164;95;27;90;165;40;185;179;145;78;31;113;175;171;16;25;44;120;129;92;57;55;52;106;178;49;102;148;167;124;94;97;152;2;75;86;101;1;26;53;158;154;180;63;122;79;80;176;51;59;151;133;162;135;70;127;123;112;4;10;177;54;160;184;43;131;149;65;116;5;42;181;34;146;22;18;108;69;199;159;193;41;139;115;46;68;117;0;143;183;89;23;137;15;9;62;144;14;21;7,2711742925653720337,0.041002
steepest_intra:edges_start:random,131,73948,21659,52289,2063100,137,184;35;84;112;4;177;54;48;34;103;146;22;159;193;41;139;115;59;118;51;80;176;137;46;68;117;0;143;183;89;23;148;9;62;144;102;49;14;138;3;178;106;52;55;185;40;119;165;90;81;169;196;157;38;31;56;113;175;171;16;78;145;91;179;57;92;129;25;44;120;2;1;101;75;86;100;26;97;152;94;79;63;53;180;154;135;133;151;162;123;149;131;47;65;116;43;5;42;181;160,192047264912256664,0.046043
steepest_intra:edges_start:random,132,74240,23313,50927,2063100,137,101;86;53;26;97;1;152;94;63;180;154;135;70;127;194;162;151;133;79;80;176;51;109;118;59;65;47;149;131;43;184;35;24;123;112;4;84;190;10;177;54;48;160;34;181;195;146;22;159;193;41;5;42;116;115;139;198;46;68;18;108;93;117;0;143;183;137;148;9;62;102;49;144;14;138;165;90;40;185;3;178;106;52;55;57;129;92;179;196;31;113;175;171;16;78;145;25;44;120;75,4318853975018386473,0.046003
steepest_intra:edges_start:random,133,72964,24067,48897,2078050,138,46;115;139;41;193;181;42;43;116;65;47;131;149;59;118;51;151;162;133;79;80;176;137;0;143;183;89;62;9;148;167;52;55;57;92;179;185;106;178;3;49;102;144;14;138;165;119;40;90;81;196;31;113;175;171;16;78;145;25;44;120;129;2;75;101;1;97;152;124;94;63;86;53;180;154;135;70;127;123;112;4;84;190;10;177;184;160;48;54;30;34;103;146;22;159;18;108;140;93;68,6019899991680287417,0.045576
steepest_intra:edges_start:random,134,73541,22571,50970,2182700,145,135;70;127;123;24;149;131;47;65;116;105;43;42;184;35;84;112;4;10;177;54;160;34;181;159;146;22;18;108;193;41;139;115;198;46;68;117;0;143;183;89;137;51;109;118;59;72;151;162;133;176;80;79;63;94;124;148;9;62;167;129;92;57;55;52;106;178;3;49;102;144;14;165;90;40;185;145;78;31;113;175;171;16;25;44;120;2;75;86;101;1;152;97;26;100;121;53;158;180;154,866259570281991762,0.047578
steepest_intra:edges_start:random,135,72631,23313,49318,1988350,132,178;3;138;14;144;49;102;62;9;148;137;89;183;143;117;0;46;51;176;80;94;63;79;133;151;162;59;118;115;41;193;159;139;68;93;140;108;18;22;146;34;54;10;177;48;160;181;42;43;116;65;47;149;131;184;84;112;123;135;154;180;53;121;100;26;97;152;1;101;86;75;2;129;82;120;44;25;16;171;175;113;56;31;78;145;92;57;179;157;196;81;90;27;165;119;40;185;55;52;106,893607554150664563,0.047005
steepest_intra:edges_start:random,136,74020,23952,50068,2033200,135,14;144;62;9;49;178;106;52;55;57;92;129;2;152;97;1;101;26;100;121;182;136;63;79;122;94;124;148;137;183;143;0;117;68;46;198;115;139;108;18;22;159;193;41;181;34;160;48;54;177;10;190;184;42;43;35;84;4;112;123;127;135;162;65;116;59;118;109;51;176;80;151;133;180;154;158;53;86;75;120;44;25;145;78;16;171;175;113;31;157;196;81;40;119;185;165;90;164;7;21,2518406128686859259,0.046539
steepest_intra:edges_start:random,137,74589,22655,51934,2033200,135,182;63;94;124;152;2;129;92;120;44;25;16;171;175;113;31;78;145;57;55;52;185;40;165;106;178;3;49;102;14;144;62;9;148;15;186;23;89;183;143;117;0;153;137;176;80;79;133;151;51;46;139;108;18;22;146;103;195;159;193;41;181;34;160;54;177;184;84;4;112;123;149;131;65;116;43;42;5;115;118;59;72;162;127;70;135;154;180;158;53;86;75;101;1;97;26;100;19;189;121,264714127334923704,0.044273
steepest_intra:edges_start:random,138,75667,22879,52788,1988350,132,51;109;118;59;72;149;131;123;127;112;4;177;184;160;34;103;146;195;22;18;108;69;199;159;193;41;181;42;43;77;47;65;116;115;46;198;139;110;68;140;93;117;0;143;183;89;23;137;176;80;94;124;148;9;62;167;129;92;78;145;179;57;55;52;106;178;3;49;102;144;14;185;40;165;39;27;90;81;31;113;175;171;16;44;120;2;152;97;1;101;86;53;154;135;180;63;79;133;162;151,8169635873615875437,0.044022
steepest_intra:edges_start:random,139,72491,23125,49366,2152800,143,53;158;154;180;63;79;80;176;51;59;65;116;43;131;149;123;162;151;133;135;70;127;29;112;4;84;35;184;190;10;177;30;54;48;160;34;181;42;5;41;193;159;22;18;108;140;93;68;139;115;46;0;117;143;183;89;137;9;62;144;14;185;40;119;165;39;27;90;81;196;31;113;175;171;16;78;145;44;120;129;92;57;55;52;106;178;49;148;124;94;152;2;75;86;101;1;97;26;100;121,8311851154564592461,0.046998
steepest_intra:edges_start:random,140,73426,22233,51193,2272400,151,198;139;41;193;159;69;108;18;22;146;195;181;34;160;54;177;184;35;131;149;123;127;70;135;194;162;133;151;72;59;65;116;43;42;5;96;115;118;51;176;80;79;63;94;124;121;180;154;158;53;100;26;86;75;101;1;97;152;2;129;120;44;25;16;171;175;113;31;78;145;179;92;57;185;40;165;106;178;52;55;167;148;9;62;102;49;14;144;15;186;137;23;89;183;143;0;117;93;68;46,8896001348187353035,0.050001
steepest_intra:edges_start:random,141,73970,24082,49888,2018250,134,81;90;27;164;95;39;165;138;14;49;144;62;9;15;186;23;89;183;143;117;0;153;137;148;124;94;63;79;80;176;51;59;118;46;68;139;198;115;42;41;193;159;18;22;34;160;54;177;4;112;84;184;43;116;65;149;151;133;162;123;127;194;135;70;154;180;158;53;86;75;101;1;97;152;2;120;129;92;145;78;25;44;16;171;175;113;56;31;157;179;57;55;52;178;3;106;185;119;40;196,507069290043471304,0.044000
steepest_intra:edges_start:random,142,72290,23785,48505,1868750,124,144;49;102;62;9;37;148;15;186;137;23;89;183;143;0;117;93;68;46;139;18;22;146;159;193;41;115;5;42;181;34;160;48;54;177;10;184;43;116;65;149;131;112;123;127;70;135;162;59;118;51;176;80;151;133;79;63;180;154;158;53;100;26;86;75;101;1;97;152;94;124;167;129;2;120;44;25;78;145;31;16;171;175;113;196;81;90;165;40;185;179;92;57;55;52;106;178;3;138;14,3738084370485714673,0.042042
steepest_intra:edges_start:random,143,73365,24280,49085,1853800,123,151;133;162;123;127;70;135;154;180;158;53;86;101;1;97;152;2;120;44;16;171;175;113;56;31;78;145;92;129;57;55;52;106;178;3;49;102;14;138;165;40;185;196;81;90;164;7;21;144;62;9;148;124;94;63;122;79;80;176;137;23;186;89;183;143;117;93;0;51;109;118;59;116;115;139;46;68;108;69;18;22;159;193;41;181;34;54;48;160;42;43;65;131;184;177;10;190;4;112;149,5495046459556415966,0.040001
steepest_intra:edges_start:random,144,72073,22547,49526,2003300,133,171;175;113;31;78;145;196;81;90;27;164;7;21;144;14;138;165;119;40;185;179;92;57;55;52;106;178;3;49;102;62;9;15;148;167;124;94;122;80;79;133;162;151;51;176;137;23;89;183;143;0;117;68;46;139;115;118;59;149;65;116;43;42;5;41;193;159;22;146;195;181;34;160;54;177;184;84;112;123;127;135;154;180;63;53;100;26;86;75;101;1;97;152;2;129;82;120;44;25;16,7877670056290648635,0.044040
steepest_intra:edges_start:random,145,73313,23283,50030,1958450,130,176;137;23;89;183;143;0;46;115;139;41;193;159;108;18;22;146;34;54;177;10;184;160;42;5;43;116;65;59;149;131;35;84;4;112;156;29;123;127;70;135;162;133;180;154;158;53;26;86;75;101;1;97;152;2;129;57;92;120;44;25;16;171;175;113;31;78;145;196;81;90;27;164;7;95;39;165;119;40;185;55;52;106;178;14;144;49;102;62;9;148;124;94;63;122;79;80;151;118;51,3767272244176074364,0.043000
steepest_intra:edges_start:random,146,73180,24675,48505,2137850,142,86;53;94;63;122;79;133;180;154;135;70;127;123;112;4;10;177;30;54;184;149;65;116;43;160;34;103;146;22;195;181;42;5;41;193;159;18;69;108;117;143;0;46;139;115;118;59;162;151;80;176;137;23;183;89;186;148;9;62;102;49;52;106;178;14;144;21;7;164;27;90;39;165;185;40;81;196;31;56;113;175;171;16;78;145;92;57;55;129;25;44;120;2;152;1;97;26;100;101;75,4599459655819226861,0.047080
steepest_intra:edges_start:random,147,72791,23196,49595,1913600,127,122;80;176;51;151;162;133;79;63;53;180;154;70;135;194;127;123;112;4;84;35;43;160;184;177;54;48;34;181;41;193;159;195;146;22;18;139;115;5;42;116;65;59;118;46;68;93;117;0;143;183;89;23;137;186;114;15;148;37;9;62;102;144;14;49;3;178;106;52;55;185;40;165;90;81;196;56;113;175;171;16;31;78;145;92;57;129;44;120;2;75;101;86;100;26;97;1;152;124;94,7466479245554309916,0.043999
steepest_intra:edges_start:random,148,74109,23237,50872,2107950,140,139;46;0;143;183;89;23;137;186;15;62;9;148;167;49;102;144;14;21;164;90;165;119;40;185;138;32;3;178;106;52;55;57;129;92;179;145;78;31;56;113;175;171;16;25;44;120;82;2;75;86;101;1;152;97;26;100;158;70;135;154;180;53;121;124;94;63;122;79;133;123;162;151;80;176;51;109;118;59;115;42;43;116;65;149;131;184;10;177;54;48;160;34;181;41;193;159;22;18;108,6319425001460688106,0.046125
steepest_intra:edges_start:random,149,72801,23387,49414,2003300,133,1;97;152;2;129;92;57;55;52;49;102;144;21;14;138;3;178;106;185;40;119;165;27;90;81;196;179;145;78;157;31;56;113;175;171;16;25;44;120;75;86;53;180;154;135;123;162;151;133;80;176;51;59;118;46;139;115;116;65;149;131;43;5;42;184;84;112;4;177;54;48;160;34;181;41;193;22;18;108;140;93;117;0;143;183;89;23;137;15;62;9;148;124;94;122;79;63;100;26;101,6437070093419861520,0.045000
steepest_intra:edges_start:random,150,72188,23005,49183,2018250,134,124;122;80;176;51;118;59;115;198;46;68;139;41;193;159;195;146;22;18;69;108;117;0;143;183;89;23;137;186;114;15;148;9;62;102;49;144;21;14;138;3;178;106;52;55;57;185;40;119;165;90;81;196;31;113;175;171;16;78;145;92;129;44;120;2;152;97;1;101;75;86;26;100;53;180;154;135;123;112;84;184;190;10;177;54;48;160;34;181;42;43;116;65;149;162;151;133;79;63;94,5682211116333611115,0.045000
steepest_intra:edges_start:random,151,73916,23914,50002,1868750,124,138;14;144;15;186;23;89;183;143;0;117;93;140;108;18;22;159;193;41;42;181;34;160;54;177;10;184;35;84;112;123;127;70;135;154;180;53;101;75;120;44;25;16;171;175;113;56;31;81;90;27;164;39;165;119;40;185;3;178;106;52;55;57;92;145;78;2;1;97;152;94;63;122;80;79;133;162;149;131;65;116;43;115;198;139;68;46;59;118;109;51;151;176;137;148;37;9;62;102;49,4514736659645915685,0.042001
steepest_intra:edges_start:random,152,73012,23503,49509,1898650,126,115;59;51;80;176;137;148;9;62;102;49;178;106;52;55;57;129;92;179;91;145;78;82;120;44;25;16;171;175;113;56;31;157;196;81;90;119;40;185;165;138;14;144;15;114;186;23;89;183;143;0;117;93;140;68;46;198;139;69;108;18;22;159;193;41;181;42;5;43;35;184;160;34;54;177;112;123;127;70;135;154;180;53;26;86;75;101;97;1;2;152;124;94;63;79;133;151;162;65;116,6202590045927238064,0.040997
steepest_intra:edges_start:random,153,72790,23509,49281,1913600,127,145;31;16;171;175;113;196;81;90;27;39;165;119;40;185;179;92;57;55;52;106;178;3;138;14;144;49;102;62;9;167;124;94;148;15;186;23;89;183;137;51;118;59;65;116;43;42;41;193;139;115;198;46;68;0;143;117;93;140;108;69;18;22;34;160;184;54;177;10;190;4;112;131;149;123;127;70;135;154;180;133;151;176;80;79;63;53;100;26;97;152;1;101;86;75;2;129;120;44;78,1357502639558991124,0.042701
steepest_intra:edges_start:random,154,73981,24298,49683,2093000,139,112;149;65;116;43;42;59;51;176;80;79;133;151;162;123;127;70;135;154;180;158;53;63;94;148;9;62;49;3;178;106;52;55;57;2;152;97;1;101;26;86;75;120;44;25;78;16;171;175;113;56;31;157;145;92;179;196;81;185;40;119;90;27;39;165;138;14;144;186;23;89;183;143;117;0;153;137;109;118;115;46;68;139;41;193;159;69;108;18;22;146;34;160;184;48;54;30;177;10;4,8572546347692789940,0.045998
steepest_intra:edges_start:random,155,72595,23539,49056,1838850,122,106;178;49;102;62;9;15;37;148;94;63;79;80;133;151;162;123;149;131;47;43;42;116;65;59;51;176;137;23;89;183;143;117;0;46;68;93;140;108;18;69;139;115;41;193;159;22;146;195;181;34;160;54;184;84;112;127;135;154;180;53;100;26;97;86;75;101;1;152;2;120;44;25;129;92;57;55;52;179;145;78;16;171;175;113;56;31;157;196;81;40;119;185;165;90;27;164;21;144;14,7245526469513719787,0.040002
steepest_intra:edges_start:random,156,72919,23532,49387,2093000,139,40;165;90;81;145;78;31;113;175;171;16;44;120;2;75;101;86;100;26;97;1;152;124;94;189;121;53;180;154;135;70;127;123;112;4;190;10;177;184;160;48;54;30;34;146;22;18;108;69;159;193;41;115;5;181;42;43;116;65;47;131;149;59;118;51;151;162;133;79;63;122;80;176;137;46;139;117;0;143;183;89;23;186;144;14;49;102;62;9;148;167;129;92;57;55;52;178;3;106;185,7073585159314387677,0.046000
steepest_intra:edges_start:random,157,74371,23436,50935,2018250,134,40;119;165;39;164;27;90;81;31;113;175;171;16;78;145;179;52;55;57;92;129;82;25;44;120;2;75;101;1;152;97;26;100;86;53;180;154;135;70;127;194;133;151;162;123;112;35;131;149;65;116;115;96;5;43;42;181;160;48;184;10;177;54;34;146;22;159;193;41;139;46;59;118;109;51;176;80;79;122;63;94;124;148;137;0;117;143;183;89;9;62;144;102;49;14;138;3;178;106;185,7509857987957343136,0.045000
steepest_intra:edges_start:random,158,72536,22502,50034,1943500,129,52;106;178;3;138;14;144;49;102;62;9;37;148;124;94;63;122;79;80;176;137;23;186;15;114;89;183;143;0;46;59;115;139;108;18;159;193;41;42;43;116;65;47;149;131;35;184;160;181;22;146;34;48;54;177;10;4;112;127;123;162;151;133;135;154;180;53;100;26;86;75;101;1;97;152;2;120;44;25;16;171;175;113;56;31;78;145;92;129;57;179;196;81;90;27;39;165;40;185;55,2511757997456855638,0.043998
steepest_intra:edges_start:random,159,75825,23331,52494,1883700,125,135;154;180;158;53;100;26;97;1;101;86;75;120;92;145;78;44;16;171;175;113;31;81;90;165;40;185;14;144;62;9;49;178;106;52;55;57;129;2;152;94;124;148;137;183;143;0;117;93;140;68;46;51;109;118;59;65;47;116;105;77;43;42;5;115;198;139;110;191;41;193;159;108;18;22;146;195;181;34;160;48;54;177;184;84;112;131;149;123;162;151;176;80;122;63;79;133;194;127;70,690374522575470952,0.041009
steepest_intra:edges_start:random,160,74694,22949,51745,2033200,135,124;167;148;9;62;102;49;3;178;106;138;14;144;186;89;183;23;137;176;80;122;63;79;133;162;151;51;118;59;149;131;65;116;43;42;181;5;115;46;139;41;193;159;18;22;146;34;160;48;54;177;10;184;35;84;4;112;123;135;154;180;158;53;136;182;121;100;26;97;1;101;86;75;2;120;44;145;78;16;171;175;113;31;81;90;27;164;39;165;119;40;185;52;55;57;179;92;129;152;94,4084939827574581996,0.045581
steepest_intra:edges_start:random,161,73211,22829,50382,2018250,134,2;129;57;55;52;106;178;3;49;102;148;9;62;144;14;138;185;40;119;165;39;27;90;81;196;157;31;56;113;175;171;16;78;145;92;25;44;120;75;1;97;26;100;101;86;53;154;135;180;63;133;151;162;123;112;4;10;177;54;184;84;35;43;116;65;59;118;46;68;139;198;115;96;5;42;41;193;159;195;181;160;34;146;22;18;108;93;117;0;143;183;89;186;23;137;176;80;94;124;152,430557110463234214,0.045002
steepest_intra:edges_start:random,162,72531,23100,49431,1838850,122,26;100;53;180;154;135;70;127;112;84;35;184;177;54;48;160;34;146;22;181;42;5;43;116;65;47;131;149;123;162;151;133;79;63;122;80;176;51;109;118;59;115;41;193;159;18;108;140;68;139;46;0;143;183;89;23;137;186;15;9;62;144;14;49;178;106;52;55;185;40;119;165;27;90;81;196;57;92;145;78;31;113;175;171;16;44;120;75;86;101;1;97;152;2;129;167;148;124;94;121,7009798069268162155,0.041578
steepest_intra:edges_start:random,163,75469,24944,50525,1764100,117,146;34;54;160;181;42;5;96;41;193;139;68;115;116;43;184;177;10;4;112;127;194;135;70;154;180;158;53;63;79;122;94;124;152;2;1;97;101;86;75;120;44;25;129;92;145;78;31;16;171;175;113;90;27;164;39;165;119;40;185;179;57;55;52;106;178;14;49;102;144;62;148;89;183;137;176;80;133;151;162;123;149;131;47;65;59;118;109;51;46;0;170;143;117;93;140;108;18;159;22,2158640197254264091,0.038998
steepest_intra:edges_start:random,164,73234,23614,49620,1913600,127,160;34;181;42;5;195;103;146;22;18;159;193;41;139;46;115;118;59;162;151;133;79;63;80;176;51;137;0;143;183;89;23;186;144;14;138;106;185;165;39;27;90;119;40;81;196;56;113;175;171;16;31;145;78;44;120;2;129;92;57;55;52;178;3;49;62;9;148;167;124;94;152;97;1;101;75;86;26;100;53;180;154;135;70;127;123;149;65;116;43;184;84;112;4;190;10;177;30;54;48,2365011176563504846,0.041968
steepest_intra:edges_start:random,165,72736,22547,50189,1973400,131,153;183;89;186;23;137;176;80;151;162;133;79;63;94;124;167;148;9;62;102;49;144;14;138;3;178;106;52;55;185;40;119;165;27;90;81;196;179;57;92;145;78;113;175;171;16;25;44;120;2;152;97;26;1;101;75;86;53;180;154;135;70;127;123;112;4;177;54;30;34;160;48;184;42;181;195;146;22;199;18;108;69;159;193;41;139;115;5;43;116;65;149;59;118;46;68;93;117;143;0,4865738435962505312,0.045030
steepest_intra:edges_start:random,166,73356,23695,49661,2078050,138,14;144;15;80;176;137;23;186;89;183;143;0;117;93;68;46;198;139;41;193;159;69;108;18;199;22;146;195;181;34;160;54;177;184;35;84;112;123;149;65;116;43;42;5;115;59;151;133;162;127;70;135;154;180;158;53;63;79;122;94;124;148;9;62;102;49;178;106;52;55;57;152;97;1;101;86;75;2;120;129;92;179;145;78;25;44;16;171;175;113;56;31;196;81;90;27;165;40;185;138,4984743866632646688,0.046001
steepest_intra:edges_start:random,167,71642,22617,49025,1928550,128,112;4;84;35;184;10;177;54;48;160;34;181;146;22;159;41;193;18;108;93;117;0;143;183;89;23;137;176;80;94;124;111;167;148;9;62;102;144;14;138;49;3;178;106;52;55;185;40;119;165;90;81;31;113;175;171;16;78;145;179;57;92;129;25;44;120;2;152;97;1;101;75;86;26;100;53;70;135;154;180;63;79;133;151;162;59;118;46;68;139;115;5;42;43;116;65;131;149;123;127,657081066416438343,0.044098
steepest_intra:edges_start:random,168,74183,24662,49521,1958450,130,30;34;22;159;193;41;42;43;116;65;47;131;149;59;118;115;46;139;18;108;117;143;183;89;23;137;176;80;148;15;9;62;102;144;21;7;164;27;90;165;119;40;185;106;138;14;49;3;178;52;55;57;129;92;145;179;196;81;31;56;113;175;171;16;78;25;44;120;2;75;86;26;97;101;1;152;94;63;53;180;154;135;70;127;194;133;79;151;51;72;162;123;112;4;84;184;160;48;177;54,5792550660181005229,0.041904
steepest_intra:edges_start:random,169,72233,23004,49229,2093000,139,120;2;152;97;1;101;75;86;26;100;53;180;154;135;127;123;112;4;84;184;35;131;149;47;65;116;105;77;43;5;42;160;177;54;34;181;146;22;159;193;41;139;69;18;108;93;117;143;0;46;115;59;118;51;176;80;151;162;133;79;63;94;124;137;183;89;23;186;15;148;9;62;102;49;14;144;21;164;27;90;165;40;185;106;178;52;55;57;129;92;179;145;78;31;113;175;171;16;25;44,7614434551303473526,0.047965
steepest_intra:edges_start:random,170,73501,23412,50089,1779050,118,115;46;68;0;183;143;117;93;140;108;18;22;34;160;184;48;54;177;10;190;4;112;84;35;131;149;123;127;70;135;154;158;180;63;122;79;133;151;176;80;124;94;121;53;86;101;100;26;97;1;152;74;2;75;120;44;25;16;171;175;113;56;31;78;145;179;92;129;57;55;52;178;106;185;40;81;90;27;165;14;49;102;144;62;9;148;137;51;118;59;116;65;47;43;42;181;159;193;41;139,3815003743635917262,0.038747
steepest_intra:edges_start:random,171,72218,23377,48841,2107950,140,102;62;9;148;15;186;23;89;183;143;0;117;93;140;68;46;115;116;65;43;42;181;193;41;139;108;18;159;22;34;160;184;84;112;131;149;59;118;51;137;176;80;124;94;63;79;133;151;162;123;127;70;135;154;180;53;86;75;101;100;26;97;1;152;2;129;82;120;44;25;16;171;175;113;56;31;157;78;145;196;81;90;27;164;39;165;40;185;179;92;57;55;52;106;178;3;138;14;144;49,5900746734723475374,0.048794
steepest_intra:edges_start:random,172,75566,23567,51999,1928550,128,2;120;44;25;16;171;175;113;31;78;145;92;57;55;52;185;40;196;81;90;27;39;165;106;178;14;144;49;102;62;9;37;167;148;15;186;137;23;89;183;143;139;115;59;118;51;176;80;133;151;162;65;116;41;193;159;199;69;108;18;22;195;146;103;34;181;42;43;149;35;84;184;160;54;177;10;190;4;112;123;135;154;180;53;121;182;136;63;79;94;124;189;152;1;101;97;26;100;86;75,2280351228728144297,0.042999
steepest_intra:edges_start:random,173,73275,23641,49634,1973400,131,145;92;129;57;55;52;178;3;106;185;40;165;90;27;164;21;144;14;49;62;9;148;186;137;51;176;80;94;63;79;133;151;162;59;118;46;0;23;89;183;143;117;108;18;22;146;34;160;181;159;193;41;139;115;96;5;42;43;116;65;47;184;54;177;10;190;4;112;84;35;131;149;123;127;135;154;180;158;53;136;121;100;26;86;75;101;1;97;152;2;120;44;25;16;171;175;113;56;31;78,7111338420795175908,0.043001
steepest_intra:edges_start:random,174,73871,22969,50902,2018250,134,77;131;149;123;127;70;135;154;180;53;121;100;26;97;152;1;101;86;75;2;129;55;52;57;92;120;44;16;171;175;113;31;78;145;179;196;81;90;27;39;165;40;185;106;178;49;102;14;144;62;9;15;186;23;89;183;143;0;137;148;37;167;111;124;94;189;63;122;176;80;79;133;162;151;51;118;59;65;47;116;42;5;115;46;68;139;41;193;159;18;22;146;181;34;160;54;177;10;184;43,995764070050434878,0.043999
steepest_intra:edges_start:random,175,73465,22745,50720,2182700,145,106;165;39;95;164;27;90;40;185;52;55;57;129;92;145;78;31;113;175;171;16;44;120;2;1;97;101;75;86;26;100;121;136;53;158;180;154;135;127;123;112;4;84;184;10;177;54;48;160;34;181;146;22;20;18;108;69;199;159;193;41;139;5;42;43;116;65;47;131;149;59;118;115;46;68;117;0;143;183;89;186;23;137;176;80;51;151;162;133;79;63;94;152;148;62;144;14;49;3;178,1621233918565157916,0.049000
steepest_intra:edges_start:random,176,73887,23419,50468,2063100,137,143;0;139;41;193;159;108;18;22;146;181;34;160;54;30;177;10;190;4;112;84;184;35;131;149;47;65;116;43;42;115;59;118;51;151;133;162;123;127;135;154;180;158;53;136;121;189;26;100;86;75;101;1;97;152;2;129;92;57;55;52;178;106;185;179;145;78;120;44;16;171;175;113;56;31;81;90;40;119;165;164;21;144;14;49;102;62;9;15;37;148;124;94;63;79;80;176;137;89;183,7980585182247830153,0.047045
steepest_intra:edges_start:random,177,74991,23879,51112,1988350,132,167;124;94;189;121;53;158;180;154;135;127;123;149;131;112;4;177;184;160;34;181;42;139;41;193;159;22;18;108;117;143;183;0;46;115;43;116;47;65;59;151;133;79;63;122;80;176;137;23;186;15;144;21;164;27;90;39;165;185;119;40;81;196;157;31;113;175;171;16;78;25;44;120;2;75;101;86;100;26;97;1;152;129;92;145;179;57;55;52;106;178;3;138;14;49;102;62;9;37;148,8425819967089528103,0.042998
steepest_intra:edges_start:random,178,73029,25170,47859,1838850,122,0;46;115;139;41;193;159;69;108;18;22;146;34;48;160;181;42;43;116;65;149;35;84;184;54;30;177;10;4;112;123;127;70;135;154;180;53;86;75;120;2;152;97;1;101;26;94;63;122;79;133;162;151;72;59;118;51;80;176;137;148;9;49;178;106;185;52;55;57;92;145;78;25;44;16;171;175;113;56;31;196;81;40;165;90;164;7;21;14;144;62;186;23;89;183;143;117;93;140;68,3193574862973544744,0.041041
steepest_intra:edges_start:random,179,74931,25178,49753,1823900,121,145;78;16;171;175;113;31;81;90;164;21;138;14;144;62;9;102;49;178;106;165;40;185;52;55;57;92;129;167;148;186;23;89;183;143;0;117;68;139;198;115;96;41;193;108;18;22;146;159;195;34;48;54;177;10;4;112;184;160;181;42;5;43;116;65;59;118;46;137;176;80;63;79;133;151;51;72;162;123;135;154;180;158;53;121;189;94;124;152;1;97;26;100;86;101;75;2;120;44;25,1329769723576246028,0.039124
steepest_intra:edges_start:random,180,73757,23036,50721,1973400,131,53;158;180;154;135;70;127;123;112;4;190;10;177;184;54;48;34;160;42;43;149;65;116;115;139;41;193;159;146;22;18;69;108;140;93;68;46;0;117;143;153;183;89;23;137;186;15;148;9;62;49;178;106;14;144;21;7;164;27;90;165;40;185;52;55;57;92;145;78;175;171;16;25;44;120;2;1;101;75;86;100;26;97;152;124;94;122;80;176;51;118;59;72;151;162;133;79;63;182;121,6500669422591750511,0.043987
steepest_intra:edges_start:random,181,75244,24314,50930,1883700,125,26;100;121;189;19;97;1;152;124;94;122;80;151;133;79;63;53;180;154;135;70;127;123;112;4;10;177;54;184;160;42;181;34;146;22;18;108;159;193;41;139;143;0;46;115;5;43;116;65;47;131;149;59;118;51;176;137;23;89;183;62;9;148;167;52;106;178;49;102;144;14;138;165;185;40;90;81;196;157;31;113;175;171;16;25;78;145;179;91;55;57;92;129;82;44;120;2;75;101;86,6430430134770065971,0.041854
steepest_intra:edges_start:random,182,73757,21801,51956,2093000,139,193;159;22;146;34;48;54;30;177;10;190;4;112;84;35;184;28;160;181;42;43;116;65;47;131;149;162;194;123;127;70;135;154;180;158;53;136;121;100;26;86;75;101;1;97;152;2;120;44;16;171;175;113;31;78;145;92;57;55;52;185;40;90;165;106;178;3;49;102;14;144;62;9;15;186;89;183;23;137;148;124;94;63;79;80;176;133;151;51;109;118;59;46;0;143;117;68;139;115;41,2190010453507291164,0.046076
steepest_intra:edges_start:random,183,73767,22992,50775,1988350,132,44;25;16;171;175;113;56;31;196;185;40;90;165;14;144;102;49;178;106;52;55;57;129;92;145;78;82;2;152;94;124;148;62;137;89;183;143;117;93;140;108;69;18;22;146;34;160;54;177;10;190;4;112;184;43;5;42;181;159;193;41;139;68;46;115;116;65;47;77;131;149;123;127;70;135;162;133;151;72;59;118;109;51;176;80;79;122;63;180;154;158;53;86;100;26;97;1;101;75;120,654002009199449216,0.044084
steepest_intra:edges_start:random,184,73722,22861,50861,1943500,129,178;106;185;40;81;90;165;138;14;144;49;102;62;9;15;114;186;137;23;89;183;143;170;0;117;93;108;18;159;193;41;139;46;115;5;42;43;160;181;22;146;34;48;54;177;184;35;84;4;112;123;149;131;77;105;47;65;116;59;118;109;51;151;162;133;176;80;79;63;135;154;180;53;100;26;86;75;101;1;97;94;124;148;152;2;120;44;16;171;175;113;56;31;78;145;92;129;57;55;52,8835781503403963145,0.043160
steepest_intra:edges_start:random,185,71973,22069,49904,2018250,134,190;10;177;30;54;160;34;181;146;22;159;199;18;69;108;140;68;139;193;41;5;42;43;116;65;131;149;59;118;115;46;0;143;183;137;176;80;151;162;133;79;63;94;148;9;62;102;49;144;14;138;3;178;106;52;55;57;185;40;119;165;27;90;81;196;157;31;56;113;175;171;16;44;25;78;145;179;92;129;120;2;152;97;1;101;75;86;26;100;121;53;180;154;135;70;127;123;112;84;184,6326521408607956432,0.044880
steepest_intra:edges_start:random,186,74115,23730,50385,1838850,122,62;9;37;148;111;167;152;2;129;57;92;145;179;55;52;106;178;3;14;49;102;144;21;7;164;27;90;165;185;119;40;81;196;31;56;113;175;171;16;78;44;120;75;86;101;1;97;26;100;53;180;154;135;127;123;149;131;47;65;116;43;184;177;54;34;160;42;41;193;22;18;69;108;140;93;117;68;46;139;115;118;59;72;162;133;151;51;176;80;79;63;94;124;137;0;143;183;89;186;15,3998417595530608355,0.040002
steepest_intra:edges_start:random,187,73575,22324,51251,2048150,136,48;34;103;146;22;195;159;193;41;139;69;18;108;140;93;117;0;143;183;89;186;23;137;148;9;62;144;49;14;165;40;185;106;178;52;55;57;92;145;78;31;113;175;171;16;44;120;75;86;26;101;1;97;152;2;129;167;124;94;122;63;53;180;154;135;127;123;162;133;79;80;176;51;151;72;59;118;46;115;5;116;65;47;149;131;77;43;42;181;160;184;35;84;112;4;190;10;177;30;54,4806451368797637367,0.044761
steepest_intra:edges_start:random,188,74038,24250,49788,1913600,127,127;123;149;35;84;112;4;177;54;34;146;22;181;160;184;42;43;65;116;115;198;139;41;193;159;18;108;117;143;0;68;46;118;59;72;151;51;176;137;23;183;89;186;15;144;14;138;3;106;185;40;165;90;81;145;78;31;56;113;175;171;16;25;44;120;75;86;26;101;1;97;152;2;129;92;57;55;52;178;49;102;62;9;37;148;124;94;122;80;133;79;63;121;53;180;154;70;135;194;162,2518595357790583455,0.042001
steepest_intra:edges_start:random,189,74663,24038,50625,1928550,128,48;54;177;10;184;160;42;5;43;65;116;115;118;59;149;123;127;70;154;158;53;180;135;194;162;151;72;51;176;80;133;79;122;63;94;124;148;9;62;102;49;3;178;106;52;55;57;92;129;152;189;182;121;100;26;97;1;101;86;75;2;120;44;25;16;171;175;113;31;78;145;179;185;40;165;90;164;7;21;138;14;144;15;137;89;183;143;0;46;68;139;108;18;22;146;159;193;41;181;34,1408817399188423464,0.042010
steepest_intra:edges_start:random,190,73278,22526,50752,2018250,134,15;186;137;23;89;183;143;0;117;93;140;108;18;22;193;41;139;42;160;34;48;54;177;184;84;112;149;65;43;116;59;118;115;46;51;176;80;79;133;151;162;123;127;135;154;180;158;53;63;94;124;189;121;100;26;86;75;101;1;97;152;2;120;44;82;129;92;57;179;145;78;25;16;171;175;113;56;31;38;157;196;81;90;165;40;185;55;52;106;178;3;138;14;49;102;144;62;9;37;148,6050491384197081978,0.043591
steepest_intra:edges_start:random,191,73565,23608,49957,2018250,134,46;68;139;115;59;118;51;151;162;133;79;63;80;176;137;23;183;89;186;15;62;9;148;167;2;129;57;55;52;106;178;49;102;144;14;138;185;40;165;39;95;7;164;90;81;196;179;92;145;78;38;157;31;56;113;175;171;16;25;44;120;75;101;86;26;97;1;152;94;121;53;158;180;154;135;127;123;65;116;43;42;160;184;10;177;54;48;34;146;22;159;41;193;199;18;69;108;117;143;0,4472259052624399194,0.043980
steepest_intra:edges_start:random,192,73180,23172,50008,1958450,130,145;78;31;113;175;171;16;44;120;2;75;86;53;180;154;135;133;151;162;123;127;112;131;149;65;116;59;118;115;42;43;184;10;177;54;48;160;34;181;195;103;146;22;18;108;159;193;41;139;46;68;140;93;117;143;0;153;183;89;114;15;186;23;137;176;80;79;122;63;121;100;26;101;1;97;152;94;124;148;37;9;62;102;49;144;14;178;106;52;55;185;40;165;27;90;81;196;179;57;92,7713691348421502051,0.043646
steepest_intra:edges_start:random,193,74976,21402,53574,1943500,129,40;185;106;178;49;14;144;102;62;9;148;124;94;80;176;51;151;162;59;118;46;68;93;140;108;69;18;22;146;195;159;193;41;139;115;96;5;42;181;34;160;48;54;30;177;10;190;4;112;84;184;43;105;116;65;47;131;149;123;127;135;154;180;133;79;63;136;158;53;121;100;26;97;86;75;101;1;2;152;167;52;55;57;129;92;145;78;120;44;25;16;171;175;113;56;31;81;90;165;119,4493412222954966558,0.043000
steepest_intra:edges_start:random,194,74453,24433,50020,1898650,126,124;148;9;62;49;14;144;21;164;165;90;81;157;196;40;119;185;106;178;52;57;129;92;145;78;31;113;175;171;16;44;120;2;152;1;97;26;100;101;75;86;53;158;180;154;70;135;194;127;123;112;4;84;190;10;177;30;54;160;34;103;146;22;159;193;41;181;42;43;184;131;149;47;65;116;115;139;46;68;18;108;117;0;143;183;137;176;51;109;118;59;162;151;133;79;80;122;63;121;94,8868137785849603350,0.041033
steepest_intra:edges_start:random,195,74865,24164,50701,1988350,132,86;100;26;97;1;152;124;12;94;189;121;53;158;180;154;70;135;194;127;123;162;151;133;79;63;122;80;176;137;51;109;118;59;116;65;149;131;112;84;184;177;54;48;160;34;103;146;22;18;108;69;159;181;42;43;41;193;139;115;46;68;117;0;143;183;89;186;15;148;9;62;144;102;49;178;106;52;55;185;40;165;14;21;164;90;113;175;171;16;25;44;120;78;145;92;57;129;2;75;101,4469933360776949082,0.045000
steepest_intra:edges_start:random,196,73118,24347,48771,1853800,123,53;86;75;101;1;97;26;100;121;189;94;124;152;2;129;57;92;120;44;25;16;171;175;113;56;31;78;145;179;55;52;185;196;81;90;40;165;164;21;14;138;106;178;3;49;144;62;9;148;80;176;51;137;23;186;89;183;143;170;0;117;93;108;18;22;159;193;41;5;42;181;34;160;48;54;30;177;10;190;184;43;65;116;115;139;46;118;59;149;123;127;70;135;154;180;162;151;133;79;63,7442067538796353911,0.040701
steepest_intra:edges_start:random,197,72942,23246,49696,2018250,134,41;193;159;22;18;108;117;0;143;183;89;186;23;137;148;124;94;152;2;82;129;57;92;145;179;55;52;106;178;49;9;62;144;14;138;3;185;40;119;165;27;90;81;31;56;113;175;171;16;78;25;44;120;75;101;1;97;86;26;100;121;53;154;70;135;180;63;79;133;162;151;80;176;51;59;116;65;47;131;149;123;112;4;10;177;30;54;48;34;181;160;184;43;42;5;96;115;46;68;139,7860039476976766480,0.044997
steepest_intra:edges_start:random,198,74054,24775,49279,1868750,124,193;41;115;139;68;117;143;170;0;46;59;118;109;51;151;162;133;79;63;80;176;137;23;183;89;186;15;124;94;152;97;1;2;167;148;9;62;144;102;49;3;178;52;106;138;14;21;164;90;165;185;119;40;81;196;31;113;175;171;16;78;145;179;55;57;92;129;44;120;75;101;86;53;180;154;135;70;127;123;149;131;47;65;116;5;42;43;35;112;4;84;184;177;54;160;34;146;22;18;159,8448362296238045106,0.040002
steepest_intra:edges_start:random,199,72255,22847,49408,1958450,130,81;196;157;31;56;113;175;171;16;78;145;179;55;57;92;129;25;44;120;2;152;97;1;101;75;86;26;100;121;53;180;154;135;127;123;162;133;151;51;59;118;46;68;139;198;115;5;42;43;116;65;149;131;184;177;54;160;34;146;22;159;41;193;18;108;140;93;117;0;143;183;89;23;137;176;80;79;63;94;148;15;9;62;144;102;49;52;106;178;3;14;138;165;39;164;27;90;119;40;185,7281748024766865939,0.043588
steepest_intra:edges_start:greedy,0,70571,22366,48205,119600,7,0;117;143;183;89;186;23;137;176;80;79;63;94;124;152;97;1;101;2;82;129;92;57;55;52;49;102;148;9;62;144;14;3;178;106;185;40;165;90;81;196;179;145;78;31;56;113;175;171;16;25;44;120;75;86;26;100;121;53;180;154;135;70;127;123;162;133;151;51;118;59;65;116;43;184;84;112;4;190;10;177;54;48;160;34;146;22;18;108;69;159;181;42;5;41;193;115;139;68;46,6492086014418828195,0.002998
steepest_intra:edges_start:greedy,1,71446,23257,48189,74750,4,1;101;75;86;53;154;70;135;180;63;79;133;151;162;127;123;149;65;116;43;184;10;177;54;48;160;34;146;22;18;108;69;159;181;42;5;41;193;139;68;140;93;117;143;0;46;115;59;118;51;80;176;137;23;183;89;186;114;15;9;62;144;14;138;185;40;165;90;81;196;179;145;78;31;56;113;175;171;16;25;44;120;2;129;92;57;55;52;106;178;49;102;148;124;94;121;100;26;97;152,6301954048016233990,0.002000
steepest_intra:edges_start:greedy,2,71382,23110,48272,119600,7,2;129;92;57;55;52;49;102;148;9;62;144;14;3;178;106;185;40;165;90;81;196;179;145;78;31;56;113;175;171;16;25;44;120;75;86;53;180;154;135;70;127;123;162;149;131;65;116;43;184;84;190;10;177;54;48;160;34;146;22;18;108;69;159;181;42;5;41;193;139;68;140;93;117;143;183;89;186;23;137;0;46;115;59;118;51;151;133;176;80;79;63;94;121;100;26;101;1;97;152,4947059194603746048,0.003000
steepest_intra:edges_start:greedy,3,71246,23052,48194,104650,6,138;14;144;62;9;148;102;49;178;106;52;55;57;92;129;2;152;97;1;101;26;100;121;94;63;79;80;176;133;151;51;118;59;115;46;0;137;23;186;89;183;143;117;93;140;68;139;193;41;5;42;181;159;69;108;18;22;146;34;160;48;54;177;10;190;84;184;43;116;65;131;149;162;123;127;70;135;154;180;53;86;75;120;44;25;16;171;175;113;56;31;78;145;179;196;81;90;165;40;185,5273364432749090775,0.002000
steepest_intra:edges_start:greedy,4,71327,23150,48177,149500,9,4;190;10;177;54;48;34;160;42;181;146;22;18;108;69;159;193;41;139;68;46;115;118;59;65;116;43;184;35;131;149;123;162;133;151;51;0;117;143;183;89;23;137;176;80;79;63;94;124;152;97;1;101;2;82;129;92;57;55;52;49;102;148;9;62;144;14;3;178;106;185;40;165;90;81;196;179;145;78;31;56;113;175;171;16;25;44;120;75;86;26;100;121;53;180;154;135;70;127;112,8082042885444362903,0.003011
steepest_intra:edges_start:greedy,5,71179,23056,48123,104650,6,5;43;116;65;149;123;127;162;151;133;135;70;154;180;53;121;100;26;86;75;120;44;25;16;171;175;113;56;31;78;145;179;196;81;90;165;40;185;106;178;3;14;144;62;9;148;102;49;52;55;57;92;129;82;2;101;1;97;152;124;94;63;79;80;176;137;23;186;89;183;143;117;0;51;118;59;115;46;68;139;41;193;159;69;108;18;22;146;181;34;160;48;54;177;10;190;4;112;184;42,1358537964008019279,0.002037
steepest_intra:edges_start:greedy,6,71403,22833,48570,89700,5,158;70;135;154;180;63;79;133;151;162;127;123;149;65;116;43;184;177;54;48;160;34;146;22;18;108;69;159;181;42;5;41;193;139;68;140;93;117;143;0;46;115;59;118;51;80;176;137;23;183;89;186;114;15;9;62;144;14;138;185;40;165;90;81;196;179;145;78;31;56;113;175;171;16;25;44;120;2;129;92;57;55;52;106;178;49;102;148;124;94;152;97;1;101;75;86;26;100;121;53,7795792334872291556,0.002002
steepest_intra:edges_start:greedy,7,72221,24124,48097,119600,7,7;21;144;62;9;148;102;49;14;178;106;52;55;185;165;40;179;145;78;92;57;129;2;152;97;1;101;26;100;121;94;63;79;80;176;133;151;51;118;59;115;46;0;137;23;89;183;143;117;93;140;68;139;193;41;5;42;181;159;69;108;18;22;146;34;160;48;54;177;184;43;116;65;149;162;123;127;70;135;154;180;53;86;75;120;44;25;16;171;175;113;56;31;157;196;81;90;27;95;164,9099000011238601657,0.002996
steepest_intra:edges_start:greedy,8,71285,23048,48237,119600,7,27;165;40;185;138;14;144;62;9;148;102;49;178;106;52;55;57;92;129;2;152;97;1;101;26;100;121;94;63;79;80;176;133;151;51;118;59;115;46;0;137;23;186;89;183;143;117;93;140;68;139;193;41;5;42;181;159;69;108;18;22;146;34;160;48;54;177;10;190;184;43;116;65;131;149;162;123;127;70;135;154;180;53;86;75;120;44;25;16;171;175;113;56;31;78;145;179;196;81;90,7181564927001783087,0.003002
steepest_intra:edges_start:greedy,9,71246,23052,48194,89700,5,9;148;102;49;178;106;52;55;57;92;129;2;152;97;1;101;26;100;121;94;63;79;80;176;133;151;51;118;59;115;46;0;137;23;186;89;183;143;117;93;140;68;139;193;41;5;42;181;159;69;108;18;22;146;34;160;48;54;177;10;190;84;184;43;116;65;131;149;162;123;127;70;135;154;180;53;86;75;120;44;25;16;171;175;113;56;31;78;145;179;196;81;90;165;40;185;138;14;144;62,2913224806215420326,0.002011
steepest_intra:edges_start:greedy,10,71327,23150,48177,149500,9,10;190;4;112;127;70;135;154;180;53;121;100;26;86;75;120;44;25;16;171;175;113;56;31;78;145;179;196;81;90;165;40;185;106;178;3;14;144;62;9;148;102;49;52;55;57;92;129;82;2;101;1;97;152;124;94;63;79;80;176;137;23;89;183;143;117;0;51;151;133;162;123;149;131;35;184;43;116;65;59;118;115;46;68;139;41;193;159;69;108;18;22;146;181;42;160;34;48;54;177,7429444320062263411,0.002981
steepest_intra:edges_start:greedy,11,71233,22908,48325,149500,9,149;35;84;4;112;127;123;162;151;133;135;70;154;180;53;121;100;26;86;75;120;44;25;16;171;175;113;56;31;78;145;179;196;81;90;165;40;185;106;178;3;14;144;62;9;148;102;49;52;55;57;92;129;82;2;101;1;97;152;124;94;63;79;80;176;137;23;186;89;183;143;117;0;46;68;139;115;118;51;59;65;116;43;42;5;41;193;159;69;108;18;22;146;181;34;160;48;54;177;184,7328631030602510154,0.002994
steepest_intra:edges_start:greedy,12,72072,23105,48967,89700,5,124;94;152;97;1;101;2;82;129;92;57;179;145;78;31;56;113;175;171;16;25;44;120;75;86;26;100;121;53;158;154;70;135;180;63;79;133;151;162;123;149;65;116;43;184;177;54;48;160;34;146;22;18;108;69;159;181;42;5;41;193;139;68;140;93;117;143;0;46;115;59;118;51;80;176;137;23;183;89;186;114;15;9;62;144;14;138;165;90;81;196;40;185;55;52;106;178;49;102;148,5668512985923490322,0.002230
steepest_intra:edges_start:greedy,13,71808,23361,48447,149500,9,157;31;56;113;175;171;16;25;44;120;75;86;53;180;154;135;70;127;123;162;149;131;65;116;43;184;190;10;177;54;48;160;34;146;22;18;108;69;159;181;42;5;41;193;139;68;140;93;117;143;183;89;186;23;137;0;46;115;59;118;51;151;133;176;80;79;63;94;121;100;26;101;1;97;152;2;129;57;55;52;49;102;148;9;62;144;14;3;178;106;185;40;165;90;81;196;179;92;145;78,1469820970040067648,0.002998
steepest_intra:edges_start:greedy,14,71246,23052,48194,89700,5,14;144;62;9;148;102;49;178;106;52;55;57;92;129;2;152;97;1;101;26;100;121;94;63;79;80;176;133;151;51;118;59;115;46;0;137;23;186;89;183;143;117;93;140;68;139;193;41;5;42;181;159;69;108;18;22;146;34;160;48;54;177;10;190;84;184;43;116;65;131;149;162;123;127;70;135;154;180;53;86;75;120;44;25;16;171;175;113;56;31;78;145;179;196;81;90;165;40;185;138,3189076230047789010,0.001857
steepest_intra:edges_start:greedy,15,71325,23171,48154,89700,5,15;144;14;138;185;40;165;90;81;196;179;145;78;31;56;113;175;171;16;25;44;120;75;86;53;180;154;135;70;127;123;162;149;131;65;116;43;184;190;10;177;54;48;160;34;146;22;18;108;69;159;181;42;5;41;193;139;68;140;93;117;143;183;89;186;23;137;0;46;115;59;118;51;151;133;176;80;79;63;94;121;100;26;101;1;97;152;2;129;92;57;55;52;106;178;49;102;62;9;148,4466599323136168923,0.001999
steepest_intra:edges_start:greedy,16,71579,23307,48272,119600,7,16;25;44;120;75;86;53;180;154;135;70;127;123;162;149;131;65;116;43;184;84;190;10;177;54;48;160;34;146;22;18;108;69;159;181;42;5;41;193;139;68;140;93;117;143;183;89;186;23;137;0;46;115;59;118;51;151;133;176;80;79;63;94;121;100;26;101;1;97;152;2;129;57;55;52;49;102;148;9;62;144;14;3;178;106;185;40;165;90;81;196;179;92;145;78;31;56;113;175;171,2247367333947243584,0.002011
steepest_intra:edges_start:greedy,17,72552,23722,48830,149500,9,119;165;39;95;7;164;58;27;90;81;196;157;31;56;113;175;171;16;25;44;120;75;86;53;180;154;135;70;127;123;162;149;65;116;43;184;177;54;48;160;34;146;22;18;108;159;181;42;41;193;139;68;140;93;117;143;183;89;23;137;0;46;115;59;118;51;151;133;176;80;79;63;94;26;101;1;97;152;2;82;78;145;179;92;129;57;55;52;49;102;148;9;62;144;14;3;178;106;185;40,4574808431183901707,0.004000
steepest_intra:edges_start:greedy,18,71359,23109,48250,119600,7,18;22;146;159;193;41;5;42;181;34;160;48;54;177;10;190;4;112;184;43;116;65;149;123;127;162;151;133;135;70;154;180;53;121;100;26;86;75;120;44;25;16;171;175;113;56;31;78;145;179;196;81;90;165;40;185;106;178;3;14;144;62;9;148;102;49;52;55;57;92;129;82;2;101;1;97;152;124;94;63;79;80;176;137;51;118;59;115;139;68;46;0;89;183;143;117;93;140;108;69,125604271971038324,0.003000
steepest_intra:edges_start:greedy,19,71608,22548,49060,59800,3,189;94;124;148;102;49;178;106;52;55;57;92;129;2;120;44;25;16;171;175;113;56;31;78;145;179;196;81;90;165;40;185;138;14;144;62;9;15;114;186;89;183;23;137;176;80;51;118;59;115;46;0;143;117;93;140;68;139;193;41;5;42;181;159;69;108;18;22;146;34;160;48;54;177;184;43;116;65;149;123;162;151;133;79;63;180;135;70;154;158;53;121;100;26;86;75;101;1;97;152,7716315361603739599,0.002000
steepest_intra:edges_start:greedy,20,71788,22810,48978,119600,7,199;22;146;159;193;41;5;42;181;34;160;48;54;177;10;190;84;184;43;116;65;149;123;127;162;151;133;135;70;154;180;53;121;100;26;86;75;120;44;25;16;171;175;113;56;31;78;145;179;196;81;90;165;40;185;106;178;3;14;144;62;9;148;102;49;52;55;57;92;129;82;2;101;1;97;152;124;94;63;79;80;176;137;51;118;59;115;139;68;46;0;89;183;143;117;93;140;108;69;18,8255881413956602707,0.003000
steepest_intra:edges_start:greedy,21,71711,23674,48037,89700,5,21;14;138;185;40;165;90;81;196;179;145;78;31;56;113;175;171;16;25;44;120;75;86;53;180;154;135;70;127;123;162;149;131;65;116;43;184;190;10;177;54;48;160;34;146;22;18;108;69;159;181;42;5;41;193;139;68;140;93;117;143;183;89;186;23;137;0;46;115;59;118;51;151;133;176;80;79;63;94;121;100;26;101;1;97;152;2;129;92;57;55;52;106;178;49;102;148;9;62;144,5424719762098704046,0.001999
steepest_intra:edges_start:greedy,22,70906,22933,47973,89700,5,22;146;181;34;160;48;54;177;10;190;4;112;84;184;42;43;116;65;149;123;127;162;151;133;135;70;154;180;53;121;100;26;86;75;120;44;25;16;171;175;113;56;31;78;145;179;196;81;90;165;40;185;106;178;3;14;144;62;9;148;102;49;52;55;57;92;129;82;2;101;1;97;152;124;94;63;79;80;176;137;23;186;89;183;143;117;0;51;118;59;115;46;68;139;41;193;159;69;108;18,7194812034178584506,0.002000
steepest_intra:edges_start:greedy,23,70571,22366,48205,119600,7,23;137;176;80;79;63;94;124;152;97;1;101;2;82;129;92;57;55;52;49;102;148;9;62;144;14;3;178;106;185;40;165;90;81;196;179;145;78;31;56;113;175;171;16;25;44;120;75;86;26;100;121;53;180;154;135;70;127;123;162;133;151;51;118;59;65;116;43;184;84;112;4;190;10;177;54;48;160;34;146;22;18;108;69;159;181;42;5;41;193;115;139;68;46;0;117;143;183;89;186,4314222721083263966,0.001998
steepest_intra:edges_start:greedy,24,71514,22952,48562,119600,7,131;149;123;127;162;151;133;135;70;154;180;53;121;100;26;86;75;120;44;25;16;171;175;113;56;31;78;145;179;196;81;90;165;40;185;106;178;3;14;144;62;9;148;102;49;52;55;57;92;129;82;2;101;1;97;152;124;94;63;79;80;176;137;23;186;89;183;143;117;0;51;118;59;115;46;68;139;193;41;5;42;181;159;69;108;18;22;146;34;160;48;54;177;10;190;84;184;43;116;65,3574994906169451408,0.002250
steepest_intra:edges_start:greedy,25,71382,23110,48272,119600,7,25;44;120;75;86;53;180;154;135;70;127;123;162;149;131;65;116;43;184;84;190;10;177;54;48;160;34;146;22;18;108;69;159;181;42;5;41;193;139;68;140;93;117;143;183;89;186;23;137;0;46;115;59;118;51;151;133;176;80;79;63;94;121;100;26;101;1;97;152;2;129;92;57;55;52;49;102;148;9;62;144;14;3;178;106;185;40;165;90;81;196;179;145;78;31;56;113;175;171;16,5668747205096161334,0.001999
steepest_intra:edges_start:greedy,26,71224,23198,48026,59800,3,26;97;1;152;94;124;148;102;49;178;106;52;55;57;92;129;2;120;44;25;16;171;175;113;56;31;78;145;179;196;81;90;165;40;185;138;14;144;62;9;15;114;186;89;183;23;137;176;80;51;118;59;115;46;0;143;117;93;140;68;139;193;41;5;42;181;159;69;108;18;22;146;34;160;48;54;177;10;190;184;43;116;65;149;123;127;162;151;133;79;63;180;135;70;154;53;86;75;101;100,3548374336922768223,0.002002
steepest_intra:edges_start:greedy,27,71912,23384,48528,59800,3,27;58;164;7;95;39;165;138;14;144;62;9;148;102;49;178;106;52;55;57;92;129;2;152;94;63;79;80;176;133;151;51;118;59;115;46;0;137;23;89;183;143;117;93;140;68;139;193;41;5;42;181;159;69;108;18;22;146;34;160;48;54;177;184;43;116;65;149;162;123;127;70;135;154;180;53;100;26;97;1;101;86;75;120;44;25;16;171;175;113;56;31;78;145;179;196;81;185;40;90,3616443858335980486,0.001002
steepest_intra:edges_start:greedy,28,71641,23034,48607,134550,8,35;43;116;65;131;149;123;127;162;151;133;135;70;154;180;53;121;100;26;86;75;120;44;25;16;171;175;113;56;31;78;145;179;196;81;90;165;40;185;106;178;3;14;144;62;9;148;102;49;52;55;57;92;129;82;2;101;1;97;152;124;94;63;79;80;176;137;23;186;89;183;143;117;0;51;118;59;115;46;68;139;193;41;5;42;181;159;69;108;18;22;146;34;160;48;54;177;10;190;184,1797754148666954545,0.004001
steepest_intra:edges_start:greedy,29,71061,22454,48607,179400,11,149;123;162;151;133;135;70;154;180;53;121;100;26;86;75;120;44;25;16;171;175;113;56;31;78;145;179;196;81;90;165;40;185;106;178;3;14;144;62;9;148;102;49;52;55;57;92;129;82;2;101;1;97;152;124;94;63;79;80;176;137;23;186;89;183;143;117;0;46;68;139;115;118;51;59;65;116;43;42;5;41;193;159;69;108;18;22;146;181;34;160;48;54;177;184;35;84;4;112;131,1811040377097371606,0.004002
steepest_intra:edges_start:greedy,30,71512,22948,48564,149500,9,48;54;177;10;190;84;184;43;116;65;59;118;115;46;0;51;151;133;162;123;127;70;135;154;180;53;121;100;26;86;75;120;44;25;16;171;175;113;56;31;78;145;179;196;81;90;165;40;185;106;178;3;14;144;62;9;148;102;49;52;55;57;92;129;82;2;101;1;97;152;124;94;63;79;80;176;137;23;186;89;183;143;117;93;140;68;139;41;193;159;69;108;18;22;146;195;181;42;160;34,1852656974655735134,0.003001
steepest_intra:edges_start:greedy,31,71579,23307,48272,119600,7,31;78;145;92;179;196;81;90;165;40;185;106;178;3;14;144;62;9;148;102;49;52;55;57;129;2;152;97;1;101;26;100;121;94;63;79;80;176;133;151;51;118;59;115;46;0;137;23;186;89;183;143;117;93;140;68;139;193;41;5;42;181;159;69;108;18;22;146;34;160;48;54;177;10;190;84;184;43;116;65;131;149;162;123;127;70;135;154;180;53;86;75;120;44;25;16;171;175;113;56,6341774041645889476,0.003221
steepest_intra:edges_start:greedy,32,71246,23052,48194,104650,6,138;14;144;62;9;148;102;49;178;106;52;55;57;92;129;2;152;97;1;101;26;100;121;94;63;79;80;176;133;151;51;118;59;115;46;0;137;23;186;89;183;143;117;93;140;68;139;193;41;5;42;181;159;69;108;18;22;146;34;160;48;54;177;10;190;84;184;43;116;65;131;149;162;123;127;70;135;154;180;53;86;75;120;44;25;16;171;175;113;56;31;78;145;179;196;81;90;165;40;185,2663556741712006120,0.003000
steepest_intra:edges_start:greedy,33,71402,22870,48532,104650,6,37;102;49;178;106;52;55;57;92;129;2;152;97;1;101;26;100;121;94;63;79;80;176;133;151;51;118;59;115;46;0;137;23;186;89;183;143;117;93;140;68;139;193;41;5;42;181;159;69;108;18;22;146;34;160;48;54;177;10;190;184;43;116;65;131;149;162;123;127;70;135;154;180;53;86;75;120;44;25;16;171;175;113;56;31;78;145;179;196;81;90;165;40;185;138;14;144;62;9;148,3228228806167299808,0.003003
steepest_intra:edges_start:greedy,34,70906,22933,47973,89700,5,34;181;146;22;18;108;69;159;193;41;139;68;46;115;59;118;51;0;117;143;183;89;186;23;137;176;80;79;63;94;124;152;97;1;101;2;82;129;92;57;55;52;49;102;148;9;62;144;14;3;178;106;185;40;165;90;81;196;179;145;78;31;56;113;175;171;16;25;44;120;75;86;26;100;121;53;180;154;70;135;133;151;162;127;123;149;65;116;43;42;184;84;112;4;190;10;177;54;48;160,962527812614336432,0.002001
steepest_intra:edges_start:greedy,35,70846,22596,48250,149500,9,35;84;4;112;127;123;162;151;133;135;70;154;180;53;121;100;26;86;75;120;44;25;16;171;175;113;56;31;78;145;179;196;81;90;165;40;185;106;178;3;14;144;62;9;148;102;49;52;55;57;92;129;82;2;101;1;97;152;124;94;63;79;80;176;137;23;186;89;183;143;117;0;46;68;139;115;118;51;59;65;116;43;42;5;41;193;159;69;108;18;22;146;181;34;160;48;54;177;10;184,3119045073324627125,0.003004
steepest_intra:edges_start:greedy,36,71952,22784,49168,104650,6,36;108;69;18;22;146;159;193;41;5;42;181;34;160;48;54;177;10;190;84;184;43;116;65;149;123;127;162;151;133;135;70;154;180;53;121;100;26;86;75;120;44;25;16;171;175;113;56;31;78;145;179;196;81;90;165;40;185;106;178;3;14;144;62;9;148;102;49;52;55;57;92;129;82;2;101;1;97;152;124;94;63;79;80;176;137;51;118;59;115;139;68;46;0;89;183;143;117;93;140,7942143740306980369,0.002999
steepest_intra:edges_start:greedy,37,71402,22870,48532,89700,5,37;102;49;178;106;52;55;57;92;129;2;152;97;1;101;26;100;121;94;63;79;80;176;133;151;51;118;59;115;46;0;137;23;186;89;183;143;117;93;140;68;139;193;41;5;42;181;159;69;108;18;22;146;34;160;48;54;177;10;190;184;43;116;65;131;149;162;123;127;70;135;154;180;53;86;75;120;44;25;16;171;175;113;56;31;78;145;179;196;81;90;165;40;185;138;14;144;62;9;148,2292434877863943997,0.001997
steepest_intra:edges_start:greedy,38,71808,23361,48447,134550,8,157;78;145;92;179;196;81;90;165;40;185;106;178;3;14;144;62;9;148;102;49;52;55;57;129;2;152;97;1;101;26;100;121;94;63;79;80;176;133;151;51;118;59;115;46;0;137;23;186;89;183;143;117;93;140;68;139;193;41;5;42;181;159;69;108;18;22;146;34;160;48;54;177;10;190;184;43;116;65;131;149;162;123;127;70;135;154;180;53;86;75;120;44;25;16;171;175;113;56;31,226979146104768108,0.002998
steepest_intra:edges_start:greedy,39,71938,23600,48338,74750,4,39;95;7;164;27;90;40;185;81;196;179;145;78;31;56;113;175;171;16;25;44;120;75;86;53;180;154;135;70;127;123;162;149;65;116;43;184;177;54;48;160;34;146;22;18;108;69;159;181;42;5;41;193;139;68;140;93;117;143;183;89;23;137;0;46;115;59;118;51;151;133;176;80;79;63;94;121;100;26;101;1;97;152;2;129;92;57;55;52;106;178;49;102;148;9;62;144;14;138;165,6643632282623788134,0.001000
steepest_intra:edges_start:greedy,40,71246,23052,48194,89700,5,40;165;90;81;196;179;145;78;31;56;113;175;171;16;25;44;120;75;86;53;180;154;135;70;127;123;162;149;131;65;116;43;184;84;190;10;177;54;48;160;34;146;22;18;108;69;159;181;42;5;41;193;139;68;140;93;117;143;183;89;186;23;137;0;46;115;59;118;51;151;133;176;80;79;63;94;121;100;26;101;1;97;152;2;129;92;57;55;52;106;178;49;102;148;9;62;144;14;138;185,3222677860847924440,0.001000
steepest_intra:edges_start:greedy,41,71369,23246,48123,104650,6,41;5;42;181;159;69;108;18;22;146;34;160;48;54;177;10;190;4;112;184;43;116;65;149;123;127;162;151;133;135;70;154;180;53;121;100;26;86;75;120;44;25;16;171;175;113;56;31;78;145;179;196;81;90;165;40;185;106;178;3;14;144;62;9;148;102;49;52;55;57;92;129;82;2;101;1;97;152;124;94;63;79;80;176;137;23;186;89;183;143;117;0;51;118;59;115;46;68;139;193,3108445255331062538,0.002000
steepest_intra:edges_start:greedy,42,71369,23246,48123,104650,6,42;5;41;193;139;68;46;115;59;118;51;0;117;143;183;89;186;23;137;176;80;79;63;94;124;152;97;1;101;2;82;129;92;57;55;52;49;102;148;9;62;144;14;3;178;106;185;40;165;90;81;196;179;145;78;31;56;113;175;171;16;25;44;120;75;86;26;100;121;53;180;154;70;135;133;151;162;127;123;149;65;116;43;184;112;4;190;10;177;54;48;160;34;146;22;18;108;69;159;181,2120013785831199178,0.002000
steepest_intra:edges_start:greedy,43,71548,23048,48500,104650,6,43;116;65;59;118;115;46;0;51;151;133;162;123;127;70;135;154;180;53;121;100;26;86;75;120;44;25;16;171;175;113;56;31;78;145;179;196;81;90;165;40;185;106;178;3;14;144;62;9;148;102;49;52;55;57;92;129;82;2;101;1;97;152;124;94;63;79;80;176;137;23;186;89;183;143;117;93;140;68;139;193;41;5;42;181;159;69;108;18;22;146;34;160;48;54;177;10;190;84;184,8392042951510006940,0.002000
steepest_intra:edges_start:greedy,44,71382,23110,48272,119600,7,44;25;16;171;175;113;56;31;78;145;179;196;81;90;165;40;185;106;178;3;14;144;62;9;148;102;49;52;55;57;92;129;2;152;97;1;101;26;100;121;94;63;79;80;176;133;151;51;118;59;115;46;0;137;23;186;89;183;143;117;93;140;68;139;193;41;5;42;181;159;69;108;18;22;146;34;160;48;54;177;10;190;84;184;43;116;65;131;149;162;123;127;70;135;154;180;53;86;75;120,4498514411945377571,0.002001
steepest_intra:edges_start:greedy,45,72056,23228,48828,119600,7,72;162;127;123;149;65;116;43;184;84;190;10;177;54;48;160;34;146;22;18;108;69;159;181;42;5;41;193;139;68;46;115;59;118;51;0;117;143;183;89;186;23;137;176;80;79;63;94;124;152;97;1;101;2;82;129;92;57;55;52;49;102;148;9;62;144;14;3;178;106;185;40;165;90;81;196;179;145;78;31;56;113;175;171;16;25;44;120;75;86;26;100;121;53;180;154;70;135;133;151,6680150812530970088,0.002980
steepest_intra:edges_start:greedy,46,71369,23246,48123,104650,6,46;115;59;118;51;0;117;143;183;89;186;23;137;176;80;79;63;94;124;152;97;1;101;2;82;129;92;57;55;52;49;102;148;9;62;144;14;3;178;106;185;40;165;90;81;196;179;145;78;31;56;113;175;171;16;25;44;120;75;86;26;100;121;53;180;154;70;135;133;151;162;127;123;149;65;116;43;184;112;4;190;10;177;54;48;160;34;146;22;18;108;69;159;181;42;5;41;193;139;68,6126526316783292932,0.002003
steepest_intra:edges_start:greedy,47,71514,22952,48562,134550,8,131;149;123;127;162;151;133;135;70;154;180;53;121;100;26;86;75;120;44;25;16;171;175;113;56;31;78;145;179;196;81;90;165;40;185;106;178;3;14;144;62;9;148;102;49;52;55;57;92;129;82;2;101;1;97;152;124;94;63;79;80;176;137;23;186;89;183;143;117;0;51;118;59;115;46;68;139;193;41;5;42;181;159;69;108;18;22;146;34;160;48;54;177;10;190;84;184;43;116;65,3124816388783194381,0.003000
steepest_intra:edges_start:greedy,48,71512,22948,48564,134550,8,48;34;160;42;181;195;146;22;18;108;69;159;193;41;139;68;140;93;117;143;183;89;186;23;137;176;80;79;63;94;124;152;97;1;101;2;82;129;92;57;55;52;49;102;148;9;62;144;14;3;178;106;185;40;165;90;81;196;179;145;78;31;56;113;175;171;16;25;44;120;75;86;26;100;121;53;180;154;135;70;127;123;162;133;151;51;0;46;115;118;59;65;116;43;184;84;190;10;177;54,8420686658811368500,0.003014
steepest_intra:edges_start:greedy,49,71246,23052,48194,89700,5,49;178;106;52;55;57;92;129;2;152;97;1;101;26;100;121;94;63;79;80;176;133;151;51;118;59;115;46;0;137;23;186;89;183;143;117;93;140;68;139;193;41;5;42;181;159;69;108;18;22;146;34;160;48;54;177;10;190;84;184;43;116;65;131;149;162;123;127;70;135;154;180;53;86;75;120;44;25;16;171;175;113;56;31;78;145;179;196;81;90;165;40;185;138;14;144;62;9;148;102,7800658899155151290,0.001000
steepest_intra:edges_start:greedy,50,71808,23361,48447,179400,11,157;31;56;113;175;171;16;25;44;120;75;86;53;180;154;135;70;127;123;162;149;131;65;116;43;184;190;10;177;54;48;160;34;146;22;18;108;69;159;181;42;5;41;193;139;68;140;93;117;143;183;89;186;23;137;0;46;115;59;118;51;151;133;176;80;79;63;94;121;100;26;101;1;97;152;2;129;57;55;52;49;102;148;9;62;144;14;3;178;106;185;40;165;90;81;196;179;92;145;78,5823187496562944837,0.004000
steepest_intra:edges_start:greedy,51,71369,23246,48123,104650,6,51;118;59;115;46;68;139;193;41;5;42;181;159;69;108;18;22;146;34;160;48;54;177;10;190;4;112;184;43;116;65;149;123;127;162;151;133;135;70;154;180;53;121;100;26;86;75;120;44;25;16;171;175;113;56;31;78;145;179;196;81;90;165;40;185;106;178;3;14;144;62;9;148;102;49;52;55;57;92;129;82;2;101;1;97;152;124;94;63;79;80;176;137;23;186;89;183;143;117;0,6411053699355934859,0.003024
steepest_intra:edges_start:greedy,52,71246,23052,48194,104650,6,52;106;178;49;102;148;9;62;144;14;138;185;40;165;90;81;196;179;145;78;31;56;113;175;171;16;25;44;120;75;86;53;180;154;135;70;127;123;162;149;131;65;116;43;184;84;190;10;177;54;48;160;34;146;22;18;108;69;159;181;42;5;41;193;139;68;140;93;117;143;183;89;186;23;137;0;46;115;59;118;51;151;133;176;80;79;63;94;121;100;26;101;1;97;152;2;129;92;57;55,5509070529337862308,0.002897
steepest_intra:edges_start:greedy,53,71413,22843,48570,44850,2,53;158;154;70;135;180;63;79;133;151;162;127;123;149;65;116;43;184;177;54;48;160;34;146;22;18;108;69;159;181;42;5;41;193;139;68;140;93;117;143;0;46;115;59;118;51;80;176;137;23;183;89;186;114;15;9;62;144;14;138;185;40;165;90;81;196;179;145;78;31;56;113;175;171;16;25;44;120;2;129;92;57;55;52;106;178;49;102;148;124;94;152;97;1;101;75;86;26;100;121,6383196083456221805,0.001003
steepest_intra:edges_start:greedy,54,71512,22948,48564,134550,8,54;48;34;160;42;181;195;146;22;18;108;69;159;193;41;139;68;140;93;117;143;183;89;186;23;137;176;80;79;63;94;124;152;97;1;101;2;82;129;92;57;55;52;49;102;148;9;62;144;14;3;178;106;185;40;165;90;81;196;179;145;78;31;56;113;175;171;16;25;44;120;75;86;26;100;121;53;180;154;135;70;127;123;162;133;151;51;0;46;115;118;59;65;116;43;184;84;190;10;177,5229867396285943683,0.002999
steepest_intra:edges_start:greedy,55,71246,23052,48194,104650,6,55;52;106;178;49;102;148;9;62;144;14;138;185;40;165;90;81;196;179;145;78;31;56;113;175;171;16;25;44;120;75;86;53;180;154;135;70;127;123;162;149;131;65;116;43;184;84;190;10;177;54;48;160;34;146;22;18;108;69;159;181;42;5;41;193;139;68;140;93;117;143;183;89;186;23;137;0;46;115;59;118;51;151;133;176;80;79;63;94;121;100;26;101;1;97;152;2;129;92;57,8818662218394953832,0.002000
steepest_intra:edges_start:greedy,56,71579,23307,48272,119600,7,56;31;78;145;92;179;196;81;90;165;40;185;106;178;3;14;144;62;9;148;102;49;52;55;57;129;2;152;97;1;101;26;100;121;94;63;79;80;176;133;151;51;118;59;115;46;0;137;23;186;89;183;143;117;93;140;68;139;193;41;5;42;181;159;69;108;18;22;146;34;160;48;54;177;10;190;84;184;43;116;65;131;149;162;123;127;70;135;154;180;53;86;75;120;44;25;16;171;175;113,7674674188049845875,0.003000
steepest_intra:edges_start:greedy,57,71382,23110,48272,104650,6,57;55;52;49;102;148;9;62;144;14;3;178;106;185;40;165;90;81;196;179;145;78;31;56;113;175;171;16;25;44;120;75;86;53;180;154;135;70;127;123;162;149;131;65;116;43;184;84;190;10;177;54;48;160;34;146;22;18;108;69;159;181;42;5;41;193;139;68;140;93;117;143;183;89;186;23;137;0;46;115;59;118;51;151;133;176;80;79;63;94;121;100;26;101;1;97;152;2;129;92,8253148620827910958,0.002000
steepest_intra:edges_start:greedy,58,72221,23934,48287,89700,5,58;95;27;90;81;196;157;31;56;113;175;171;16;25;44;120;75;86;101;1;97;26;100;53;180;154;135;70;127;123;162;149;65;116;43;184;177;54;48;160;34;146;22;18;108;69;159;181;42;5;41;193;139;68;140;93;117;143;183;89;23;137;0;46;115;59;118;51;151;133;176;80;79;63;94;152;2;129;57;92;78;145;179;40;165;185;55;52;106;178;14;49;102;148;9;62;144;21;7;164,6759499033540696280,0.001999
steepest_intra:edges_start:greedy,59,71369,23246,48123,104650,6,59;115;46;68;139;193;41;5;42;181;159;69;108;18;22;146;34;160;48;54;177;10;190;4;112;184;43;116;65;149;123;127;162;151;133;135;70;154;180;53;121;100;26;86;75;120;44;25;16;171;175;113;56;31;78;145;179;196;81;90;165;40;185;106;178;3;14;144;62;9;148;102;49;52;55;57;92;129;82;2;101;1;97;152;124;94;63;79;80;176;137;23;186;89;183;143;117;0;51;118,2580050476482163337,0.002000
steepest_intra:edges_start:greedy,60,71369,23246,48123,149500,9,68;46;115;59;118;51;0;117;143;183;89;186;23;137;176;80;79;63;94;124;152;97;1;101;2;82;129;92;57;55;52;49;102;148;9;62;144;14;3;178;106;185;40;165;90;81;196;179;145;78;31;56;113;175;171;16;25;44;120;75;86;26;100;121;53;180;154;70;135;133;151;162;127;123;149;65;116;43;184;112;4;190;10;177;54;48;160;34;146;22;18;108;69;159;181;42;5;41;193;139,5564629271854149998,0.004008
steepest_intra:edges_start:greedy,61,71325,23171,48154,104650,6,15;144;14;138;185;40;165;90;81;196;179;145;78;31;56;113;175;171;16;25;44;120;75;86;53;180;154;135;70;127;123;162;149;131;65;116;43;184;190;10;177;54;48;160;34;146;22;18;108;69;159;181;42;5;41;193;139;68;140;93;117;143;183;89;186;23;137;0;46;115;59;118;51;151;133;176;80;79;63;94;121;100;26;101;1;97;152;2;129;92;57;55;52;106;178;49;102;62;9;148,5012315798679020021,0.003003
steepest_intra:edges_start:greedy,62,71246,23052,48194,89700,5,62;144;14;138;185;40;165;90;81;196;179;145;78;31;56;113;175;171;16;25;44;120;75;86;53;180;154;135;70;127;123;162;149;131;65;116;43;184;84;190;10;177;54;48;160;34;146;22;18;108;69;159;181;42;5;41;193;139;68;140;93;117;143;183;89;186;23;137;0;46;115;59;118;51;151;133;176;80;79;63;94;121;100;26;101;1;97;152;2;129;92;57;55;52;106;178;49;102;148;9,4692396082661523869,0.001000
steepest_intra:edges_start:greedy,63,71413,22843,48570,44850,2,63;180;135;70;154;158;53;121;100;26;86;75;101;1;97;152;94;124;148;102;49;178;106;52;55;57;92;129;2;120;44;25;16;171;175;113;56;31;78;145;179;196;81;90;165;40;185;138;14;144;62;9;15;114;186;89;183;23;137;176;80;51;118;59;115;46;0;143;117;93;140;68;139;193;41;5;42;181;159;69;108;18;22;146;34;160;48;54;177;184;43;116;65;149;123;127;162;151;133;79,1176324903174801012,0.001000
steepest_intra:edges_start:greedy,64,72036,22517,49519,44850,2,64;114;186;89;183;23;137;176;80;51;118;59;115;46;0;143;117;93;140;68;139;193;41;5;42;181;159;69;108;18;22;146;34;160;48;54;177;184;43;116;65;149;123;162;151;133;79;63;180;135;70;154;158;53;121;100;26;86;75;101;1;97;152;94;124;148;9;62;102;49;178;106;52;55;57;92;129;2;120;44;25;16;171;175;113;56;31;78;145;179;196;81;90;165;40;185;138;14;144;15,1302751443742373582,0.001000
steepest_intra:edges_start:greedy,65,71369,23246,48123,104650,6,65;149;123;127;162;151;133;135;70;154;180;53;121;100;26;86;75;120;44;25;16;171;175;113;56;31;78;145;179;196;81;90;165;40;185;106;178;3;14;144;62;9;148;102;49;52;55;57;92;129;82;2;101;1;97;152;124;94;63;79;80;176;137;23;186;89;183;143;117;0;51;118;59;115;46;68;139;193;41;5;42;181;159;69;108;18;22;146;34;160;48;54;177;10;190;4;112;184;43;116,6091621961439898219,0.003001
steepest_intra:edges_start:greedy,66,72214,23724,48490,104650,6,23;51;118;59;115;46;0;89;183;143;117;93;140;68;139;193;41;5;42;181;159;69;108;18;22;146;34;160;48;54;177;10;190;84;184;43;116;65;149;123;127;162;151;133;135;70;154;180;53;121;100;26;86;75;120;44;25;16;171;175;113;56;31;78;145;179;196;81;90;165;40;185;106;178;3;14;144;62;9;148;102;49;52;55;57;92;129;82;2;101;1;97;152;124;94;63;79;80;176;137,4296450308617515704,0.002000
steepest_intra:edges_start:greedy,67,71952,22784,49168,119600,7,36;108;69;18;22;146;159;193;41;5;42;181;34;160;48;54;177;10;190;84;184;43;116;65;149;123;127;162;151;133;135;70;154;180;53;121;100;26;86;75;120;44;25;16;171;175;113;56;31;78;145;179;196;81;90;165;40;185;106;178;3;14;144;62;9;148;102;49;52;55;57;92;129;82;2;101;1;97;152;124;94;63;79;80;176;137;51;118;59;115;139;68;46;0;89;183;143;117;93;140,2520588224903577203,0.003001
steepest_intra:edges_start:greedy,68,71369,23246,48123,104650,6,68;46;115;59;118;51;0;117;143;183;89;186;23;137;176;80;79;63;94;124;152;97;1;101;2;82;129;92;57;55;52;49;102;148;9;62;144;14;3;178;106;185;40;165;90;81;196;179;145;78;31;56;113;175;171;16;25;44;120;75;86;26;100;121;53;180;154;70;135;133;151;162;127;123;149;65;116;43;184;112;4;190;10;177;54;48;160;34;146;22;18;108;69;159;181;42;5;41;193;139,3261491925463714962,0.002003
steepest_intra:edges_start:greedy,69,71643,22792,48851,104650,6,69;108;18;199;22;146;159;193;41;5;42;181;34;160;48;54;177;10;190;84;184;43;116;65;149;123;127;162;151;133;135;70;154;180;53;121;100;26;86;75;120;44;25;16;171;175;113;56;31;78;145;179;196;81;90;165;40;185;106;178;3;14;144;62;9;148;102;49;52;55;57;92;129;82;2;101;1;97;152;124;94;63;79;80;176;137;23;186;89;183;143;117;0;51;118;59;115;46;68;139,986891755495577337,0.003013
steepest_intra:edges_start:greedy,70,71413,22843,48570,44850,2,70;154;158;53;121;100;26;86;75;101;1;97;152;94;124;148;102;49;178;106;52;55;57;92;129;2;120;44;25;16;171;175;113;56;31;78;145;179;196;81;90;165;40;185;138;14;144;62;9;15;114;186;89;183;23;137;176;80;51;118;59;115;46;0;143;117;93;140;68;139;193;41;5;42;181;159;69;108;18;22;146;34;160;48;54;177;184;43;116;65;149;123;127;162;151;133;79;63;180;135,6413018353807492771,0.001001
steepest_intra:edges_start:greedy,71,71912,23384,48528,59800,3,58;164;7;95;39;165;138;14;144;62;9;148;102;49;178;106;52;55;57;92;129;2;152;94;63;79;80;176;133;151;51;118;59;115;46;0;137;23;89;183;143;117;93;140;68;139;193;41;5;42;181;159;69;108;18;22;146;34;160;48;54;177;184;43;116;65;149;162;123;127;70;135;154;180;53;100;26;97;1;101;86;75;120;44;25;16;171;175;113;56;31;78;145;179;196;81;185;40;90;27,5002417449121209562,0.001000
steepest_intra:edges_start:greedy,72,71787,22917,48870,119600,7,109;51;0;117;143;183;89;186;23;137;176;80;79;63;94;124;152;97;1;101;2;82;129;92;57;55;52;49;102;148;9;62;144;14;3;178;106;185;40;165;90;81;196;179;145;78;31;56;113;175;171;16;25;44;120;75;86;26;100;121;53;180;154;70;135;133;151;162;127;123;149;65;116;43;184;84;190;10;177;54;48;160;34;146;22;18;108;69;159;181;42;5;41;193;139;68;46;115;59;118,2680630800071931028,0.002890
steepest_intra:edges_start:greedy,73,71763,23518,48245,119600,7,114;15;148;9;62;102;49;178;106;52;55;57;92;129;2;152;97;1;101;26;100;121;94;63;79;80;176;133;151;51;118;59;115;46;0;137;23;186;89;183;143;117;93;140;68;139;193;41;5;42;181;159;69;108;18;22;146;34;160;48;54;177;10;184;43;116;65;131;149;162;123;127;70;135;154;180;53;86;75;120;44;25;16;171;175;113;56;31;78;145;179;196;81;90;165;40;185;138;14;144,825848626694924543,0.002978
steepest_intra:edges_start:greedy,74,71540,22899,48641,104650,6,121;53;154;70;135;180;63;79;133;151;162;127;123;149;65;116;43;184;177;54;48;160;34;146;22;18;108;69;159;181;42;5;41;193;139;68;140;93;117;143;0;46;115;59;118;51;80;176;137;23;183;89;186;114;15;9;62;144;14;138;185;40;165;90;81;196;179;145;78;31;56;113;175;171;16;25;44;120;2;129;92;57;55;52;106;178;49;102;148;124;94;189;152;97;1;101;75;86;26;100,8033993529805913399,0.001972
steepest_intra:edges_start:greedy,75,71569,23095,48474,149500,9,75;120;44;25;16;171;175;113;56;31;78;145;179;196;81;90;165;40;185;106;178;3;14;144;62;9;148;102;49;52;55;57;92;129;82;2;152;97;1;101;26;100;121;94;63;79;80;176;133;151;51;118;59;115;46;0;137;23;186;89;183;143;117;93;140;68;139;193;41;5;42;181;159;69;108;18;22;146;34;160;48;54;177;10;190;184;43;116;65;131;149;162;123;127;70;135;154;180;53;86,7177193548603525049,0.002979
steepest_intra:edges_start:greedy,76,71769,22943,48826,104650,6,153;137;176;80;51;118;59;115;46;68;139;193;41;5;42;181;159;69;108;18;22;146;34;160;48;54;177;10;184;43;116;65;149;123;127;162;151;133;79;63;180;135;70;154;158;53;121;100;26;86;75;101;1;97;152;94;124;148;102;49;178;106;52;55;57;92;129;2;120;44;25;16;171;175;113;56;31;78;145;179;196;81;90;165;40;185;138;14;144;62;9;15;114;186;23;89;183;143;117;0,1922682918278638445,0.002979
steepest_intra:edges_start:greedy,77,71601,23183,48418,119600,7,149;59;118;115;46;0;51;151;133;162;123;127;70;135;154;180;53;121;100;26;86;75;120;44;25;16;171;175;113;56;31;78;145;179;196;81;90;165;40;185;106;178;3;14;144;62;9;148;102;49;52;55;57;92;129;82;2;101;1;97;152;124;94;63;79;80;176;137;23;186;89;183;143;117;93;140;68;139;193;41;5;42;181;159;69;108;18;22;146;34;160;48;54;177;10;190;184;43;116;65,2474984307642636660,0.002691
steepest_intra:edges_start:greedy,78,71382,23110,48272,119600,7,78;31;56;113;175;171;16;25;44;120;75;86;53;180;154;135;70;127;123;162;149;131;65;116;43;184;84;190;10;177;54;48;160;34;146;22;18;108;69;159;181;42;5;41;193;139;68;140;93;117;143;183;89;186;23;137;0;46;115;59;118;51;151;133;176;80;79;63;94;121;100;26;101;1;97;152;2;129;92;57;55;52;49;102;148;9;62;144;14;3;178;106;185;40;165;90;81;196;179;145,2022265394395040517,0.002030
steepest_intra:edges_start:greedy,79,71779,22893,48886,104650,6,79;80;176;133;151;51;118;59;115;46;0;137;23;186;89;183;143;117;93;140;68;139;193;41;5;42;181;159;69;108;18;22;146;34;160;48;54;177;184;43;116;65;131;149;162;123;127;70;135;154;180;158;53;121;100;26;86;75;120;44;25;16;171;175;113;56;31;78;145;179;196;81;90;165;40;185;106;178;3;14;144;62;9;148;102;49;52;55;57;92;129;82;2;101;1;97;152;124;94;63,3576733643539642672,0.002002
steepest_intra:edges_start:greedy,80,71461,22899,48562,89700,5,80;79;63;94;124;152;97;1;101;2;82;129;92;57;55;52;49;102;148;9;62;144;14;3;178;106;185;40;165;90;81;196;179;145;78;31;56;113;175;171;16;25;44;120;75;86;26;100;121;53;180;154;135;70;127;123;162;133;151;149;131;65;116;43;184;84;190;10;177;54;48;160;34;146;22;18;108;69;159;181;42;5;41;193;139;68;46;115;59;118;51;0;117;143;183;89;186;23;137;176,8716107489404532146,0.002003
steepest_intra:edges_start:greedy,81,71470,23276,48194,74750,4,81;196;40;185;179;145;78;31;56;113;175;171;16;25;44;120;75;86;53;180;154;135;70;127;123;162;149;131;65;116;43;184;84;190;10;177;54;48;160;34;146;22;18;108;69;159;181;42;5;41;193;139;68;140;93;117;143;183;89;186;23;137;0;46;115;59;118;51;151;133;176;80;79;63;94;121;100;26;101;1;97;152;2;129;92;57;55;52;106;178;49;102;148;9;62;144;14;138;165;90,6113988316287198906,0.002002
steepest_intra:edges_start:greedy,82,71713,23239,48474,119600,7,82;2;75;86;53;180;154;135;70;127;123;162;149;131;65;116;43;184;190;10;177;54;48;160;34;146;22;18;108;69;159;181;42;5;41;193;139;68;140;93;117;143;183;89;186;23;137;0;46;115;59;118;51;151;133;176;80;79;63;94;121;100;26;101;1;97;152;129;92;57;55;52;49;102;148;9;62;144;14;3;178;106;185;40;165;90;81;196;179;145;78;31;56;113;175;171;16;25;44;120,6852981247292431871,0.003000
steepest_intra:edges_start:greedy,83,70942,22646,48296,149500,9,114;89;183;143;117;0;46;68;139;115;193;41;5;42;181;159;69;108;18;22;146;34;160;48;54;177;10;190;4;112;184;43;116;65;59;118;51;151;133;162;123;127;70;135;154;180;53;121;100;26;86;75;120;44;25;16;171;175;113;56;31;78;145;179;196;81;90;165;40;185;106;178;3;14;144;62;9;148;102;49;52;55;57;92;129;82;2;101;1;97;152;124;94;63;79;80;176;137;23;186,3889570036156475826,0.003000
steepest_intra:edges_start:greedy,84,70846,22596,48250,149500,9,84;4;112;127;123;162;151;133;135;70;154;180;53;121;100;26;86;75;120;44;25;16;171;175;113;56;31;78;145;179;196;81;90;165;40;185;106;178;3;14;144;62;9;148;102;49;52;55;57;92;129;82;2;101;1;97;152;124;94;63;79;80;176;137;23;186;89;183;143;117;0;46;68;139;115;118;51;59;65;116;43;42;5;41;193;159;69;108;18;22;146;181;34;160;48;54;177;10;184;35,6383919692768137186,0.004001
steepest_intra:edges_start:greedy,85,71927,23480,48447,134550,8,157;145;179;196;81;90;165;40;185;106;178;3;14;144;62;9;148;102;49;52;55;57;92;129;2;152;97;1;101;26;100;121;94;63;79;80;176;133;151;51;118;59;115;46;0;137;23;186;89;183;143;117;93;140;68;139;193;41;5;42;181;159;69;108;18;22;146;34;160;48;54;177;10;190;184;43;116;65;131;149;162;123;127;70;135;154;180;53;86;75;120;44;25;78;31;16;171;175;113;56,6811356798344696452,0.004000
steepest_intra:edges_start:greedy,86,71413,22843,48570,44850,2,86;75;101;1;97;152;94;124;148;102;49;178;106;52;55;57;92;129;2;120;44;25;16;171;175;113;56;31;78;145;179;196;81;90;165;40;185;138;14;144;62;9;15;114;186;89;183;23;137;176;80;51;118;59;115;46;0;143;117;93;140;68;139;193;41;5;42;181;159;69;108;18;22;146;34;160;48;54;177;184;43;116;65;149;123;127;162;151;133;79;63;180;135;70;154;158;53;121;100;26,8065946026348514417,0.001000
steepest_intra:edges_start:greedy,87,72273,23061,49212,179400,11,74;2;82;129;92;57;55;52;49;102;148;9;62;144;14;3;178;106;185;40;165;90;81;196;179;145;78;31;56;113;175;171;16;25;44;120;75;86;53;180;154;135;70;127;123;162;149;131;65;116;43;184;10;177;54;48;160;34;146;22;18;108;69;159;181;42;5;41;193;139;68;140;93;117;143;183;89;186;23;137;0;46;115;59;118;51;151;133;176;80;79;63;94;121;100;26;101;1;97;152,3155584900475991503,0.003998
steepest_intra:edges_start:greedy,88,71858,23384,48474,164450,10,82;44;25;16;171;175;113;56;31;78;145;92;179;196;81;90;165;40;185;106;178;3;14;144;62;9;148;102;49;52;55;57;129;2;152;97;1;101;26;100;121;94;63;79;80;176;133;151;51;118;59;115;46;0;137;23;186;89;183;143;117;93;140;68;139;193;41;5;42;181;159;69;108;18;22;146;34;160;48;54;177;10;190;184;43;116;65;131;149;162;123;127;70;135;154;180;53;86;75;120,3220185318719865743,0.004000
steepest_intra:edges_start:greedy,89,70599,22099,48500,134550,8,89;186;23;137;176;80;79;63;94;124;152;97;1;101;2;82;129;92;57;55;52;49;102;148;9;62;144;14;3;178;106;185;40;165;90;81;196;179;145;78;31;56;113;175;171;16;25;44;120;75;86;26;100;121;53;180;154;135;70;127;123;162;133;151;51;118;59;65;116;43;184;84;190;10;177;54;48;160;34;146;22;18;108;69;159;181;42;5;41;193;139;115;46;68;140;93;117;0;143;183,396791854138906003,0.003011
steepest_intra:edges_start:greedy,90,71301,23107,48194,89700,5,90;40;185;165;138;14;144;62;9;148;102;49;178;106;52;55;57;92;129;2;152;97;1;101;26;100;121;94;63;79;80;176;133;151;51;118;59;115;46;0;137;23;186;89;183;143;117;93;140;68;139;193;41;5;42;181;159;69;108;18;22;146;34;160;48;54;177;10;190;84;184;43;116;65;131;149;162;123;127;70;135;154;180;53;86;75;120;44;25;16;171;175;113;56;31;78;145;179;196;81,8168444235731270047,0.002000
steepest_intra:edges_start:greedy,91,71706,23259,48447,119600,7,157;179;145;78;31;56;113;175;171;16;25;44;120;75;86;53;180;154;135;70;127;123;162;149;131;65;116;43;184;190;10;177;54;48;160;34;146;22;18;108;69;159;181;42;5;41;193;139;68;140;93;117;143;183;89;186;23;137;0;46;115;59;118;51;151;133;176;80;79;63;94;121;100;26;101;1;97;152;2;129;92;57;55;52;49;102;148;9;62;144;14;3;178;106;185;40;165;90;81;196,8789004328338782661,0.003000
steepest_intra:edges_start:greedy,92,71382,23110,48272,119600,7,92;129;2;152;97;1;101;26;100;121;94;63;79;80;176;133;151;51;118;59;115;46;0;137;23;186;89;183;143;117;93;140;68;139;193;41;5;42;181;159;69;108;18;22;146;34;160;48;54;177;10;190;84;184;43;116;65;131;149;162;123;127;70;135;154;180;53;86;75;120;44;25;16;171;175;113;56;31;78;145;179;196;81;90;165;40;185;106;178;3;14;144;62;9;148;102;49;52;55;57,2994046611957806457,0.002000
steepest_intra:edges_start:greedy,93,71359,23109,48250,119600,7,93;140;108;69;18;22;146;159;193;41;5;42;181;34;160;48;54;177;10;190;4;112;184;43;116;65;149;123;127;162;151;133;135;70;154;180;53;121;100;26;86;75;120;44;25;16;171;175;113;56;31;78;145;179;196;81;90;165;40;185;106;178;3;14;144;62;9;148;102;49;52;55;57;92;129;82;2;101;1;97;152;124;94;63;79;80;176;137;51;118;59;115;139;68;46;0;89;183;143;117,2641754865558320753,0.003001
steepest_intra:edges_start:greedy,94,71413,22843,48570,44850,2,94;152;97;1;101;75;86;26;100;121;53;158;154;70;135;180;63;79;133;151;162;127;123;149;65;116;43;184;177;54;48;160;34;146;22;18;108;69;159;181;42;5;41;193;139;68;140;93;117;143;0;46;115;59;118;51;80;176;137;23;183;89;186;114;15;9;62;144;14;138;185;40;165;90;81;196;179;145;78;31;56;113;175;171;16;25;44;120;2;129;92;57;55;52;106;178;49;102;148;124,3751822600324097987,0.001000
steepest_intra:edges_start:greedy,95,71912,23384,48528,59800,3,95;7;164;58;27;90;40;185;81;196;179;145;78;31;56;113;175;171;16;25;44;120;75;86;101;1;97;26;100;53;180;154;135;70;127;123;162;149;65;116;43;184;177;54;48;160;34;146;22;18;108;69;159;181;42;5;41;193;139;68;140;93;117;143;183;89;23;137;0;46;115;59;118;51;151;133;176;80;79;63;94;152;2;129;92;57;55;52;106;178;49;102;148;9;62;144;14;138;165;39,324899630184849203,0.002011
steepest_intra:edges_start:greedy,96,71179,23056,48123,119600,7,5;43;116;65;149;123;127;162;151;133;135;70;154;180;53;121;100;26;86;75;120;44;25;16;171;175;113;56;31;78;145;179;196;81;90;165;40;185;106;178;3;14;144;62;9;148;102;49;52;55;57;92;129;82;2;101;1;97;152;124;94;63;79;80;176;137;23;186;89;183;143;117;0;51;118;59;115;46;68;139;41;193;159;69;108;18;22;146;181;34;160;48;54;177;10;190;4;112;184;42,3295880495471809130,0.003015
steepest_intra:edges_start:greedy,97,71446,23257,48189,74750,4,97;152;1;101;75;86;53;154;70;135;180;63;79;133;151;162;127;123;149;65;116;43;184;10;177;54;48;160;34;146;22;18;108;69;159;181;42;5;41;193;139;68;140;93;117;143;0;46;115;59;118;51;80;176;137;23;183;89;186;114;15;9;62;144;14;138;185;40;165;90;81;196;179;145;78;31;56;113;175;171;16;25;44;120;2;129;92;57;55;52;106;178;49;102;148;124;94;121;100;26,6901810665356624995,0.001000
steepest_intra:edges_start:greedy,98,72072,23467,48605,119600,7,119;40;185;106;178;3;14;144;62;9;148;102;49;52;55;57;129;92;179;145;78;82;2;152;94;63;79;80;176;133;151;51;118;59;115;46;0;137;23;89;183;143;117;93;140;68;139;193;41;5;42;181;159;69;108;18;22;146;34;160;48;54;177;184;43;116;65;149;162;123;127;70;135;154;180;53;100;26;97;1;101;86;75;120;44;25;16;171;175;113;56;31;157;196;81;90;27;164;39;165,5246729530114846942,0.002000
steepest_intra:edges_start:greedy,99,71530,22960,48570,74750,4,121;100;26;97;86;75;101;1;152;94;124;148;102;49;178;106;52;55;57;92;129;2;120;44;25;16;171;175;113;56;31;78;145;179;196;81;90;165;40;185;138;14;144;62;9;15;114;186;89;183;23;137;176;80;51;118;59;115;46;0;143;117;93;140;68;139;193;41;5;42;181;159;69;108;18;22;146;34;160;48;54;177;184;43;116;65;149;123;127;162;151;133;79;63;180;135;70;154;158;53,5837257888496839307,0.000840
steepest_intra:edges_start:greedy,100,71413,22843,48570,44850,2,100;26;86;75;101;1;97;152;94;124;148;102;49;178;106;52;55;57;92;129;2;120;44;25;16;171;175;113;56;31;78;145;179;196;81;90;165;40;185;138;14;144;62;9;15;114;186;89;183;23;137;176;80;51;118;59;115;46;0;143;117;93;140;68;139;193;41;5;42;181;159;69;108;18;22;146;34;160;48;54;177;184;43;116;65;149;123;127;162;151;133;79;63;180;135;70;154;158;53;121,3841102775083390606,0.001000
steepest_intra:edges_start:greedy,101,71446,23257,48189,74750,4,101;1;152;97;26;100;121;94;124;148;102;49;178;106;52;55;57;92;129;2;120;44;25;16;171;175;113;56;31;78;145;179;196;81;90;165;40;185;138;14;144;62;9;15;114;186;89;183;23;137;176;80;51;118;59;115;46;0;143;117;93;140;68;139;193;41;5;42;181;159;69;108;18;22;146;34;160;48;54;177;10;184;43;116;65;149;123;127;162;151;133;79;63;180;135;70;154;53;86;75,9032075652934429557,0.002002
steepest_intra:edges_start:greedy,102,71246,23052,48194,89700,5,102;148;9;62;144;14;138;185;40;165;90;81;196;179;145;78;31;56;113;175;171;16;25;44;120;75;86;53;180;154;135;70;127;123;162;149;131;65;116;43;184;84;190;10;177;54;48;160;34;146;22;18;108;69;159;181;42;5;41;193;139;68;140;93;117;143;183;89;186;23;137;0;46;115;59;118;51;151;133;176;80;79;63;94;121;100;26;101;1;97;152;2;129;92;57;55;52;106;178;49,6993713712722982119,0.002005
steepest_intra:edges_start:greedy,103,70906,22933,47973,104650,6,181;34;160;48;54;177;10;190;4;112;84;184;42;43;116;65;149;123;127;162;151;133;135;70;154;180;53;121;100;26;86;75;120;44;25;16;171;175;113;56;31;78;145;179;196;81;90;165;40;185;106;178;3;14;144;62;9;148;102;49;52;55;57;92;129;82;2;101;1;97;152;124;94;63;79;80;176;137;23;186;89;183;143;117;0;51;118;59;115;46;68;139;41;193;159;69;108;18;22;146,512261239974039315,0.003007
steepest_intra:edges_start:greedy,104,71524,22866,48658,164450,10,30;54;48;34;160;42;181;195;146;22;18;108;69;159;193;41;139;68;140;93;117;143;183;89;186;23;137;176;80;79;63;94;124;152;97;1;101;2;82;129;92;57;55;52;49;102;148;9;62;144;14;3;178;106;185;40;165;90;81;196;179;145;78;31;56;113;175;171;16;25;44;120;75;86;26;100;121;53;180;154;135;70;127;123;162;133;151;51;0;46;115;118;59;65;116;43;184;190;10;177,4810632850354035581,0.003998
steepest_intra:edges_start:greedy,105,71514,22952,48562,149500,9,131;149;123;127;162;151;133;135;70;154;180;53;121;100;26;86;75;120;44;25;16;171;175;113;56;31;78;145;179;196;81;90;165;40;185;106;178;3;14;144;62;9;148;102;49;52;55;57;92;129;82;2;101;1;97;152;124;94;63;79;80;176;137;23;186;89;183;143;117;0;51;118;59;115;46;68;139;193;41;5;42;181;159;69;108;18;22;146;34;160;48;54;177;10;190;84;184;43;116;65,7177460996296464648,0.004000
steepest_intra:edges_start:greedy,106,71246,23052,48194,89700,5,106;178;49;102;148;9;62;144;14;138;185;40;165;90;81;196;179;145;78;31;56;113;175;171;16;25;44;120;75;86;53;180;154;135;70;127;123;162;149;131;65;116;43;184;84;190;10;177;54;48;160;34;146;22;18;108;69;159;181;42;5;41;193;139;68;140;93;117;143;183;89;186;23;137;0;46;115;59;118;51;151;133;176;80;79;63;94;121;100;26;101;1;97;152;2;129;92;57;55;52,1038283289079209589,0.002000
steepest_intra:edges_start:greedy,107,71912,23384,48528,89700,5,58;27;90;40;185;81;196;179;145;78;31;56;113;175;171;16;25;44;120;75;86;101;1;97;26;100;53;180;154;135;70;127;123;162;149;65;116;43;184;177;54;48;160;34;146;22;18;108;69;159;181;42;5;41;193;139;68;140;93;117;143;183;89;23;137;0;46;115;59;118;51;151;133;176;80;79;63;94;152;2;129;92;57;55;52;106;178;49;102;148;9;62;144;14;138;165;39;95;7;164,6376739318003592119,0.002001
steepest_intra:edges_start:greedy,108,71643,22792,48851,104650,6,108;69;139;68;46;115;59;118;51;0;117;143;183;89;186;23;137;176;80;79;63;94;124;152;97;1;101;2;82;129;92;57;55;52;49;102;148;9;62;144;14;3;178;106;185;40;165;90;81;196;179;145;78;31;56;113;175;171;16;25;44;120;75;86;26;100;121;53;180;154;70;135;133;151;162;127;123;149;65;116;43;184;84;190;10;177;54;48;160;34;181;42;5;41;193;159;146;22;199;18,4425654192843553895,0.002000
steepest_intra:edges_start:greedy,109,70815,22215,48600,179400,11,109;118;59;65;116;43;184;112;4;190;10;177;54;48;160;34;146;22;18;108;69;159;181;42;5;41;193;139;115;46;68;117;0;143;183;89;186;23;137;176;80;79;63;94;124;152;97;1;101;2;82;129;92;57;55;52;49;102;148;9;62;144;14;3;178;106;185;40;165;90;81;196;179;145;78;31;56;113;175;171;16;25;44;120;75;86;26;100;121;53;180;154;135;70;127;123;162;133;151;51,6114287163809237353,0.004000
steepest_intra:edges_start:greedy,110,71848,23049,48799,119600,7,198;68;46;115;59;118;51;0;117;143;183;89;186;23;137;176;80;79;63;94;124;152;97;1;101;2;82;129;92;57;55;52;49;102;148;9;62;144;14;3;178;106;185;40;165;90;81;196;179;145;78;31;56;113;175;171;16;25;44;120;75;86;26;100;121;53;180;154;70;135;133;151;162;127;123;149;65;116;43;184;84;190;10;177;54;48;160;34;146;22;18;108;69;159;181;42;5;41;193;139,2682187837907252213,0.002000
steepest_intra:edges_start:greedy,111,72183,23587,48596,59800,3,167;148;9;62;102;144;14;49;178;106;165;39;95;164;27;90;81;196;40;185;52;55;57;129;92;179;145;78;31;56;113;175;171;16;25;44;120;2;152;97;1;101;75;86;26;100;121;53;158;154;70;135;180;63;79;133;151;162;127;123;149;65;116;43;184;177;54;48;160;34;146;22;18;108;69;159;181;42;5;41;193;139;68;140;93;117;143;183;89;0;46;115;59;118;51;137;176;80;94;124,4501942830714554337,0.002000
steepest_intra:edges_start:greedy,112,70846,22596,48250,149500,9,112;4;84;35;184;10;177;54;48;160;34;181;146;22;18;108;69;159;193;41;5;42;43;116;65;59;51;118;115;139;68;46;0;117;143;183;89;186;23;137;176;80;79;63;94;124;152;97;1;101;2;82;129;92;57;55;52;49;102;148;9;62;144;14;3;178;106;185;40;165;90;81;196;179;145;78;31;56;113;175;171;16;25;44;120;75;86;26;100;121;53;180;154;70;135;133;151;162;123;127,2315681853133913138,0.004000
steepest_intra:edges_start:greedy,113,71579,23307,48272,119600,7,113;56;31;78;145;92;179;196;81;90;165;40;185;106;178;3;14;144;62;9;148;102;49;52;55;57;129;2;152;97;1;101;26;100;121;94;63;79;80;176;133;151;51;118;59;115;46;0;137;23;186;89;183;143;117;93;140;68;139;193;41;5;42;181;159;69;108;18;22;146;34;160;48;54;177;10;190;84;184;43;116;65;131;149;162;123;127;70;135;154;180;53;86;75;120;44;25;16;171;175,4322097485606626462,0.003000
steepest_intra:edges_start:greedy,114,71345,22775,48570,44850,2,114;186;89;183;23;137;176;80;51;118;59;115;46;0;143;117;93;140;68;139;193;41;5;42;181;159;69;108;18;22;146;34;160;48;54;177;184;43;116;65;149;123;127;162;151;133;79;63;180;135;70;154;158;53;121;100;26;86;75;101;1;97;152;94;124;148;9;62;102;49;178;106;52;55;57;92;129;2;120;44;25;16;171;175;113;56;31;78;145;179;196;81;90;165;40;185;138;14;144;15,8781255840964259065,0.000999
steepest_intra:edges_start:greedy,115,71369,23246,48123,104650,6,115;59;118;51;0;117;143;183;89;186;23;137;176;80;79;63;94;124;152;97;1;101;2;82;129;92;57;55;52;49;102;148;9;62;144;14;3;178;106;185;40;165;90;81;196;179;145;78;31;56;113;175;171;16;25;44;120;75;86;26;100;121;53;180;154;70;135;133;151;162;127;123;149;65;116;43;184;112;4;190;10;177;54;48;160;34;146;22;18;108;69;159;181;42;5;41;193;139;68;46,5001812070387976646,0.001997
steepest_intra:edges_start:greedy,116,71369,23246,48123,104650,6,116;43;184;112;4;190;10;177;54;48;160;34;146;22;18;108;69;159;181;42;5;41;193;139;68;46;115;59;118;51;0;117;143;183;89;186;23;137;176;80;79;63;94;124;152;97;1;101;2;82;129;92;57;55;52;49;102;148;9;62;144;14;3;178;106;185;40;165;90;81;196;179;145;78;31;56;113;175;171;16;25;44;120;75;86;26;100;121;53;180;154;70;135;133;151;162;127;123;149;65,6624769421732339307,0.003000
steepest_intra:edges_start:greedy,117,70571,22366,48205,119600,7,117;0;46;68;139;115;193;41;5;42;181;159;69;108;18;22;146;34;160;48;54;177;10;190;4;112;84;184;43;116;65;59;118;51;151;133;162;123;127;70;135;154;180;53;121;100;26;86;75;120;44;25;16;171;175;113;56;31;78;145;179;196;81;90;165;40;185;106;178;3;14;144;62;9;148;102;49;52;55;57;92;129;82;2;101;1;97;152;124;94;63;79;80;176;137;23;186;89;183;143,8968783025275342973,0.002009
steepest_intra:edges_start:greedy,118,71369,23246,48123,119600,7,118;51;0;117;143;183;89;186;23;137;176;80;79;63;94;124;152;97;1;101;2;82;129;92;57;55;52;49;102;148;9;62;144;14;3;178;106;185;40;165;90;81;196;179;145;78;31;56;113;175;171;16;25;44;120;75;86;26;100;121;53;180;154;70;135;133;151;162;127;123;149;65;116;43;184;112;4;190;10;177;54;48;160;34;146;22;18;108;69;159;181;42;5;41;193;139;68;46;115;59,4522320507806585431,0.002011
steepest_intra:edges_start:greedy,119,71195,22868,48327,89700,5,119;40;185;138;14;144;62;9;148;102;49;178;106;52;55;57;92;129;2;152;97;1;101;26;100;121;94;63;79;80;176;133;151;51;118;59;115;46;0;137;23;186;89;183;143;117;93;140;68;139;193;41;5;42;181;159;69;108;18;22;146;34;160;48;54;177;10;190;184;43;116;65;131;149;162;123;127;70;135;154;180;53;86;75;120;44;25;16;171;175;113;56;31;78;145;179;196;81;90;165,6835345355915689164,0.002001
steepest_intra:edges_start:greedy,120,71382,23110,48272,119600,7,120;75;86;53;180;154;135;70;127;123;162;149;131;65;116;43;184;84;190;10;177;54;48;160;34;146;22;18;108;69;159;181;42;5;41;193;139;68;140;93;117;143;183;89;186;23;137;0;46;115;59;118;51;151;133;176;80;79;63;94;121;100;26;101;1;97;152;2;129;92;57;55;52;49;102;148;9;62;144;14;3;178;106;185;40;165;90;81;196;179;145;78;31;56;113;175;171;16;25;44,6862866409171695238,0.002996
steepest_intra:edges_start:greedy,121,71530,22960,48570,44850,2,121;100;26;97;86;75;101;1;152;94;124;148;102;49;178;106;52;55;57;92;129;2;120;44;25;16;171;175;113;56;31;78;145;179;196;81;90;165;40;185;138;14;144;62;9;15;114;186;89;183;23;137;176;80;51;118;59;115;46;0;143;117;93;140;68;139;193;41;5;42;181;159;69;108;18;22;146;34;160;48;54;177;184;43;116;65;149;123;127;162;151;133;79;63;180;135;70;154;158;53,2867733431919574138,0.001002
steepest_intra:edges_start:greedy,122,72025,22815,49210,104650,6,122;176;80;79;133;151;51;118;59;115;46;0;137;23;89;183;143;117;93;140;68;139;193;41;5;42;181;159;69;108;18;22;146;34;160;48;54;177;184;43;116;65;131;149;162;123;127;70;135;154;180;158;53;121;100;26;86;75;120;44;25;16;171;175;113;56;31;78;145;179;196;81;90;165;40;185;106;178;3;14;144;62;9;148;102;49;52;55;57;92;129;82;2;101;1;97;152;124;94;63,2313602530886430638,0.003000
steepest_intra:edges_start:greedy,123,71461,22899,48562,89700,5,123;162;133;151;149;131;65;116;43;184;84;190;10;177;54;48;160;34;146;22;18;108;69;159;181;42;5;41;193;139;68;46;115;59;118;51;0;117;143;183;89;186;23;137;176;80;79;63;94;124;152;97;1;101;2;82;129;92;57;55;52;49;102;148;9;62;144;14;3;178;106;185;40;165;90;81;196;179;145;78;31;56;113;175;171;16;25;44;120;75;86;26;100;121;53;180;154;135;70;127,4916745410477875592,0.001968
steepest_intra:edges_start:greedy,124,71413,22843,48570,59800,3,124;148;102;49;178;106;52;55;57;92;129;2;120;44;25;16;171;175;113;56;31;78;145;179;196;81;90;165;40;185;138;14;144;62;9;15;114;186;89;183;23;137;176;80;51;118;59;115;46;0;143;117;93;140;68;139;193;41;5;42;181;159;69;108;18;22;146;34;160;48;54;177;184;43;116;65;149;123;127;162;151;133;79;63;180;135;70;154;158;53;121;100;26;86;75;101;1;97;152;94,6115878608992993632,0.002009
steepest_intra:edges_start:greedy,125,72614,23133,49481,119600,7,74;2;82;129;92;57;179;145;78;31;56;113;175;171;16;25;44;120;75;86;53;154;70;135;180;63;79;133;151;162;123;149;65;116;43;184;177;54;48;160;34;146;22;18;108;69;159;181;42;5;41;193;139;68;140;93;117;143;0;46;115;59;118;51;80;176;137;23;183;89;186;114;15;9;62;144;14;138;165;90;81;196;40;185;55;52;106;178;49;102;148;124;94;121;100;26;101;1;97;152,3649312057491809755,0.002016
steepest_intra:edges_start:greedy,126,71061,22454,48607,179400,11,149;123;162;151;133;135;70;154;180;53;121;100;26;86;75;120;44;25;16;171;175;113;56;31;78;145;179;196;81;90;165;40;185;106;178;3;14;144;62;9;148;102;49;52;55;57;92;129;82;2;101;1;97;152;124;94;63;79;80;176;137;23;186;89;183;143;117;0;46;68;139;115;118;51;59;65;116;43;42;5;41;193;159;69;108;18;22;146;181;34;160;48;54;177;184;35;84;4;112;131,3724289936071166150,0.004000
steepest_intra:edges_start:greedy,127,71637,23132,48505,104650,6,127;70;135;154;180;53;121;100;26;86;75;120;44;25;16;171;175;113;56;31;78;145;179;196;81;90;165;40;185;106;178;3;14;144;62;9;148;102;49;52;55;57;92;129;82;2;101;1;97;152;124;94;63;79;80;176;133;151;51;118;59;115;46;0;137;23;186;89;183;143;117;93;140;68;139;193;41;5;42;181;159;69;108;18;22;146;34;160;48;54;177;10;184;43;116;65;131;149;162;123,7508578679684757943,0.002014
steepest_intra:edges_start:greedy,128,71295,22994,48301,149500,9,3;49;14;144;102;62;9;148;167;52;55;57;92;129;2;152;97;1;101;26;100;121;94;63;79;80;176;133;151;51;118;59;115;46;0;137;23;186;89;183;143;117;93;140;68;139;193;41;5;42;181;159;69;108;18;22;146;34;160;48;54;177;10;190;184;43;116;65;131;149;162;123;127;70;135;154;180;53;86;75;120;44;25;16;171;175;113;56;31;78;145;179;196;81;90;165;40;185;106;178,5761992787663618026,0.004024
steepest_intra:edges_start:greedy,129,71382,23110,48272,119600,7,129;92;57;55;52;49;102;148;9;62;144;14;3;178;106;185;40;165;90;81;196;179;145;78;31;56;113;175;171;16;25;44;120;75;86;53;180;154;135;70;127;123;162;149;131;65;116;43;184;84;190;10;177;54;48;160;34;146;22;18;108;69;159;181;42;5;41;193;139;68;140;93;117;143;183;89;186;23;137;0;46;115;59;118;51;151;133;176;80;79;63;94;121;100;26;101;1;97;152;2,115900517754501452,0.002002
steepest_intra:edges_start:greedy,130,71413,22843,48570,59800,3,124;148;102;49;178;106;52;55;57;92;129;2;120;44;25;16;171;175;113;56;31;78;145;179;196;81;90;165;40;185;138;14;144;62;9;15;114;186;89;183;23;137;176;80;51;118;59;115;46;0;143;117;93;140;68;139;193;41;5;42;181;159;69;108;18;22;146;34;160;48;54;177;184;43;116;65;149;123;127;162;151;133;79;63;180;135;70;154;158;53;121;100;26;86;75;101;1;97;152;94,4903774930891626725,0.001698
steepest_intra:edges_start:greedy,131,71514,22952,48562,89700,5,131;149;123;127;162;151;133;135;70;154;180;53;121;100;26;86;75;120;44;25;16;171;175;113;56;31;78;145;179;196;81;90;165;40;185;106;178;3;14;144;62;9;148;102;49;52;55;57;92;129;82;2;101;1;97;152;124;94;63;79;80;176;137;23;186;89;183;143;117;0;51;118;59;115;46;68;139;193;41;5;42;181;159;69;108;18;22;146;34;160;48;54;177;10;190;84;184;43;116;65,336480659127909594,0.001969
steepest_intra:edges_start:greedy,132,71711,23674,48037,104650,6,21;14;138;185;40;165;90;81;196;179;145;78;31;56;113;175;171;16;25;44;120;75;86;53;180;154;135;70;127;123;162;149;131;65;116;43;184;190;10;177;54;48;160;34;146;22;18;108;69;159;181;42;5;41;193;139;68;140;93;117;143;183;89;186;23;137;0;46;115;59;118;51;151;133;176;80;79;63;94;121;100;26;101;1;97;152;2;129;92;57;55;52;106;178;49;102;148;9;62;144,5967977529443891480,0.001999
steepest_intra:edges_start:greedy,133,71637,23132,48505,104650,6,133;151;51;118;59;115;46;0;137;23;186;89;183;143;117;93;140;68;139;193;41;5;42;181;159;69;108;18;22;146;34;160;48;54;177;10;184;43;116;65;131;149;162;123;127;70;135;154;180;53;121;100;26;86;75;120;44;25;16;171;175;113;56;31;78;145;179;196;81;90;165;40;185;106;178;3;14;144;62;9;148;102;49;52;55;57;92;129;82;2;101;1;97;152;124;94;63;79;80;176,3356126367792791044,0.002000
steepest_intra:edges_start:greedy,134,71702,22637,49065,164450,10,199;18;108;69;139;68;46;115;59;118;51;0;117;143;183;89;186;23;137;176;80;79;63;94;124;152;97;1;101;2;82;129;92;57;55;52;49;102;148;9;62;144;14;3;178;106;185;40;165;90;81;196;179;145;78;31;56;113;175;171;16;25;44;120;75;86;26;100;121;53;180;154;70;135;133;151;162;127;123;149;65;116;43;184;190;10;177;54;48;160;34;181;42;5;41;193;159;195;146;22,2772152164576366371,0.003024
steepest_intra:edges_start:greedy,135,71413,22843,48570,44850,2,135;70;154;158;53;121;100;26;86;75;101;1;97;152;94;124;148;102;49;178;106;52;55;57;92;129;2;120;44;25;16;171;175;113;56;31;78;145;179;196;81;90;165;40;185;138;14;144;62;9;15;114;186;89;183;23;137;176;80;51;118;59;115;46;0;143;117;93;140;68;139;193;41;5;42;181;159;69;108;18;22;146;34;160;48;54;177;184;43;116;65;149;123;127;162;151;133;79;63;180,4265736677392965626,0.001007
steepest_intra:edges_start:greedy,136,71667,22968,48699,164450,10,158;180;154;70;135;133;151;162;127;123;149;65;116;43;184;84;190;10;177;54;48;160;34;146;22;18;108;69;159;181;42;5;41;193;139;68;46;115;59;118;51;0;117;143;183;89;186;23;137;176;80;79;63;94;124;152;97;1;101;2;82;129;92;57;55;52;49;102;148;9;62;144;14;3;178;106;185;40;165;90;81;196;179;145;78;31;56;113;175;171;16;25;44;120;75;86;26;100;121;53,2637104832378798306,0.003973
steepest_intra:edges_start:greedy,137,71413,22843,48570,44850,2,137;23;183;89;186;114;15;9;62;144;14;138;185;40;165;90;81;196;179;145;78;31;56;113;175;171;16;25;44;120;2;129;92;57;55;52;106;178;49;102;148;124;94;152;97;1;101;75;86;26;100;121;53;158;154;70;135;180;63;79;133;151;162;127;123;149;65;116;43;184;177;54;48;160;34;146;22;18;108;69;159;181;42;5;41;193;139;68;140;93;117;143;0;46;115;59;118;51;80;176,35775568743135175,0.001005
steepest_intra:edges_start:greedy,138,71246,23052,48194,89700,5,138;14;144;62;9;148;102;49;178;106;52;55;57;92;129;2;152;97;1;101;26;100;121;94;63;79;80;176;133;151;51;118;59;115;46;0;137;23;186;89;183;143;117;93;140;68;139;193;41;5;42;181;159;69;108;18;22;146;34;160;48;54;177;10;190;84;184;43;116;65;131;149;162;123;127;70;135;154;180;53;86;75;120;44;25;16;171;175;113;56;31;78;145;179;196;81;90;165;40;185,3637922909974046539,0.002002
steepest_intra:edges_start:greedy,139,71369,23246,48123,104650,6,139;68;46;115;59;118;51;0;117;143;183;89;186;23;137;176;80;79;63;94;124;152;97;1;101;2;82;129;92;57;55;52;49;102;148;9;62;144;14;3;178;106;185;40;165;90;81;196;179;145;78;31;56;113;175;171;16;25;44;120;75;86;26;100;121;53;180;154;70;135;133;151;162;127;123;149;65;116;43;184;112;4;190;10;177;54;48;160;34;146;22;18;108;69;159;181;42;5;41;193,4777283881372457851,0.002012
steepest_intra:edges_start:greedy,140,71359,23109,48250,119600,7,140;108;69;18;22;146;159;193;41;5;42;181;34;160;48;54;177;10;190;4;112;184;43;116;65;149;123;127;162;151;133;135;70;154;180;53;121;100;26;86;75;120;44;25;16;171;175;113;56;31;78;145;179;196;81;90;165;40;185;106;178;3;14;144;62;9;148;102;49;52;55;57;92;129;82;2;101;1;97;152;124;94;63;79;80;176;137;51;118;59;115;139;68;46;0;89;183;143;117;93,6674574027566904133,0.002973
steepest_intra:edges_start:greedy,141,70792,22201,48591,149500,9,114;89;183;143;0;117;93;140;68;46;115;139;193;41;5;42;181;159;69;108;18;22;146;34;160;48;54;177;10;190;184;43;116;65;59;118;51;151;133;162;123;127;70;135;154;180;53;121;100;26;86;75;120;44;25;16;171;175;113;56;31;78;145;179;196;81;90;165;40;185;106;178;3;14;144;62;9;148;102;49;52;55;57;92;129;82;2;101;1;97;152;124;94;63;79;80;176;137;23;186,2762485251282593714,0.004002
steepest_intra:edges_start:greedy,142,71848,23049,48799,119600,7,198;139;193;41;5;42;181;159;69;108;18;22;146;34;160;48;54;177;10;190;84;184;43;116;65;149;123;127;162;151;133;135;70;154;180;53;121;100;26;86;75;120;44;25;16;171;175;113;56;31;78;145;179;196;81;90;165;40;185;106;178;3;14;144;62;9;148;102;49;52;55;57;92;129;82;2;101;1;97;152;124;94;63;79;80;176;137;23;186;89;183;143;117;0;51;118;59;115;46;68,6136172247661830814,0.001999
steepest_intra:edges_start:greedy,143,70571,22366,48205,119600,7,143;117;0;46;68;139;115;193;41;5;42;181;159;69;108;18;22;146;34;160;48;54;177;10;190;4;112;84;184;43;116;65;59;118;51;151;133;162;123;127;70;135;154;180;53;121;100;26;86;75;120;44;25;16;171;175;113;56;31;78;145;179;196;81;90;165;40;185;106;178;3;14;144;62;9;148;102;49;52;55;57;92;129;82;2;101;1;97;152;124;94;63;79;80;176;137;23;186;89;183,8287610234340302324,0.003034
steepest_intra:edges_start:greedy,144,71246,23052,48194,89700,5,144;14;138;185;40;165;90;81;196;179;145;78;31;56;113;175;171;16;25;44;120;75;86;53;180;154;135;70;127;123;162;149;131;65;116;43;184;84;190;10;177;54;48;160;34;146;22;18;108;69;159;181;42;5;41;193;139;68;140;93;117;143;183;89;186;23;137;0;46;115;59;118;51;151;133;176;80;79;63;94;121;100;26;101;1;97;152;2;129;92;57;55;52;106;178;49;102;148;9;62,2648214186964745738,0.002015
steepest_intra:edges_start:greedy,145,71382,23110,48272,119600,7,145;179;196;81;90;165;40;185;106;178;3;14;144;62;9;148;102;49;52;55;57;92;129;2;152;97;1;101;26;100;121;94;63;79;80;176;133;151;51;118;59;115;46;0;137;23;186;89;183;143;117;93;140;68;139;193;41;5;42;181;159;69;108;18;22;146;34;160;48;54;177;10;190;84;184;43;116;65;131;149;162;123;127;70;135;154;180;53;86;75;120;44;25;16;171;175;113;56;31;78,5589638496756231548,0.002002
steepest_intra:edges_start:greedy,146,70906,22933,47973,89700,5,146;181;34;160;48;54;177;10;190;4;112;84;184;42;43;116;65;149;123;127;162;151;133;135;70;154;180;53;121;100;26;86;75;120;44;25;16;171;175;113;56;31;78;145;179;196;81;90;165;40;185;106;178;3;14;144;62;9;148;102;49;52;55;57;92;129;82;2;101;1;97;152;124;94;63;79;80;176;137;23;186;89;183;143;117;0;51;118;59;115;46;68;139;41;193;159;69;108;18;22,7253132370102756966,0.002014
steepest_intra:edges_start:greedy,147,71524,22866,48658,164450,10,30;177;10;190;184;43;116;65;59;118;115;46;0;51;151;133;162;123;127;70;135;154;180;53;121;100;26;86;75;120;44;25;16;171;175;113;56;31;78;145;179;196;81;90;165;40;185;106;178;3;14;144;62;9;148;102;49;52;55;57;92;129;82;2;101;1;97;152;124;94;63;79;80;176;137;23;186;89;183;143;117;93;140;68;139;41;193;159;69;108;18;22;146;195;181;42;160;34;48;54,3407302884026741866,0.004001
steepest_intra:edges_start:greedy,148,71246,23052,48194,89700,5,148;102;49;178;106;52;55;57;92;129;2;152;97;1;101;26;100;121;94;63;79;80;176;133;151;51;118;59;115;46;0;137;23;186;89;183;143;117;93;140;68;139;193;41;5;42;181;159;69;108;18;22;146;34;160;48;54;177;10;190;84;184;43;116;65;131;149;162;123;127;70;135;154;180;53;86;75;120;44;25;16;171;175;113;56;31;78;145;179;196;81;90;165;40;185;138;14;144;62;9,8014993843267891030,0.002015
steepest_intra:edges_start:greedy,149,71369,23246,48123,104650,6,149;123;127;162;151;133;135;70;154;180;53;121;100;26;86;75;120;44;25;16;171;175;113;56;31;78;145;179;196;81;90;165;40;185;106;178;3;14;144;62;9;148;102;49;52;55;57;92;129;82;2;101;1;97;152;124;94;63;79;80;176;137;23;186;89;183;143;117;0;51;118;59;115;46;68;139;193;41;5;42;181;159;69;108;18;22;146;34;160;48;54;177;10;190;4;112;184;43;116;65,4246998628770499035,0.002997
steepest_intra:edges_start:greedy,150,72250,23212,49038,134550,8,121;53;154;70;135;180;63;79;133;151;162;123;149;65;116;43;184;177;54;48;160;34;146;22;18;108;69;159;181;42;5;41;193;139;68;140;93;117;143;0;46;115;59;118;51;80;176;137;23;183;89;186;114;15;9;62;144;14;138;165;90;81;196;40;185;55;52;106;178;49;102;148;124;94;189;100;26;97;1;152;2;82;129;92;57;179;145;78;31;56;113;175;171;16;25;44;120;75;101;86,5955232813042888872,0.003002
steepest_intra:edges_start:greedy,151,71461,22899,48562,89700,5,151;133;162;123;127;70;135;154;180;53;121;100;26;86;75;120;44;25;16;171;175;113;56;31;78;145;179;196;81;90;165;40;185;106;178;3;14;144;62;9;148;102;49;52;55;57;92;129;82;2;101;1;97;152;124;94;63;79;80;176;137;23;186;89;183;143;117;0;51;118;59;115;46;68;139;193;41;5;42;181;159;69;108;18;22;146;34;160;48;54;177;10;190;84;184;43;116;65;131;149,3788675717212721449,0.002001
steepest_intra:edges_start:greedy,152,71446,23257,48189,74750,4,152;1;101;75;86;53;154;70;135;180;63;79;133;151;162;127;123;149;65;116;43;184;10;177;54;48;160;34;146;22;18;108;69;159;181;42;5;41;193;139;68;140;93;117;143;0;46;115;59;118;51;80;176;137;23;183;89;186;114;15;9;62;144;14;138;185;40;165;90;81;196;179;145;78;31;56;113;175;171;16;25;44;120;2;129;92;57;55;52;106;178;49;102;148;124;94;121;100;26;97,2357558670568429425,0.002003
steepest_intra:edges_start:greedy,153,70510,22376,48134,194350,12,93;117;0;143;183;89;186;23;137;176;80;79;63;94;124;152;97;1;101;2;82;129;92;57;55;52;49;102;148;9;62;144;14;3;178;106;185;40;165;90;81;196;179;145;78;31;56;113;175;171;16;25;44;120;75;86;26;100;121;53;180;154;135;70;127;123;162;133;151;51;118;59;65;116;43;184;112;4;190;10;177;54;48;160;34;146;22;18;108;69;159;181;42;5;41;193;139;115;46;68,1081108994310373338,0.005012
steepest_intra:edges_start:greedy,154,71413,22843,48570,44850,2,154;158;53;121;100;26;86;75;101;1;97;152;94;124;148;102;49;178;106;52;55;57;92;129;2;120;44;25;16;171;175;113;56;31;78;145;179;196;81;90;165;40;185;138;14;144;62;9;15;114;186;89;183;23;137;176;80;51;118;59;115;46;0;143;117;93;140;68;139;193;41;5;42;181;159;69;108;18;22;146;34;160;48;54;177;184;43;116;65;149;123;127;162;151;133;79;63;180;135;70,5699302558176581580,0.001053
steepest_intra:edges_start:greedy,155,71711,23674,48037,104650,6,21;14;138;185;40;165;90;81;196;179;145;78;31;56;113;175;171;16;25;44;120;75;86;53;180;154;135;70;127;123;162;149;131;65;116;43;184;190;10;177;54;48;160;34;146;22;18;108;69;159;181;42;5;41;193;139;68;140;93;117;143;183;89;186;23;137;0;46;115;59;118;51;151;133;176;80;79;63;94;121;100;26;101;1;97;152;2;129;92;57;55;52;106;178;49;102;148;9;62;144,8697706385669191160,0.003030
steepest_intra:edges_start:greedy,156,71061,22454,48607,179400,11,149;123;162;151;133;135;70;154;180;53;121;100;26;86;75;120;44;25;16;171;175;113;56;31;78;145;179;196;81;90;165;40;185;106;178;3;14;144;62;9;148;102;49;52;55;57;92;129;82;2;101;1;97;152;124;94;63;79;80;176;137;23;186;89;183;143;117;0;46;68;139;115;118;51;59;65;116;43;42;5;41;193;159;69;108;18;22;146;181;34;160;48;54;177;184;35;84;4;112;131,1535033353828028704,0.004004
steepest_intra:edges_start:greedy,157,71686,23239,48447,104650,6,157;196;81;90;165;40;185;106;178;3;14;144;62;9;148;102;49;52;55;179;145;78;92;57;129;2;152;97;1;101;26;100;121;94;63;79;80;176;133;151;51;118;59;115;46;0;137;23;186;89;183;143;117;93;140;68;139;193;41;5;42;181;159;69;108;18;22;146;34;160;48;54;177;10;190;184;43;116;65;131;149;162;123;127;70;135;154;180;53;86;75;120;44;25;16;171;175;113;56;31,1933060947752289111,0.002003
steepest_intra:edges_start:greedy,158,71413,22843,48570,44850,2,158;154;70;135;180;63;79;133;151;162;127;123;149;65;116;43;184;177;54;48;160;34;146;22;18;108;69;159;181;42;5;41;193;139;68;140;93;117;143;0;46;115;59;118;51;80;176;137;23;183;89;186;114;15;9;62;144;14;138;185;40;165;90;81;196;179;145;78;31;56;113;175;171;16;25;44;120;2;129;92;57;55;52;106;178;49;102;148;124;94;152;97;1;101;75;86;26;100;121;53,2578572700733090532,0.001001
steepest_intra:edges_start:greedy,159,71359,23109,48250,119600,7,159;146;22;18;69;108;140;93;117;143;183;89;0;46;68;139;115;59;118;51;137;176;80;79;63;94;124;152;97;1;101;2;82;129;92;57;55;52;49;102;148;9;62;144;14;3;178;106;185;40;165;90;81;196;179;145;78;31;56;113;175;171;16;25;44;120;75;86;26;100;121;53;180;154;70;135;133;151;162;127;123;149;65;116;43;184;112;4;190;10;177;54;48;160;34;181;42;5;41;193,8196817373769357099,0.002013
steepest_intra:edges_start:greedy,160,70906,22933,47973,89700,5,160;48;54;177;10;190;4;112;84;184;42;43;116;65;149;123;127;162;151;133;135;70;154;180;53;121;100;26;86;75;120;44;25;16;171;175;113;56;31;78;145;179;196;81;90;165;40;185;106;178;3;14;144;62;9;148;102;49;52;55;57;92;129;82;2;101;1;97;152;124;94;63;79;80;176;137;23;186;89;183;143;117;0;51;118;59;115;46;68;139;41;193;159;69;108;18;22;146;181;34,7412966201671824199,0.001999
steepest_intra:edges_start:greedy,161,71610,22824,48786,149500,9,127;162;151;133;135;70;154;180;158;53;121;100;26;86;75;120;44;25;16;171;175;113;56;31;78;145;179;196;81;90;165;40;185;106;178;3;14;144;62;9;148;102;49;52;55;57;92;129;82;2;101;1;97;152;124;94;63;79;80;176;137;23;186;89;183;143;117;0;51;118;59;115;46;68;139;193;41;5;42;181;159;69;108;18;22;146;34;160;48;54;177;10;190;184;43;116;65;131;149;123,1214600452276626508,0.002973
steepest_intra:edges_start:greedy,162,71369,23246,48123,104650,6,162;151;133;135;70;154;180;53;121;100;26;86;75;120;44;25;16;171;175;113;56;31;78;145;179;196;81;90;165;40;185;106;178;3;14;144;62;9;148;102;49;52;55;57;92;129;82;2;101;1;97;152;124;94;63;79;80;176;137;23;186;89;183;143;117;0;51;118;59;115;46;68;139;193;41;5;42;181;159;69;108;18;22;146;34;160;48;54;177;10;190;4;112;184;43;116;65;149;123;127,5001858858397195543,0.002000
steepest_intra:edges_start:greedy,163,71643,22792,48851,119600,7,69;139;68;46;115;59;118;51;0;117;143;183;89;186;23;137;176;80;79;63;94;124;152;97;1;101;2;82;129;92;57;55;52;49;102;148;9;62;144;14;3;178;106;185;40;165;90;81;196;179;145;78;31;56;113;175;171;16;25;44;120;75;86;26;100;121;53;180;154;70;135;133;151;162;127;123;149;65;116;43;184;84;190;10;177;54;48;160;34;181;42;5;41;193;159;146;22;199;18;108,3953344843631894656,0.001999
steepest_intra:edges_start:greedy,164,71912,23384,48528,59800,3,164;7;95;39;165;138;14;144;62;9;148;102;49;178;106;52;55;57;92;129;2;152;94;63;79;80;176;133;151;51;118;59;115;46;0;137;23;89;183;143;117;93;140;68;139;193;41;5;42;181;159;69;108;18;22;146;34;160;48;54;177;184;43;116;65;149;162;123;127;70;135;154;180;53;100;26;97;1;101;86;75;120;44;25;16;171;175;113;56;31;78;145;179;196;81;185;40;90;27;58,7183552211932188604,0.001011
steepest_intra:edges_start:greedy,165,71246,23052,48194,89700,5,165;40;185;138;14;144;62;9;148;102;49;178;106;52;55;57;92;129;2;152;97;1;101;26;100;121;94;63;79;80;176;133;151;51;118;59;115;46;0;137;23;186;89;183;143;117;93;140;68;139;193;41;5;42;181;159;69;108;18;22;146;34;160;48;54;177;10;190;84;184;43;116;65;131;149;162;123;127;70;135;154;180;53;86;75;120;44;25;16;171;175;113;56;31;78;145;179;196;81;90,3347583170663452596,0.002031
steepest_intra:edges_start:greedy,166,71675,23130,48545,119600,7,35;184;190;10;177;54;48;160;34;146;22;18;108;69;159;181;42;5;41;193;139;68;140;93;117;143;183;89;186;23;137;176;80;79;63;94;124;152;97;1;101;2;82;129;92;57;55;52;49;102;148;9;62;144;14;3;178;106;185;40;165;90;81;196;179;145;78;31;56;113;175;171;16;25;44;120;75;86;26;100;121;53;180;154;135;70;127;123;162;133;151;51;0;46;115;118;59;65;116;43,7536271846411863201,0.001997
steepest_intra:edges_start:greedy,167,72333,23757,48576,74750,4,167;148;9;62;102;144;14;49;178;106;165;39;95;7;164;58;27;90;81;196;40;185;52;55;57;129;92;179;145;78;31;56;113;175;171;16;25;44;120;2;75;101;1;152;97;26;100;86;53;154;70;135;180;63;79;133;151;162;127;123;149;65;116;43;184;177;54;48;160;34;146;22;18;108;69;159;181;42;5;41;193;139;68;140;93;117;143;183;89;0;46;115;59;118;51;137;176;80;94;124,389425513863726715,0.001005
steepest_intra:edges_start:greedy,168,71611,23164,48447,149500,9,157;31;56;113;175;171;16;25;44;120;75;86;53;180;154;135;70;127;123;162;149;131;65;116;43;184;190;10;177;54;48;160;34;146;22;18;108;69;159;181;42;5;41;193;139;68;140;93;117;143;183;89;186;23;137;0;46;115;59;118;51;151;133;176;80;79;63;94;121;100;26;101;1;97;152;2;129;92;57;55;52;49;102;148;9;62;144;14;3;178;106;185;40;165;90;81;196;179;145;78,3523139082351708058,0.004002
steepest_intra:edges_start:greedy,169,71439,23112,48327,119600,7,119;40;196;81;90;165;138;14;144;62;9;148;102;49;178;106;52;55;57;92;129;2;152;97;1;101;26;100;121;94;63;79;80;176;133;151;51;118;59;115;46;0;137;23;186;89;183;143;117;93;140;68;139;193;41;5;42;181;159;69;108;18;22;146;34;160;48;54;177;10;190;184;43;116;65;131;149;162;123;127;70;135;154;180;53;86;75;120;44;25;16;171;175;113;56;31;78;145;179;185,875872580462130182,0.003000
steepest_intra:edges_start:greedy,170,71005,22381,48624,134550,8,170;117;0;46;68;139;115;193;41;5;42;181;159;69;108;18;22;146;34;160;48;54;177;10;190;4;112;184;43;116;65;59;118;51;151;133;162;123;127;70;135;154;180;53;121;100;26;86;75;120;44;25;16;171;175;113;56;31;78;145;179;196;81;90;165;40;185;106;178;3;14;144;62;9;148;102;49;52;55;57;92;129;82;2;101;1;97;152;124;94;63;79;80;176;137;23;186;89;183;143,6825165666796475641,0.003000
steepest_intra:edges_start:greedy,171,71579,23307,48272,119600,7,171;175;113;56;31;78;145;92;179;196;81;90;165;40;185;106;178;3;14;144;62;9;148;102;49;52;55;57;129;2;152;97;1;101;26;100;121;94;63;79;80;176;133;151;51;118;59;115;46;0;137;23;186;89;183;143;117;93;140;68;139;193;41;5;42;181;159;69;108;18;22;146;34;160;48;54;177;10;190;84;184;43;116;65;131;149;162;123;127;70;135;154;180;53;86;75;120;44;25;16,7263285856391679077,0.003028
steepest_intra:edges_start:greedy,172,71364,22899,48465,119600,7,124;167;148;9;62;102;144;14;49;178;106;165;39;27;90;81;196;40;185;52;55;57;129;92;179;145;78;31;56;113;175;171;16;25;44;120;2;75;86;101;1;152;97;26;100;121;53;180;154;135;70;127;123;162;149;131;65;116;43;184;177;54;48;160;34;146;22;18;108;69;159;181;42;5;41;193;139;68;140;93;117;143;183;89;186;23;137;0;46;115;59;118;51;151;133;176;80;79;63;94,416477882966489769,0.002014
steepest_intra:edges_start:greedy,173,71571,23001,48570,74750,4,127;135;180;63;79;133;151;162;123;149;65;116;43;184;177;54;48;160;34;146;22;18;108;69;159;181;42;5;41;193;139;68;140;93;117;143;0;46;115;59;118;51;80;176;137;23;183;89;186;114;15;9;62;144;14;138;185;40;165;90;81;196;179;145;78;31;56;113;175;171;16;25;44;120;2;129;92;57;55;52;106;178;49;102;148;124;94;152;97;1;101;75;86;26;100;121;53;158;154;70,7332470564237906184,0.002009
steepest_intra:edges_start:greedy,174,71470,23276,48194,89700,5,196;40;185;179;145;78;31;56;113;175;171;16;25;44;120;75;86;53;180;154;135;70;127;123;162;149;131;65;116;43;184;84;190;10;177;54;48;160;34;146;22;18;108;69;159;181;42;5;41;193;139;68;140;93;117;143;183;89;186;23;137;0;46;115;59;118;51;151;133;176;80;79;63;94;121;100;26;101;1;97;152;2;129;92;57;55;52;106;178;49;102;148;9;62;144;14;138;165;90;81,9079723212088093404,0.002028
steepest_intra:edges_start:greedy,175,71579,23307,48272,119600,7,175;113;56;31;78;145;92;179;196;81;90;165;40;185;106;178;3;14;144;62;9;148;102;49;52;55;57;129;2;152;97;1;101;26;100;121;94;63;79;80;176;133;151;51;118;59;115;46;0;137;23;186;89;183;143;117;93;140;68;139;193;41;5;42;181;159;69;108;18;22;146;34;160;48;54;177;10;190;84;184;43;116;65;131;149;162;123;127;70;135;154;180;53;86;75;120;44;25;16;171,8157511533306046443,0.003038
steepest_intra:edges_start:greedy,176,71461,22899,48562,89700,5,176;80;79;63;94;124;152;97;1;101;2;82;129;92;57;55;52;49;102;148;9;62;144;14;3;178;106;185;40;165;90;81;196;179;145;78;31;56;113;175;171;16;25;44;120;75;86;26;100;121;53;180;154;135;70;127;123;162;133;151;149;131;65;116;43;184;84;190;10;177;54;48;160;34;146;22;18;108;69;159;181;42;5;41;193;139;68;46;115;59;118;51;0;117;143;183;89;186;23;137,2799278627699367036,0.001990
steepest_intra:edges_start:greedy,177,71512,22948,48564,134550,8,177;54;48;34;160;42;181;195;146;22;18;108;69;159;193;41;139;68;140;93;117;143;183;89;186;23;137;176;80;79;63;94;124;152;97;1;101;2;82;129;92;57;55;52;49;102;148;9;62;144;14;3;178;106;185;40;165;90;81;196;179;145;78;31;56;113;175;171;16;25;44;120;75;86;26;100;121;53;180;154;135;70;127;123;162;133;151;51;0;46;115;118;59;65;116;43;184;84;190;10,8423792336994732625,0.003002
steepest_intra:edges_start:greedy,178,71246,23052,48194,89700,5,178;49;102;148;9;62;144;14;138;185;40;165;90;81;196;179;145;78;31;56;113;175;171;16;25;44;120;75;86;53;180;154;135;70;127;123;162;149;131;65;116;43;184;84;190;10;177;54;48;160;34;146;22;18;108;69;159;181;42;5;41;193;139;68;140;93;117;143;183;89;186;23;137;0;46;115;59;118;51;151;133;176;80;79;63;94;121;100;26;101;1;97;152;2;129;92;57;55;52;106,3875776200944128712,0.002000
steepest_intra:edges_start:greedy,179,71382,23110,48272,104650,6,179;145;78;31;56;113;175;171;16;25;44;120;75;86;53;180;154;135;70;127;123;162;149;131;65;116;43;184;84;190;10;177;54;48;160;34;146;22;18;108;69;159;181;42;5;41;193;139;68;140;93;117;143;183;89;186;23;137;0;46;115;59;118;51;151;133;176;80;79;63;94;121;100;26;101;1;97;152;2;129;92;57;55;52;49;102;148;9;62;144;14;3;178;106;185;40;165;90;81;196,3991673839902120774,0.002999
steepest_intra:edges_start:greedy,180,71413,22843,48570,44850,2,180;135;70;154;158;53;121;100;26;86;75;101;1;97;152;94;124;148;102;49;178;106;52;55;57;92;129;2;120;44;25;16;171;175;113;56;31;78;145;179;196;81;90;165;40;185;138;14;144;62;9;15;114;186;89;183;23;137;176;80;51;118;59;115;46;0;143;117;93;140;68;139;193;41;5;42;181;159;69;108;18;22;146;34;160;48;54;177;184;43;116;65;149;123;127;162;151;133;79;63,6902594828357179570,0.001000
steepest_intra:edges_start:greedy,181,70906,22933,47973,89700,5,181;34;160;48;54;177;10;190;4;112;84;184;42;43;116;65;149;123;127;162;151;133;135;70;154;180;53;121;100;26;86;75;120;44;25;16;171;175;113;56;31;78;145;179;196;81;90;165;40;185;106;178;3;14;144;62;9;148;102;49;52;55;57;92;129;82;2;101;1;97;152;124;94;63;79;80;176;137;23;186;89;183;143;117;0;51;118;59;115;46;68;139;41;193;159;69;108;18;22;146,2916604478534173179,0.002000
steepest_intra:edges_start:greedy,182,71413,22843,48570,74750,4,158;154;70;135;180;63;79;133;151;162;127;123;149;65;116;43;184;177;54;48;160;34;146;22;18;108;69;159;181;42;5;41;193;139;68;140;93;117;143;0;46;115;59;118;51;80;176;137;23;183;89;186;114;15;9;62;144;14;138;185;40;165;90;81;196;179;145;78;31;56;113;175;171;16;25;44;120;2;129;92;57;55;52;106;178;49;102;148;124;94;152;97;1;101;75;86;26;100;121;53,2637888942437495681,0.002001
steepest_intra:edges_start:greedy,183,70571,22366,48205,119600,7,183;89;186;23;137;176;80;79;63;94;124;152;97;1;101;2;82;129;92;57;55;52;49;102;148;9;62;144;14;3;178;106;185;40;165;90;81;196;179;145;78;31;56;113;175;171;16;25;44;120;75;86;26;100;121;53;180;154;135;70;127;123;162;133;151;51;118;59;65;116;43;184;84;112;4;190;10;177;54;48;160;34;146;22;18;108;69;159;181;42;5;41;193;115;139;68;46;0;117;143,4582690647388252811,0.002816
steepest_intra:edges_start:greedy,184,71548,23048,48500,104650,6,184;43;116;65;59;118;115;46;0;51;151;133;162;123;127;70;135;154;180;53;121;100;26;86;75;120;44;25;16;171;175;113;56;31;78;145;179;196;81;90;165;40;185;106;178;3;14;144;62;9;148;102;49;52;55;57;92;129;82;2;101;1;97;152;124;94;63;79;80;176;137;23;186;89;183;143;117;93;140;68;139;193;41;5;42;181;159;69;108;18;22;146;34;160;48;54;177;10;190;84,8248559798819870402,0.002999
steepest_intra:edges_start:greedy,185,71246,23052,48194,89700,5,185;138;14;144;62;9;148;102;49;178;106;52;55;57;92;129;2;152;97;1;101;26;100;121;94;63;79;80;176;133;151;51;118;59;115;46;0;137;23;186;89;183;143;117;93;140;68;139;193;41;5;42;181;159;69;108;18;22;146;34;160;48;54;177;10;190;84;184;43;116;65;131;149;162;123;127;70;135;154;180;53;86;75;120;44;25;16;171;175;113;56;31;78;145;179;196;81;90;165;40,1240027525245288982,0.002000
steepest_intra:edges_start:greedy,186,70571,22366,48205,119600,7,186;89;183;143;117;0;46;68;139;115;193;41;5;42;181;159;69;108;18;22;146;34;160;48;54;177;10;190;4;112;84;184;43;116;65;59;118;51;151;133;162;123;127;70;135;154;180;53;121;100;26;86;75;120;44;25;16;171;175;113;56;31;78;145;179;196;81;90;165;40;185;106;178;3;14;144;62;9;148;102;49;52;55;57;92;129;82;2;101;1;97;152;124;94;63;79;80;176;137;23,5177643056392799817,0.002000
steepest_intra:edges_start:greedy,187,71509,23272,48237,104650,6,27;165;138;14;144;62;9;148;102;49;178;106;52;55;57;92;129;2;152;97;1;101;26;100;121;94;63;79;80;176;133;151;51;118;59;115;46;0;137;23;186;89;183;143;117;93;140;68;139;193;41;5;42;181;159;69;108;18;22;146;34;160;48;54;177;10;190;184;43;116;65;131;149;162;123;127;70;135;154;180;53;86;75;120;44;25;16;171;175;113;56;31;78;145;179;185;40;196;81;90,1068391936389207039,0.002003
steepest_intra:edges_start:greedy,188,71808,23361,48447,149500,9,157;31;56;113;175;171;16;25;44;120;75;86;53;180;154;135;70;127;123;162;149;131;65;116;43;184;190;10;177;54;48;160;34;146;22;18;108;69;159;181;42;5;41;193;139;68;140;93;117;143;183;89;186;23;137;0;46;115;59;118;51;151;133;176;80;79;63;94;121;100;26;101;1;97;152;2;129;57;55;52;49;102;148;9;62;144;14;3;178;106;185;40;165;90;81;196;179;92;145;78,9036885687580453146,0.003000
steepest_intra:edges_start:greedy,189,71608,22548,49060,44850,2,189;94;124;148;102;49;178;106;52;55;57;92;129;2;120;44;25;16;171;175;113;56;31;78;145;179;196;81;90;165;40;185;138;14;144;62;9;15;114;186;89;183;23;137;176;80;51;118;59;115;46;0;143;117;93;140;68;139;193;41;5;42;181;159;69;108;18;22;146;34;160;48;54;177;184;43;116;65;149;123;162;151;133;79;63;180;135;70;154;158;53;121;100;26;86;75;101;1;97;152,188186925832109045,0.001001
steepest_intra:edges_start:greedy,190,71327,23150,48177,149500,9,190;10;177;54;48;34;160;42;181;146;22;18;108;69;159;193;41;139;68;46;115;118;59;65;116;43;184;35;131;149;123;162;133;151;51;0;117;143;183;89;23;137;176;80;79;63;94;124;152;97;1;101;2;82;129;92;57;55;52;49;102;148;9;62;144;14;3;178;106;185;40;165;90;81;196;179;145;78;31;56;113;175;171;16;25;44;120;75;86;26;100;121;53;180;154;135;70;127;112;4,9150736422130000264,0.003999
steepest_intra:edges_start:greedy,191,71848,23049,48799,119600,7,198;68;46;115;59;118;51;0;117;143;183;89;186;23;137;176;80;79;63;94;124;152;97;1;101;2;82;129;92;57;55;52;49;102;148;9;62;144;14;3;178;106;185;40;165;90;81;196;179;145;78;31;56;113;175;171;16;25;44;120;75;86;26;100;121;53;180;154;70;135;133;151;162;127;123;149;65;116;43;184;84;190;10;177;54;48;160;34;146;22;18;108;69;159;181;42;5;41;193;139,1616638427038116432,0.002785
steepest_intra:edges_start:greedy,192,71740,22893,48847,149500,9,96;5;42;181;159;69;108;18;22;146;34;160;48;54;177;10;190;184;43;116;65;59;118;115;46;0;51;151;133;162;123;127;70;135;154;180;53;121;100;26;86;75;120;44;25;16;171;175;113;56;31;78;145;179;196;81;90;165;40;185;106;178;3;14;144;62;9;148;102;49;52;55;57;92;129;82;2;101;1;97;152;124;94;63;79;80;176;137;23;186;89;183;143;117;93;140;68;139;193;41,5913994802808253676,0.003002
steepest_intra:edges_start:greedy,193,71369,23246,48123,104650,6,193;139;68;46;115;59;118;51;0;117;143;183;89;186;23;137;176;80;79;63;94;124;152;97;1;101;2;82;129;92;57;55;52;49;102;148;9;62;144;14;3;178;106;185;40;165;90;81;196;179;145;78;31;56;113;175;171;16;25;44;120;75;86;26;100;121;53;180;154;70;135;133;151;162;127;123;149;65;116;43;184;112;4;190;10;177;54;48;160;34;146;22;18;108;69;159;181;42;5;41,921927789217614875,0.002000
steepest_intra:edges_start:greedy,194,71873,22902,48971,104650,6,194;127;123;162;133;151;149;131;65;116;43;184;190;10;177;54;48;160;34;146;22;18;108;69;159;181;42;5;41;193;139;68;46;115;59;118;51;0;117;143;183;89;186;23;137;176;80;79;63;94;124;152;97;1;101;2;82;129;92;57;55;52;49;102;148;9;62;144;14;3;178;106;185;40;165;90;81;196;179;145;78;31;56;113;175;171;16;25;44;120;75;86;26;100;121;53;180;154;70;135,5138151548398651646,0.003000
steepest_intra:edges_start:greedy,195,71156,22969,48187,104650,6,195;181;34;160;48;54;177;10;190;4;112;184;42;43;116;65;149;123;127;162;151;133;135;70;154;180;53;121;100;26;86;75;120;44;25;16;171;175;113;56;31;78;145;179;196;81;90;165;40;185;106;178;3;14;144;62;9;148;102;49;52;55;57;92;129;82;2;101;1;97;152;124;94;63;79;80;176;137;23;186;89;183;143;117;0;51;118;59;115;46;68;139;41;193;159;69;108;18;22;146,2113737972096712153,0.003000
steepest_intra:edges_start:greedy,196,71978,23329,48649,119600,7,196;81;90;165;40;185;106;178;3;14;144;62;9;148;102;49;52;55;57;129;92;179;145;78;82;2;152;97;1;101;26;100;121;94;63;79;80;176;133;151;51;118;59;115;46;0;137;23;186;89;183;143;117;93;140;68;139;193;41;5;42;181;159;69;108;18;22;146;34;160;48;54;177;10;184;43;116;65;131;149;162;123;127;70;135;154;180;53;86;75;120;44;25;16;171;175;113;56;31;157,6611918682434803534,0.003011
steepest_intra:edges_start:greedy,197,71760,22961,48799,104650,6,198;46;68;139;193;41;5;42;181;159;69;108;18;22;146;34;160;48;54;177;10;190;84;184;43;116;65;149;123;127;162;151;133;135;70;154;180;53;121;100;26;86;75;120;44;25;16;171;175;113;56;31;78;145;179;196;81;90;165;40;185;106;178;3;14;144;62;9;148;102;49;52;55;57;92;129;82;2;101;1;97;152;124;94;63;79;80;176;137;23;186;89;183;143;117;0;51;118;59;115,7419070345094957828,0.002003
steepest_intra:edges_start:greedy,198,71369,23246,48123,119600,7,68;46;115;59;118;51;0;117;143;183;89;186;23;137;176;80;79;63;94;124;152;97;1;101;2;82;129;92;57;55;52;49;102;148;9;62;144;14;3;178;106;185;40;165;90;81;196;179;145;78;31;56;113;175;171;16;25;44;120;75;86;26;100;121;53;180;154;70;135;133;151;162;127;123;149;65;116;43;184;112;4;190;10;177;54;48;160;34;146;22;18;108;69;159;181;42;5;41;193;139,3677537807306009240,0.003003
steepest_intra:edges_start:greedy,199,71188,22872,48316,164450,10,140;108;18;22;146;159;193;41;5;42;181;34;160;48;54;177;10;190;84;184;43;116;65;149;123;127;162;151;133;135;70;154;180;53;121;100;26;86;75;120;44;25;16;171;175;113;56;31;78;145;179;196;81;90;165;40;185;106;178;3;14;144;62;9;148;102;49;52;55;57;92;129;82;2;101;1;97;152;124;94;63;79;80;176;137;23;186;89;183;143;117;0;51;118;59;115;139;46;68;93,5968877086975063323,0.003975
greedy_intra:nodes_start:random,0,91115,42322,48793,976752,508,65;43;116;118;51;167;55;179;145;78;25;101;133;151;162;149;42;22;18;108;69;139;68;46;180;154;53;121;100;26;97;189;94;137;183;143;117;0;122;63;79;80;123;190;10;177;54;160;34;181;23;186;15;9;62;144;102;148;124;1;2;129;57;92;82;120;75;86;135;70;127;35;184;84;4;112;44;16;171;175;113;56;31;52;106;178;176;115;41;193;49;14;165;90;81;196;40;185;152;59,6452460060048383322,0.093147
greedy_intra:nodes_start:random,1,90232,41446,48786,1327977,527,178;79;162;123;177;10;4;70;75;44;120;2;122;80;139;18;22;159;193;41;137;148;145;78;124;94;176;51;118;59;151;167;52;55;179;196;81;31;113;175;171;16;25;86;158;53;100;26;101;1;97;63;133;43;5;42;34;54;160;144;14;165;90;40;185;57;92;129;152;121;180;154;135;127;112;84;184;46;0;143;117;93;68;115;116;65;131;149;183;89;23;186;15;9;62;102;49;138;3;106,7318081768846449889,0.101653
greedy_intra:nodes_start:random,2,86695,37043,49652,928053,471,182;63;79;80;176;51;151;133;121;120;25;78;92;129;162;149;43;42;159;108;18;22;34;160;184;131;167;52;40;119;90;81;196;31;145;179;55;57;82;75;101;100;26;97;1;2;152;94;124;148;23;186;144;14;165;185;106;178;49;102;114;89;183;46;115;116;65;135;70;127;123;112;4;177;139;0;143;117;93;68;193;41;59;118;137;15;9;62;56;113;175;171;16;44;86;53;158;180;154;136,2337249887599279173,0.090771
greedy_intra:nodes_start:random,3,90402,40127,50275,1136868,527,124;189;97;1;101;2;92;40;165;27;90;81;196;185;106;178;167;127;123;149;131;65;116;43;184;84;35;9;62;144;14;52;57;129;75;86;158;53;136;121;100;26;46;139;18;22;159;193;41;115;152;120;31;56;113;175;171;16;49;102;37;148;51;118;151;133;79;63;122;176;137;153;0;143;117;162;135;154;180;186;23;89;183;15;55;179;145;78;25;44;70;112;177;54;34;160;42;59;80;94,7509708625532401534,0.105578
greedy_intra:nodes_start:random,4,86999,37717,49282,1271927,498,22;34;54;177;10;190;184;160;42;5;43;131;47;65;116;59;118;151;79;63;180;154;123;112;84;35;149;137;62;144;14;138;40;185;106;176;51;46;117;0;80;101;75;86;53;70;135;162;133;178;165;90;81;196;157;145;78;25;92;129;167;37;148;186;23;143;93;108;18;193;139;183;89;57;179;31;113;175;171;16;44;120;2;1;97;26;100;121;189;94;124;152;55;52;49;9;115;41;159;146,8556792208133076093,0.096252
greedy_intra:nodes_start:random,5,85807,35146,50661,807616,475,146;22;18;159;193;41;5;26;101;1;97;80;51;118;109;176;9;62;89;183;46;115;59;79;63;182;121;136;53;180;154;137;23;186;114;15;167;2;75;120;44;25;129;57;55;52;106;185;165;90;40;196;179;92;145;31;113;175;171;16;78;86;158;70;112;184;43;123;127;135;100;152;178;3;49;14;144;102;148;124;94;122;133;151;162;149;131;47;65;116;139;68;117;143;0;42;160;177;54;34,4135957814312298299,0.089882
greedy_intra:nodes_start:random,6,87447,38823,48624,1048733,474,1;97;152;3;178;106;52;179;92;129;82;120;44;25;31;16;171;175;113;196;185;49;186;23;137;94;124;167;55;57;2;86;154;135;35;184;84;112;127;123;131;43;42;34;181;118;51;176;9;62;15;89;183;143;0;46;139;115;59;116;65;47;149;162;133;79;180;158;53;63;80;41;193;159;22;18;108;117;14;165;40;81;90;21;144;102;148;151;160;48;54;177;70;121;100;26;145;78;75;101,7260080400127538138,0.092198
greedy_intra:nodes_start:random,7,87325,37871,49454,1012113,461,90;81;196;120;75;86;51;46;68;140;93;117;0;143;183;89;23;137;63;136;182;121;97;101;26;100;53;154;70;127;112;4;84;123;135;180;94;124;152;1;2;78;145;179;55;52;106;178;176;118;41;193;159;18;108;186;9;62;144;14;57;92;129;44;16;171;175;113;31;59;22;146;34;181;116;47;65;115;198;139;96;5;42;43;149;151;80;79;133;162;35;184;177;54;160;148;49;185;40;165,1608115473528961346,0.085271
greedy_intra:nodes_start:random,8,85103,35487,49616,878113,509,93;143;170;0;179;145;78;196;40;119;165;185;167;133;162;184;54;160;43;116;115;46;118;176;80;94;152;120;25;44;75;86;158;154;135;180;53;121;124;148;37;9;15;186;23;89;183;62;102;144;21;164;90;81;31;56;113;175;171;16;1;97;63;79;151;59;41;193;159;131;149;123;127;70;100;26;101;2;129;92;57;55;52;106;178;3;138;14;49;137;51;65;42;181;34;22;18;139;68;117,5119223620781495399,0.092034
greedy_intra:nodes_start:random,9,89159,39311,49848,931241,464,148;167;124;12;176;51;118;139;41;193;22;18;117;0;143;90;27;164;7;21;138;3;121;154;135;127;112;177;54;184;65;59;162;151;133;80;94;129;92;179;145;82;101;86;158;180;53;78;31;157;196;81;40;15;114;186;23;89;183;144;14;165;185;57;2;152;1;97;122;79;63;100;26;120;44;25;16;56;113;175;171;75;70;123;160;34;42;43;116;115;46;137;55;52;106;178;49;102;62;9,9215620264422420970,0.085602
greedy_intra:nodes_start:random,10,87183,35481,51702,1272348,508,41;42;131;149;123;127;162;79;122;63;121;53;180;133;151;80;148;102;49;106;57;92;129;152;97;94;176;46;68;140;93;117;143;183;62;3;178;167;124;59;116;65;47;26;100;158;154;135;70;86;75;120;44;25;16;171;175;81;90;27;165;119;40;185;82;2;1;101;51;115;193;159;22;34;160;184;43;118;137;144;14;138;196;157;56;113;31;78;145;179;55;52;9;15;114;186;23;89;0;139,7055071190922887379,0.108572
greedy_intra:nodes_start:random,11,85351,34291,51060,892595,477,97;129;92;185;119;40;145;78;120;2;152;115;139;46;0;143;183;89;53;158;180;80;176;137;23;186;15;9;138;165;196;157;31;113;175;171;16;25;44;75;135;70;127;123;149;131;47;59;118;51;122;94;124;189;26;100;121;182;63;79;151;72;162;133;148;167;52;55;106;178;14;49;102;62;144;21;164;90;81;179;57;42;181;41;193;159;22;146;34;160;54;177;184;43;116;65;154;86;101;1,363830179736468417,0.081038
greedy_intra:nodes_start:random,12,83091,33718,49373,1033409,484,178;106;52;55;185;119;40;196;113;175;171;78;145;179;82;75;120;44;25;16;56;31;90;165;138;144;102;167;124;176;118;115;41;193;159;18;183;89;15;62;9;148;46;139;68;140;93;117;143;0;59;149;123;127;70;135;154;180;158;53;86;101;1;152;94;122;79;116;42;43;65;151;133;162;35;184;160;181;22;34;54;177;112;51;137;23;186;80;63;121;100;26;97;2;129;92;57;49;14;3,7821369441383783959,0.093499
greedy_intra:nodes_start:random,13,87789,39236,48553,1119979,474,1;82;78;145;179;185;106;178;144;15;186;137;80;122;63;94;148;9;62;133;162;59;41;193;139;46;118;151;100;31;113;175;171;16;44;25;92;49;102;167;121;158;70;127;123;69;18;108;117;143;183;89;23;79;154;135;112;184;177;54;160;42;43;116;65;131;149;180;53;86;75;120;196;81;90;40;165;138;14;114;0;68;159;181;34;146;22;115;51;176;124;52;55;57;129;2;152;97;26;101,2382298464301734560,0.091898
greedy_intra:nodes_start:random,14,84926,37284,47642,933988,485,68;108;18;22;159;123;135;180;63;79;51;0;143;117;139;115;41;193;181;34;42;59;129;92;82;120;75;154;70;127;112;35;131;149;162;53;100;26;86;101;1;152;167;148;14;165;90;119;40;185;196;31;16;171;175;113;81;27;164;21;144;15;160;54;30;177;10;190;184;43;116;65;97;2;44;25;78;145;57;55;52;106;178;49;62;9;186;23;89;183;137;176;80;124;94;122;133;151;118;46,9139061037496809304,0.089225
greedy_intra:nodes_start:random,15,84681,36463,48218,867418,482,2;1;101;26;100;53;127;84;35;43;5;139;68;117;143;0;46;115;131;149;162;180;154;70;135;63;79;133;151;80;122;94;124;148;62;165;40;90;81;196;145;78;92;75;86;123;184;160;34;146;22;18;108;93;183;89;137;176;51;109;118;41;193;159;181;42;116;97;152;9;15;114;186;23;59;65;54;177;10;4;112;57;55;52;49;102;144;14;178;106;185;179;31;113;175;171;16;44;120;129,6313010001807031488,0.086299
greedy_intra:nodes_start:random,16,83209,33489,49720,888973,442,146;18;108;68;46;51;176;80;86;75;120;145;179;92;129;2;101;1;94;124;148;167;152;97;26;100;63;137;9;62;49;52;55;57;79;162;65;105;77;43;5;41;22;159;193;115;118;59;151;133;180;53;158;154;135;70;127;123;112;184;139;93;117;143;153;23;186;144;14;178;106;185;119;40;196;78;25;44;16;171;175;113;31;81;90;165;102;15;89;183;0;116;47;149;131;42;181;160;54;34,3031670895975724197,0.090821
greedy_intra:nodes_start:random,17,89027,38893,50134,800673,465,129;2;49;102;144;14;179;145;78;31;56;85;157;196;40;119;81;113;175;171;16;101;162;149;131;123;180;53;100;26;121;115;41;193;68;117;143;23;137;59;43;184;160;34;42;116;65;124;148;9;62;176;151;4;112;127;86;75;120;44;25;92;52;178;106;185;165;90;21;15;186;89;183;0;139;159;146;22;18;108;46;118;51;80;122;152;1;97;158;154;135;70;133;79;63;94;167;3;55;57,2614068253901282210,0.086001
greedy_intra:nodes_start:random,18,86255,35003,51252,886989,447,102;15;186;23;114;144;14;165;90;81;40;185;52;55;179;145;92;57;106;178;3;49;183;143;0;139;41;193;181;184;112;127;70;94;148;37;9;62;137;176;122;80;51;118;115;116;59;151;79;16;171;175;113;31;78;25;120;44;82;129;2;46;68;108;18;22;159;5;42;43;65;133;63;189;97;1;101;86;75;74;152;26;100;121;53;158;180;154;135;194;123;149;131;160;34;54;177;162;124;167,8314556654200429075,0.081026
greedy_intra:nodes_start:random,19,78929,30248,48681,1591200,570,143;170;0;137;46;68;198;139;159;22;34;160;181;42;115;118;151;79;63;80;176;51;59;116;65;47;149;131;112;4;10;177;54;184;162;133;180;121;94;124;148;102;49;167;152;101;75;86;26;97;1;2;82;78;31;113;175;171;16;25;44;120;92;57;55;52;106;178;14;144;62;9;15;186;89;183;23;129;145;196;81;90;27;165;40;185;100;53;154;135;70;127;123;43;41;193;18;108;93;117,6646704893324706899,0.121688
greedy_intra:nodes_start:random,20,84233,35633,48600,912666,468,86;121;53;180;123;184;160;34;54;177;43;115;118;59;151;133;79;122;94;124;97;26;100;1;129;82;78;145;179;185;40;90;165;14;144;62;9;3;178;106;196;81;113;175;31;148;15;186;176;80;154;135;70;127;112;84;42;181;146;22;18;108;0;23;114;102;49;52;55;57;92;167;137;46;41;193;159;139;68;117;143;183;89;51;149;131;116;65;162;63;189;152;2;120;25;171;16;44;75;101,4597681394174455325,0.086859
greedy_intra:nodes_start:random,21,87427,37071,50356,723036,423,0;143;183;144;14;138;106;57;2;101;86;63;51;109;118;72;151;133;121;26;100;53;158;59;115;139;41;193;159;146;22;18;69;108;68;46;137;92;31;56;113;175;171;196;185;3;9;62;102;49;178;52;55;94;180;112;177;54;34;160;184;35;70;75;120;44;25;16;78;145;179;40;119;165;90;81;129;154;135;127;123;162;149;131;43;42;116;47;65;79;122;124;148;167;152;1;97;80;176;117,8401666169235001016,0.069327
greedy_intra:nodes_start:random,22,86838,37800,49038,912876,457,181;34;160;54;177;184;59;23;114;21;14;138;185;113;175;171;16;31;176;51;118;137;165;39;27;90;40;81;196;179;92;124;94;121;100;26;1;101;86;75;2;178;106;3;49;102;144;62;9;57;129;152;189;133;115;139;41;193;22;18;69;108;93;117;183;89;186;15;148;37;167;52;55;145;78;44;25;120;97;63;79;80;143;0;46;116;65;149;162;123;112;127;70;135;154;53;180;151;43;42,3518408546908524518,0.090000
greedy_intra:nodes_start:random,23,86502,37057,49445,954804,480,145;55;52;185;40;119;165;90;27;164;21;15;137;51;118;59;65;116;115;198;139;69;18;108;143;183;144;14;106;178;3;49;62;9;89;117;93;140;68;46;176;80;94;124;152;2;31;113;175;171;16;1;100;53;136;133;123;112;184;160;42;5;41;181;195;146;22;159;193;97;120;44;75;70;135;154;180;158;86;101;26;121;63;79;151;162;149;43;177;54;34;0;23;148;57;92;129;25;78;179,2308292205017523388,0.095972
greedy_intra:nodes_start:random,24,84172,36414,47758,1024099,463,146;159;181;34;160;54;177;10;4;112;70;135;16;171;175;113;56;31;81;196;78;145;179;40;90;27;165;57;129;2;152;94;89;183;53;158;154;180;79;133;151;65;47;43;42;193;41;115;59;162;127;123;35;84;184;116;118;51;9;62;102;49;144;14;185;55;52;106;178;167;148;137;176;80;149;131;46;23;186;15;92;25;44;120;75;86;101;1;97;26;63;139;68;0;143;117;93;108;18;22,7259023974563902933,0.087704
greedy_intra:nodes_start:random,25,87102,37634,49468,858404,463,68;176;80;65;116;43;42;181;146;22;18;159;193;41;139;75;120;196;90;81;175;171;16;78;145;179;57;55;52;178;106;185;92;2;184;54;34;160;115;23;186;114;144;102;129;82;44;25;113;56;31;40;165;138;14;49;63;4;112;70;135;154;180;158;53;121;97;1;101;86;100;26;152;189;94;124;148;37;9;62;15;137;79;133;151;131;149;123;127;162;59;118;51;89;183;143;0;117;93;46,5033454977458804941,0.083252
greedy_intra:nodes_start:random,26,87703,39298,48405,825452,464,40;165;90;164;21;138;178;106;52;145;78;120;101;86;158;180;53;100;26;121;63;79;94;124;152;57;55;167;176;47;43;181;22;18;108;140;68;46;116;65;59;80;1;44;16;171;175;113;75;154;184;177;4;112;127;70;135;162;123;131;149;151;133;97;2;129;92;31;196;49;102;62;9;148;51;160;48;54;34;146;159;193;41;139;117;0;143;183;89;186;23;137;118;42;5;115;15;144;14;185,7908991091098216384,0.091940
greedy_intra:nodes_start:random,27,81976,33593,48383,732564,449,175;56;31;196;81;90;165;138;14;144;62;9;102;40;185;55;57;1;100;180;123;35;160;34;181;42;43;47;65;116;59;118;115;18;108;68;46;139;41;193;159;22;146;131;149;51;23;186;148;124;94;122;79;133;135;127;10;177;54;184;84;4;112;70;154;26;97;152;167;49;178;106;52;2;75;86;53;162;151;80;176;137;183;143;117;0;63;121;101;129;92;179;78;145;120;44;25;16;171;113,4621203702393401308,0.081287
greedy_intra:nodes_start:random,28,87658,39158,48500,1050665,444,181;159;22;146;34;43;116;65;94;124;167;55;52;185;106;178;3;49;102;148;122;80;176;118;59;72;151;133;127;70;135;154;86;75;44;120;1;97;101;2;129;57;92;78;145;179;15;183;143;68;41;193;18;108;93;117;0;162;123;112;177;54;160;184;165;90;81;31;56;113;175;171;16;25;26;100;121;53;180;79;51;46;139;115;63;152;196;40;14;144;62;9;114;186;89;23;137;149;131;42,8448533670495744213,0.086850
greedy_intra:nodes_start:random,29,88124,38551,49573,857793,494,121;53;180;154;75;25;113;175;171;16;63;79;94;124;167;49;102;9;62;144;14;138;165;27;90;81;40;119;185;15;143;93;140;68;118;59;162;194;135;70;127;123;149;43;42;160;184;112;151;176;137;0;117;41;193;115;139;108;18;22;146;34;181;159;183;89;23;186;148;82;44;120;101;1;55;52;178;106;179;196;157;31;80;51;46;116;65;133;189;152;78;145;92;57;129;2;97;86;26;100,2771895632726630306,0.084967
greedy_intra:nodes_start:random,30,81366,32563,48803,774301,471,123;35;84;4;112;127;135;180;133;151;59;115;96;41;193;139;68;46;79;63;94;53;100;26;97;152;120;44;25;196;81;157;31;113;175;171;16;57;167;148;114;186;23;137;176;80;162;149;184;190;10;177;54;160;34;181;146;22;18;159;5;42;43;116;65;51;9;62;144;14;3;178;165;90;52;55;15;89;0;117;143;183;49;106;185;119;40;179;145;78;92;129;2;1;101;75;86;158;154;70,5307067721259204735,0.093854
greedy_intra:nodes_start:random,31,84939,35857,49082,878616,438,55;129;25;44;120;101;79;41;193;181;160;54;184;35;43;42;116;65;127;70;135;154;158;97;152;49;14;138;39;165;185;179;92;145;78;157;196;40;119;2;1;26;100;53;180;133;151;59;115;139;46;0;143;117;108;18;22;34;177;112;123;162;164;27;90;81;31;56;113;175;171;16;82;75;86;121;63;80;176;51;118;137;62;102;144;183;89;23;186;15;9;148;94;124;167;3;178;106;52;57,4884469360583097070,0.079236
greedy_intra:nodes_start:random,32,88915,39752,49163,1137150,459,35;16;171;175;113;31;90;165;106;178;3;167;124;94;189;97;1;101;100;121;63;186;23;183;89;137;80;176;148;9;62;15;115;181;160;34;22;18;108;69;159;193;41;139;68;46;0;117;143;114;144;145;78;162;149;65;116;5;42;43;123;127;135;154;26;152;49;14;52;55;92;25;44;75;86;53;158;180;79;133;151;59;118;51;2;120;82;129;57;185;40;196;179;70;112;4;177;54;184;84,8218406944124577204,0.089196
greedy_intra:nodes_start:random,33,87324,36250,51074,1109847,535,157;81;196;138;14;3;106;178;139;193;159;22;146;34;160;184;118;51;80;121;26;97;152;57;55;52;167;124;176;115;41;181;54;177;4;112;127;123;149;131;65;151;145;56;113;175;171;16;25;86;135;162;133;79;63;182;136;180;154;158;53;100;1;101;120;44;75;2;129;92;179;185;40;90;165;49;102;144;186;23;15;62;9;37;148;137;89;183;143;117;0;46;5;42;43;116;59;94;78;31,5824971939488673786,0.094047
greedy_intra:nodes_start:random,34,85863,37003,48860,1213503,513,55;106;178;3;14;144;114;186;15;9;62;57;16;25;44;75;70;127;123;131;149;162;151;133;65;116;5;42;160;34;181;193;41;115;59;118;51;152;120;171;175;113;56;81;90;165;40;185;167;124;94;121;100;53;158;180;35;84;4;112;135;154;86;101;2;129;92;145;78;31;196;49;102;183;89;23;137;80;79;97;1;26;63;176;0;143;117;18;22;146;54;177;10;190;184;43;139;46;148;52,8812429303059490605,0.102467
greedy_intra:nodes_start:random,35,83261,34974,48287,931069,471,181;159;108;18;22;146;34;54;177;10;190;4;127;70;154;158;53;100;26;152;2;120;44;25;16;171;175;78;92;129;82;75;86;101;1;97;121;63;79;80;133;151;162;149;43;42;160;184;84;112;123;135;180;57;40;165;90;81;113;31;145;179;196;185;106;178;143;117;46;139;115;118;94;124;148;37;15;186;114;144;14;49;102;62;137;59;116;65;51;176;167;55;52;9;23;89;183;0;41;193,7677365145357690601,0.085920
greedy_intra:nodes_start:random,36,89082,39699,49383,1634253,547,54;34;22;18;139;46;94;92;179;52;23;183;89;186;15;49;3;178;106;167;180;154;158;53;100;26;97;1;101;2;129;57;55;185;40;90;27;165;138;14;137;118;115;181;159;193;41;117;143;0;122;121;86;75;25;78;145;152;162;47;43;42;160;48;184;35;127;70;135;133;79;63;120;44;16;171;175;113;31;196;124;176;51;59;116;65;131;149;151;80;148;9;62;144;102;123;112;4;10;177,2023354967299042184,0.114170
greedy_intra:nodes_start:random,37,79509,30845,48664,1103731,484,138;14;49;3;178;106;185;165;27;90;40;52;55;152;121;53;86;75;120;44;25;78;145;179;92;167;148;9;62;186;23;0;117;93;108;69;18;22;34;181;193;41;42;43;116;65;59;115;139;46;68;143;183;89;124;94;189;100;26;97;1;101;2;129;57;102;144;15;137;151;51;176;80;79;63;180;154;135;70;127;123;112;4;84;35;184;177;54;48;160;149;162;133;31;16;171;175;113;81;196,3373456448557315428,0.102595
greedy_intra:nodes_start:random,38,83126,34511,48615,1677281,574,1;2;16;56;113;175;171;75;133;162;123;149;131;116;68;117;0;143;183;89;15;144;14;102;9;148;124;94;79;151;59;65;47;35;84;112;4;10;177;54;184;160;34;146;22;18;108;159;181;42;43;180;63;122;80;176;137;23;186;62;49;178;157;31;25;44;120;78;145;92;129;51;109;46;139;193;41;115;118;57;179;196;81;90;165;40;185;106;52;55;152;101;86;70;135;154;53;100;26;97,3202932810639008738,0.131038
greedy_intra:nodes_start:random,39,81885,32855,49030,963147,498,152;167;148;176;118;59;43;42;181;54;177;127;135;86;75;92;57;55;52;106;178;49;62;9;186;89;183;143;117;68;93;140;108;18;22;146;34;160;184;84;4;112;123;149;131;116;65;162;63;94;124;122;80;51;151;133;79;180;154;53;100;26;97;16;171;175;113;196;81;90;165;15;137;46;198;139;193;41;115;0;23;144;14;138;40;185;179;82;120;44;25;78;31;56;157;145;129;2;1;101,4351152639539856337,0.105687
greedy_intra:nodes_start:random,40,87412,38834,48578,925957,469,14;62;9;176;59;65;184;177;54;146;22;18;108;140;93;159;193;41;5;42;43;131;149;180;100;26;152;92;113;175;171;16;75;86;101;129;57;185;40;90;81;196;31;78;145;2;1;97;121;63;94;124;148;178;106;3;49;15;183;143;117;68;46;198;139;115;118;109;51;80;79;120;25;44;53;70;127;135;154;133;151;162;116;160;34;181;0;89;186;23;137;84;4;112;123;167;55;52;165;144,3921304971890516693,0.094954
greedy_intra:nodes_start:random,41,84811,34736,50075,1377674,559,149;47;65;116;41;181;160;34;146;22;159;18;117;143;183;89;137;176;46;68;0;23;186;15;196;31;56;113;175;171;16;81;40;119;90;27;165;185;55;57;2;152;189;94;124;9;62;102;49;148;80;79;133;162;123;112;84;184;42;43;59;151;129;92;179;145;78;25;44;75;158;135;154;180;53;97;1;26;100;63;51;118;115;193;139;114;144;14;138;3;178;106;52;82;120;101;86;70;127;131,6935052497697590439,0.112936
greedy_intra:nodes_start:random,42,86466,37880,48586,1011521,464,129;94;59;116;43;160;34;181;42;118;148;167;152;121;70;127;112;84;35;131;149;158;86;26;100;53;65;5;193;159;140;93;68;46;198;115;41;139;117;0;143;183;89;49;52;179;145;78;31;196;81;90;165;40;185;57;92;25;44;120;75;101;1;2;55;106;178;14;144;62;9;15;137;184;10;177;54;146;22;18;69;108;51;176;80;63;180;154;135;123;162;151;133;79;122;97;16;171;175;113,1513786619923920920,0.088761
greedy_intra:nodes_start:random,43,85751,35258,50493,1261096,512,93;117;143;183;89;23;124;152;26;100;127;112;184;34;22;193;41;181;160;42;43;59;51;63;121;86;75;129;57;55;52;106;178;94;122;79;133;194;135;70;154;180;158;53;120;44;25;78;31;113;81;90;165;21;114;153;0;46;116;65;149;123;162;151;80;176;137;186;15;62;102;49;167;148;9;144;14;138;3;185;119;40;196;179;92;1;97;101;2;82;145;175;171;16;118;115;139;18;108;140,2531547857229404982,0.103538
greedy_intra:nodes_start:random,44,87878,38257,49621,849336,466,1;75;2;74;152;97;26;100;121;53;154;70;135;51;0;143;183;89;144;14;3;178;49;102;62;9;15;148;106;119;40;185;167;5;42;48;54;177;84;35;79;94;124;55;52;165;90;81;196;31;113;175;171;16;44;86;180;149;131;43;116;65;151;133;162;194;127;123;59;46;139;193;18;22;146;159;41;115;118;176;129;57;92;145;78;25;120;112;4;184;160;34;181;68;117;23;137;80;63;101,762540227934388839,0.082373
greedy_intra:nodes_start:random,45,83152,35232,47920,1239095,494,22;159;193;41;115;59;118;46;139;68;117;143;0;160;34;54;177;10;4;112;84;184;131;149;123;127;162;151;176;137;23;186;94;100;26;97;152;106;178;3;49;102;148;80;133;135;70;154;180;63;53;86;75;120;92;129;51;116;42;43;65;79;167;165;27;90;81;57;2;101;1;55;185;119;40;196;31;56;113;25;44;16;171;175;78;145;179;52;138;14;144;62;9;15;89;183;93;108;18;146,4136517724499961333,0.107641
greedy_intra:nodes_start:random,46,92697,41801,50896,843643,433,26;100;121;53;158;180;154;70;127;112;181;22;159;86;75;16;31;78;145;52;55;135;123;131;149;51;137;15;62;9;37;148;122;80;176;23;89;183;0;118;35;84;177;54;34;160;184;162;189;152;129;92;57;94;63;133;59;115;41;193;117;143;144;14;113;175;171;124;46;68;139;96;5;42;43;65;116;151;79;167;49;3;178;106;82;120;44;25;185;40;119;165;90;81;196;179;2;101;1;97,2964264839055645196,0.084847
greedy_intra:nodes_start:random,47,86469,36688,49781,798353,514,113;175;171;16;31;3;49;102;62;9;15;114;186;23;148;144;14;40;185;55;2;1;101;53;158;154;180;121;100;26;97;75;120;82;129;52;178;106;165;90;81;196;92;152;133;162;123;184;34;22;159;193;41;115;5;42;181;160;54;177;118;109;89;183;143;117;0;46;43;35;112;127;135;86;44;25;78;145;179;57;124;94;59;116;65;131;149;151;79;63;122;80;176;51;139;18;108;137;167;56,3523844679604758974,0.083960
greedy_intra:nodes_start:random,48,90582,41639,48943,1424641,537,164;21;46;139;68;117;0;143;183;89;144;14;49;57;129;124;176;51;118;59;151;53;86;101;1;148;37;167;55;52;106;178;3;152;26;100;121;122;80;79;63;180;154;135;149;131;65;116;43;35;112;4;84;42;5;181;160;162;133;97;2;120;44;75;177;10;190;127;70;123;184;54;48;34;146;22;137;9;62;108;18;159;193;41;115;94;92;31;113;175;171;16;78;145;185;40;165;90;27;7,7258343970087497036,0.110636
greedy_intra:nodes_start:random,49,86325,36311,50014,724965,467,129;57;55;102;37;148;9;62;15;137;68;139;193;159;22;146;41;51;124;94;122;79;133;176;80;63;26;97;152;49;14;3;178;106;185;40;119;138;144;114;186;23;89;0;46;115;5;42;43;149;162;123;35;184;160;54;177;4;112;84;131;65;116;59;118;151;121;100;53;180;154;158;86;101;75;31;113;175;171;16;120;2;167;183;143;117;108;18;181;34;135;1;52;165;90;81;145;78;44;92,7450851413973808401,0.071559
greedy_intra:nodes_start:random,50,84636,34681,49955,1006345,512,89;15;144;138;185;92;129;57;55;52;106;178;3;9;62;102;14;49;148;137;46;198;68;108;18;181;42;43;131;149;65;115;139;193;41;5;116;59;79;122;97;1;121;136;180;135;127;112;4;70;154;158;53;100;26;86;101;75;44;120;2;152;63;133;151;51;0;117;143;176;80;162;123;184;160;34;146;22;159;118;94;124;167;179;196;81;90;165;40;78;25;16;171;175;113;31;145;186;23;183,5067135793401417714,0.091365
greedy_intra:nodes_start:random,51,88061,38159,49902,842132,459,106;178;14;144;59;65;131;149;123;112;4;177;34;22;18;108;117;143;183;89;137;133;135;70;154;94;124;12;80;122;100;101;120;25;44;75;86;180;162;42;41;139;46;148;49;62;9;186;23;0;93;140;68;118;51;176;152;31;113;175;171;16;78;145;179;92;129;2;1;26;121;182;136;158;53;97;55;185;40;119;165;90;81;196;57;189;63;79;151;116;43;184;54;160;181;159;193;115;167;52,517449373446306938,0.085894
greedy_intra:nodes_start:random,52,85824,36867,48957,1024725,478,120;75;101;86;100;121;63;176;51;41;193;18;117;143;23;15;62;9;137;115;5;42;181;22;34;54;48;160;43;118;144;102;49;14;138;165;90;81;179;57;55;52;178;106;185;40;196;56;113;175;171;16;31;124;46;198;139;59;162;180;53;70;112;4;190;10;177;184;68;0;183;89;186;148;167;152;97;94;122;79;80;151;133;154;135;127;123;149;131;116;65;26;1;2;129;92;145;78;25;44,8619689514201173592,0.096868
greedy_intra:nodes_start:random,53,86360,37711,48649,558476,435,186;23;89;183;115;35;112;26;97;1;120;25;44;75;86;154;135;127;123;162;148;37;15;137;118;59;149;131;184;34;54;177;4;70;101;2;129;92;57;55;52;106;178;167;94;124;9;62;102;49;3;185;165;90;81;196;179;82;152;100;53;180;79;133;151;193;159;22;42;5;139;198;46;68;18;108;93;117;143;0;41;181;160;43;116;65;51;176;80;63;78;145;16;171;175;113;31;40;14;144,59486608742832901,0.067123
greedy_intra:nodes_start:random,54,93887,43102,50785,585386,440,102;14;138;39;90;81;196;129;2;1;152;92;57;55;106;178;49;41;193;159;22;146;184;112;135;53;100;26;31;56;113;175;70;127;123;131;149;94;124;25;171;16;44;121;5;42;181;34;54;177;48;160;43;59;79;63;136;158;154;180;46;0;170;143;117;68;139;115;118;109;137;23;89;183;176;151;162;133;80;148;9;62;97;101;78;145;179;185;40;165;52;82;120;75;86;65;116;51;15;144,248990875585688551,0.078468
greedy_intra:nodes_start:random,55,92687,43810,48877,1192225,503,151;162;133;135;123;184;160;43;116;59;138;165;119;40;185;106;178;3;49;176;80;79;63;121;86;75;101;26;100;53;180;154;127;112;84;48;34;54;177;4;70;25;31;56;157;179;55;52;51;118;115;41;42;65;78;145;196;81;90;14;144;102;62;9;15;114;186;89;183;23;124;94;152;120;44;16;171;175;113;0;140;93;117;143;57;92;129;2;1;97;167;148;137;108;18;22;193;139;46;68,2446761856518572973,0.096831
greedy_intra:nodes_start:random,56,84540,35897,48643,759635,478,121;100;26;180;79;51;118;115;41;5;59;162;70;135;133;151;184;177;54;160;34;181;42;43;116;65;149;131;112;123;127;154;101;1;97;152;106;178;9;62;144;14;138;39;27;90;165;185;57;129;82;2;94;124;52;40;81;196;56;113;31;145;179;55;148;137;23;89;186;15;167;92;78;25;120;63;80;176;46;68;139;193;159;22;18;108;117;0;143;183;102;49;175;171;16;44;75;86;158;53,5936192552948769517,0.079201
greedy_intra:nodes_start:random,57,88245,38270,49975,831801,477,89;183;143;0;123;127;112;184;34;146;22;159;41;193;18;108;154;180;53;97;1;2;25;16;171;175;113;31;82;152;118;115;59;162;135;70;86;101;75;120;44;129;148;9;62;92;78;145;179;106;178;49;102;15;23;137;176;80;79;57;185;40;165;138;14;52;55;167;124;94;189;26;100;121;63;133;151;51;109;46;117;68;139;5;42;181;160;43;116;65;47;131;149;144;39;90;27;164;21;186,8925761058185862094,0.092231
greedy_intra:nodes_start:random,58,79705,31173,48532,1414741,533,196;145;120;75;101;1;97;26;100;79;151;59;41;193;159;22;18;108;93;117;143;183;89;137;51;176;80;15;9;62;102;49;144;186;23;0;46;68;139;115;118;167;3;178;106;52;55;57;92;179;40;185;129;82;2;63;133;162;65;116;5;42;43;184;160;34;48;54;177;4;112;84;35;131;149;123;127;70;135;154;180;53;86;44;25;16;171;175;113;31;78;152;189;94;124;148;14;165;90;81,4588762028796866860,0.109449
greedy_intra:nodes_start:random,59,85899,37022,48877,1014030,469,106;52;179;157;31;171;25;120;75;86;46;0;143;117;68;159;22;18;108;139;115;118;51;176;137;23;183;89;186;15;9;148;124;97;1;92;196;81;90;57;26;123;112;127;70;135;154;121;100;53;180;63;151;43;42;181;34;160;48;54;177;184;131;149;101;44;16;175;113;56;78;145;185;40;119;165;167;80;59;193;41;96;5;116;65;162;133;79;122;94;152;2;129;55;49;102;62;144;14;178,1751453497451530856,0.087751
greedy_intra:nodes_start:random,60,91012,40938,50074,908201,456,144;137;118;59;131;149;51;186;114;183;89;23;80;79;133;135;127;123;162;72;0;117;68;46;122;94;124;152;1;97;86;101;2;120;44;82;57;55;52;3;49;37;148;26;100;121;53;158;180;116;42;160;34;177;10;4;78;196;81;90;119;40;106;178;167;176;115;18;22;159;193;41;139;143;15;9;62;102;145;31;113;175;171;16;25;75;154;70;112;184;43;65;151;63;129;92;179;185;165;14,5747857608507214036,0.092650
greedy_intra:nodes_start:random,61,89923,39953,49970,1075099,476,138;14;49;102;62;9;167;129;120;2;1;97;41;193;160;54;177;4;112;127;123;162;59;118;183;89;114;90;27;164;21;144;15;186;23;137;176;51;116;65;131;149;70;135;154;25;113;56;31;78;145;92;57;124;94;189;152;178;106;52;55;179;175;171;16;44;158;133;151;115;42;43;180;53;86;75;101;26;100;121;182;63;79;80;0;143;117;68;46;139;22;34;184;148;185;196;81;40;165;39,1774563519564957252,0.092072
greedy_intra:nodes_start:random,62,89057,41205,47852,1382535,521,167;179;78;31;16;171;175;113;56;81;90;165;137;193;159;22;41;118;151;133;80;176;0;143;183;89;15;49;52;55;152;26;53;158;180;154;135;70;127;123;149;131;112;4;84;35;184;43;5;42;181;146;34;160;97;1;101;2;129;145;196;40;185;106;51;59;65;116;115;46;68;93;117;186;9;62;144;14;178;57;92;25;44;120;75;86;190;10;177;54;162;63;94;122;79;139;18;108;23;148,7332920704677354760,0.110248
greedy_intra:nodes_start:random,63,89459,41298,48161,880955,482,53;75;120;16;171;175;113;179;186;89;183;115;42;43;116;59;40;165;90;81;196;157;31;25;44;78;145;185;106;178;152;123;112;4;84;190;10;177;54;48;34;146;22;181;160;184;131;149;65;151;133;121;1;97;122;176;80;79;63;100;26;86;101;2;129;92;57;55;52;49;23;108;18;68;46;0;117;143;144;14;102;51;118;41;193;159;139;137;62;9;148;162;127;70;135;94;124;189;180;154,6932298261236990357,0.086709
greedy_intra:nodes_start:random,64,88108,38209,49899,1124016,584,129;101;70;112;184;177;54;34;160;42;43;65;152;57;55;52;178;106;185;40;119;49;167;26;100;53;158;180;154;127;123;72;118;46;0;137;176;80;122;94;124;15;186;23;51;131;149;148;165;90;81;196;78;25;44;120;2;1;97;133;151;116;5;41;139;68;93;117;144;14;102;62;9;89;183;143;108;18;22;193;115;59;162;194;135;79;63;121;86;75;16;171;175;113;31;157;145;179;92;82,196967890355914326,0.109672
greedy_intra:nodes_start:random,65,88486,40108,48378,639039,429,89;186;148;120;44;78;31;113;175;171;16;75;121;63;122;80;51;46;68;18;108;93;137;102;49;55;57;2;1;152;124;94;79;133;162;35;84;112;127;70;185;40;165;90;81;196;52;176;115;41;34;160;54;177;10;190;184;131;149;47;116;65;151;180;86;101;145;179;92;129;97;26;100;53;154;135;123;43;5;193;139;0;23;114;15;9;62;144;14;106;178;59;42;181;146;22;159;117;143;183,5629590100453324771,0.079398
greedy_intra:nodes_start:random,66,85303,36416,48887,906087,520,63;152;55;52;62;9;148;51;65;47;43;42;5;139;68;140;108;18;69;154;70;135;162;59;118;115;41;193;181;160;184;112;4;177;54;34;103;146;22;159;151;133;180;86;1;101;75;44;16;171;78;145;185;40;196;31;175;113;81;90;165;129;2;97;26;100;121;53;79;80;15;114;186;23;137;176;127;123;149;131;116;46;0;117;143;183;144;14;49;102;167;120;25;92;57;106;178;124;94;122,764794097469007520,0.096037
greedy_intra:nodes_start:random,67,87504,37939,49565,776878,454,129;25;175;171;16;44;120;75;51;109;153;0;170;143;117;68;46;176;80;121;100;26;53;180;154;86;101;2;167;9;62;102;49;52;55;57;135;70;127;112;184;43;131;149;151;144;14;138;165;27;90;81;40;185;178;106;196;113;31;78;145;92;115;139;193;41;59;79;63;97;1;152;148;186;89;183;23;137;118;65;116;42;195;146;22;18;108;69;159;103;34;181;160;54;177;123;162;133;94;124,8526859569885527610,0.080614
greedy_intra:nodes_start:random,68,90439,41339,49100,781812,459,122;80;51;118;72;151;75;120;44;25;78;145;196;81;175;171;16;70;177;10;4;112;123;127;135;154;129;185;40;165;14;144;102;49;124;94;133;162;149;42;41;193;181;160;184;86;101;97;1;152;167;62;9;59;65;47;116;43;115;46;183;89;114;186;23;68;22;159;139;137;148;57;92;113;31;179;55;52;106;178;2;26;100;53;180;84;54;34;146;18;108;140;93;117;143;0;153;176;63;79,2185525883789589158,0.083374
greedy_intra:nodes_start:random,69,85032,35667,49365,841548,464,78;196;81;119;165;27;90;31;113;175;171;16;120;124;94;80;115;193;41;116;65;176;137;114;186;23;0;93;140;108;18;22;146;181;42;43;131;149;189;2;129;92;57;55;52;106;178;3;152;1;97;121;53;158;100;26;101;40;185;167;112;184;177;54;160;34;159;139;46;68;117;143;183;89;144;14;49;62;148;51;109;118;59;162;151;133;79;122;63;180;154;135;123;127;70;86;75;44;25;145,5098449636844326621,0.080083
greedy_intra:nodes_start:random,70,87680,37280,50400,1742684,596,180;133;151;59;41;193;159;22;18;137;49;178;106;80;176;51;42;160;34;54;177;112;135;55;196;81;157;56;113;175;171;16;31;78;145;179;57;122;79;63;182;121;26;97;1;2;129;92;40;90;27;165;185;52;70;127;123;162;118;46;139;115;116;47;43;184;131;149;65;0;117;143;183;89;23;82;25;44;120;75;101;86;100;189;94;124;186;114;15;148;37;9;62;102;144;14;167;152;53;154,8881316340002302362,0.129849
greedy_intra:nodes_start:random,71,87608,38637,48971,589462,434,137;124;94;79;80;176;51;118;59;116;43;160;48;123;44;25;175;171;16;75;86;26;100;97;101;120;92;179;196;113;31;78;145;57;55;167;115;41;193;42;190;10;177;54;34;181;146;22;159;18;0;144;102;14;165;27;90;40;185;129;2;152;9;62;183;143;117;68;139;46;148;49;178;106;52;1;53;180;133;151;162;149;131;65;184;35;84;4;112;127;70;135;154;63;15;114;89;76;23;186,8613853169441827253,0.081447
greedy_intra:nodes_start:random,72,89416,40330,49086,949519,452,175;31;40;90;27;165;102;15;23;0;117;143;186;144;14;138;185;92;129;2;152;97;26;100;86;101;1;121;154;135;162;151;133;63;179;145;78;25;120;122;46;68;183;89;137;118;59;123;127;70;75;82;57;49;9;62;148;124;94;53;158;180;79;80;176;51;198;139;69;108;18;22;146;159;193;41;42;116;65;178;106;52;55;167;115;181;34;54;177;10;4;112;184;160;43;149;44;16;171;113,3753356384591541921,0.085941
greedy_intra:nodes_start:random,73,88821,40253,48568,1101306,467,180;154;53;100;26;152;189;124;94;122;80;176;137;148;178;106;185;40;119;165;138;62;9;51;115;41;193;159;181;160;42;43;149;59;118;151;63;121;86;101;97;1;75;70;177;54;34;22;18;139;46;52;55;57;82;44;25;78;31;157;196;179;145;92;129;2;127;112;84;184;35;123;162;102;49;14;144;183;143;0;117;68;116;65;120;16;171;175;113;81;90;164;7;21;186;89;23;79;133;135,7944033760795068978,0.092057
greedy_intra:nodes_start:random,74,85499,36854,48645,1070766,510,70;53;100;94;124;186;23;137;176;51;118;108;18;135;154;180;121;145;157;31;2;101;1;167;178;3;40;119;185;106;179;78;25;44;92;57;129;120;75;86;26;97;152;55;52;16;171;175;113;196;81;90;165;138;14;144;89;0;68;139;115;116;43;5;41;193;159;22;146;181;42;65;59;151;133;79;63;122;80;46;140;93;117;143;183;15;102;49;62;9;148;162;149;184;160;34;54;177;112;123,4326716655042385353,0.092415
greedy_intra:nodes_start:random,75,84050,33300,50750,997807,466,9;148;176;51;59;115;198;139;69;108;18;159;181;105;47;65;116;96;5;42;43;149;131;35;184;84;112;127;70;135;154;158;75;44;16;171;175;113;31;0;143;117;193;41;80;79;133;162;123;177;54;48;160;34;146;22;140;93;68;46;151;180;53;100;26;86;101;120;25;78;145;92;57;129;2;94;63;137;183;89;23;186;15;178;106;165;40;185;52;55;1;97;152;167;102;49;14;138;144;62,2751795684015131144,0.087367
greedy_intra:nodes_start:random,76,87839,37229,50610,1982425,526,78;75;86;70;112;84;184;54;34;160;42;43;65;51;176;129;82;2;1;101;26;100;121;182;189;94;23;186;15;167;57;92;16;171;175;113;56;31;25;44;120;118;59;116;115;46;0;183;89;9;62;102;37;148;124;152;97;53;180;63;79;80;133;151;162;149;181;146;22;18;108;117;143;49;178;3;14;144;137;139;193;41;131;123;135;154;158;196;81;90;165;119;40;185;106;52;55;179;145;157,6575325403020704319,0.124780
greedy_intra:nodes_start:random,77,83098,32700,50398,1059178,492,41;159;69;108;18;22;146;34;184;131;149;24;123;112;35;65;59;118;51;80;63;136;53;158;180;176;0;143;183;89;9;62;37;148;124;79;133;162;116;43;42;181;160;54;177;151;137;23;186;94;189;1;101;86;75;2;129;57;179;145;78;31;113;175;171;16;25;44;120;82;92;55;178;106;40;185;152;97;26;100;70;127;135;154;121;167;52;81;90;27;165;14;49;102;144;15;46;115;139;193,6292173117795581064,0.103054
greedy_intra:nodes_start:random,78,83790,34716,49074,1545150,570,186;23;137;80;162;123;135;154;158;53;180;133;151;118;59;65;184;54;34;160;43;116;115;198;46;0;114;15;9;62;52;55;57;129;2;1;101;75;120;44;25;113;175;171;16;149;131;42;181;146;22;18;108;69;159;193;41;139;68;117;143;183;89;94;26;100;86;70;127;112;35;51;176;148;102;3;178;106;185;179;145;78;31;196;40;165;90;81;92;152;97;121;63;79;124;167;49;138;14;144,3792072504129186656,0.115498
greedy_intra:nodes_start:random,79,82491,33312,49179,1053493,438,122;79;63;121;100;26;86;75;101;1;97;152;2;120;16;171;196;165;90;81;56;113;175;179;148;0;140;93;117;143;183;89;23;186;114;9;62;102;49;57;92;44;25;78;31;157;145;129;53;158;70;123;149;115;139;68;108;18;22;159;193;41;59;151;162;65;116;42;181;34;160;48;54;177;10;184;43;51;176;80;180;154;135;133;118;46;137;15;144;14;138;3;178;106;52;185;119;40;55;94,6082657293095917877,0.085924
greedy_intra:nodes_start:random,80,86539,38044,48495,616748,444,139;140;93;68;115;116;65;43;184;48;160;34;146;22;42;123;70;44;120;2;18;108;117;0;137;148;9;62;167;152;101;75;86;100;154;135;127;112;84;35;131;149;72;151;162;133;63;94;124;176;46;118;59;51;80;79;180;53;121;178;49;144;14;138;106;165;27;90;40;185;52;55;57;179;92;129;25;78;145;31;16;171;175;113;56;81;196;1;97;26;186;23;89;183;143;177;54;181;193;41,1836928648263333466,0.072381
greedy_intra:nodes_start:random,81,87727,37930,49797,1122860,531,183;89;23;186;124;152;2;120;113;175;171;16;44;75;135;184;177;54;48;160;34;139;68;140;93;117;143;0;51;151;133;180;53;121;167;49;3;178;145;31;78;92;57;106;138;14;144;176;65;43;42;5;159;193;41;59;118;80;79;63;100;101;1;97;26;189;94;148;9;62;137;46;108;18;22;146;195;181;149;162;86;129;40;90;27;165;119;185;52;55;154;70;127;123;112;35;131;47;116;115,7896351013370709430,0.108669
greedy_intra:nodes_start:random,82,86486,36775,49711,969513,471,162;35;84;112;123;127;70;194;133;151;115;139;193;159;22;41;5;47;131;149;65;116;43;42;160;34;181;137;23;186;15;144;14;185;106;178;49;148;124;94;97;26;100;86;101;1;120;44;75;53;79;51;118;59;46;0;143;183;89;9;52;55;57;129;92;145;78;31;113;175;171;16;25;82;2;152;63;80;176;68;18;108;117;62;165;40;196;179;4;190;10;177;30;54;48;184;135;154;158;180,4240227231003587419,0.082163
greedy_intra:nodes_start:random,83,87319,38663,48656,1138122,491,63;121;26;97;101;75;16;171;175;113;31;59;65;131;149;162;57;92;179;185;40;14;144;165;90;81;196;145;78;86;35;184;160;34;18;108;68;46;176;189;100;1;129;25;44;120;2;152;9;62;49;55;52;106;178;148;137;115;181;146;22;159;193;41;139;183;89;118;116;43;42;48;54;177;10;190;4;112;123;127;194;135;70;154;180;158;53;94;124;186;23;143;117;0;51;151;133;79;122;80,3182510785998146949,0.096563
greedy_intra:nodes_start:random,84,85547,36405,49142,1016965,477,162;154;158;86;120;25;175;171;16;44;75;70;127;123;42;5;41;181;160;34;146;22;18;159;193;139;115;118;59;149;65;116;43;184;177;10;4;112;135;180;124;148;15;186;183;143;0;51;176;80;167;3;178;106;185;145;92;57;23;89;117;68;46;137;196;81;90;27;39;165;40;138;14;144;62;9;102;49;52;55;94;79;133;63;152;129;78;31;56;113;82;2;101;1;97;26;100;121;53;151,1827496283045762302,0.092568
greedy_intra:nodes_start:random,85,84368,34393,49975,834879,465,189;121;182;136;53;127;112;4;177;184;79;124;148;40;119;165;90;81;196;56;113;175;171;120;1;101;100;26;97;152;55;52;178;106;185;92;145;78;31;16;44;75;86;151;43;42;181;30;54;48;160;34;146;22;159;193;41;116;65;51;176;137;15;144;14;102;62;9;49;3;57;129;2;80;115;139;18;68;46;0;140;93;117;143;183;89;118;59;149;131;123;162;133;135;70;158;154;180;63;94,8965777234541034769,0.082420
greedy_intra:nodes_start:random,86,84897,34738,50159,771281,461,43;181;34;54;160;115;118;59;123;162;133;79;122;63;53;121;100;26;189;124;49;3;178;165;40;185;106;167;152;97;1;129;92;57;55;52;145;78;25;44;120;82;2;101;75;16;171;175;113;56;31;62;9;15;186;23;137;116;65;149;112;84;184;146;22;18;69;108;93;117;143;0;51;72;151;80;176;14;90;81;196;86;154;70;127;135;180;94;148;102;144;114;89;183;139;159;193;41;5;42,7404393787556864718,0.085519
greedy_intra:nodes_start:random,87,87347,37753,49594,976227,432,86;101;26;100;158;154;180;63;80;137;23;186;15;144;165;90;81;119;40;179;92;2;152;94;122;79;151;133;97;1;75;120;78;145;31;196;185;106;102;49;62;9;59;116;43;160;42;5;65;162;136;121;53;135;123;35;184;131;149;14;138;3;178;52;55;176;51;118;115;139;46;124;57;113;175;171;16;25;44;129;167;148;89;183;143;0;117;108;69;18;193;41;159;22;34;54;177;112;127;70,8397629779500064085,0.087502
greedy_intra:nodes_start:random,88,80762,32365,48397,755791,440,171;16;31;78;145;179;14;144;9;148;94;63;154;135;70;127;112;4;177;34;181;41;193;159;146;22;68;117;93;140;163;69;18;108;0;143;183;89;51;118;115;139;46;151;133;79;121;26;97;152;92;82;25;44;120;75;1;2;129;57;55;52;81;90;165;119;40;59;116;65;149;131;43;42;160;48;54;184;123;162;180;53;86;101;100;80;176;137;23;186;15;62;102;49;178;106;185;196;113;175,7233222669369089273,0.074280
greedy_intra:nodes_start:random,89,84198,35244,48954,772040,474,170;46;115;43;177;10;4;112;123;180;158;154;135;127;70;101;2;55;57;92;129;152;94;133;162;149;131;53;86;75;25;78;31;175;113;81;90;165;40;185;106;138;14;144;178;52;179;145;171;16;44;120;151;65;116;41;193;159;34;54;160;42;139;68;143;117;93;140;18;108;22;181;184;84;35;47;59;118;109;51;79;63;97;1;26;100;80;176;148;167;49;102;62;9;15;137;23;89;183;0,1599790172262394492,0.082344
greedy_intra:nodes_start:random,90,85019,35172,49847,1006847,527,57;55;52;165;90;40;185;106;178;0;46;68;140;93;117;143;183;89;25;16;171;175;113;56;31;78;145;179;129;152;97;26;53;158;180;63;122;80;79;133;151;184;190;10;177;54;34;160;131;149;162;127;123;35;84;112;70;135;94;124;9;62;144;14;49;148;176;51;116;43;42;5;118;137;23;186;15;167;82;44;120;75;154;65;41;181;146;22;159;193;139;115;59;121;100;86;101;1;2;92,3010181985660093487,0.095563
greedy_intra:nodes_start:random,91,88385,39295,49090,588378,415,14;3;178;106;176;59;116;43;65;2;44;120;75;4;10;177;54;112;135;154;86;1;15;114;183;143;117;0;89;179;196;81;90;27;39;165;119;40;185;55;57;129;25;78;92;145;31;56;113;175;171;16;101;121;162;184;160;34;22;18;108;68;151;133;79;180;158;53;63;122;137;23;186;9;62;144;102;49;148;124;94;80;51;118;115;46;139;193;41;42;149;123;127;70;100;26;97;152;52;138,6128700106137841254,0.069942
greedy_intra:nodes_start:random,92,80249,31691,48558,1138957,498,4;112;70;16;171;175;81;90;27;164;21;138;145;78;31;113;56;196;185;106;178;3;49;102;62;167;152;97;1;86;158;154;135;194;127;123;149;59;118;115;46;68;140;108;18;34;54;160;43;42;181;146;22;159;193;41;139;143;183;89;186;23;137;176;80;51;151;133;79;63;94;124;148;9;144;14;57;92;179;40;165;52;55;129;25;44;120;2;75;101;26;100;53;180;162;65;116;184;177;10,9155202986975153049,0.095431
greedy_intra:nodes_start:random,93,90491,41315,49176,851933,442,31;113;175;171;16;78;25;44;75;70;127;123;112;84;35;131;149;43;184;190;10;177;54;41;193;139;198;118;151;180;154;135;162;133;79;63;100;26;97;152;94;124;137;23;89;183;143;170;117;0;186;15;49;178;52;55;129;1;121;80;59;65;116;5;195;146;22;159;115;40;90;165;148;51;160;34;181;42;53;86;101;9;62;144;14;106;185;179;145;92;57;93;108;18;68;46;176;2;120;82,2766678483904143209,0.081249
greedy_intra:nodes_start:random,94,90689,40897,49792,742773,387,62;9;15;186;89;23;137;118;65;116;5;115;46;144;21;138;14;102;183;143;0;41;193;22;18;108;139;80;180;154;53;121;86;101;2;92;165;39;90;27;164;95;81;196;178;148;176;51;59;149;131;123;133;79;151;162;135;70;16;175;171;44;75;1;97;100;26;189;94;152;57;55;52;106;167;124;63;127;112;84;184;54;34;160;42;43;120;113;56;31;78;40;119;185;179;145;25;82;129;49,7831166430001485475,0.066775
greedy_intra:nodes_start:random,95,84004,34374,49630,1032295,521,69;18;193;41;5;131;149;123;127;70;135;154;158;53;180;112;35;84;4;190;10;177;146;22;181;42;116;65;43;48;54;30;34;160;184;86;101;75;40;165;14;144;186;137;151;162;133;79;122;94;124;148;9;102;49;167;152;1;176;51;80;63;26;97;23;89;183;114;15;62;185;145;78;31;113;175;171;16;25;44;120;2;129;92;179;57;55;52;106;178;118;59;115;139;68;46;0;143;117;108,7268699413639615385,0.101818
greedy_intra:nodes_start:random,96,84786,35130,49656,796314,471,113;31;57;15;186;23;137;176;122;121;189;152;97;1;101;86;75;129;55;52;178;49;102;62;9;148;167;82;44;120;51;59;116;43;184;54;160;34;41;193;18;108;68;139;159;22;146;181;42;65;162;158;53;100;26;2;106;138;14;144;89;183;143;117;0;46;115;151;180;154;70;135;63;79;133;127;112;84;35;123;80;94;124;3;165;90;81;145;78;16;25;92;179;185;119;40;196;56;175;171,3651884263623647480,0.080868
greedy_intra:nodes_start:random,97,85447,35799,49648,1113647,498,164;27;90;40;165;138;14;49;152;1;75;120;44;16;171;175;113;56;31;179;185;81;196;145;78;25;94;79;133;151;139;159;193;41;115;149;123;127;70;135;80;186;23;137;51;59;35;112;4;84;34;146;22;195;181;43;131;154;180;53;97;52;106;178;102;62;9;15;184;177;54;48;160;42;5;116;65;47;162;63;121;100;26;86;101;2;129;92;57;55;167;148;176;118;46;0;143;183;144;21,2086065714161736034,0.094758
greedy_intra:nodes_start:random,98,86643,37097,49546,822563,449,30;177;10;190;84;35;131;149;47;116;65;59;154;180;53;167;62;9;148;186;89;183;23;137;25;16;78;145;57;178;3;14;144;102;49;171;175;113;31;196;40;165;185;106;52;55;179;92;129;124;176;46;139;41;115;118;1;75;44;120;2;51;159;22;18;108;93;117;143;0;68;193;181;42;43;184;112;127;133;79;122;94;152;97;26;121;63;80;151;162;135;70;158;86;101;100;123;160;34;54,6499056280755494534,0.077206
greedy_intra:nodes_start:random,99,83020,33271,49749,1077012,521,90;27;58;164;7;95;39;165;81;196;179;57;92;145;78;25;53;133;151;59;65;116;43;184;42;68;117;143;0;46;115;118;152;31;113;175;171;16;44;120;75;63;80;137;23;183;89;186;114;15;144;102;62;9;148;180;135;127;123;162;79;122;94;124;52;106;178;3;138;14;49;154;70;112;4;190;10;177;54;160;34;146;22;193;41;139;51;176;100;26;97;1;86;101;2;129;55;185;40;119,5328092277894506873,0.099433
greedy_intra:nodes_start:random,100,81367,31234,50133,945630,497,56;157;196;119;165;27;90;81;179;92;57;55;52;14;144;114;186;23;89;183;137;176;80;100;26;124;94;121;53;158;70;127;112;184;190;10;177;54;34;160;42;181;22;159;193;41;139;115;46;15;9;62;102;138;40;185;129;82;2;152;97;1;101;86;75;120;25;175;171;16;44;162;123;149;65;47;43;116;59;118;117;143;0;51;151;133;135;154;180;63;79;122;148;49;178;106;145;78;31;113,8991807198656949108,0.090862
greedy_intra:nodes_start:random,101,89558,39158,50400,816522,446,171;175;113;81;90;27;39;165;1;135;127;131;149;9;62;102;144;14;138;185;119;40;196;145;78;25;120;86;154;180;53;101;2;129;92;31;56;157;179;57;55;52;15;143;117;0;51;162;123;112;84;184;43;116;47;65;59;118;137;23;183;89;186;148;167;152;189;80;46;68;139;22;193;41;115;151;121;100;26;97;63;133;79;122;94;124;106;178;49;176;42;181;34;160;54;177;70;75;44;16,5491871719038582558,0.081949
greedy_intra:nodes_start:random,102,79792,30489,49303,1233819,537,102;62;9;148;167;124;94;122;80;176;51;43;42;159;22;18;108;140;93;68;115;116;65;35;112;127;70;154;180;121;189;97;26;100;86;101;1;152;2;120;44;16;171;175;113;31;25;75;53;135;123;184;54;160;34;181;193;41;139;198;137;23;15;49;178;106;55;57;129;92;78;145;196;81;90;27;39;165;119;40;144;186;89;183;143;117;0;46;118;59;149;162;151;133;79;63;52;185;138;14,4507729379134085463,0.101591
greedy_intra:nodes_start:random,103,90815,42324,48491,832498,516,190;177;30;54;84;4;112;94;52;178;106;165;138;14;183;143;0;117;108;18;22;181;43;79;152;92;129;1;26;100;121;63;133;162;35;184;160;34;42;118;15;62;9;80;151;65;47;131;127;70;82;78;145;196;81;90;27;119;40;185;55;97;53;180;154;123;149;116;59;51;137;23;89;186;144;102;49;148;176;46;139;159;193;41;115;57;31;113;175;171;16;25;44;120;2;75;101;86;135;10,7496973726138717690,0.088782
greedy_intra:nodes_start:random,104,85252,33774,51478,990858,458,186;89;183;51;109;72;151;162;123;149;59;118;139;159;22;146;195;181;184;84;112;127;70;86;101;26;100;121;189;97;16;171;175;113;56;31;106;178;148;137;176;80;79;63;94;152;129;82;44;120;2;1;53;158;136;124;167;49;102;144;14;52;55;185;40;165;46;68;198;115;116;65;43;42;160;48;177;54;34;41;193;18;117;143;0;133;135;154;180;75;25;78;145;179;92;57;62;9;15;23,137177331024548699,0.090813
greedy_intra:nodes_start:random,105,84562,35115,49447,758733,454,78;196;81;31;113;175;171;16;44;1;97;152;185;165;90;119;40;179;92;129;82;75;135;70;127;123;184;48;160;42;117;143;144;14;102;80;151;59;0;183;89;62;49;57;55;52;106;178;167;176;51;46;139;41;193;159;146;34;54;177;4;112;84;35;131;149;47;65;116;115;18;22;181;43;162;133;79;63;136;180;154;158;53;100;26;86;101;124;148;9;15;186;23;137;94;189;2;120;25;145,59372970254094504,0.083601
greedy_intra:nodes_start:random,106,82699,33884,48815,1229966,551,5;133;79;63;152;2;178;3;14;144;15;137;118;59;149;131;65;116;43;42;181;160;184;35;84;112;4;177;54;34;18;0;23;186;102;165;90;81;196;78;120;129;92;57;49;62;9;148;124;94;180;154;158;53;101;1;97;26;135;70;127;123;121;100;86;75;44;25;16;171;175;113;31;145;179;40;185;106;52;55;167;80;51;46;139;68;117;170;143;183;89;176;151;162;115;41;193;159;22;146,1135208271675047274,0.102505
greedy_intra:nodes_start:random,107,84319,34461,49858,864005,477,182;158;70;127;112;184;22;18;117;143;183;89;14;165;90;119;40;185;57;2;75;101;1;97;86;26;100;133;46;139;193;159;146;34;54;177;160;181;41;68;0;137;148;52;55;178;106;81;196;145;78;25;44;120;92;129;152;167;9;62;102;144;114;23;186;15;49;31;113;175;171;16;124;94;189;121;53;63;79;80;176;51;59;43;42;5;115;118;72;151;162;65;116;131;149;123;135;154;180;136,2669532915160540915,0.084402
greedy_intra:nodes_start:random,108,88393,38759,49634,965529,458,157;81;90;165;40;148;5;42;181;159;22;146;195;41;46;15;62;49;178;106;92;145;78;1;97;63;0;143;117;93;140;68;198;139;108;69;18;193;115;118;109;51;59;116;43;184;35;162;151;133;180;135;127;123;131;149;72;176;9;144;14;185;31;113;175;171;16;101;79;65;160;34;54;177;112;154;158;53;100;26;86;75;44;25;120;186;89;183;23;137;80;94;124;152;2;129;57;55;52;196,9125662548373335299,0.084952
greedy_intra:nodes_start:random,109,83018,32472,50546,1194339,491,44;16;171;175;113;78;167;137;118;115;41;193;159;22;34;160;59;51;176;94;124;148;37;9;62;102;144;15;186;89;183;143;117;0;151;133;180;154;135;194;127;123;112;131;149;65;116;43;42;5;139;68;46;80;63;121;26;100;53;158;70;4;10;177;54;184;162;79;97;2;129;52;3;49;14;138;185;40;81;196;179;55;57;92;145;31;56;157;90;27;165;106;178;152;1;101;86;75;120;25,6482286559072646565,0.097178
greedy_intra:nodes_start:random,110,90809,41282,49527,1235460,514,62;9;15;137;116;43;184;54;160;34;181;42;65;86;44;171;16;75;70;177;10;4;112;127;135;79;176;23;186;114;89;183;193;41;115;118;145;78;25;120;26;100;121;189;94;124;148;102;49;106;196;157;31;175;113;56;81;90;27;165;52;55;97;1;101;2;82;129;152;80;51;59;149;131;123;162;133;151;159;22;18;139;46;0;143;63;180;154;53;185;119;40;179;92;57;178;3;138;14;144,3129690254302696414,0.100663
greedy_intra:nodes_start:random,111,86853,36245,50608,901227,521,68;46;153;89;183;143;117;0;137;23;186;15;37;148;59;116;65;131;149;162;80;79;94;124;152;97;1;2;129;57;92;82;101;86;70;127;112;84;184;35;123;78;145;179;165;90;81;56;113;175;171;16;31;196;40;119;185;106;14;144;62;9;176;51;151;133;180;53;121;100;26;167;55;52;178;3;49;118;115;193;22;146;34;48;54;177;4;135;154;158;75;44;25;120;63;43;160;42;41;139,3626893201454010606,0.096347
greedy_intra:nodes_start:random,112,83423,35085,48338,1088643,513,176;94;152;75;120;44;25;78;145;31;113;175;171;16;179;57;92;101;86;53;154;180;0;117;143;183;89;21;7;164;144;62;9;148;102;49;3;178;52;55;129;2;1;97;162;149;131;65;116;43;48;54;177;184;42;5;59;118;51;151;133;79;63;121;26;100;135;70;127;123;112;84;160;34;22;18;108;159;193;41;139;15;14;138;196;157;81;90;165;40;185;106;186;23;137;46;68;198;115;80,5556695148504605105,0.091691
greedy_intra:nodes_start:random,113,88104,38299,49805,761298,440,175;113;123;112;160;18;108;93;0;80;154;158;53;100;101;120;25;44;75;86;70;135;162;47;65;116;5;42;181;41;115;118;51;176;49;178;106;52;55;185;119;40;179;129;2;1;26;180;133;151;79;122;63;121;97;152;167;62;9;37;148;124;94;145;78;31;196;81;90;165;138;14;92;57;102;144;15;186;137;23;89;183;143;117;59;149;131;43;184;177;54;34;103;146;22;193;139;46;16;171,7918372841901517645,0.075709
greedy_intra:nodes_start:random,114,85903,36476,49427,1191898,524,113;171;16;15;186;89;183;143;117;0;137;167;57;129;63;133;115;41;193;139;68;46;94;152;2;1;97;121;42;181;34;160;54;177;184;123;135;70;127;112;4;84;35;148;9;144;14;165;40;90;81;196;78;25;44;185;106;178;49;62;23;108;18;22;159;5;43;77;131;149;47;65;116;59;118;72;162;151;109;51;176;80;79;180;154;158;53;100;26;86;101;75;120;92;55;52;179;145;31;175,8684011179170692572,0.100085
greedy_intra:nodes_start:random,115,87759,36764,50995,720853,476,49;14;144;114;23;186;15;138;119;40;185;92;129;2;152;189;137;89;183;143;0;117;193;41;42;115;118;51;176;148;52;55;1;97;26;100;121;122;79;63;180;53;158;154;135;184;54;160;34;22;18;108;139;68;46;57;179;157;38;31;78;145;101;86;70;127;112;123;162;133;75;16;171;175;113;56;25;44;120;82;196;81;90;27;165;106;3;178;167;124;94;80;151;65;43;116;59;9;62;102,3771190828686694206,0.076119
greedy_intra:nodes_start:random,116,90485,41741,48744,662098,465,175;113;31;165;39;164;27;90;40;196;145;185;14;144;62;115;193;159;146;34;10;190;177;54;181;41;68;117;183;89;102;49;178;52;55;162;149;131;184;48;160;42;5;43;112;123;86;75;44;78;92;129;180;154;70;127;135;133;80;137;23;186;15;9;3;106;57;51;65;116;195;22;18;139;176;94;152;2;1;97;101;26;63;79;151;59;118;46;0;143;114;148;167;124;121;53;100;120;16;171,8319257454246686184,0.083652
greedy_intra:nodes_start:random,117,87120,39121,47999,915607,488,171;175;113;56;31;94;176;51;59;118;137;15;62;9;148;124;80;151;5;181;146;22;159;193;41;184;84;112;123;133;79;63;121;53;180;162;115;46;139;18;108;117;0;143;183;55;57;92;179;196;81;90;165;21;114;186;23;89;65;116;43;42;160;34;54;177;4;127;70;154;52;185;40;138;14;144;106;145;78;25;44;120;129;178;49;102;167;2;152;97;1;101;26;100;131;149;135;86;75;16,756183502655463983,0.088484
greedy_intra:nodes_start:random,118,83824,33933,49891,1323039,512,122;63;121;100;86;101;129;82;78;25;44;120;2;1;97;26;53;154;135;70;127;112;84;35;123;151;94;152;167;185;40;119;90;165;14;144;62;42;181;160;43;131;149;72;51;137;0;108;18;22;146;34;54;184;148;9;49;178;106;52;55;57;92;179;145;196;81;157;31;56;113;175;171;16;75;180;162;47;65;116;23;89;183;143;117;93;68;46;139;159;193;41;115;59;118;109;176;80;133;79,5925555615628645632,0.104001
greedy_intra:nodes_start:random,119,87576,39516,48060,1064658,501,175;16;129;2;1;97;152;179;81;90;165;185;63;177;10;4;112;84;184;54;34;160;123;127;70;135;154;101;57;55;52;106;178;49;80;118;115;139;96;43;116;162;180;53;86;75;120;44;25;113;56;31;196;40;14;144;102;148;176;51;59;65;131;149;121;100;26;137;89;183;143;117;0;23;186;62;9;159;22;181;42;5;41;193;18;108;140;93;68;46;151;133;79;94;124;167;92;145;78;171,2039088589098818114,0.090418
greedy_intra:nodes_start:random,120,86279,37342,48937,746106,456,3;49;102;62;9;148;137;46;115;118;80;97;26;100;70;127;112;4;84;123;135;154;152;129;92;179;196;40;119;185;82;25;44;120;2;75;86;42;181;34;22;159;41;65;131;149;63;94;124;167;55;52;138;14;144;176;59;116;43;184;177;54;160;5;23;186;89;183;68;139;193;18;117;143;0;51;151;162;133;79;180;158;53;101;1;57;165;27;90;81;56;113;175;171;16;31;78;145;106;178,8591316312235904757,0.077364
greedy_intra:nodes_start:random,121,89300,40487,48813,1080250,532,140;93;144;14;185;165;90;40;196;113;31;167;137;153;0;51;151;118;59;42;160;34;48;54;177;10;4;112;127;135;154;53;121;100;26;86;101;97;1;2;129;78;145;179;106;178;49;102;9;148;124;94;122;80;176;117;143;183;89;23;186;92;175;171;16;25;63;79;133;162;116;41;193;139;115;46;114;15;62;52;55;57;152;35;184;43;65;131;149;180;120;44;75;70;123;181;146;22;18;108,6710665626191823491,0.101149
greedy_intra:nodes_start:random,122,82527,32117,50410,1127926,493,100;121;180;162;118;46;139;115;116;65;59;72;124;94;122;79;63;136;86;101;75;120;44;25;16;171;175;113;56;31;196;81;90;165;138;15;148;37;106;185;40;14;144;137;176;80;133;151;51;0;117;68;41;193;34;160;54;177;184;35;131;149;43;42;181;146;22;18;143;183;89;186;9;62;102;49;3;178;52;145;78;82;2;53;158;154;135;70;127;112;123;167;55;57;92;129;152;1;97;26,6017694347097000692,0.097482
greedy_intra:nodes_start:random,123,84703,34265,50438,901145,483,148;57;171;175;113;31;196;3;49;102;144;14;138;178;179;145;78;16;25;44;120;2;79;72;59;149;131;43;160;184;123;135;180;167;106;185;40;165;90;81;92;129;94;80;176;51;109;151;133;162;118;0;170;143;137;122;63;100;26;86;75;101;1;152;52;55;97;53;154;112;4;177;54;34;146;159;193;41;139;198;68;108;18;22;181;42;5;116;65;115;46;93;117;183;89;186;15;62;9;37,817280079428122636,0.086608
greedy_intra:nodes_start:random,124,88909,41016,47893,1170277,469,183;89;186;15;62;3;178;31;113;175;171;16;2;162;149;146;22;18;69;108;117;0;51;151;80;122;100;26;97;167;102;144;14;49;1;101;121;63;127;123;46;68;139;115;116;65;78;145;179;196;81;40;119;106;124;79;133;135;70;154;180;158;53;86;120;25;44;75;112;177;54;34;159;193;41;42;181;160;184;43;59;118;148;9;21;164;90;165;185;52;55;57;92;129;152;94;176;137;23;143,5042261124533958558,0.096017
greedy_intra:nodes_start:random,125,91433,40973,50460,994146,503,53;65;116;43;42;5;115;176;148;49;102;144;14;3;178;106;185;119;40;175;171;16;154;135;70;127;123;180;120;44;25;113;56;31;89;183;143;117;0;137;12;124;94;122;80;23;186;9;62;52;55;57;92;167;46;139;159;193;41;79;63;133;151;51;118;59;131;149;121;97;152;129;165;27;90;81;196;179;145;78;82;2;1;160;34;181;195;22;146;54;177;4;112;184;162;26;101;75;86;100,1706172188112179523,0.100104
greedy_intra:nodes_start:random,126,87867,37504,50363,1027068,468,182;121;100;26;97;178;106;165;119;40;185;52;55;129;1;101;86;75;44;25;92;9;15;114;186;23;80;180;158;154;135;70;35;184;42;5;139;46;68;117;0;143;183;137;51;176;148;102;49;14;144;62;118;160;54;177;4;112;127;123;162;133;79;124;167;57;179;145;31;113;181;34;146;22;159;193;41;115;59;65;116;43;131;149;151;53;16;171;175;81;90;196;78;120;2;152;94;122;63;136,2231865857519453529,0.089993
greedy_intra:nodes_start:random,127,85694,35971,49723,1455719,566,52;55;78;16;171;175;113;56;31;92;15;114;186;137;176;80;94;124;152;1;97;26;100;121;133;151;79;122;63;180;154;70;127;112;184;54;22;18;68;46;0;23;89;183;153;143;117;93;140;167;57;129;2;189;162;149;65;116;59;118;51;148;102;49;185;40;119;90;81;196;179;145;25;44;82;120;75;101;86;193;159;181;34;160;43;42;41;139;115;123;135;53;9;62;144;14;138;165;106;178,4859970563795009581,0.114364
greedy_intra:nodes_start:random,128,86901,37471,49430,1067467,462,16;175;113;31;186;89;183;153;143;117;68;46;139;18;108;140;93;0;176;80;63;94;124;152;167;148;37;9;62;102;49;129;2;1;43;42;22;146;34;54;177;184;160;181;159;193;41;115;23;15;144;52;55;97;26;121;162;65;116;47;131;149;123;135;70;86;82;92;57;179;145;78;196;81;90;165;185;106;178;79;133;151;59;118;51;137;14;138;40;119;180;154;53;100;101;75;120;44;25;171,4718730504002750223,0.089269
greedy_intra:nodes_start:random,129,82501,34056,48445,847081,447,137;186;15;62;148;133;162;112;84;184;54;177;10;190;35;131;149;123;127;70;135;154;180;53;185;40;90;165;138;14;49;178;106;52;31;113;175;171;16;2;152;121;63;79;80;94;1;44;25;78;145;57;55;81;196;179;92;129;82;120;75;86;101;97;26;100;151;59;43;160;48;34;181;42;5;41;193;159;69;18;108;115;116;47;65;118;51;176;9;144;183;143;0;117;68;22;146;139;46;23,899087331723406227,0.082956
greedy_intra:nodes_start:random,130,86462,37037,49425,1137021,521,117;68;46;51;180;158;75;120;92;179;40;185;52;55;57;129;2;63;151;59;42;181;160;184;54;34;22;18;0;89;23;186;114;15;144;14;178;106;145;78;196;81;90;27;164;39;165;167;124;94;176;137;49;102;62;9;37;148;152;97;26;100;53;154;135;70;127;112;123;133;79;121;86;101;1;122;80;118;115;139;159;193;41;116;65;43;84;35;149;162;44;25;16;171;175;113;31;183;143;170,9094813864270773139,0.096459
greedy_intra:nodes_start:random,131,87371,38611,48760,938839,495,62;9;80;151;133;158;53;63;79;122;94;124;12;176;51;118;181;22;159;193;41;115;137;167;52;55;57;97;121;59;131;149;162;75;120;44;16;171;175;113;31;179;185;106;102;89;183;0;68;139;46;14;165;40;90;81;196;145;78;25;70;127;135;154;180;100;26;148;15;186;23;143;117;93;140;108;69;18;5;42;43;116;65;184;160;34;54;177;112;123;86;101;1;152;2;129;92;178;49;144,5056864539288672658,0.094072
greedy_intra:nodes_start:random,132,84370,36077,48293,973494,453,34;181;42;159;193;41;115;148;167;152;124;94;46;139;22;18;108;93;117;143;0;137;9;3;178;106;52;179;157;196;40;185;144;15;186;23;89;183;62;31;113;175;171;16;25;44;75;101;2;120;78;145;57;55;86;112;4;190;10;177;54;184;43;131;149;123;127;70;135;154;180;53;121;100;26;97;1;49;102;14;138;165;90;81;92;129;63;133;162;59;118;51;176;80;122;79;151;65;116;160,6883476266070408540,0.089352
greedy_intra:nodes_start:random,133,84910,33839,51071,979296,483,80;129;92;179;196;81;90;148;122;63;180;154;158;53;133;151;162;149;131;137;186;114;15;144;165;40;185;31;56;113;175;171;16;145;57;55;52;106;138;14;49;102;62;9;3;178;167;152;1;97;26;121;135;70;127;123;65;5;41;193;18;108;143;183;89;23;12;124;94;189;100;86;101;75;44;25;78;120;2;79;118;115;198;46;68;117;0;176;51;59;116;43;42;184;160;34;146;22;159;139,5833243142845802521,0.097573
greedy_intra:nodes_start:random,134,87811,39964,47847,787693,503,149;43;5;42;181;159;193;23;186;62;9;137;0;140;93;117;143;183;89;21;164;165;185;106;178;49;102;57;92;78;145;40;90;81;196;179;129;124;68;108;18;22;34;84;112;162;79;63;121;100;26;1;2;31;113;175;171;16;25;44;120;75;123;184;160;54;177;127;70;180;152;167;144;14;3;55;52;148;176;51;115;41;139;46;118;72;59;116;65;151;133;80;94;97;101;86;53;154;135;131,8946641833255001171,0.086169
greedy_intra:nodes_start:random,135,87723,38107,49616,1067790,498,23;89;183;144;165;90;119;40;185;137;176;51;118;59;5;42;43;47;133;79;94;124;167;129;92;57;148;80;151;162;149;131;10;190;112;127;123;65;116;181;34;30;54;177;48;160;184;35;84;4;135;70;154;152;55;52;106;14;102;62;9;49;178;179;25;44;16;171;175;81;196;78;120;75;101;86;100;26;1;97;121;53;180;115;41;193;139;46;68;108;18;22;159;63;2;113;56;31;145;186,6127714236867930360,0.100289
greedy_intra:nodes_start:random,136,82199,32427,49772,770795,480,27;95;164;7;21;39;165;113;175;171;16;92;57;55;52;94;63;180;154;79;133;151;162;149;65;59;118;80;121;26;97;2;129;82;75;86;123;4;112;127;70;135;158;53;100;189;9;102;14;144;62;15;186;89;183;143;0;117;68;46;139;115;42;43;116;41;193;159;18;22;34;160;54;184;51;176;137;148;37;49;3;106;185;40;119;178;167;124;152;1;101;120;44;25;78;145;31;196;81;90,1227880270068409162,0.087064
greedy_intra:nodes_start:random,137,84866,35296,49570,882453,497,57;179;44;120;75;86;158;53;124;148;9;62;15;114;143;117;93;108;18;193;25;16;171;175;113;31;78;145;81;90;165;40;185;94;79;133;63;136;180;154;70;112;4;177;54;184;123;127;135;162;149;131;59;151;49;102;144;14;138;3;178;106;52;55;167;137;115;139;68;0;23;186;89;183;153;46;65;116;43;42;160;34;22;159;41;118;51;176;80;122;121;100;26;97;101;1;152;2;129;92,4797991958331614151,0.092887
greedy_intra:nodes_start:random,138,87943,37799,50144,1376987,489,55;185;40;119;165;138;15;114;186;79;122;124;148;37;144;14;39;90;81;113;175;171;18;22;159;193;41;42;43;116;65;149;123;127;70;75;16;31;196;106;178;3;49;102;62;9;167;152;1;97;121;63;115;139;68;46;51;80;176;0;117;143;183;89;23;137;94;100;26;101;120;44;25;78;145;92;129;82;2;86;53;162;59;118;72;151;133;180;158;154;135;35;184;160;34;54;177;112;57;52,5786640132260103465,0.100935
greedy_intra:nodes_start:random,139,85775,36168,49607,1659247,567,4;127;158;121;100;26;97;1;101;16;171;175;113;56;31;78;167;186;23;137;152;2;129;92;57;15;114;89;183;143;117;0;46;68;18;22;159;193;41;181;34;54;184;160;42;5;139;115;151;80;94;55;52;3;14;49;102;148;124;189;53;180;154;70;135;79;63;178;106;165;40;185;179;145;25;44;120;75;86;133;162;123;131;149;59;118;51;176;9;62;144;138;39;90;81;196;65;116;43;112,2064242041872468666,0.116205
greedy_intra:nodes_start:random,140,80931,32730,48201,1033192,505,0;89;186;114;102;49;119;40;185;106;148;137;115;41;193;139;68;46;51;176;80;79;63;53;154;180;133;151;118;59;162;123;127;70;135;86;2;129;92;179;57;152;1;101;75;16;171;175;113;31;82;97;26;100;121;94;124;167;178;52;55;196;81;157;78;25;44;120;145;90;165;14;144;62;9;15;23;183;143;108;18;22;146;34;160;54;177;10;4;112;84;184;181;42;43;131;149;65;116;117,258956448771603433,0.093474
greedy_intra:nodes_start:random,141,84813,36295,48518,884678,506,144;49;178;52;55;57;78;171;16;44;120;25;175;113;56;31;145;179;106;3;14;138;165;185;40;119;90;81;196;92;70;112;4;10;177;54;184;176;137;23;117;108;18;22;146;159;193;41;139;46;15;62;9;186;89;183;143;0;42;181;34;160;154;86;75;82;129;2;152;97;121;135;127;123;131;43;65;149;162;180;53;101;1;26;100;63;122;124;94;79;133;151;51;118;115;116;59;80;148;102,5448319146725810010,0.087517
greedy_intra:nodes_start:random,142,84953,36452,48501,1076170,554,164;90;81;196;113;175;31;179;106;52;55;57;92;145;78;171;16;79;151;22;159;193;41;117;0;143;183;89;23;186;49;178;185;40;119;165;138;14;144;102;62;9;148;80;176;51;118;59;139;108;18;123;127;70;135;154;180;35;184;34;181;5;42;160;48;54;177;112;158;86;75;44;25;120;101;26;121;63;122;94;124;152;2;82;129;1;97;100;53;133;162;149;131;65;116;43;115;46;137;21,7932194063401383686,0.107108
greedy_intra:nodes_start:random,143,86846,38803,48043,958300,492,151;118;59;65;43;184;123;135;70;127;112;177;54;34;160;146;22;195;159;193;68;15;62;52;55;57;152;121;53;63;79;133;51;115;139;69;18;108;93;23;186;148;124;94;89;183;143;170;117;0;167;78;175;113;56;31;25;120;75;86;100;26;101;44;16;171;196;81;40;165;90;164;21;144;102;14;185;106;178;3;49;9;137;46;41;181;42;116;176;80;179;145;92;129;2;1;97;180;154;162,7874513200187514159,0.089204
greedy_intra:nodes_start:random,144,86614,34977,51637,938748,520,181;22;18;139;46;68;117;23;186;37;49;102;62;9;15;89;0;143;183;114;144;14;138;3;106;179;92;82;120;25;78;145;31;157;196;81;90;165;119;40;185;113;175;171;16;44;75;70;127;123;184;54;34;160;137;148;178;52;55;57;129;2;152;189;162;65;116;43;131;149;136;100;26;63;122;79;118;115;193;41;59;151;133;180;154;158;86;101;1;97;124;94;121;53;135;194;80;176;51;42,7134309193815757987,0.093543
greedy_intra:nodes_start:random,145,87932,38761,49171,1245052,522,14;178;106;52;55;82;25;44;120;97;63;79;151;115;41;193;159;22;181;160;42;5;43;51;165;90;40;185;179;57;152;189;122;80;176;62;9;148;124;94;133;162;65;116;59;118;137;102;49;144;114;89;183;143;0;46;68;139;108;18;34;54;177;184;131;149;123;180;2;129;145;196;81;31;56;113;175;70;4;112;127;135;154;53;121;100;26;1;101;86;75;16;171;78;92;167;23;186;15;138,7569195903163574998,0.101412
greedy_intra:nodes_start:random,146,86431,37647,48784,1059441,492,120;101;154;135;70;127;131;149;72;151;79;122;63;94;124;148;9;15;186;23;115;41;193;159;42;43;100;26;97;121;133;59;118;51;80;176;137;62;102;167;152;56;113;175;75;86;53;180;162;123;112;84;65;116;46;0;89;114;144;14;165;90;40;185;52;55;145;78;25;2;1;35;184;177;54;160;34;146;22;18;108;139;68;117;143;183;49;178;106;57;129;92;179;196;81;157;31;171;16;44,8025285603720868375,0.093011
greedy_intra:nodes_start:random,147,94053,44101,49952,635224,412,101;135;123;162;183;89;186;23;116;184;84;112;127;70;154;180;53;100;26;80;115;41;193;139;176;92;145;113;175;171;16;44;75;65;43;42;46;0;143;153;137;94;97;2;129;179;185;106;3;14;138;119;40;31;78;25;120;82;57;49;62;9;148;124;122;79;151;59;118;15;144;165;90;81;196;51;109;72;133;63;152;55;52;178;102;114;117;93;140;108;18;22;146;34;160;54;177;4;1;86,1975522656567598872,0.071706
greedy_intra:nodes_start:random,148,91206,41000,50206,910460,536,146;160;149;101;2;129;152;80;118;115;42;181;34;54;177;184;43;116;59;176;167;57;92;179;185;165;40;145;78;16;171;175;113;31;25;75;86;121;136;158;154;180;63;122;124;102;144;14;90;81;196;52;55;70;127;123;65;41;139;23;62;178;106;49;9;137;51;109;46;68;69;18;108;117;0;170;143;186;15;148;44;120;1;97;79;133;151;72;162;135;53;100;26;189;94;89;183;193;159;22,3859426201510681714,0.105404
greedy_intra:nodes_start:random,149,84895,36821,48074,862719,490,151;59;46;68;139;115;137;23;89;183;184;10;177;54;41;193;159;146;34;160;131;120;44;25;145;196;185;106;178;3;167;124;94;63;121;100;86;75;101;1;152;97;26;53;158;180;154;135;70;127;123;112;35;116;65;9;62;102;14;138;49;148;122;79;133;162;149;43;42;181;22;18;117;143;0;118;51;176;15;144;21;164;90;81;31;113;175;171;16;78;57;55;52;165;40;179;92;129;2;80,2021414547765096165,0.088628
greedy_intra:nodes_start:random,150,87057,37305,49752,863947,418,75;101;100;26;121;136;53;158;154;123;112;84;35;184;42;43;151;133;79;122;80;176;193;159;22;146;181;41;137;9;62;15;114;186;23;46;68;139;115;118;51;59;65;116;69;18;108;93;117;0;143;183;89;57;92;129;120;86;70;127;135;180;167;52;55;179;145;78;25;44;16;171;175;113;31;63;162;149;177;54;34;160;148;144;14;178;185;40;90;165;106;49;102;124;94;97;1;152;74;2,860008966253625185,0.084533
greedy_intra:nodes_start:random,151,87326,37624,49702,865728,449,117;143;23;15;62;102;49;144;114;186;137;176;51;59;118;0;183;89;14;165;40;185;31;113;175;171;16;44;75;86;135;149;131;65;116;5;42;160;181;159;193;139;46;9;178;106;167;148;80;151;133;97;1;2;129;92;179;57;152;112;4;190;10;177;54;41;68;93;140;108;69;18;22;34;184;127;70;154;158;53;180;79;63;121;100;26;101;120;78;145;55;52;94;162;123;84;35;43;115;198,1981243156897309816,0.086720
greedy_intra:nodes_start:random,152,88572,38972,49600,804470,469,158;53;86;75;120;113;175;171;16;41;193;22;18;108;139;46;0;143;117;42;160;34;54;177;127;136;182;121;189;94;148;14;21;164;90;165;185;55;26;100;70;135;133;151;162;123;112;84;184;43;115;176;92;145;179;137;23;183;89;186;15;9;62;144;102;49;178;52;57;129;2;101;1;97;152;124;167;82;44;25;78;31;196;81;40;119;106;51;118;59;116;65;131;149;80;122;63;79;180;154,2920423512774816753,0.088937
greedy_intra:nodes_start:random,153,83180,33133,50047,838531,484,4;177;54;149;15;9;62;144;165;90;81;196;31;113;175;171;16;25;44;57;55;52;178;3;49;167;152;97;1;101;75;120;78;145;179;92;129;86;70;135;154;180;158;53;136;182;121;100;189;63;122;79;115;139;42;43;116;65;59;137;23;186;89;183;143;0;46;118;151;80;176;51;68;108;18;22;159;193;41;34;160;184;84;112;127;26;2;40;119;185;106;138;14;102;148;124;94;133;162;123,440514438710681413,0.088361
greedy_intra:nodes_start:random,154,85809,36616,49193,863876,459,106;178;3;49;9;148;124;53;180;154;135;42;159;193;41;139;68;46;121;26;97;1;101;86;100;133;162;149;43;160;54;177;4;112;70;158;75;16;171;175;113;56;179;55;52;102;62;15;176;80;151;118;115;116;65;59;51;23;186;137;123;35;184;34;22;18;108;93;117;0;143;183;89;25;44;120;2;63;79;122;94;152;82;145;78;31;157;196;81;90;165;40;57;92;129;167;144;14;138;185,8433646417044941683,0.085994
greedy_intra:nodes_start:random,155,85108,35210,49898,1589284,623,70;177;54;34;160;184;133;148;37;15;186;89;183;143;117;0;176;80;79;139;41;193;159;22;18;68;46;115;116;47;131;149;123;135;63;94;100;26;101;1;97;152;2;120;44;31;81;90;119;40;185;179;55;52;106;178;164;7;21;144;102;49;14;138;165;196;145;78;25;129;92;57;62;9;137;118;59;109;51;151;112;84;35;77;43;42;5;65;162;180;154;158;53;86;75;16;171;175;113;56,6656929129309608694,0.134181
greedy_intra:nodes_start:random,156,90030,40437,49593,892783,444,175;16;75;70;177;54;35;180;53;100;26;63;79;80;5;42;43;116;162;133;151;59;65;131;149;123;194;135;127;160;34;146;22;181;184;84;4;112;154;86;101;1;97;152;167;3;178;106;179;145;78;120;2;124;139;159;193;41;115;176;49;102;62;9;15;186;137;51;118;46;68;183;89;23;148;129;82;92;57;55;52;196;31;25;44;94;0;117;143;114;144;14;165;185;40;119;90;81;113;171,5997208817420736528,0.080649
greedy_intra:nodes_start:random,157,87204,37611,49593,951790,471,52;55;49;102;144;15;89;183;143;46;115;5;42;160;184;43;149;162;133;63;97;152;57;185;40;165;138;14;186;23;137;94;189;158;154;135;194;127;123;124;167;62;9;148;176;80;79;122;121;26;1;129;92;179;145;31;113;56;196;90;81;175;171;16;78;82;2;101;86;53;180;151;59;118;51;0;117;93;68;139;193;41;116;65;100;120;25;44;75;70;112;177;54;34;146;22;18;108;178;106,507202178824427743,0.092180
greedy_intra:nodes_start:random,158,88663,38790,49873,731502,460,41;80;12;148;124;94;152;97;1;26;121;63;167;55;196;113;175;171;82;129;2;101;86;100;53;158;122;137;23;0;143;183;89;114;49;178;3;14;144;176;51;59;123;127;162;133;79;151;43;42;193;18;108;117;106;52;40;90;165;185;179;145;78;92;57;102;62;9;15;186;46;139;115;116;65;180;120;25;31;56;16;44;75;154;135;70;112;4;84;35;149;131;184;177;54;160;34;146;22;159,4731757498357408696,0.079975
greedy_intra:nodes_start:random,159,84600,36121,48479,915476,517,177;160;181;18;108;93;117;0;68;139;193;41;42;43;184;84;112;35;131;149;123;133;79;180;53;1;2;120;75;101;86;26;100;63;80;176;148;9;62;102;144;15;51;151;162;135;70;154;129;92;78;113;56;31;145;196;40;119;106;178;114;186;23;89;183;143;46;198;115;116;65;59;44;16;171;175;81;90;164;21;14;49;167;124;94;189;97;152;57;55;52;185;165;138;137;159;22;146;34;54,3968403880198344710,0.086543
greedy_intra:nodes_start:random,160,84921,34917,50004,1042766,452,146;22;159;43;162;180;154;118;115;41;193;181;160;42;5;139;46;9;62;102;49;14;144;143;117;93;108;18;68;80;79;101;75;1;97;63;122;94;124;26;86;100;121;53;158;135;123;127;70;145;31;56;113;175;171;16;78;25;44;120;129;57;55;52;106;178;3;37;148;167;185;40;119;165;90;81;196;92;2;152;133;151;72;149;131;0;183;89;23;137;176;51;59;65;116;184;177;54;34;103,3547826923507068571,0.087440
greedy_intra:nodes_start:random,161,82579,32867,49712,1271870,498,118;51;176;137;102;178;106;3;14;144;15;114;89;183;143;117;108;69;18;22;34;160;54;184;65;116;46;68;139;41;181;42;43;149;123;127;70;135;154;167;52;185;40;55;57;129;92;179;196;81;90;27;39;165;119;138;49;59;115;193;159;0;23;186;62;9;148;124;94;79;133;162;151;80;122;63;152;97;100;53;180;158;86;1;2;16;171;175;113;56;31;145;78;25;44;120;75;101;26;121,3632160357276370076,0.104876
greedy_intra:nodes_start:random,162,84453,35543,48910,966287,456,117;0;68;139;181;42;43;131;149;162;133;136;121;100;189;94;167;9;62;102;49;196;157;31;171;175;113;81;90;178;176;51;118;46;115;5;116;65;59;151;79;63;124;148;144;14;138;165;119;40;185;106;52;179;92;57;55;137;193;159;41;80;145;78;16;25;129;152;97;1;101;86;75;44;120;2;26;53;180;154;135;70;127;123;112;4;84;184;177;54;160;34;22;18;108;183;89;186;23;143,861083975661754843,0.089678
greedy_intra:nodes_start:random,163,83497,33574,49923,1003992,510,0;46;118;51;176;137;23;89;186;15;62;144;14;138;106;185;40;196;145;92;57;129;82;25;44;120;75;101;86;133;151;41;159;22;18;193;139;115;59;80;122;148;167;152;189;124;94;63;79;135;70;127;123;112;4;10;177;54;34;160;42;43;184;35;78;16;171;175;113;56;31;81;90;165;52;55;2;1;97;26;100;121;136;53;158;154;180;162;149;131;65;116;9;178;3;49;102;183;143;117,1747191257352451702,0.087620
greedy_intra:nodes_start:random,164,86753,37229,49524,870305,483,145;133;116;43;42;5;115;139;41;193;159;22;146;34;160;54;184;112;135;154;158;53;100;101;1;26;136;162;65;131;149;123;127;70;180;94;124;152;97;121;63;122;79;151;59;118;148;138;165;90;40;106;3;14;144;62;9;15;186;176;51;46;0;183;89;23;129;92;179;57;178;49;102;167;55;52;185;196;81;113;175;171;16;44;120;2;137;143;117;93;108;18;68;80;86;75;25;56;31;78,8734160272887068436,0.087029
greedy_intra:nodes_start:random,165,87438,38057,49381,803518,433,144;176;80;122;79;133;151;59;149;131;35;184;43;89;183;143;117;0;23;186;15;37;148;124;94;121;101;1;2;185;119;90;81;113;175;171;16;75;86;63;51;118;46;139;115;116;65;47;41;193;181;54;177;112;70;154;135;127;123;162;49;3;179;78;25;44;120;53;180;159;18;22;146;34;48;160;42;5;137;9;62;167;152;100;26;97;129;92;52;106;178;55;57;145;31;196;40;165;14;102,2080943454831558922,0.077442
greedy_intra:nodes_start:random,166,84597,36757,47840,1100001,514,178;14;144;15;9;62;102;49;167;148;176;51;59;118;46;0;117;93;68;139;115;43;116;65;151;79;63;121;26;100;180;154;135;149;184;160;181;42;80;94;124;152;2;120;75;101;86;53;133;162;123;127;70;44;25;89;183;143;108;18;193;41;159;22;146;103;34;54;177;10;190;4;112;97;1;55;52;196;113;31;145;57;186;23;137;129;92;78;16;171;175;81;90;27;39;165;119;40;185;106,111735815765969966,0.097288
greedy_intra:nodes_start:random,167,88741,39104,49637,998967,474,140;117;68;159;146;34;181;42;59;51;176;167;185;179;145;78;25;120;2;152;94;80;109;115;193;41;5;116;47;131;149;162;44;171;175;16;75;86;100;158;70;127;123;135;154;180;133;151;79;124;165;90;81;113;31;157;196;40;62;9;137;118;43;160;54;177;184;65;15;144;14;49;178;106;1;97;189;122;63;53;121;26;101;129;92;57;55;52;148;23;89;183;143;0;46;139;22;18;108;93,2365697598874267283,0.092154
greedy_intra:nodes_start:random,168,85327,35500,49827,787908,468,54;34;160;42;43;131;149;123;70;1;2;57;185;119;40;196;157;56;113;175;171;16;31;165;14;102;49;178;106;52;124;94;23;89;183;0;46;118;109;51;176;137;186;148;167;152;101;75;44;25;82;129;92;179;81;90;27;164;144;62;80;151;133;79;97;120;78;145;55;9;143;117;68;139;108;18;22;146;181;5;96;115;116;47;65;59;162;63;121;100;26;86;53;180;154;135;41;193;184;177,7233049164399658843,0.090128
greedy_intra:nodes_start:random,169,88033,38987,49046,713519,401,86;53;149;65;116;68;117;143;0;176;80;79;133;162;123;35;84;112;4;177;54;184;160;34;41;193;159;108;18;22;181;42;43;63;94;124;40;165;39;95;164;27;90;81;196;175;171;16;25;44;82;9;62;102;49;3;129;2;101;1;152;55;52;106;178;154;135;59;115;139;46;148;37;57;179;185;14;144;15;137;51;109;118;151;180;75;120;78;113;31;145;92;167;186;89;183;23;97;100;26,915790822926924217,0.070220
greedy_intra:nodes_start:random,170,87908,38825,49083,1038868,498,124;55;52;106;178;49;102;9;62;144;14;165;90;40;196;31;113;175;171;16;53;180;146;22;159;139;115;118;51;121;100;26;1;129;92;179;57;148;116;43;42;5;59;176;122;152;2;120;44;75;101;97;137;23;153;0;46;65;47;162;133;79;80;151;149;131;112;4;84;35;184;181;41;193;69;108;18;34;54;177;48;160;68;117;143;183;89;186;185;145;78;25;86;154;70;127;123;135;63;94,6232143759273711341,0.093670
greedy_intra:nodes_start:random,171,87172,37804,49368,1158638,439,54;160;42;43;123;154;75;82;92;179;145;31;78;129;137;0;170;143;117;108;18;139;115;116;65;131;149;80;9;62;152;1;101;86;70;4;112;127;135;196;81;56;113;175;171;16;25;44;120;2;148;15;186;89;183;23;124;97;26;100;121;53;158;180;63;79;133;151;51;118;59;41;181;34;103;146;22;159;193;68;46;176;57;55;52;185;40;90;165;14;144;102;49;3;178;106;167;94;162;184,8972493198805337749,0.091594
greedy_intra:nodes_start:random,172,87153,37947,49206,978194,485,63;124;49;165;90;81;196;80;176;46;68;108;69;18;159;22;34;160;54;177;184;112;123;162;133;79;86;75;16;171;175;40;119;185;152;70;127;135;154;180;53;100;26;94;89;183;153;0;140;93;117;143;114;144;14;31;56;113;78;145;179;52;106;3;178;55;57;129;2;1;97;51;118;115;41;193;139;137;23;186;15;62;9;37;148;167;92;25;44;120;101;149;131;43;42;116;65;59;151;122,338004552560742894,0.091341
greedy_intra:nodes_start:random,173,85224,34855,50369,788004,497,178;102;62;9;122;79;137;23;89;183;143;0;46;118;51;162;149;131;43;184;54;177;10;4;112;127;70;53;97;1;129;78;145;80;176;116;65;123;135;154;180;121;94;124;148;37;15;186;114;144;49;31;56;113;175;171;16;25;101;26;100;63;133;151;72;59;160;34;181;42;115;139;41;193;159;22;18;68;86;75;120;44;82;2;152;167;185;119;40;90;165;138;14;52;55;57;92;179;106;3,1641730236142837935,0.091483
greedy_intra:nodes_start:random,174,88303,38328,49975,1153400,494,154;180;133;151;79;122;63;94;3;165;27;90;81;179;80;176;51;149;184;84;112;127;70;100;101;1;97;26;121;123;177;54;160;34;181;42;5;43;116;65;59;23;15;62;9;37;167;129;82;92;57;55;52;178;106;185;119;40;196;157;56;113;31;145;78;25;120;148;186;89;114;102;49;14;144;183;18;22;159;53;86;75;16;175;171;44;2;152;124;137;143;0;46;139;193;41;115;118;162;135,4351410245041517427,0.092839
greedy_intra:nodes_start:random,175,93752,43539,50213,860725,448,120;2;152;167;148;102;62;9;15;137;51;149;131;112;35;43;116;183;89;65;47;162;79;122;55;52;179;145;92;159;22;195;146;103;34;160;181;42;80;94;124;189;97;1;101;86;123;184;54;177;127;70;135;154;53;158;180;133;151;41;193;23;186;144;165;40;185;57;129;26;100;63;139;69;18;108;140;93;115;59;118;0;143;117;68;46;176;75;16;171;175;113;31;14;49;178;106;78;25;44,6431139884383432332,0.080478
greedy_intra:nodes_start:random,176,87541,38139,49402,1582654,554,159;181;42;116;59;118;115;46;139;41;193;18;108;117;143;186;15;49;3;178;106;185;165;119;40;179;57;124;176;65;43;184;149;162;133;151;51;0;153;183;89;23;137;2;82;129;92;78;31;113;175;70;123;54;177;4;112;127;135;154;90;81;196;145;1;101;120;25;171;16;44;75;86;121;63;122;79;80;94;55;52;138;14;144;62;9;37;148;167;152;97;26;100;53;180;160;34;146;22;195,8325510233058145649,0.114483
greedy_intra:nodes_start:random,177,86540,36873,49667,800760,462,44;120;82;145;78;16;75;53;133;151;47;43;116;65;162;100;26;94;124;23;89;183;144;102;3;106;178;37;148;186;114;15;62;9;137;18;159;22;146;34;30;54;48;160;181;42;193;41;115;139;68;117;143;0;46;118;59;51;129;179;31;113;175;171;154;70;127;112;4;177;184;131;149;123;135;180;79;80;176;63;121;86;101;2;55;52;185;40;90;165;1;97;152;167;49;14;138;57;92;25,1797440775794714956,0.078688
greedy_intra:nodes_start:random,178,89783,40707,49076,780190,422,100;152;55;52;62;9;118;116;42;34;160;43;80;167;178;106;138;14;102;49;25;44;75;86;151;59;41;193;159;22;18;108;117;143;23;186;137;148;124;94;176;51;46;115;139;68;0;183;89;15;144;165;90;81;175;171;16;78;82;2;101;53;158;180;136;121;97;1;57;185;119;40;179;154;135;127;70;120;145;31;113;56;196;92;129;63;122;79;133;123;112;4;190;10;177;54;184;65;162;26,353409412502257384,0.073429
greedy_intra:nodes_start:random,179,87428,38408,49020,1384505,483,115;118;186;15;52;55;167;124;184;54;177;4;112;94;49;14;144;62;9;37;148;42;181;34;160;70;75;44;25;82;92;57;129;152;26;100;121;180;135;154;53;86;101;196;81;90;40;119;165;138;3;178;106;185;179;16;171;175;113;31;145;78;120;2;1;97;63;59;193;159;22;18;108;68;46;80;79;133;151;162;127;123;149;131;47;116;139;117;0;143;183;89;23;137;176;51;65;43;5;41,5010347263481851279,0.097743
greedy_intra:nodes_start:random,180,82814,33630,49184,1809011,601,121;189;97;1;152;55;52;185;106;178;49;137;118;59;151;154;180;63;94;124;167;40;165;90;81;196;16;171;175;113;31;78;145;179;57;92;129;122;79;123;35;184;131;149;162;133;80;148;102;62;9;15;114;89;183;143;0;46;115;116;65;43;42;181;41;193;18;108;117;23;186;144;14;176;51;139;159;22;146;34;160;54;177;112;127;70;135;158;86;101;75;120;44;25;82;2;26;100;53;136,2826001300501450205,0.129846
greedy_intra:nodes_start:random,181,83616,34354,49262,1123934,541,162;149;131;160;184;84;35;49;144;62;9;152;97;26;135;123;43;42;159;193;41;115;118;51;148;37;15;114;0;46;68;117;143;183;89;186;23;137;133;79;63;122;80;176;139;108;18;22;34;48;54;177;112;127;70;154;180;158;53;100;86;75;101;1;2;120;44;25;145;179;57;129;82;92;78;31;113;175;171;16;55;52;185;40;106;178;14;138;165;90;81;196;167;124;94;59;116;65;47;151,707018908326631662,0.101585
greedy_intra:nodes_start:random,182,87092,37729,49363,859816,494,120;63;133;162;127;70;148;9;62;49;178;106;52;55;53;158;180;136;152;57;185;40;90;165;167;124;94;135;154;100;1;129;31;56;175;113;81;196;92;25;16;171;78;145;179;14;144;102;97;101;75;86;26;121;122;80;59;5;42;160;184;131;149;43;181;146;22;18;108;93;117;143;183;89;0;68;46;118;51;176;137;186;23;123;112;177;54;34;193;41;139;115;116;65;151;79;189;2;82;44,2127435714339376662,0.085983
greedy_intra:nodes_start:random,183,91287,40621,50666,1579142,525,196;40;185;106;178;97;100;53;158;180;63;80;176;137;183;89;114;144;14;102;51;118;59;159;18;22;34;42;116;65;151;79;124;167;52;55;57;129;74;152;1;2;120;44;25;82;92;78;113;56;31;145;179;3;49;62;9;148;133;162;123;149;131;184;43;115;46;23;186;94;189;182;121;26;101;75;86;154;135;127;112;177;54;160;70;16;171;175;143;117;193;41;139;0;15;138;165;27;90;81,2478408097996887425,0.111745
greedy_intra:nodes_start:random,184,83805,35494,48311,1007815,473,44;171;16;70;184;160;181;42;5;43;65;162;151;63;86;101;2;129;40;119;81;196;75;53;180;133;79;80;176;51;109;118;59;116;41;193;159;22;18;108;139;115;46;117;0;137;15;144;14;102;49;3;178;167;148;124;94;100;26;152;185;165;90;27;164;7;106;52;57;92;78;113;175;31;145;179;55;62;9;114;186;23;89;183;143;68;34;54;177;4;112;123;127;135;154;121;97;1;120;25,3505825146286150711,0.088255
greedy_intra:nodes_start:random,185,80814,29206,51608,1078494,538,53;133;151;65;116;47;77;43;42;5;96;41;193;159;22;18;108;93;117;68;139;181;34;160;131;51;137;23;186;148;9;62;49;178;3;14;138;106;52;55;57;129;120;2;152;1;101;63;79;80;176;94;124;189;180;154;135;194;162;59;118;115;198;46;0;143;183;144;165;40;185;196;179;92;145;78;31;56;113;175;171;16;25;44;75;86;70;127;123;112;4;177;54;184;149;121;97;26;100;158,7026205917753739185,0.096771
greedy_intra:nodes_start:random,186,86643,37557,49086,1016784,459,113;31;145;0;143;183;89;57;78;171;16;70;127;112;4;184;34;146;22;18;115;116;47;131;149;65;59;118;151;133;100;26;97;1;86;101;2;55;52;102;62;9;15;186;23;46;68;139;198;109;51;176;49;178;106;185;40;119;165;90;81;196;92;129;152;80;79;180;154;53;63;94;124;167;14;144;148;137;43;42;41;193;159;181;160;54;177;10;190;84;35;123;162;135;75;120;44;25;175;56,1179076783170103270,0.086767
greedy_intra:nodes_start:random,187,85567,36299,49268,748504,511,176;80;72;59;149;131;65;46;68;93;140;69;108;18;22;146;121;100;26;86;53;180;133;162;47;43;5;41;139;198;115;123;127;112;4;177;54;184;160;34;181;42;116;124;55;52;106;165;90;113;175;56;31;78;25;44;75;101;97;1;129;57;178;49;148;94;154;70;135;151;51;0;143;117;159;193;118;79;63;152;2;120;82;92;145;16;171;157;196;81;40;185;14;144;62;9;183;89;23;137,8947017824511106857,0.094865
greedy_intra:nodes_start:random,188,85278,37054,48224,906852,472,23;52;55;57;101;86;26;100;63;162;4;112;70;154;158;53;180;135;127;123;149;131;65;116;43;96;5;42;34;160;80;124;167;185;40;165;14;144;102;62;9;15;114;89;183;143;117;0;118;51;176;148;49;178;106;179;31;113;175;171;16;25;44;120;75;35;184;54;177;84;152;92;90;81;196;145;78;129;2;1;97;94;79;133;151;59;115;41;193;181;146;22;159;18;108;139;68;46;137;186,8106313234006038746,0.085459
greedy_intra:nodes_start:random,189,82174,33671,48503,871408,497,158;154;70;127;112;4;84;35;51;176;137;23;0;143;183;89;186;62;102;14;178;106;40;185;52;55;49;9;148;80;79;133;151;131;184;54;177;10;123;162;118;59;41;193;159;5;42;65;53;100;26;121;63;94;124;152;97;1;2;120;16;171;175;113;31;145;78;25;44;75;86;101;129;92;57;165;90;21;144;15;117;139;115;46;68;140;108;18;22;146;181;34;48;160;43;116;47;149;135;180,8996106071126745100,0.094864
greedy_intra:nodes_start:random,190,87461,38219,49242,1305816,566,14;15;186;23;137;176;51;41;193;139;117;143;183;57;92;129;2;1;97;121;63;94;124;185;40;119;165;90;81;196;52;55;0;108;18;22;146;159;181;180;100;26;152;167;62;9;80;59;65;43;160;34;54;177;10;184;112;123;101;44;16;171;175;113;56;31;145;179;106;178;49;102;148;122;79;149;131;47;116;42;5;115;46;118;151;133;162;194;127;70;135;154;53;86;75;120;25;78;3;144,5278530136896678275,0.107569
greedy_intra:nodes_start:random,191,88757,40061,48696,812389,454,100;152;167;9;62;15;63;154;70;135;162;59;118;115;46;0;143;117;22;159;193;176;80;94;129;92;120;75;101;121;53;180;133;151;79;97;1;2;57;55;52;185;165;39;138;14;144;186;23;89;183;137;51;43;177;54;48;160;34;181;42;5;96;41;139;68;108;18;69;116;65;44;16;171;175;113;25;86;123;149;131;184;112;127;78;31;145;179;40;119;178;106;196;81;90;49;102;148;124;26,1840493737224172386,0.089035
greedy_intra:nodes_start:random,192,83936,32925,51011,748440,453,62;9;186;23;89;183;137;12;124;2;120;25;175;171;16;44;75;70;177;54;34;160;184;84;112;127;135;154;180;162;115;139;46;117;143;0;51;133;151;65;47;43;42;181;22;159;193;41;5;116;118;59;149;131;35;123;79;14;144;148;176;80;63;94;152;1;97;121;53;158;100;26;86;101;129;92;179;52;185;8;40;81;196;113;31;78;145;57;55;178;106;119;90;27;39;165;138;3;49;102,6596822351470013266,0.077487
greedy_intra:nodes_start:random,193,82655,33063,49592,1363761,470,1;152;167;52;55;57;129;120;82;92;179;196;81;90;165;3;176;80;151;162;59;18;108;140;93;46;118;65;116;42;5;115;198;68;117;0;137;23;186;144;14;138;119;40;185;106;178;31;113;175;171;16;44;25;78;145;2;75;97;94;124;148;49;102;62;9;15;89;183;143;139;41;160;48;184;123;135;180;100;26;121;63;122;79;133;149;43;193;22;146;34;54;177;112;127;70;154;53;86;101,610334711284865951,0.102426
greedy_intra:nodes_start:random,194,93287,43103,50184,1291592,493,39;138;49;46;41;193;34;160;123;127;70;154;16;171;175;78;82;26;100;121;53;86;75;44;25;120;101;151;59;5;42;43;116;65;131;149;162;133;63;94;167;55;57;92;129;2;1;97;152;106;178;3;14;144;183;143;117;22;18;108;140;93;89;114;37;148;184;177;4;112;135;180;185;40;119;165;52;124;122;79;80;137;186;15;62;9;176;51;118;115;139;68;0;23;179;145;31;113;81;90,1589089196932343209,0.103656
greedy_intra:nodes_start:random,195,86045,37361,48684,1057482,473,153;186;15;57;129;53;180;154;135;70;127;112;35;65;116;115;46;139;159;146;34;160;184;149;44;16;171;175;113;31;157;179;92;75;86;101;2;55;52;3;167;94;79;43;54;177;84;123;162;151;133;63;121;100;26;80;176;9;62;144;14;90;81;196;145;78;25;120;1;97;152;178;106;185;40;119;165;49;148;51;59;5;41;193;69;108;18;22;181;42;118;137;23;89;183;143;117;93;140;0,8884337319775051061,0.088812
greedy_intra:nodes_start:random,196,84633,35405,49228,907761,526,189;121;100;26;97;101;1;152;2;129;92;80;46;68;117;93;108;18;159;22;146;34;54;177;4;112;127;70;154;158;86;120;44;25;55;106;178;167;53;180;63;79;133;118;198;139;193;41;5;115;43;42;181;160;184;116;65;59;51;9;62;102;49;14;165;40;185;57;75;135;123;131;149;162;151;176;137;186;15;144;52;179;145;78;196;81;31;113;175;171;16;148;114;183;143;0;89;23;124;94,8033720551054534467,0.096951
greedy_intra:nodes_start:random,197,89167,40766,48401,1112255,470,158;70;127;123;162;133;121;100;26;97;63;118;115;139;69;108;18;22;159;86;101;1;2;52;185;81;196;179;92;129;82;25;175;113;56;31;145;55;57;78;171;16;44;120;75;152;167;9;62;15;186;23;89;183;143;0;43;184;48;54;177;112;94;124;106;178;49;102;148;65;116;42;160;34;181;137;14;138;40;90;165;144;117;93;68;46;51;176;80;79;151;59;193;41;131;149;135;154;180;53,1136342253179213816,0.101153
greedy_intra:nodes_start:random,198,87773,36916,50857,1062753,481,92;57;55;52;185;179;145;82;2;152;133;151;51;176;119;40;81;196;31;78;101;86;158;180;123;43;42;181;34;160;54;177;184;116;89;183;143;117;0;46;68;108;18;22;159;193;41;139;115;118;100;26;1;97;63;79;80;94;124;189;121;53;154;135;194;127;70;75;44;120;102;144;15;137;59;65;131;149;162;25;16;171;175;113;56;90;165;106;178;37;148;9;62;49;3;138;14;128;167;129,1241714583495018302,0.089752
greedy_intra:nodes_start:random,199,84725,32059,52666,726073,432,160;34;146;22;159;137;23;186;55;179;145;78;82;44;25;31;56;113;175;171;16;120;1;97;26;100;121;136;133;151;41;193;5;42;43;116;65;149;131;72;51;176;148;9;62;49;57;92;129;2;152;124;94;80;79;63;180;154;135;70;53;101;75;86;127;123;162;59;118;115;198;46;93;140;36;108;18;69;163;110;68;117;143;144;165;40;185;52;106;178;14;102;15;89;183;0;139;181;184;54,8537810269032506765,0.072410
greedy_intra:nodes_start:greedy,0,70628,22423,48205,130544,14,0;117;143;183;89;186;23;137;176;80;79;63;94;124;152;97;1;101;2;120;82;129;92;57;55;52;49;102;148;9;62;144;14;3;178;106;185;40;165;90;81;196;179;145;78;31;56;113;175;171;16;25;44;75;86;26;100;121;53;180;154;135;70;127;123;162;133;151;51;118;59;65;116;43;184;84;112;4;190;10;177;54;48;160;34;146;22;18;108;69;159;181;42;5;41;193;139;115;46;68,3483967338855390150,0.005832
greedy_intra:nodes_start:greedy,1,71666,23477,48189,36897,3,1;101;75;86;53;154;70;135;180;63;79;133;51;118;59;115;46;0;143;117;93;140;68;139;193;41;5;42;181;159;69;108;18;22;146;34;160;48;54;177;10;184;43;116;65;149;123;127;162;151;80;176;137;23;183;89;186;114;15;9;62;144;14;138;185;40;165;90;81;196;179;145;78;31;56;113;175;171;16;25;44;120;2;129;92;57;55;52;106;178;49;102;148;124;94;121;100;26;97;152,4629231467993603776,0.001154
greedy_intra:nodes_start:greedy,2,71822,23682,48140,15887,3,2;129;57;92;55;52;49;102;148;9;62;144;14;3;178;106;185;165;40;90;81;196;179;145;78;31;56;113;175;171;16;25;44;120;75;86;26;124;94;63;79;80;176;133;151;51;118;59;115;46;0;137;23;186;89;183;143;117;93;140;68;139;193;41;5;42;181;159;69;108;18;22;146;34;160;48;54;177;10;190;84;184;43;116;65;131;149;162;123;127;70;135;154;180;53;100;101;1;97;152,3399335740873744977,0.000998
greedy_intra:nodes_start:greedy,3,71292,23221,48071,156104,16,185;14;144;62;9;148;102;49;178;106;52;55;57;92;129;2;101;1;97;26;100;53;180;154;135;70;127;123;162;149;131;65;116;43;184;84;190;10;177;54;48;160;34;146;22;18;108;69;159;181;42;5;41;193;139;68;140;93;117;143;183;89;186;23;137;0;46;115;59;118;51;151;133;176;80;79;63;94;124;152;86;75;120;44;25;16;171;175;113;56;31;78;145;179;196;81;90;165;119;40,5878893834572034181,0.006997
greedy_intra:nodes_start:greedy,4,71590,23413,48177,65430,6,4;190;10;177;54;48;34;160;42;181;146;22;18;108;69;159;193;41;139;68;46;115;118;59;65;116;43;184;35;131;149;123;162;133;151;51;0;117;143;183;89;23;137;176;80;79;63;94;124;152;97;1;101;2;120;82;129;92;57;55;52;49;102;148;9;62;144;14;3;178;106;185;165;40;90;81;196;179;145;78;31;56;113;175;171;16;25;44;75;86;26;100;121;53;180;154;135;70;127;112,2531175753547392181,0.002571
greedy_intra:nodes_start:greedy,5,71647,23524,48123,29515,3,5;43;116;65;149;123;127;162;151;133;135;70;154;180;53;121;100;26;86;75;44;25;16;171;175;113;56;31;78;145;179;196;81;90;40;165;185;106;178;3;14;144;62;9;148;102;49;52;55;92;57;129;82;120;2;101;1;97;152;124;94;63;79;80;176;137;23;186;89;183;143;117;0;51;118;59;115;46;68;139;41;193;159;69;108;18;22;146;181;34;160;48;54;177;10;4;112;84;184;42,8684674801367214842,0.001579
greedy_intra:nodes_start:greedy,6,71746,23176,48570,79694,8,154;158;53;121;100;26;86;75;101;1;97;152;94;124;148;102;49;178;106;52;55;57;92;129;2;120;44;25;16;171;175;113;56;31;78;145;179;196;81;90;165;40;185;138;14;144;62;9;15;114;186;89;183;23;137;176;80;151;162;127;123;149;65;116;43;184;177;54;48;160;34;146;22;18;108;69;159;181;42;5;41;193;139;68;140;93;117;143;0;46;115;59;118;51;133;79;63;135;70;180,3023325149462262513,0.004029
greedy_intra:nodes_start:greedy,7,72454,24489,47965,63041,6,164;21;144;62;9;148;102;49;14;178;106;52;55;185;165;40;179;145;78;92;57;129;2;152;97;1;26;100;53;180;154;135;70;127;123;162;149;65;116;43;184;177;54;48;160;34;146;22;18;108;69;159;181;42;5;41;193;139;68;140;93;117;143;183;89;23;137;0;46;115;59;118;51;151;133;176;80;79;63;94;124;101;86;75;120;44;25;16;171;175;113;56;31;157;196;81;90;27;95;7,6064091358018570089,0.003004
greedy_intra:nodes_start:greedy,8,71693,24246,47447,68993,13,164;165;185;40;90;81;196;179;145;78;31;56;113;175;171;16;25;44;120;75;86;101;124;94;63;79;80;176;133;151;51;118;59;115;46;0;137;23;186;89;183;143;117;93;140;68;139;193;41;5;42;181;159;69;108;18;22;146;34;160;48;54;177;10;190;184;43;116;65;131;149;162;123;127;70;135;154;180;53;100;26;1;97;152;2;129;92;57;55;52;106;178;49;102;148;9;62;144;14;21,5851659190746123483,0.004033
greedy_intra:nodes_start:greedy,9,71393,23331,48062,19986,2,9;148;102;49;178;106;52;55;57;92;129;2;152;97;1;101;100;53;180;154;135;70;127;123;162;149;131;65;116;43;184;84;190;10;177;54;48;160;34;146;22;18;108;69;159;181;42;5;41;193;139;68;140;93;117;143;183;89;186;23;137;0;46;115;59;118;51;151;133;176;80;79;63;94;124;26;86;75;120;44;25;16;171;175;113;56;31;78;145;179;196;81;90;40;185;165;138;14;144;62,4314336721920538607,0.001000
greedy_intra:nodes_start:greedy,10,71866,23689,48177,63663,6,10;190;4;112;127;70;135;154;180;53;121;100;26;86;75;44;25;16;171;175;113;56;31;78;145;179;196;81;90;40;165;185;106;178;3;14;144;62;9;148;102;49;52;55;92;57;129;82;120;2;101;1;97;152;124;94;63;79;80;176;137;23;89;183;143;117;0;51;151;133;162;123;149;131;35;184;43;116;65;59;118;115;46;68;139;193;41;159;69;108;18;22;146;181;42;160;34;48;54;177,4253908206129318992,0.002008
greedy_intra:nodes_start:greedy,11,72265,23898,48367,18921,3,131;149;84;4;112;127;123;162;151;133;135;70;154;180;53;121;100;26;86;75;44;25;16;171;175;113;56;31;78;145;179;196;81;90;40;165;185;106;178;3;14;144;62;9;148;102;49;52;55;92;57;129;82;120;2;101;1;97;152;124;94;63;79;80;176;137;23;186;89;183;143;117;0;51;118;59;115;139;68;46;65;116;43;42;5;41;193;159;69;108;18;22;146;181;34;160;48;54;177;184,8198264688798550580,0.000000
greedy_intra:nodes_start:greedy,12,72443,23476,48967,22466,1,124;94;152;97;1;101;2;120;82;129;57;92;179;145;78;31;56;113;175;171;16;25;44;75;86;26;100;121;53;158;154;70;135;180;63;79;133;51;118;59;115;46;0;143;117;93;140;68;139;193;41;5;42;181;159;69;108;18;22;146;34;160;48;54;177;184;43;116;65;149;123;162;151;80;176;137;23;183;89;186;114;15;9;62;144;14;138;165;90;81;196;40;185;55;52;106;178;49;102;148,2687990213759542418,0.001000
greedy_intra:nodes_start:greedy,13,72149,23834,48315,60830,8,56;157;145;78;92;179;196;81;90;165;40;185;106;178;3;14;144;62;9;148;102;49;52;55;57;129;2;152;97;1;26;100;53;180;154;135;70;127;123;162;149;131;65;116;43;184;190;10;177;54;48;160;34;146;22;18;108;69;159;181;42;5;41;193;139;68;140;93;117;143;183;89;186;23;137;0;46;115;59;118;51;151;133;176;80;79;63;94;124;101;86;75;120;44;25;16;171;175;113;31,3346900994672217629,0.002811
greedy_intra:nodes_start:greedy,14,71391,23329,48062,46140,4,14;144;62;9;148;102;49;178;106;52;55;57;92;129;2;152;97;1;26;100;53;180;154;135;70;127;123;162;149;131;65;116;43;184;84;190;10;177;54;48;160;34;146;22;18;108;69;159;181;42;5;41;193;139;68;140;93;117;143;183;89;186;23;137;0;46;115;59;118;51;151;133;176;80;79;63;94;124;101;86;75;120;44;25;16;171;175;113;56;31;78;145;179;196;81;90;40;185;165;138,4437320135410377651,0.001548
greedy_intra:nodes_start:greedy,15,71482,23460,48022,67632,6,148;144;14;138;185;40;165;90;81;196;179;145;78;31;56;113;175;171;16;25;44;120;75;86;152;124;94;63;79;80;176;133;151;51;118;59;115;46;0;137;23;186;89;183;143;117;93;140;68;139;193;41;5;42;181;159;69;108;18;22;146;34;160;48;54;177;10;190;184;43;116;65;131;149;162;123;127;70;135;154;180;53;100;26;97;1;101;2;129;92;57;55;52;106;178;49;102;62;9;15,775022266170613294,0.002778
greedy_intra:nodes_start:greedy,16,71671,23531,48140,86259,8,16;25;44;120;75;86;26;124;94;63;79;80;176;133;151;51;118;59;115;46;0;137;23;186;89;183;143;117;93;140;68;139;193;41;5;42;181;159;69;108;18;22;146;34;160;48;54;177;10;190;84;184;43;116;65;131;149;162;123;127;70;135;154;180;53;100;101;1;97;152;2;129;57;55;52;49;102;148;9;62;144;14;3;178;106;185;40;165;90;81;196;179;92;145;78;31;56;113;175;171,587519668918508038,0.004001
greedy_intra:nodes_start:greedy,17,73403,24573,48830,187139,21,157;81;40;90;27;58;164;7;95;39;165;119;185;106;178;3;14;144;62;9;148;102;49;52;55;57;129;92;179;145;78;82;2;152;97;26;86;53;180;154;135;70;127;123;162;149;65;116;43;184;177;54;48;160;34;146;22;18;108;159;181;42;41;193;139;68;140;93;117;143;183;89;23;137;0;46;115;59;118;51;151;133;176;80;79;63;94;1;101;75;120;44;25;16;171;175;113;56;31;196,3139412932218605080,0.010089
greedy_intra:nodes_start:greedy,18,71657,23407,48250,62578,6,18;22;146;159;193;41;5;42;181;34;160;48;54;177;10;4;112;84;184;43;116;65;149;123;127;162;151;133;135;70;154;180;53;121;100;26;86;75;44;25;16;171;175;113;56;31;78;145;179;196;81;90;40;165;185;106;178;3;14;144;62;9;148;102;49;52;55;57;92;129;82;120;2;101;1;97;152;124;94;63;79;80;176;137;51;118;59;115;139;46;68;0;89;183;143;117;93;140;108;69,8692837702969512738,0.002000
greedy_intra:nodes_start:greedy,19,72127,23067,49060,42486,4,152;94;124;148;102;49;178;106;52;55;57;92;129;2;120;44;25;16;171;175;113;56;31;78;145;179;196;81;90;40;185;165;138;14;144;62;9;15;114;186;89;183;23;137;176;80;151;162;123;149;65;116;43;184;177;54;48;160;34;146;22;18;108;69;159;181;42;5;41;193;139;68;140;93;117;143;0;46;115;59;118;51;133;79;63;180;135;70;154;158;53;121;100;26;86;75;101;1;97;189,2075271440334775422,0.003001
greedy_intra:nodes_start:greedy,20,72264,23286,48978,55149,5,18;22;146;159;193;41;5;42;181;34;160;48;54;177;10;190;84;184;43;116;65;149;123;127;162;151;133;135;70;154;180;53;121;100;26;86;75;44;25;16;171;175;113;56;31;78;145;179;196;81;90;40;165;185;106;178;3;14;144;62;9;148;102;49;52;55;57;92;129;82;120;2;101;1;97;152;124;94;63;79;80;176;137;51;118;59;115;139;68;46;0;89;183;143;117;93;140;108;69;199,8239892110182085445,0.002004
greedy_intra:nodes_start:greedy,21,71827,23922,47905,53163,5,21;14;138;165;185;40;90;81;196;179;145;78;31;56;113;175;171;16;25;44;120;75;86;101;124;94;63;79;80;176;133;151;51;118;59;115;46;0;137;23;186;89;183;143;117;93;140;68;139;193;41;5;42;181;159;69;108;18;22;146;34;160;48;54;177;10;190;184;43;116;65;131;149;162;123;127;70;135;154;180;53;100;26;97;1;152;2;129;92;57;55;52;106;178;49;102;148;9;62;144,4113287033717615144,0.002738
greedy_intra:nodes_start:greedy,22,71370,23397,47973,17869,1,22;146;181;34;160;48;54;177;10;190;4;112;84;184;42;43;116;65;149;123;127;162;151;133;135;70;154;180;53;121;100;26;86;75;44;25;16;171;175;113;56;31;78;145;179;196;81;90;40;165;185;106;178;3;14;144;62;9;148;102;49;52;55;92;57;129;82;120;2;101;1;97;152;124;94;63;79;80;176;137;23;186;89;183;143;117;0;51;118;59;115;46;68;139;41;193;159;69;108;18,3361464657419605435,0.000000
greedy_intra:nodes_start:greedy,23,70703,22498,48205,88471,8,186;137;176;80;79;63;94;124;152;97;1;101;2;120;82;129;92;57;55;52;49;102;148;9;62;144;14;3;178;106;185;40;165;90;81;196;179;145;78;31;56;113;175;171;16;25;44;75;86;26;100;121;53;180;154;135;70;127;123;162;133;151;51;118;59;65;116;43;184;84;112;4;190;10;177;54;48;160;34;146;22;18;108;69;159;181;42;5;41;193;115;139;68;46;0;117;143;183;89;23,766837347398104467,0.003001
greedy_intra:nodes_start:greedy,24,71889,23738,48151,64944,8,123;149;65;116;43;184;84;190;10;177;54;48;160;34;146;22;18;108;69;159;181;42;5;41;193;139;68;46;115;59;118;51;0;117;143;183;89;186;23;137;176;80;79;63;94;124;152;97;1;101;2;120;82;129;92;57;55;52;49;102;148;9;62;144;14;3;178;106;185;40;165;90;81;196;179;145;78;31;56;113;175;171;16;25;44;75;86;26;100;121;53;180;154;70;135;133;151;162;127;112,4542933576705059522,0.002999
greedy_intra:nodes_start:greedy,25,71822,23682,48140,33169,3,25;44;120;75;86;26;124;94;63;79;80;176;133;151;51;118;59;115;46;0;137;23;186;89;183;143;117;93;140;68;139;193;41;5;42;181;159;69;108;18;22;146;34;160;48;54;177;10;190;84;184;43;116;65;131;149;162;123;127;70;135;154;180;53;100;101;1;97;152;2;129;57;92;55;52;49;102;148;9;62;144;14;3;178;106;185;165;40;90;81;196;179;145;78;31;56;113;175;171;16,1437434727457077092,0.002000
greedy_intra:nodes_start:greedy,26,71529,23503,48026,45119,3,26;97;1;101;75;86;53;154;70;135;180;63;79;133;51;118;59;115;46;0;143;117;93;140;68;139;193;41;5;42;181;159;69;108;18;22;146;34;160;48;54;177;10;190;184;43;116;65;149;123;127;162;151;80;176;137;23;183;89;186;114;15;9;62;144;14;138;165;185;40;90;81;196;179;145;78;31;56;113;175;171;16;25;44;120;2;129;92;57;55;52;106;178;49;102;148;124;94;152;100,6430033610205926883,0.000998
greedy_intra:nodes_start:greedy,27,71941,23633,48308,90442,11,90;27;164;7;95;39;165;138;14;144;62;9;148;102;49;178;106;52;55;57;92;129;2;152;97;1;101;100;53;180;154;135;70;127;123;162;149;65;116;43;184;177;54;48;160;34;146;22;18;108;69;159;181;42;5;41;193;139;68;140;93;117;143;183;89;23;137;0;46;115;59;118;51;151;133;176;80;79;63;94;26;86;75;120;44;25;16;171;175;113;56;31;78;145;179;196;81;185;40;119,6036235680904455593,0.003970
greedy_intra:nodes_start:greedy,28,71978,23416,48562,79118,10,184;43;116;65;131;149;123;127;162;151;133;135;70;154;180;53;121;100;26;86;75;44;25;16;171;175;113;56;31;78;145;179;196;81;90;40;165;185;106;178;3;14;144;62;9;148;102;49;52;55;92;57;129;82;120;2;101;1;97;152;124;94;63;79;80;176;137;23;186;89;183;143;117;0;51;118;59;115;46;68;139;193;41;5;42;181;159;69;108;18;22;146;34;160;48;54;177;10;190;84,4174903367811323601,0.004245
greedy_intra:nodes_start:greedy,29,71954,23347,48607,32530,4,149;112;4;84;35;184;177;54;48;160;34;181;146;22;18;108;69;159;193;41;5;42;43;116;65;46;68;139;115;59;118;51;0;117;143;183;89;186;23;137;176;80;79;63;94;124;152;97;1;101;2;120;82;129;57;92;55;52;49;102;148;9;62;144;14;3;178;106;185;40;165;90;81;196;179;145;78;31;56;113;175;171;16;25;44;75;86;26;100;121;53;180;154;70;135;133;151;162;123;131,8265335178337903046,0.001000
greedy_intra:nodes_start:greedy,30,72272,23708,48564,16187,2,48;54;177;10;190;84;184;43;65;116;59;118;115;46;0;51;151;133;162;123;127;70;135;154;180;53;121;100;26;86;75;44;25;16;171;175;113;56;31;78;145;179;196;81;90;40;165;185;106;178;3;14;144;62;9;148;102;49;52;55;92;57;129;82;120;2;101;1;97;152;124;94;63;79;80;176;137;23;186;89;183;143;117;93;140;68;139;193;41;159;69;108;18;22;146;195;42;181;160;34,6058254979001448595,0.001129
greedy_intra:nodes_start:greedy,31,71624,23484,48140,124011,11,31;78;145;92;179;196;81;90;165;40;185;106;178;3;14;144;62;9;148;102;49;52;55;57;129;2;101;1;97;26;100;53;180;154;135;70;127;123;162;149;131;65;116;43;184;84;190;10;177;54;48;160;34;146;22;18;108;69;159;181;42;5;41;193;139;68;140;93;117;143;183;89;186;23;137;0;46;115;59;118;51;151;133;176;80;79;63;94;124;152;86;75;120;44;25;16;171;175;113;56,3043222173726855181,0.004972
greedy_intra:nodes_start:greedy,32,71328,23257,48071,115795,15,185;14;144;62;9;148;102;49;178;106;52;55;57;92;129;2;152;1;97;26;100;53;180;154;135;70;127;123;162;149;131;65;116;43;184;84;190;10;177;54;48;160;34;146;22;18;108;69;159;181;42;5;41;193;139;68;140;93;117;143;183;89;186;23;137;0;46;115;59;118;51;151;133;176;80;79;63;94;124;101;86;75;120;44;25;16;171;175;113;56;31;78;145;179;196;81;90;165;40;119,8669625702004797990,0.004969
greedy_intra:nodes_start:greedy,33,71549,23149,48400,58444,7,37;102;49;178;106;52;55;57;92;129;2;152;97;1;101;100;53;180;154;135;70;127;123;162;149;131;65;116;43;184;190;10;177;54;48;160;34;146;22;18;108;69;159;181;42;5;41;193;139;68;140;93;117;143;183;89;186;23;137;0;46;115;59;118;51;151;133;176;80;79;63;94;124;26;86;75;120;44;25;16;171;175;113;56;31;78;145;179;196;81;90;40;185;165;138;14;144;62;9;148,4327606368127755465,0.002000
greedy_intra:nodes_start:greedy,34,71264,23291,47973,36498,3,160;181;146;22;18;108;69;159;193;41;139;68;46;115;59;118;51;0;117;143;183;89;186;23;137;176;80;79;63;94;124;152;97;1;101;2;120;82;129;92;57;55;52;49;102;148;9;62;144;14;3;178;106;185;165;40;90;81;196;179;145;78;31;56;113;175;171;16;25;44;75;86;26;100;121;53;180;154;70;135;133;151;162;127;123;149;65;116;43;42;184;84;112;4;190;10;177;54;48;34,6823872114841545010,0.002000
greedy_intra:nodes_start:greedy,35,71642,23392,48250,29319,3,35;84;4;112;127;123;162;151;133;135;70;154;180;53;121;100;26;86;75;44;25;16;171;175;113;56;31;78;145;179;196;81;90;40;165;185;106;178;3;14;144;62;9;148;102;49;52;55;57;92;129;82;120;2;101;1;97;152;124;94;63;79;80;176;137;23;186;89;183;143;117;0;51;118;59;115;139;68;46;65;116;43;42;5;41;193;159;69;108;18;22;146;181;34;160;48;54;177;10;184,519683580171545401,0.002000
greedy_intra:nodes_start:greedy,36,72099,22931,49168,61300,5,36;108;69;18;22;146;159;193;41;5;42;181;34;160;48;54;177;10;190;84;184;43;116;65;149;123;127;162;151;133;135;70;154;180;53;121;100;26;86;75;44;25;16;171;175;113;56;31;78;145;179;196;81;90;165;40;185;106;178;3;14;144;62;9;148;102;49;52;55;57;92;129;82;120;2;101;1;97;152;124;94;63;79;80;176;137;51;118;59;115;139;46;68;0;89;183;143;117;93;140,7119822298405018267,0.003002
greedy_intra:nodes_start:greedy,37,71463,23063,48400,107236,12,37;102;49;178;106;52;55;57;92;129;2;152;1;97;26;100;53;180;154;135;70;127;123;162;149;131;65;116;43;184;190;10;177;54;48;160;34;146;22;18;108;69;159;181;42;5;41;193;139;68;140;93;117;143;183;89;186;23;137;0;46;115;59;118;51;151;133;176;80;79;63;94;124;101;86;75;120;44;25;16;171;175;113;56;31;78;145;179;196;81;90;165;40;185;138;14;144;62;9;148,7151958350952843258,0.005029
greedy_intra:nodes_start:greedy,38,72000,23685,48315,110120,12,157;78;145;92;179;196;81;90;40;165;185;106;178;3;14;144;62;9;148;102;49;52;55;57;129;2;101;1;97;26;100;53;180;154;135;70;127;123;162;149;131;65;116;43;184;190;10;177;54;48;160;34;146;22;18;108;69;159;181;42;5;41;193;139;68;140;93;117;143;183;89;186;23;137;0;46;115;59;118;51;151;133;176;80;79;63;94;124;152;86;75;120;44;25;16;171;175;113;56;31,6637488389157736640,0.004032
greedy_intra:nodes_start:greedy,39,72215,24009,48206,18245,2,165;95;7;164;27;90;40;185;81;196;179;145;78;31;56;113;175;171;16;25;44;120;75;86;26;124;94;63;79;80;176;133;151;51;118;59;115;46;0;137;23;89;183;143;117;93;140;68;139;193;41;5;42;181;159;69;108;18;22;146;34;160;48;54;177;184;43;116;65;149;162;123;127;70;135;154;180;53;100;101;1;97;152;2;129;92;57;55;52;106;178;49;102;148;9;62;144;14;138;39,7229050128219690025,0.001000
greedy_intra:nodes_start:greedy,40,71291,23229,48062,55493,5,40;185;138;14;144;62;9;148;102;49;178;106;52;55;57;92;129;2;101;1;97;26;100;53;180;154;135;70;127;123;162;149;131;65;116;43;184;84;190;10;177;54;48;160;34;146;22;18;108;69;159;181;42;5;41;193;139;68;140;93;117;143;183;89;186;23;137;0;46;115;59;118;51;151;133;176;80;79;63;94;124;152;86;75;120;44;25;16;171;175;113;56;31;78;145;179;196;81;90;165,6209967871416451313,0.002788
greedy_intra:nodes_start:greedy,41,71690,23567,48123,32445,4,41;5;42;181;159;69;108;18;22;146;34;160;48;54;177;10;4;112;84;184;43;116;65;149;123;127;162;151;133;135;70;154;180;53;121;100;26;86;75;44;25;16;171;175;113;56;31;78;145;179;196;81;90;165;40;185;106;178;3;14;144;62;9;148;102;49;52;55;92;57;129;82;120;2;101;1;97;152;124;94;63;79;80;176;137;23;186;89;183;143;117;0;51;118;59;115;46;68;139;193,5996671130092398013,0.002002
greedy_intra:nodes_start:greedy,42,71485,23362,48123,43636,4,42;5;41;193;139;68;46;115;59;118;51;0;117;143;183;89;186;23;137;176;80;79;63;94;124;152;97;1;101;2;120;82;129;92;57;55;52;49;102;148;9;62;144;14;3;178;106;185;40;165;90;81;196;179;145;78;31;56;113;175;171;16;25;44;75;86;26;100;121;53;180;154;70;135;133;151;162;127;123;149;65;116;43;184;112;4;190;10;177;54;48;160;34;146;22;18;108;69;159;181,3069744970090350088,0.001999
greedy_intra:nodes_start:greedy,43,72009,24011,47998,64052,9,184;116;65;59;118;115;46;0;51;151;133;162;123;127;70;135;154;180;53;121;100;26;86;75;44;25;16;171;175;113;56;31;78;145;179;196;81;90;165;40;185;106;178;3;14;144;62;9;148;102;49;52;55;92;57;129;82;120;2;101;1;97;152;124;94;63;79;80;176;137;23;186;89;183;143;117;93;140;68;139;193;41;43;42;181;159;69;108;18;22;146;34;160;48;54;177;10;4;112;84,7083187391815464566,0.002000
greedy_intra:nodes_start:greedy,44,71822,23682,48140,24401,2,44;25;16;171;175;113;56;31;78;145;179;196;81;90;40;165;185;106;178;3;14;144;62;9;148;102;49;52;55;92;57;129;2;152;97;1;101;100;53;180;154;135;70;127;123;162;149;131;65;116;43;184;84;190;10;177;54;48;160;34;146;22;18;108;69;159;181;42;5;41;193;139;68;140;93;117;143;183;89;186;23;137;0;46;115;59;118;51;151;133;176;80;79;63;94;124;26;86;75;120,2905338049747179990,0.000991
greedy_intra:nodes_start:greedy,45,71738,23587,48151,83097,10,162;151;133;135;70;154;180;53;121;100;26;86;75;44;25;16;171;175;113;56;31;78;145;179;196;81;90;165;40;185;106;178;3;14;144;62;9;148;102;49;52;55;57;92;129;82;120;2;101;1;97;152;124;94;63;79;80;176;137;23;186;89;183;143;117;0;51;118;59;115;46;68;139;193;41;5;42;181;159;69;108;18;22;146;34;160;48;54;177;10;190;84;184;43;116;65;149;112;127;123,8852807491472829660,0.003970
greedy_intra:nodes_start:greedy,46,71854,23731,48123,47128,4,68;115;59;118;51;0;117;143;183;89;186;23;137;176;80;79;63;94;124;152;97;1;101;2;120;82;129;57;92;55;52;49;102;148;9;62;144;14;3;178;106;185;40;165;90;81;196;179;145;78;31;56;113;175;171;16;25;44;75;86;26;100;121;53;180;154;70;135;133;151;162;127;123;149;65;116;43;184;112;4;190;10;177;54;48;160;34;146;22;18;108;69;159;181;42;5;41;193;139;46,3620006329489349479,0.002917
greedy_intra:nodes_start:greedy,47,71831,23269,48562,47963,5,65;116;43;184;84;190;10;177;54;48;160;34;146;22;18;108;69;159;181;42;5;41;193;139;68;46;115;59;118;51;0;117;143;183;89;186;23;137;176;80;79;63;94;124;152;97;1;101;2;120;82;129;57;92;55;52;49;102;148;9;62;144;14;3;178;106;185;40;165;90;81;196;179;145;78;31;56;113;175;171;16;25;44;75;86;26;100;121;53;180;154;70;135;133;151;162;127;123;149;131,5544918679173617216,0.002391
greedy_intra:nodes_start:greedy,48,71628,23064,48564,69135,6,48;34;160;42;181;195;146;22;18;108;69;159;193;41;139;68;140;93;117;143;183;89;186;23;137;176;80;79;63;94;124;152;97;1;101;2;120;82;129;92;57;55;52;49;102;148;9;62;144;14;3;178;106;185;40;165;90;81;196;179;145;78;31;56;113;175;171;16;25;44;75;86;26;100;121;53;180;154;135;70;127;123;162;133;151;51;0;46;115;118;59;65;116;43;184;84;190;10;177;54,2212986010838830733,0.002978
greedy_intra:nodes_start:greedy,49,71538,23282,48256,52433,4,3;178;106;52;55;57;92;129;2;152;97;1;101;100;53;180;154;135;70;127;123;162;149;131;65;116;43;184;84;190;10;177;54;48;160;34;146;22;18;108;69;159;181;42;5;41;193;139;68;140;93;117;143;183;89;186;23;137;0;46;115;59;118;51;151;133;176;80;79;63;94;124;26;86;75;120;44;25;16;171;175;113;56;31;78;145;179;196;81;90;40;185;165;138;14;144;62;9;148;49,4183198259269734511,0.002003
greedy_intra:nodes_start:greedy,50,72218,23903,48315,102981,11,56;175;171;16;25;44;120;75;86;26;124;94;63;79;80;176;133;151;51;118;59;115;46;0;137;23;186;89;183;143;117;93;140;68;139;193;41;5;42;181;159;69;108;18;22;146;34;160;48;54;177;10;190;184;43;116;65;131;149;162;123;127;70;135;154;180;53;100;101;1;97;152;2;129;57;55;52;49;102;148;9;62;144;14;3;178;106;185;40;165;90;81;196;179;92;145;78;157;113;31,6413318650018114277,0.005003
greedy_intra:nodes_start:greedy,51,71833,23710,48123,16405,2,51;118;59;115;46;68;139;193;41;5;42;181;159;69;108;18;22;146;34;160;48;54;177;10;190;4;112;184;43;116;65;149;123;127;162;151;133;135;70;154;180;53;121;100;26;86;75;44;25;16;171;175;113;56;31;78;145;179;196;81;90;40;165;185;106;178;3;14;144;62;9;148;102;49;52;55;92;57;129;82;120;2;101;1;97;152;124;94;63;79;80;176;137;23;186;89;183;143;117;0,7490312247737091868,0.000999
greedy_intra:nodes_start:greedy,52,71403,23341,48062,42339,3,52;178;106;49;102;148;9;62;144;14;138;185;40;165;90;81;196;179;145;78;31;56;113;175;171;16;25;44;120;75;86;101;124;94;63;79;80;176;133;151;51;118;59;115;46;0;137;23;186;89;183;143;117;93;140;68;139;193;41;5;42;181;159;69;108;18;22;146;34;160;48;54;177;10;190;84;184;43;116;65;131;149;162;123;127;70;135;154;180;53;100;26;1;97;152;2;129;92;57;55,6869093077375942693,0.002000
greedy_intra:nodes_start:greedy,53,71688,23118,48570,44475,3,53;158;154;70;135;180;63;79;133;51;118;59;115;46;0;143;117;93;140;68;139;193;41;5;42;181;159;69;108;18;22;146;34;160;48;54;177;184;43;116;65;149;123;127;162;151;80;176;137;23;183;89;186;114;15;9;62;144;14;138;165;185;40;90;81;196;179;145;78;31;56;113;175;171;16;25;44;120;2;129;92;57;55;52;106;178;49;102;148;124;94;152;97;1;101;75;86;26;100;121,7839826925757395006,0.002749
greedy_intra:nodes_start:greedy,54,71628,23064,48564,114395,10,54;48;34;160;42;181;195;146;22;18;108;69;159;193;41;139;68;140;93;117;143;183;89;186;23;137;176;80;79;63;94;124;152;97;1;101;2;120;82;129;92;57;55;52;49;102;148;9;62;144;14;3;178;106;185;40;165;90;81;196;179;145;78;31;56;113;175;171;16;25;44;75;86;26;100;121;53;180;154;135;70;127;123;162;133;151;51;0;46;115;118;59;65;116;43;184;84;190;10;177,3578004340812835352,0.006060
greedy_intra:nodes_start:greedy,55,71639,23577,48062,104978,9,57;52;106;178;49;102;148;9;62;144;14;138;185;40;165;90;81;196;179;145;78;31;56;113;175;171;16;25;44;120;75;86;152;124;94;63;79;80;176;133;151;51;118;59;115;46;0;137;23;186;89;183;143;117;93;140;68;139;193;41;5;42;181;159;69;108;18;22;146;34;160;48;54;177;10;190;84;184;43;116;65;131;149;162;123;127;70;135;154;180;53;100;26;97;1;101;2;129;92;55,7877401601053772211,0.005035
greedy_intra:nodes_start:greedy,56,71733,23593,48140,116764,11,113;31;78;145;92;179;196;81;90;165;40;185;106;178;3;14;144;62;9;148;102;49;52;55;57;129;2;101;1;97;26;100;53;180;154;135;70;127;123;162;149;131;65;116;43;184;84;190;10;177;54;48;160;34;146;22;18;108;69;159;181;42;5;41;193;139;68;140;93;117;143;183;89;186;23;137;0;46;115;59;118;51;151;133;176;80;79;63;94;124;152;86;75;120;44;25;16;171;175;56,4708251129375103646,0.005966
greedy_intra:nodes_start:greedy,57,71619,23479,48140,33448,4,57;55;52;49;102;148;9;62;144;14;3;178;106;185;165;40;90;81;196;179;145;78;31;56;113;175;171;16;25;44;120;75;86;101;124;94;63;79;80;176;133;151;51;118;59;115;46;0;137;23;186;89;183;143;117;93;140;68;139;193;41;5;42;181;159;69;108;18;22;146;34;160;48;54;177;10;190;84;184;43;116;65;131;149;162;123;127;70;135;154;180;53;100;26;1;97;152;2;129;92,2465750661800667961,0.001627
greedy_intra:nodes_start:greedy,58,72549,24262,48287,51607,4,164;95;27;90;81;196;157;31;56;113;175;171;16;25;44;120;75;86;26;94;63;79;80;176;133;151;51;118;59;115;46;0;137;23;89;183;143;117;93;140;68;139;193;41;5;42;181;159;69;108;18;22;146;34;160;48;54;177;184;43;116;65;149;162;123;127;70;135;154;180;53;100;101;1;97;152;2;129;57;92;78;145;179;40;165;185;55;52;106;178;14;49;102;148;9;62;144;21;7;58,370713043152317191,0.002990
greedy_intra:nodes_start:greedy,59,71485,23362,48123,72779,6,59;115;46;68;139;193;41;5;42;181;159;69;108;18;22;146;34;160;48;54;177;10;190;4;112;184;43;116;65;149;123;127;162;151;133;135;70;154;180;53;121;100;26;86;75;44;25;16;171;175;113;56;31;78;145;179;196;81;90;165;40;185;106;178;3;14;144;62;9;148;102;49;52;55;57;92;129;82;120;2;101;1;97;152;124;94;63;79;80;176;137;23;186;89;183;143;117;0;51;118,3820428743485787770,0.004032
greedy_intra:nodes_start:greedy,60,71917,23794,48123,62484,8,115;68;46;139;193;41;5;42;181;159;69;108;18;22;146;34;160;48;54;177;10;4;112;84;184;43;116;65;149;123;127;162;151;133;135;70;154;180;53;121;100;26;86;75;44;25;16;171;175;113;56;31;78;145;179;196;81;90;165;40;185;106;178;3;14;144;62;9;148;102;49;52;55;92;57;129;82;120;2;101;1;97;152;124;94;63;79;80;176;137;23;186;89;183;143;117;0;51;59;118,6128454230459848830,0.003030
greedy_intra:nodes_start:greedy,61,71415,23393,48022,45700,8,15;144;14;138;185;40;165;90;81;196;179;145;78;31;56;113;175;171;16;25;44;120;75;86;101;124;94;63;79;80;176;133;151;51;118;59;115;46;0;137;23;186;89;183;143;117;93;140;68;139;193;41;5;42;181;159;69;108;18;22;146;34;160;48;54;177;10;190;184;43;116;65;131;149;162;123;127;70;135;154;180;53;100;26;1;97;152;2;129;92;57;55;52;106;178;49;102;62;9;148,391541744051312961,0.003506
greedy_intra:nodes_start:greedy,62,71393,23331,48062,21470,3,62;144;14;138;165;185;40;90;81;196;179;145;78;31;56;113;175;171;16;25;44;120;75;86;26;124;94;63;79;80;176;133;151;51;118;59;115;46;0;137;23;186;89;183;143;117;93;140;68;139;193;41;5;42;181;159;69;108;18;22;146;34;160;48;54;177;10;190;84;184;43;116;65;131;149;162;123;127;70;135;154;180;53;100;101;1;97;152;2;129;92;57;55;52;106;178;49;102;148;9,4563509577704762127,0.001092
greedy_intra:nodes_start:greedy,63,71688,23118,48570,43416,3,63;180;135;70;154;158;53;121;100;26;86;75;101;1;97;152;94;124;148;102;49;178;106;52;55;57;92;129;2;120;44;25;16;171;175;113;56;31;78;145;179;196;81;90;40;185;165;138;14;144;62;9;15;114;186;89;183;23;137;176;80;151;162;127;123;149;65;116;43;184;177;54;48;160;34;146;22;18;108;69;159;181;42;5;41;193;139;68;140;93;117;143;0;46;115;59;118;51;133;79,7030470213159629973,0.000996
greedy_intra:nodes_start:greedy,64,72340,23237,49103,64548,6,9;114;186;89;183;23;137;176;80;151;162;123;149;65;116;43;184;177;54;48;160;34;146;22;18;108;69;159;181;42;5;41;193;139;68;140;93;117;143;0;46;115;59;118;51;133;79;63;180;135;70;154;158;53;121;100;26;86;75;101;1;97;152;94;124;148;37;62;102;49;178;106;52;55;57;92;129;2;120;44;25;16;171;175;113;56;31;78;145;179;196;81;90;40;185;165;138;14;144;15,3306375332912061771,0.003075
greedy_intra:nodes_start:greedy,65,71636,23513,48123,62470,6,65;149;123;127;162;151;133;135;70;154;180;53;121;100;26;86;75;44;25;16;171;175;113;56;31;78;145;179;196;81;90;40;165;185;106;178;3;14;144;62;9;148;102;49;52;55;57;92;129;82;120;2;101;1;97;152;124;94;63;79;80;176;137;23;186;89;183;143;117;0;51;118;59;115;46;68;139;193;41;5;42;181;159;69;108;18;22;146;34;160;48;54;177;10;4;112;84;184;43;116,3068993492477744939,0.003001
greedy_intra:nodes_start:greedy,66,72330,23840,48490,85801,9,23;51;118;59;115;46;0;89;183;143;117;93;140;68;139;193;41;5;42;181;159;69;108;18;22;146;34;160;48;54;177;10;190;84;184;43;116;65;149;123;127;162;151;133;135;70;154;180;53;121;100;26;86;75;44;25;16;171;175;113;56;31;78;145;179;196;81;90;165;40;185;106;178;3;14;144;62;9;148;102;49;52;55;57;92;129;82;120;2;101;1;97;152;124;94;63;79;80;176;137,1818872645465651751,0.004001
greedy_intra:nodes_start:greedy,67,72254,23086,49168,79438,8,140;108;69;18;22;146;159;193;41;5;42;181;34;160;48;54;177;10;190;84;184;43;116;65;149;123;127;162;151;133;135;70;154;180;53;121;100;26;86;75;44;25;16;171;175;113;56;31;78;145;179;196;81;90;165;40;185;106;178;3;14;144;62;9;148;102;49;52;55;57;92;129;82;120;2;101;1;97;152;124;94;63;79;80;176;137;51;118;59;115;139;68;46;0;89;183;143;117;93;36,480597778757423314,0.002999
greedy_intra:nodes_start:greedy,68,71489,23366,48123,68062,7,68;46;115;59;118;51;0;117;143;183;89;186;23;137;176;80;79;63;94;124;152;97;1;101;2;120;82;129;92;57;55;52;49;102;148;9;62;144;14;3;178;106;185;40;165;90;81;196;179;145;78;31;56;113;175;171;16;25;44;75;86;26;100;121;53;180;154;70;135;133;151;162;127;123;149;65;116;43;184;84;112;4;10;177;54;48;160;34;146;22;18;108;69;159;181;42;5;41;193;139,6284177363015855270,0.004001
greedy_intra:nodes_start:greedy,69,71935,23136,48799,64412,7,139;108;18;69;22;146;159;193;41;5;42;181;34;160;48;54;177;10;190;84;184;43;116;65;149;123;127;162;151;133;135;70;154;180;53;121;100;26;86;75;44;25;16;171;175;113;56;31;78;145;179;196;81;90;165;40;185;106;178;3;14;144;62;9;148;102;49;52;55;57;92;129;82;120;2;101;1;97;152;124;94;63;79;80;176;137;23;186;89;183;143;117;0;51;118;59;115;46;68;198,3127375880855569682,0.003038
greedy_intra:nodes_start:greedy,70,71750,23180,48570,12472,0,70;154;158;53;121;100;26;86;75;101;1;97;152;94;124;148;102;49;178;106;52;55;57;92;129;2;120;44;25;16;171;175;113;56;31;78;145;179;196;81;90;185;40;165;138;14;144;62;9;15;114;186;89;183;23;137;176;80;151;162;127;123;149;65;116;43;184;177;54;48;160;34;146;22;18;108;69;159;181;42;5;41;193;139;68;140;93;117;143;0;46;115;59;118;51;133;79;63;180;135,7602477162432433584,0.000000
greedy_intra:nodes_start:greedy,71,72157,23629,48528,72443,9,58;164;7;95;39;165;138;14;144;62;9;148;102;49;178;106;52;55;57;92;129;2;152;97;1;101;100;53;180;154;135;70;127;123;162;149;65;116;43;184;177;54;48;160;34;146;22;18;108;69;159;181;42;5;41;193;139;68;140;93;117;143;183;89;23;137;0;46;115;59;118;51;151;133;176;80;79;63;94;26;86;75;120;44;25;16;171;175;113;56;31;78;145;179;196;81;185;40;90;27,3805284636297796748,0.003001
greedy_intra:nodes_start:greedy,72,72411,23583,48828,53007,5,59;51;0;117;143;183;89;186;23;137;176;80;79;63;94;124;152;97;1;101;2;120;82;129;57;92;55;52;49;102;148;9;62;144;14;3;178;106;185;40;165;90;81;196;179;145;78;31;56;113;175;171;16;25;44;75;86;26;100;121;53;180;154;70;135;133;151;162;127;123;149;65;116;43;184;84;190;10;177;54;48;160;34;146;22;18;108;69;159;181;42;5;41;193;139;68;46;115;118;72,8498296803070992684,0.001972
greedy_intra:nodes_start:greedy,73,71970,23857,48113,41843,6,114;15;148;9;62;102;49;178;106;52;55;57;92;129;2;152;97;1;26;100;53;180;154;135;70;127;123;162;149;131;65;116;43;184;10;177;54;48;160;34;146;22;18;108;69;159;181;42;5;41;193;139;68;140;93;117;143;183;89;186;23;137;0;46;115;59;118;51;151;133;176;80;79;63;94;124;101;86;75;120;44;25;16;171;175;113;56;31;78;145;179;196;81;90;185;40;165;138;14;144,208261680667877665,0.003029
greedy_intra:nodes_start:greedy,74,71853,23212,48641,85950,8,152;1;101;75;86;53;154;70;135;180;63;79;133;51;118;59;115;46;0;143;117;93;140;68;139;193;41;5;42;181;159;69;108;18;22;146;34;160;48;54;177;184;43;116;65;149;123;127;162;151;80;176;137;23;183;89;186;114;15;9;62;144;14;138;185;40;165;90;81;196;179;145;78;31;56;113;175;171;16;25;44;120;2;129;92;57;55;52;106;178;49;102;148;124;94;189;121;100;26;97,1104839410331508663,0.003998
greedy_intra:nodes_start:greedy,75,72313,23971,48342,85288,7,100;44;25;16;171;175;113;56;31;78;145;179;196;81;90;165;40;185;106;178;3;14;144;62;9;148;102;49;52;55;57;92;129;82;120;2;152;97;1;101;75;53;180;154;135;70;127;123;162;149;131;65;116;43;184;190;10;177;54;48;160;34;146;22;18;108;69;159;181;42;5;41;193;139;68;140;93;117;143;183;89;186;23;137;0;46;115;59;118;51;151;133;176;80;79;63;94;124;26;86,3668694599162545182,0.003973
greedy_intra:nodes_start:greedy,76,72390,23564,48826,102819,12,153;176;80;151;162;127;123;149;65;116;43;184;10;177;54;48;160;34;146;22;18;108;69;159;181;42;5;41;193;139;68;46;115;59;118;51;133;79;63;180;135;70;154;158;53;121;100;26;86;75;101;1;97;152;94;124;148;102;49;178;106;52;55;57;92;129;2;120;44;25;16;171;175;113;56;31;78;145;179;196;81;90;40;185;165;138;14;144;62;9;15;114;186;137;23;89;183;143;117;0,1374896757901518003,0.004973
greedy_intra:nodes_start:greedy,77,71717,23299,48418,182672,19,116;43;184;190;10;177;54;48;160;34;146;22;18;108;69;159;181;42;5;41;193;139;68;140;93;117;143;183;89;186;23;137;176;80;79;63;94;124;152;97;1;101;2;120;82;129;92;57;55;52;49;102;148;9;62;144;14;3;178;106;185;40;165;90;81;196;179;145;78;31;56;113;175;171;16;25;44;75;86;26;100;121;53;180;154;135;70;127;123;162;133;151;51;0;46;115;118;59;149;65,3449282043507946047,0.008000
greedy_intra:nodes_start:greedy,78,71650,23510,48140,75903,7,145;31;56;113;175;171;16;25;44;120;75;86;26;124;94;63;79;80;176;133;151;51;118;59;115;46;0;137;23;186;89;183;143;117;93;140;68;139;193;41;5;42;181;159;69;108;18;22;146;34;160;48;54;177;10;190;84;184;43;116;65;131;149;162;123;127;70;135;154;180;53;100;101;1;97;152;2;129;92;57;55;52;49;102;148;9;62;144;14;3;178;106;185;40;165;90;81;196;179;78,3224066809988440968,0.003001
greedy_intra:nodes_start:greedy,79,72042,23156,48886,35653,3,79;80;176;133;151;51;118;59;115;46;0;137;23;186;89;183;143;117;93;140;68;139;193;41;5;42;181;159;69;108;18;22;146;34;160;48;54;177;184;43;116;65;131;149;162;123;127;70;135;154;180;158;53;121;100;26;86;75;44;25;16;171;175;113;56;31;78;145;179;196;81;90;40;165;185;106;178;3;14;144;62;9;148;102;49;52;55;57;92;129;82;120;2;101;1;97;152;124;94;63,2077051691819977902,0.002159
greedy_intra:nodes_start:greedy,80,71724,23162,48562,55879,4,80;79;63;94;124;152;97;1;101;2;120;82;129;92;57;55;52;49;102;148;9;62;144;14;3;178;106;185;165;40;90;81;196;179;145;78;31;56;113;175;171;16;25;44;75;86;26;100;121;53;180;154;135;70;127;123;162;133;151;149;131;65;116;43;184;84;190;10;177;54;48;160;34;146;22;18;108;69;159;181;42;5;41;193;139;68;46;115;59;118;51;0;117;143;183;89;186;23;137;176,2188815833945424821,0.002000
greedy_intra:nodes_start:greedy,81,71560,23498,48062,36133,3,81;196;40;185;179;145;78;31;56;113;175;171;16;25;44;120;75;86;101;124;94;63;79;80;176;133;151;51;118;59;115;46;0;137;23;186;89;183;143;117;93;140;68;139;193;41;5;42;181;159;69;108;18;22;146;34;160;48;54;177;10;190;84;184;43;116;65;131;149;162;123;127;70;135;154;180;53;100;26;1;97;152;2;129;92;57;55;52;106;178;49;102;148;9;62;144;14;138;165;90,7211804281301347684,0.000999
greedy_intra:nodes_start:greedy,82,72051,23709,48342,52816,5,120;2;75;86;26;124;94;63;79;80;176;133;151;51;118;59;115;46;0;137;23;186;89;183;143;117;93;140;68;139;193;41;5;42;181;159;69;108;18;22;146;34;160;48;54;177;10;190;184;43;116;65;131;149;162;123;127;70;135;154;180;53;100;101;1;97;152;129;92;57;55;52;49;102;148;9;62;144;14;3;178;106;185;165;40;90;81;196;179;145;78;31;56;113;175;171;16;25;44;82,1172607249909371561,0.002134
greedy_intra:nodes_start:greedy,83,71062,22766,48296,105972,11,114;89;183;143;117;0;46;68;139;115;193;41;5;42;181;159;69;108;18;22;146;34;160;48;54;177;10;4;112;84;184;43;116;65;59;118;51;151;133;162;123;127;70;135;154;180;53;121;100;26;86;75;44;25;16;171;175;113;56;31;78;145;179;196;81;90;165;40;185;106;178;3;14;144;62;9;148;102;49;52;55;57;92;129;82;120;2;101;1;97;152;124;94;63;79;80;176;137;23;186,1596097076711273932,0.005002
greedy_intra:nodes_start:greedy,84,71642,23392,48250,75618,7,84;4;112;127;123;162;151;133;135;70;154;180;53;121;100;26;86;75;44;25;16;171;175;113;56;31;78;145;179;196;81;90;40;165;185;106;178;3;14;144;62;9;148;102;49;52;55;57;92;129;82;120;2;101;1;97;152;124;94;63;79;80;176;137;23;186;89;183;143;117;0;51;118;59;115;139;68;46;65;116;43;42;5;41;193;159;69;108;18;22;146;181;34;160;48;54;177;10;184;35,4027238951906057958,0.003002
greedy_intra:nodes_start:greedy,85,72533,24218,48315,67815,9,56;31;179;196;81;90;40;165;185;106;178;3;14;144;62;9;148;102;49;52;55;57;92;129;2;101;1;97;26;100;53;180;154;135;70;127;123;162;149;131;65;116;43;184;190;10;177;54;48;160;34;146;22;18;108;69;159;181;42;5;41;193;139;68;140;93;117;143;183;89;186;23;137;0;46;115;59;118;51;151;133;176;80;79;63;94;124;152;86;75;120;44;25;78;145;16;171;175;113;157,2728633099876288069,0.003975
greedy_intra:nodes_start:greedy,86,71688,23118,48570,89825,7,86;75;101;1;97;152;94;124;148;102;49;178;106;52;55;57;92;129;2;120;44;25;16;171;175;113;56;31;78;145;179;196;81;90;40;185;165;138;14;144;62;9;15;114;186;89;183;23;137;176;80;151;162;127;123;149;65;116;43;184;177;54;48;160;34;146;22;18;108;69;159;181;42;5;41;193;139;68;140;93;117;143;0;46;115;59;118;51;133;79;63;180;135;70;154;158;53;121;100;26,5778447056890210412,0.004487
greedy_intra:nodes_start:greedy,87,71967,23462,48505,132391,16,152;2;120;82;129;92;57;55;52;49;102;148;9;62;144;14;3;178;106;185;40;165;90;81;196;179;145;78;31;56;113;175;171;16;25;44;75;86;101;124;94;63;79;80;176;133;151;51;118;59;115;46;0;137;23;186;89;183;143;117;93;140;68;139;193;41;5;42;181;159;69;108;18;22;146;34;160;48;54;177;10;184;43;116;65;131;149;162;123;127;70;135;154;180;53;121;100;26;1;97,874426301378270669,0.005999
greedy_intra:nodes_start:greedy,88,71984,23642,48342,88647,10,44;25;82;120;75;86;101;124;94;63;79;80;176;133;151;51;118;59;115;46;0;137;23;186;89;183;143;117;93;140;68;139;193;41;5;42;181;159;69;108;18;22;146;34;160;48;54;177;10;190;184;43;116;65;131;149;162;123;127;70;135;154;180;53;100;26;1;97;152;2;129;57;55;52;49;102;148;9;62;144;14;3;178;106;185;40;165;90;81;196;179;92;145;78;31;56;113;175;171;16,4084170360803986347,0.004000
greedy_intra:nodes_start:greedy,89,70941,22441,48500,102115,9,183;186;23;137;176;80;79;63;94;124;152;97;1;101;2;120;82;129;92;57;55;52;49;102;148;9;62;144;14;3;178;106;185;40;165;90;81;196;179;145;78;31;56;113;175;171;16;25;44;75;86;26;100;121;53;180;154;135;70;127;123;162;133;151;51;118;59;65;116;43;184;84;190;10;177;54;48;160;34;146;22;18;108;69;159;181;42;5;41;193;139;115;46;68;140;93;117;0;143;89,3090017703610621278,0.003997
greedy_intra:nodes_start:greedy,90,71454,23392,48062,75384,8,165;40;90;81;196;179;145;78;31;56;113;175;171;16;25;44;120;75;86;101;124;94;63;79;80;176;133;151;51;118;59;115;46;0;137;23;186;89;183;143;117;93;140;68;139;193;41;5;42;181;159;69;108;18;22;146;34;160;48;54;177;10;190;84;184;43;116;65;131;149;162;123;127;70;135;154;180;53;100;26;97;1;152;2;129;92;57;55;52;106;178;49;102;148;9;62;144;14;138;185,9207307329157029884,0.003455
greedy_intra:nodes_start:greedy,91,71798,23483,48315,34652,4,157;179;145;78;31;56;113;175;171;16;25;44;120;75;86;26;124;94;63;79;80;176;133;151;51;118;59;115;46;0;137;23;186;89;183;143;117;93;140;68;139;193;41;5;42;181;159;69;108;18;22;146;34;160;48;54;177;10;190;184;43;116;65;131;149;162;123;127;70;135;154;180;53;100;101;1;97;152;2;129;92;57;55;52;49;102;148;9;62;144;14;3;178;106;185;40;165;90;81;196,1977952194853242879,0.002195
greedy_intra:nodes_start:greedy,92,71628,23488,48140,93019,9,92;55;52;49;102;148;9;62;144;14;3;178;106;185;40;165;90;81;196;179;145;78;31;56;113;175;171;16;25;44;120;75;86;152;124;94;63;79;80;176;133;151;51;118;59;115;46;0;137;23;186;89;183;143;117;93;140;68;139;193;41;5;42;181;159;69;108;18;22;146;34;160;48;54;177;10;190;84;184;43;116;65;131;149;162;123;127;70;135;154;180;53;100;26;97;1;101;2;129;57,3043925521482475783,0.004250
greedy_intra:nodes_start:greedy,93,71479,23229,48250,64545,6,93;140;108;69;18;22;146;159;193;41;5;42;181;34;160;48;54;177;10;4;112;84;184;43;116;65;149;123;127;162;151;133;135;70;154;180;53;121;100;26;86;75;44;25;16;171;175;113;56;31;78;145;179;196;81;90;165;40;185;106;178;3;14;144;62;9;148;102;49;52;55;57;92;129;82;120;2;101;1;97;152;124;94;63;79;80;176;137;51;118;59;115;139;68;46;0;89;183;143;117,1680802377578452878,0.002004
greedy_intra:nodes_start:greedy,94,71688,23118,48570,23220,1,94;152;97;1;101;75;86;26;100;121;53;158;154;70;135;180;63;79;133;51;118;59;115;46;0;143;117;93;140;68;139;193;41;5;42;181;159;69;108;18;22;146;34;160;48;54;177;184;43;116;65;149;123;127;162;151;80;176;137;23;183;89;186;114;15;9;62;144;14;138;165;185;40;90;81;196;179;145;78;31;56;113;175;171;16;25;44;120;2;129;92;57;55;52;106;178;49;102;148;124,8017893921463975021,0.000000
greedy_intra:nodes_start:greedy,95,72422,24114,48308,47026,4,39;7;164;95;27;90;40;185;81;196;179;145;78;31;56;113;175;171;16;25;44;120;75;86;26;94;63;79;80;176;133;151;51;118;59;115;46;0;137;23;89;183;143;117;93;140;68;139;193;41;5;42;181;159;69;108;18;22;146;34;160;48;54;177;184;43;116;65;149;162;123;127;70;135;154;180;53;100;101;1;97;152;2;129;92;57;55;52;106;178;49;102;148;9;62;144;14;138;165;119,4305112114713410558,0.001029
greedy_intra:nodes_start:greedy,96,71756,23526,48230,53590,7,42;116;47;65;149;123;127;162;151;133;135;70;154;180;53;121;100;26;86;75;44;25;16;171;175;113;56;31;78;145;179;196;81;90;40;165;185;106;178;3;14;144;62;9;148;102;49;52;55;92;57;129;82;120;2;101;1;97;152;124;94;63;79;80;176;137;23;186;89;183;143;117;0;51;118;59;115;46;68;139;41;193;159;69;108;18;22;146;181;34;160;48;54;177;10;4;112;84;184;43,1637322139666851775,0.003000
greedy_intra:nodes_start:greedy,97,71666,23477,48189,32961,3,97;152;1;101;75;86;53;154;70;135;180;63;79;133;51;118;59;115;46;0;143;117;93;140;68;139;193;41;5;42;181;159;69;108;18;22;146;34;160;48;54;177;10;184;43;116;65;149;123;127;162;151;80;176;137;23;183;89;186;114;15;9;62;144;14;138;185;40;165;90;81;196;179;145;78;31;56;113;175;171;16;25;44;120;2;129;92;57;55;52;106;178;49;102;148;124;94;121;100;26,3554612699812089214,0.002000
greedy_intra:nodes_start:greedy,98,73004,23935,49069,32399,4,196;81;90;27;164;39;165;40;185;106;178;3;14;144;62;9;148;102;49;52;55;57;129;92;179;145;78;82;2;152;97;1;101;100;53;180;154;135;70;127;123;162;149;65;116;43;184;177;54;48;160;34;146;22;18;108;69;159;181;42;5;41;193;139;68;140;93;117;143;183;89;23;137;0;46;115;59;118;51;151;133;176;80;79;63;94;26;86;75;120;44;25;16;171;175;113;56;31;157;169,8917120603488353664,0.002000
greedy_intra:nodes_start:greedy,99,72038,23468,48570,58695,6,53;100;26;97;86;75;101;1;152;94;124;148;102;49;178;106;52;55;57;92;129;2;120;44;25;16;171;175;113;56;31;78;145;179;196;81;90;165;40;185;138;14;144;62;9;15;114;186;89;183;23;137;176;80;151;162;127;123;149;65;116;43;184;177;54;48;160;34;146;22;18;108;69;159;181;42;5;41;193;139;68;140;93;117;143;0;46;115;59;118;51;133;79;63;180;135;70;154;158;121,7662981003725945645,0.002837
greedy_intra:nodes_start:greedy,100,71750,23180,48570,12493,0,100;26;86;75;101;1;97;152;94;124;148;102;49;178;106;52;55;57;92;129;2;120;44;25;16;171;175;113;56;31;78;145;179;196;81;90;185;40;165;138;14;144;62;9;15;114;186;89;183;23;137;176;80;151;162;127;123;149;65;116;43;184;177;54;48;160;34;146;22;18;108;69;159;181;42;5;41;193;139;68;140;93;117;143;0;46;115;59;118;51;133;79;63;180;135;70;154;158;53;121,4618242678678358883,0.000970
greedy_intra:nodes_start:greedy,101,71811,23622,48189,37664,4,75;1;152;97;26;100;121;94;124;148;102;49;178;106;52;55;57;92;129;2;120;44;25;16;171;175;113;56;31;78;145;179;196;81;90;40;185;165;138;14;144;62;9;15;114;186;89;183;23;137;176;80;151;162;127;123;149;65;116;43;184;10;177;54;48;160;34;146;22;18;108;69;159;181;42;5;41;193;139;68;140;93;117;143;0;46;115;59;118;51;133;79;63;180;135;70;154;53;86;101,2454141836242624827,0.001997
greedy_intra:nodes_start:greedy,102,71455,23393,48062,14235,2,102;148;9;62;144;14;138;165;40;185;90;81;196;179;145;78;31;56;113;175;171;16;25;44;120;75;86;26;124;94;63;79;80;176;133;151;51;118;59;115;46;0;137;23;186;89;183;143;117;93;140;68;139;193;41;5;42;181;159;69;108;18;22;146;34;160;48;54;177;10;190;84;184;43;116;65;131;149;162;123;127;70;135;154;180;53;100;101;1;97;152;2;129;92;57;55;52;106;178;49,1661911187451017649,0.001002
greedy_intra:nodes_start:greedy,103,71169,23196,47973,33821,3,181;34;160;48;54;177;10;190;4;112;84;184;42;43;116;65;149;123;127;162;151;133;135;70;154;180;53;121;100;26;86;75;44;25;16;171;175;113;56;31;78;145;179;196;81;90;40;165;185;106;178;3;14;144;62;9;148;102;49;52;55;57;92;129;82;120;2;101;1;97;152;124;94;63;79;80;176;137;23;186;89;183;143;117;0;51;118;59;115;46;68;139;41;193;159;69;108;18;22;146,3997940924021640017,0.001003
greedy_intra:nodes_start:greedy,104,71608,23396,48212,147950,22,177;54;48;34;160;42;181;195;146;22;18;108;69;159;193;41;139;68;140;93;117;143;183;89;186;23;137;176;80;79;63;94;124;152;97;1;101;2;120;82;129;92;57;55;52;49;102;148;9;62;144;14;3;178;106;185;40;165;90;81;196;179;145;78;31;56;113;175;171;16;25;44;75;86;26;100;121;53;180;154;135;70;127;123;162;133;151;51;0;46;115;118;59;65;116;43;184;112;4;10,261279317054515951,0.007337
greedy_intra:nodes_start:greedy,105,72233,23501,48732,18796,2,47;116;43;184;84;190;10;177;54;48;160;34;146;22;18;108;69;159;181;42;5;41;193;139;68;46;115;118;59;51;0;117;143;183;89;186;23;137;176;80;79;63;94;124;152;97;1;101;2;120;82;129;57;92;55;52;49;102;148;9;62;144;14;3;178;106;185;165;40;90;81;196;179;145;78;31;56;113;175;171;16;25;44;75;86;26;100;121;53;180;154;70;135;133;151;162;127;123;149;65,2105172450278438246,0.002002
greedy_intra:nodes_start:greedy,106,71338,23276,48062,29804,3,106;178;49;102;148;9;62;144;14;138;185;40;165;90;81;196;179;145;78;31;56;113;175;171;16;25;44;120;75;86;26;124;94;63;79;80;176;133;151;51;118;59;115;46;0;137;23;186;89;183;143;117;93;140;68;139;193;41;5;42;181;159;69;108;18;22;146;34;160;48;54;177;10;190;84;184;43;116;65;131;149;162;123;127;70;135;154;180;53;100;101;1;97;152;2;129;92;57;55;52,4075829786270054637,0.001979
greedy_intra:nodes_start:greedy,107,72157,23629,48528,37213,4,27;58;164;7;95;39;165;138;14;144;62;9;148;102;49;178;106;52;55;57;92;129;2;152;97;1;101;100;53;180;154;135;70;127;123;162;149;65;116;43;184;177;54;48;160;34;146;22;18;108;69;159;181;42;5;41;193;139;68;140;93;117;143;183;89;23;137;0;46;115;59;118;51;151;133;176;80;79;63;94;26;86;75;120;44;25;16;171;175;113;56;31;78;145;179;196;81;185;40;90,8326880496270273428,0.002497
greedy_intra:nodes_start:greedy,108,72199,23348,48851,43659,4,18;108;139;68;46;115;59;118;51;0;117;143;183;89;186;23;137;176;80;79;63;94;124;152;97;1;101;2;120;82;129;57;92;55;52;49;102;148;9;62;144;14;3;178;106;185;165;40;90;81;196;179;145;78;31;56;113;175;171;16;25;44;75;86;26;100;121;53;180;154;70;135;133;151;162;127;123;149;65;116;43;184;84;190;10;177;54;48;160;34;181;42;5;41;193;159;146;22;199;69,7875792663642171313,0.001972
greedy_intra:nodes_start:greedy,109,72148,23548,48600,31467,3,109;118;115;46;68;139;193;41;5;42;181;159;69;108;18;22;146;34;160;48;54;177;10;112;4;84;184;43;116;65;59;151;133;162;123;127;70;135;154;180;53;121;100;26;86;75;44;25;16;171;175;113;56;31;78;145;179;196;81;90;40;165;185;106;178;3;14;144;62;9;148;102;49;52;55;92;57;129;82;120;2;101;1;97;152;124;94;63;79;80;176;137;23;186;89;183;143;117;0;51,8133993463388351303,0.001968
greedy_intra:nodes_start:greedy,110,71964,23165,48799,52111,5,139;193;41;5;42;181;159;69;108;18;22;146;34;160;48;54;177;10;190;84;184;43;116;65;149;123;127;162;151;133;135;70;154;180;53;121;100;26;86;75;44;25;16;171;175;113;56;31;78;145;179;196;81;90;165;40;185;106;178;3;14;144;62;9;148;102;49;52;55;57;92;129;82;120;2;101;1;97;152;124;94;63;79;80;176;137;23;186;89;183;143;117;0;51;118;59;115;46;68;198,3889718845031865436,0.002969
greedy_intra:nodes_start:greedy,111,72508,23912,48596,62654,9,167;148;9;62;102;144;14;49;178;106;165;39;95;164;27;90;81;196;40;185;52;55;57;129;92;179;145;78;31;56;113;175;171;16;25;44;120;2;152;97;1;101;75;86;26;100;121;53;158;154;70;135;180;63;79;133;51;118;59;115;46;0;89;183;143;117;93;140;68;139;193;41;5;42;181;159;69;108;18;22;146;34;160;48;54;177;184;43;116;65;149;123;127;162;151;80;176;137;94;124,3507405529882904076,0.002972
greedy_intra:nodes_start:greedy,112,71495,23245,48250,77719,10,112;4;84;35;184;10;177;54;48;160;34;181;146;22;18;108;69;159;193;41;5;42;43;116;65;46;68;139;115;59;118;51;0;117;143;183;89;186;23;137;176;80;79;63;94;124;152;97;1;101;2;120;82;129;92;57;55;52;49;102;148;9;62;144;14;3;178;106;185;40;165;90;81;196;179;145;78;31;56;113;175;171;16;25;44;75;86;26;100;121;53;180;154;70;135;133;151;162;123;127,7975364333245994314,0.004000
greedy_intra:nodes_start:greedy,113,71981,23841,48140,39862,4,175;56;31;145;78;92;179;196;81;90;165;40;185;106;178;3;14;144;62;9;148;102;49;52;55;57;129;2;152;97;1;101;100;53;180;154;135;70;127;123;162;149;131;65;116;43;184;84;190;10;177;54;48;160;34;146;22;18;108;69;159;181;42;5;41;193;139;68;140;93;117;143;183;89;186;23;137;0;46;115;59;118;51;151;133;176;80;79;63;94;124;26;86;75;120;44;25;16;171;113,3537367268585149428,0.001999
greedy_intra:nodes_start:greedy,114,71845,23275,48570,34390,2,15;186;89;183;23;137;176;80;151;162;127;123;149;65;116;43;184;177;54;48;160;34;146;22;18;108;69;159;181;42;5;41;193;139;68;140;93;117;143;0;46;115;59;118;51;133;79;63;180;135;70;154;158;53;121;100;26;86;75;101;1;97;152;94;124;148;9;62;102;49;178;106;52;55;57;92;129;2;120;44;25;16;171;175;113;56;31;78;145;179;196;81;90;165;40;185;138;14;144;114,885392597832483136,0.000998
greedy_intra:nodes_start:greedy,115,71897,23774,48123,90941,9,46;118;59;51;0;117;143;183;89;186;23;137;176;80;79;63;94;124;152;97;1;101;2;120;82;129;92;57;55;52;49;102;148;9;62;144;14;3;178;106;185;165;40;90;81;196;179;145;78;31;56;113;175;171;16;25;44;75;86;26;100;121;53;180;154;70;135;133;151;162;127;123;149;65;116;43;184;84;112;4;10;177;54;48;160;34;146;22;18;108;69;159;181;42;5;41;193;139;115;68,4350092871693386173,0.004284
greedy_intra:nodes_start:greedy,116,71837,23714,48123,19843,3,116;43;184;84;112;4;10;177;54;48;160;34;146;22;18;108;69;159;181;42;5;41;193;139;68;46;115;59;118;51;0;117;143;183;89;186;23;137;176;80;79;63;94;124;152;97;1;101;2;120;82;129;57;92;55;52;49;102;148;9;62;144;14;3;178;106;185;165;40;90;81;196;179;145;78;31;56;113;175;171;16;25;44;75;86;26;100;121;53;180;154;70;135;133;151;162;127;123;149;65,2532420853112788005,0.001000
greedy_intra:nodes_start:greedy,117,70793,22588,48205,80632,7,143;117;46;68;139;115;193;41;5;42;181;159;69;108;18;22;146;34;160;48;54;177;10;190;4;112;84;184;43;116;65;59;118;51;151;133;162;123;127;70;135;154;180;53;121;100;26;86;75;44;25;16;171;175;113;56;31;78;145;179;196;81;90;165;40;185;106;178;3;14;144;62;9;148;102;49;52;55;57;92;129;82;120;2;101;1;97;152;124;94;63;79;80;176;137;23;186;89;183;0,4028966891598958683,0.002999
greedy_intra:nodes_start:greedy,118,71749,23626,48123,34627,4,118;115;46;68;139;193;41;5;42;181;159;69;108;18;22;146;34;160;48;54;177;10;4;112;84;184;43;116;65;149;123;127;162;151;133;135;70;154;180;53;121;100;26;86;75;44;25;16;171;175;113;56;31;78;145;179;196;81;90;165;40;185;106;178;3;14;144;62;9;148;102;49;52;55;92;57;129;82;120;2;101;1;97;152;124;94;63;79;80;176;137;23;186;89;183;143;117;0;51;59,6280314766158330202,0.002000
greedy_intra:nodes_start:greedy,119,71346,23151,48195,67196,6,185;40;119;90;81;196;179;145;78;31;56;113;175;171;16;25;44;120;75;86;101;124;94;63;79;80;176;133;151;51;118;59;115;46;0;137;23;186;89;183;143;117;93;140;68;139;193;41;5;42;181;159;69;108;18;22;146;34;160;48;54;177;10;190;184;43;116;65;131;149;162;123;127;70;135;154;180;53;100;26;1;97;152;2;129;92;57;55;52;106;178;49;102;148;9;62;144;14;138;165,4827582476273132328,0.001895
greedy_intra:nodes_start:greedy,120,71472,23332,48140,75644,8,120;75;86;101;124;94;63;79;80;176;133;151;51;118;59;115;46;0;137;23;186;89;183;143;117;93;140;68;139;193;41;5;42;181;159;69;108;18;22;146;34;160;48;54;177;10;190;84;184;43;116;65;131;149;162;123;127;70;135;154;180;53;100;26;1;97;152;2;129;92;57;55;52;49;102;148;9;62;144;14;3;178;106;185;40;165;90;81;196;179;145;78;31;56;113;175;171;16;25;44,1583583221803800562,0.003000
greedy_intra:nodes_start:greedy,121,71805,23235,48570,23094,1,121;100;26;97;86;75;101;1;152;94;124;148;102;49;178;106;52;55;57;92;129;2;120;44;25;16;171;175;113;56;31;78;145;179;196;81;90;40;185;165;138;14;144;62;9;15;114;186;89;183;23;137;176;80;151;162;127;123;149;65;116;43;184;177;54;48;160;34;146;22;18;108;69;159;181;42;5;41;193;139;68;140;93;117;143;0;46;115;59;118;51;133;79;63;180;135;70;154;158;53,8426145192081367332,0.001001
greedy_intra:nodes_start:greedy,122,72236,23026,49210,58533,5,63;176;80;79;133;151;51;118;59;115;46;0;137;23;89;183;143;117;93;140;68;139;193;41;5;42;181;159;69;108;18;22;146;34;160;48;54;177;184;43;116;65;131;149;162;123;127;70;135;154;180;158;53;121;100;26;86;75;44;25;16;171;175;113;56;31;78;145;179;196;81;90;165;40;185;106;178;3;14;144;62;9;148;102;49;52;55;57;92;129;82;120;2;101;1;97;152;124;94;122,2310230286826200386,0.003311
greedy_intra:nodes_start:greedy,123,71577,23015,48562,43212,3,123;162;133;151;149;131;65;116;43;184;84;190;10;177;54;48;160;34;146;22;18;108;69;159;181;42;5;41;193;139;68;46;115;59;118;51;0;117;143;183;89;186;23;137;176;80;79;63;94;124;152;97;1;101;2;120;82;129;92;57;55;52;49;102;148;9;62;144;14;3;178;106;185;40;165;90;81;196;179;145;78;31;56;113;175;171;16;25;44;75;86;26;100;121;53;180;154;135;70;127,3255414873780952213,0.002187
greedy_intra:nodes_start:greedy,124,71688,23118,48570,58710,4,94;152;97;1;101;75;86;26;100;121;53;158;154;70;135;180;63;79;133;51;118;59;115;46;0;143;117;93;140;68;139;193;41;5;42;181;159;69;108;18;22;146;34;160;48;54;177;184;43;116;65;149;123;127;162;151;80;176;137;23;183;89;186;114;15;9;62;144;14;138;165;185;40;90;81;196;179;145;78;31;56;113;175;171;16;25;44;120;2;129;92;57;55;52;106;178;49;102;148;124,6286550270220569729,0.003002
greedy_intra:nodes_start:greedy,125,73048,23567,49481,37298,7,74;2;120;82;129;57;92;179;145;78;31;56;113;175;171;16;25;44;75;86;53;154;70;135;180;63;79;133;51;118;59;115;46;0;143;117;93;140;68;139;193;41;5;42;181;159;69;108;18;22;146;34;160;48;54;177;184;43;116;65;149;123;162;151;80;176;137;23;183;89;186;114;15;9;62;144;14;138;165;90;81;196;40;185;55;52;106;178;49;102;148;124;94;121;100;26;1;101;97;152,4936802384472080846,0.002194
greedy_intra:nodes_start:greedy,126,71857,23250,48607,53863,7,131;112;4;84;35;184;177;54;48;160;34;181;146;22;18;108;69;159;193;41;5;42;43;116;65;46;68;139;115;59;118;51;0;117;143;183;89;186;23;137;176;80;79;63;94;124;152;97;1;101;2;120;82;129;92;57;55;52;49;102;148;9;62;144;14;3;178;106;185;165;40;90;81;196;179;145;78;31;56;113;175;171;16;25;44;75;86;26;100;121;53;180;154;70;135;133;151;162;123;149,5799492425115893455,0.001999
greedy_intra:nodes_start:greedy,127,72189,23684,48505,73839,7,162;70;135;154;180;53;121;100;26;86;75;44;25;16;171;175;113;56;31;78;145;179;196;81;90;40;165;185;106;178;3;14;144;62;9;148;102;49;52;55;57;92;129;82;120;2;101;1;97;152;124;94;63;79;80;176;133;151;51;118;59;115;46;0;137;23;186;89;183;143;117;93;140;68;139;193;41;5;42;181;159;69;108;18;22;146;34;160;48;54;177;10;184;43;116;65;131;149;123;127,4729581967644951728,0.002997
greedy_intra:nodes_start:greedy,128,71621,23452,48169,69574,6,106;167;148;9;62;102;144;14;49;178;3;185;40;165;90;81;196;179;145;78;31;56;113;175;171;16;25;44;120;75;86;101;124;94;63;79;80;176;133;151;51;118;59;115;46;0;137;23;186;89;183;143;117;93;140;68;139;193;41;5;42;181;159;69;108;18;22;146;34;160;48;54;177;10;190;184;43;116;65;131;149;162;123;127;70;135;154;180;53;100;26;1;97;152;2;129;92;57;55;52,5601020899018641185,0.003000
greedy_intra:nodes_start:greedy,129,71472,23332,48140,98282,10,129;92;57;55;52;49;102;148;9;62;144;14;3;178;106;185;40;165;90;81;196;179;145;78;31;56;113;175;171;16;25;44;120;75;86;101;124;94;63;79;80;176;133;151;51;118;59;115;46;0;137;23;186;89;183;143;117;93;140;68;139;193;41;5;42;181;159;69;108;18;22;146;34;160;48;54;177;10;190;84;184;43;116;65;131;149;162;123;127;70;135;154;180;53;100;26;1;97;152;2,4695463929043036674,0.004521
greedy_intra:nodes_start:greedy,130,71633,23063,48570,64625,5,124;148;102;49;178;106;52;55;57;92;129;2;120;44;25;16;171;175;113;56;31;78;145;179;196;81;90;165;40;185;138;14;144;62;9;15;114;186;89;183;23;137;176;80;151;162;127;123;149;65;116;43;184;177;54;48;160;34;146;22;18;108;69;159;181;42;5;41;193;139;68;140;93;117;143;0;46;115;59;118;51;133;79;63;180;135;70;154;158;53;121;100;26;86;75;101;1;97;152;94,6303712832262098816,0.003959
greedy_intra:nodes_start:greedy,131,72027,23295,48732,41872,4,65;149;123;127;162;151;133;135;70;154;180;53;121;100;26;86;75;44;25;16;171;175;113;56;31;78;145;179;196;81;90;165;40;185;106;178;3;14;144;62;9;148;102;49;52;55;92;57;129;82;120;2;101;1;97;152;124;94;63;79;80;176;137;23;186;89;183;143;117;0;51;118;59;115;46;68;139;193;41;5;42;181;159;69;108;18;22;146;34;160;48;54;177;10;190;84;184;43;116;47,7648413314914704409,0.002000
greedy_intra:nodes_start:greedy,132,71858,23953,47905,45230,7,21;14;138;165;185;40;90;81;196;179;145;78;31;56;113;175;171;16;25;44;120;75;86;26;124;94;63;79;80;176;133;151;51;118;59;115;46;0;137;23;186;89;183;143;117;93;140;68;139;193;41;5;42;181;159;69;108;18;22;146;34;160;48;54;177;10;190;184;43;116;65;131;149;162;123;127;70;135;154;180;53;100;101;1;97;152;2;129;92;57;55;52;106;178;49;102;148;9;62;144,8720153849451850905,0.002985
greedy_intra:nodes_start:greedy,133,71954,23449,48505,32127,3,133;151;51;118;59;115;46;0;137;23;186;89;183;143;117;93;140;68;139;193;41;5;42;181;159;69;108;18;22;146;34;160;48;54;177;10;184;43;116;65;131;149;162;123;127;70;135;154;180;53;121;100;26;86;75;44;25;16;171;175;113;56;31;78;145;179;196;81;90;165;40;185;106;178;3;14;144;62;9;148;102;49;52;55;92;57;129;82;120;2;101;1;97;152;124;94;63;79;80;176,5057941973643260009,0.000953
greedy_intra:nodes_start:greedy,134,71910,22845,49065,99059,15,199;69;18;108;139;68;46;115;59;118;51;0;117;143;183;89;186;23;137;176;80;79;63;94;124;152;97;1;101;2;120;82;129;92;57;55;52;49;102;148;9;62;144;14;3;178;106;185;40;165;90;81;196;179;145;78;31;56;113;175;171;16;25;44;75;86;26;100;121;53;180;154;70;135;133;151;162;127;123;149;65;116;43;184;190;10;177;54;48;160;34;181;42;5;41;193;159;195;146;22,3777871178964331661,0.005000
greedy_intra:nodes_start:greedy,135,71760,23190,48570,65136,5,135;154;180;158;53;121;100;26;86;75;101;1;97;152;94;124;148;102;49;178;106;52;55;57;92;129;2;120;44;25;16;171;175;113;56;31;78;145;179;196;81;90;40;185;165;138;14;144;62;9;15;114;186;89;183;23;137;176;80;151;162;127;123;149;65;116;43;184;177;54;48;160;34;146;22;18;108;69;159;181;42;5;41;193;139;68;140;93;117;143;0;46;115;59;118;51;133;79;63;70,1648620362467864562,0.003029
greedy_intra:nodes_start:greedy,136,71783,23084,48699,101863,10,53;121;100;26;86;75;44;25;16;171;175;113;56;31;78;145;179;196;81;90;165;40;185;106;178;3;14;144;62;9;148;102;49;52;55;57;92;129;82;120;2;101;1;97;152;124;94;63;79;80;176;137;23;186;89;183;143;117;0;51;118;59;115;46;68;139;193;41;5;42;181;159;69;108;18;22;146;34;160;48;54;177;10;190;84;184;43;116;65;149;123;127;162;151;133;135;70;154;180;158,4020674307547340437,0.004999
greedy_intra:nodes_start:greedy,137,71633,23063,48570,24349,1,137;23;183;89;186;114;15;9;62;144;14;138;185;40;165;90;81;196;179;145;78;31;56;113;175;171;16;25;44;120;2;129;92;57;55;52;106;178;49;102;148;124;94;152;97;1;101;75;86;26;100;121;53;158;154;70;135;180;63;79;133;51;118;59;115;46;0;143;117;93;140;68;139;193;41;5;42;181;159;69;108;18;22;146;34;160;48;54;177;184;43;116;65;149;123;127;162;151;80;176,2908710816009634663,0.000971
greedy_intra:nodes_start:greedy,138,71393,23331,48062,40809,3,138;14;144;62;9;148;102;49;178;106;52;55;57;92;129;2;152;97;1;101;100;53;180;154;135;70;127;123;162;149;131;65;116;43;184;84;190;10;177;54;48;160;34;146;22;18;108;69;159;181;42;5;41;193;139;68;140;93;117;143;183;89;186;23;137;0;46;115;59;118;51;151;133;176;80;79;63;94;124;26;86;75;120;44;25;16;171;175;113;56;31;78;145;179;196;81;90;40;185;165,5821637365365581435,0.002924
greedy_intra:nodes_start:greedy,139,72336,24213,48123,41124,4,193;68;46;115;59;118;51;0;117;143;183;89;186;23;137;176;80;79;63;94;124;152;97;1;101;2;120;82;129;57;92;55;52;49;102;148;9;62;144;14;3;178;106;185;165;40;90;81;196;179;145;78;31;56;113;175;171;16;25;44;75;86;26;100;121;53;180;154;70;135;133;151;162;127;123;149;65;116;43;184;84;112;4;10;177;54;48;160;34;146;22;18;108;69;159;181;42;5;41;139,5083648072487393993,0.000999
greedy_intra:nodes_start:greedy,140,71627,23377,48250,68600,7,93;108;69;18;22;146;159;193;41;5;42;181;34;160;48;54;177;10;4;112;84;184;43;116;65;149;123;127;162;151;133;135;70;154;180;53;121;100;26;86;75;44;25;16;171;175;113;56;31;78;145;179;196;81;90;165;40;185;106;178;3;14;144;62;9;148;102;49;52;55;57;92;129;82;120;2;101;1;97;152;124;94;63;79;80;176;137;51;118;59;115;139;68;46;0;89;183;143;117;140,5323387524711039219,0.003773
greedy_intra:nodes_start:greedy,141,71386,22795,48591,114981,16,137;186;114;89;183;143;0;117;93;140;68;46;115;139;193;41;5;42;181;159;69;108;18;22;146;34;160;48;54;177;10;190;184;43;116;65;59;118;51;151;133;162;123;127;70;135;154;180;53;121;100;26;86;75;44;25;16;171;175;113;56;31;78;145;179;196;81;90;165;40;185;106;178;3;14;144;62;9;148;102;49;52;55;57;92;129;82;120;2;101;1;97;152;124;94;63;79;80;176;23,3051785454071580920,0.006206
greedy_intra:nodes_start:greedy,142,72418,23619,48799,79324,8,193;198;68;46;115;59;118;51;0;117;143;183;89;186;23;137;176;80;79;63;94;124;152;97;1;101;2;120;82;129;92;57;55;52;49;102;148;9;62;144;14;3;178;106;185;40;165;90;81;196;179;145;78;31;56;113;175;171;16;25;44;75;86;26;100;121;53;180;154;70;135;133;151;162;127;123;149;65;116;43;184;84;190;10;177;54;48;160;34;146;22;18;108;69;159;181;42;5;139;41,5992057190994991184,0.004008
greedy_intra:nodes_start:greedy,143,71492,23287,48205,86513,7,183;0;117;68;46;139;115;193;41;5;42;181;159;69;108;18;22;146;34;160;48;54;177;10;190;4;112;84;184;43;116;65;59;118;51;151;133;162;123;127;70;135;154;180;53;121;100;26;86;75;44;25;16;171;175;113;56;31;78;145;179;196;81;90;40;165;185;106;178;3;14;144;62;9;148;102;49;52;55;57;92;129;82;120;2;101;1;97;152;124;94;63;79;80;176;137;23;186;89;143,2176350431834385813,0.003973
greedy_intra:nodes_start:greedy,144,71481,23419,48062,134931,14,102;14;138;185;40;165;90;81;196;179;145;78;31;56;113;175;171;16;25;44;120;75;86;152;124;94;63;79;80;176;133;151;51;118;59;115;46;0;137;23;186;89;183;143;117;93;140;68;139;193;41;5;42;181;159;69;108;18;22;146;34;160;48;54;177;10;190;84;184;43;116;65;131;149;162;123;127;70;135;154;180;53;100;26;97;1;101;2;129;92;57;55;52;106;178;49;148;62;9;144,8878567296776750957,0.006993
greedy_intra:nodes_start:greedy,145,71648,23508,48140,124034,13,78;179;196;81;90;165;40;185;106;178;3;14;144;62;9;148;102;49;52;55;57;92;129;2;152;97;1;26;100;53;180;154;135;70;127;123;162;149;131;65;116;43;184;84;190;10;177;54;48;160;34;146;22;18;108;69;159;181;42;5;41;193;139;68;140;93;117;143;183;89;186;23;137;0;46;115;59;118;51;151;133;176;80;79;63;94;124;101;86;75;120;44;25;16;171;175;113;56;31;145,2699620221352641550,0.005000
greedy_intra:nodes_start:greedy,146,71022,23049,47973,43120,3,146;181;34;160;48;54;177;10;190;4;112;84;184;42;43;116;65;149;123;127;162;151;133;135;70;154;180;53;121;100;26;86;75;44;25;16;171;175;113;56;31;78;145;179;196;81;90;165;40;185;106;178;3;14;144;62;9;148;102;49;52;55;57;92;129;82;120;2;101;1;97;152;124;94;63;79;80;176;137;23;186;89;183;143;117;0;51;118;59;115;46;68;139;41;193;159;69;108;18;22,7032512878504885631,0.002001
greedy_intra:nodes_start:greedy,147,71699,23041,48658,89806,12,30;177;10;190;184;43;116;65;59;118;115;46;0;51;151;133;162;123;127;70;135;154;180;53;121;100;26;86;75;44;25;16;171;175;113;56;31;78;145;179;196;81;90;165;40;185;106;178;3;14;144;62;9;148;102;49;52;55;57;92;129;82;120;2;101;1;97;152;124;94;63;79;80;176;137;23;186;89;183;143;117;93;140;68;139;41;193;159;69;108;18;22;146;195;181;42;34;160;48;54,3999345966374962580,0.005641
greedy_intra:nodes_start:greedy,148,71455,23393,48062,17918,2,148;102;49;178;106;52;55;57;92;129;2;152;97;1;101;100;53;180;154;135;70;127;123;162;149;131;65;116;43;184;84;190;10;177;54;48;160;34;146;22;18;108;69;159;181;42;5;41;193;139;68;140;93;117;143;183;89;186;23;137;0;46;115;59;118;51;151;133;176;80;79;63;94;124;26;86;75;120;44;25;16;171;175;113;56;31;78;145;179;196;81;90;185;40;165;138;14;144;62;9,3258864974058602448,0.001000
greedy_intra:nodes_start:greedy,149,71882,23420,48462,60284,6,65;123;127;162;151;133;135;70;154;180;53;121;100;26;86;75;44;25;16;171;175;113;56;31;78;145;179;196;81;90;165;40;185;106;178;3;14;144;62;9;148;102;49;52;55;57;92;129;82;120;2;101;1;97;152;124;94;63;79;80;176;137;23;186;89;183;143;117;0;51;118;59;115;46;68;139;193;41;5;42;181;159;69;108;18;22;146;34;160;48;54;177;10;190;4;112;184;43;116;47,1090037736651643184,0.002973
greedy_intra:nodes_start:greedy,150,73015,23534,49481,125040,13,1;75;44;25;16;171;175;113;56;31;78;145;179;57;92;129;82;120;2;74;152;97;26;100;121;94;124;148;102;49;178;106;52;55;185;40;196;81;90;165;138;14;144;62;9;15;114;186;89;183;23;137;176;80;151;162;123;149;65;116;43;184;177;54;48;160;34;146;22;18;108;69;159;181;42;5;41;193;139;68;140;93;117;143;0;46;115;59;118;51;133;79;63;180;135;70;154;53;86;101,2563847540497221222,0.007001
greedy_intra:nodes_start:greedy,151,71577,23015,48562,26305,3,151;133;162;123;127;70;135;154;180;53;121;100;26;86;75;44;25;16;171;175;113;56;31;78;145;179;196;81;90;165;40;185;106;178;3;14;144;62;9;148;102;49;52;55;57;92;129;82;120;2;101;1;97;152;124;94;63;79;80;176;137;23;186;89;183;143;117;0;51;118;59;115;46;68;139;193;41;5;42;181;159;69;108;18;22;146;34;160;48;54;177;10;190;84;184;43;116;65;131;149,2446370523565059483,0.001978
greedy_intra:nodes_start:greedy,152,71714,23525,48189,45458,4,97;1;101;75;86;53;154;70;135;180;63;79;133;51;118;59;115;46;0;143;117;93;140;68;139;193;41;5;42;181;159;69;108;18;22;146;34;160;48;54;177;10;184;43;116;65;149;123;127;162;151;80;176;137;23;183;89;186;114;15;9;62;144;14;138;185;40;165;90;81;196;179;145;78;31;56;113;175;171;16;25;44;120;2;129;92;57;55;52;106;178;49;102;148;124;94;121;100;26;152,626557500417216433,0.002971
greedy_intra:nodes_start:greedy,153,71146,22617,48529,98014,13,68;0;117;143;183;89;186;23;137;176;80;79;63;94;124;152;97;1;101;2;120;82;129;92;57;55;52;49;102;148;9;62;144;14;3;178;106;185;165;40;90;81;196;179;145;78;31;56;113;175;171;16;25;44;75;86;26;100;121;53;180;154;135;70;127;123;162;133;151;51;118;59;65;116;43;184;84;112;4;10;177;54;48;160;34;146;22;18;108;69;159;181;42;5;41;193;139;115;198;46,6436388304082560327,0.005000
greedy_intra:nodes_start:greedy,154,71832,23262,48570,55772,4,154;158;53;121;100;26;86;75;101;1;97;152;94;124;148;102;49;178;106;52;55;57;92;129;2;120;44;25;16;171;175;113;56;31;78;145;179;196;81;90;40;185;165;138;14;144;62;9;15;114;186;89;183;23;137;176;80;151;162;127;123;149;65;116;43;184;177;54;48;160;34;146;22;18;108;69;159;181;42;5;41;193;139;68;140;93;117;143;0;46;115;59;118;51;133;79;63;70;135;180,6139458222070243538,0.002000
greedy_intra:nodes_start:greedy,155,71370,23348,48022,181588,21,144;14;138;185;40;165;90;81;196;179;145;78;31;56;113;175;171;16;25;44;120;75;86;152;124;94;63;79;80;176;133;151;51;118;59;115;46;0;137;23;186;89;183;143;117;93;140;68;139;193;41;5;42;181;159;69;108;18;22;146;34;160;48;54;177;10;190;184;43;116;65;131;149;162;123;127;70;135;154;180;53;100;26;97;1;101;2;129;92;57;55;52;106;178;49;102;62;9;148;15,1336280195609499717,0.008167
greedy_intra:nodes_start:greedy,156,71911,23304,48607,54464,6,131;112;4;84;35;184;177;54;48;160;34;181;146;22;18;108;69;159;193;41;5;42;43;116;65;46;68;139;115;59;118;51;0;117;143;183;89;186;23;137;176;80;79;63;94;124;152;97;1;101;2;120;82;129;57;92;55;52;49;102;148;9;62;144;14;3;178;106;185;40;165;90;81;196;179;145;78;31;56;113;175;171;16;25;44;75;86;26;100;121;53;180;154;70;135;133;151;162;123;149,396208842563232661,0.002969
greedy_intra:nodes_start:greedy,157,72083,23768,48315,88608,8,31;196;81;90;165;40;185;106;178;3;14;144;62;9;148;102;49;52;55;179;145;78;92;57;129;2;152;1;97;26;100;53;180;154;135;70;127;123;162;149;131;65;116;43;184;190;10;177;54;48;160;34;146;22;18;108;69;159;181;42;5;41;193;139;68;140;93;117;143;183;89;186;23;137;0;46;115;59;118;51;151;133;176;80;79;63;94;124;101;86;75;120;44;25;16;171;175;113;56;157,7509707399379373417,0.004025
greedy_intra:nodes_start:greedy,158,71633,23063,48570,60630,5,158;154;70;135;180;63;79;133;51;118;59;115;46;0;143;117;93;140;68;139;193;41;5;42;181;159;69;108;18;22;146;34;160;48;54;177;184;43;116;65;149;123;127;162;151;80;176;137;23;183;89;186;114;15;9;62;144;14;138;185;40;165;90;81;196;179;145;78;31;56;113;175;171;16;25;44;120;2;129;92;57;55;52;106;178;49;102;148;124;94;152;97;1;101;75;86;26;100;121;53,4257141857332174646,0.001999
greedy_intra:nodes_start:greedy,159,71479,23229,48250,63930,6,159;146;22;18;69;108;140;93;117;143;183;89;0;46;68;139;115;59;118;51;137;176;80;79;63;94;124;152;97;1;101;2;120;82;129;92;57;55;52;49;102;148;9;62;144;14;3;178;106;185;40;165;90;81;196;179;145;78;31;56;113;175;171;16;25;44;75;86;26;100;121;53;180;154;70;135;133;151;162;127;123;149;65;116;43;184;84;112;4;10;177;54;48;160;34;181;42;5;41;193,4383611796629326974,0.001978
greedy_intra:nodes_start:greedy,160,71117,23144,47973,54785,4,34;48;54;177;10;190;4;112;84;184;42;43;116;65;149;123;127;162;151;133;135;70;154;180;53;121;100;26;86;75;44;25;16;171;175;113;56;31;78;145;179;196;81;90;165;40;185;106;178;3;14;144;62;9;148;102;49;52;55;57;92;129;82;120;2;101;1;97;152;124;94;63;79;80;176;137;23;186;89;183;143;117;0;51;118;59;115;46;68;139;41;193;159;69;108;18;22;146;181;160,531760382204279401,0.002982
greedy_intra:nodes_start:greedy,161,71774,22988,48786,194710,19,133;127;70;135;154;180;158;53;121;100;26;86;75;44;25;16;171;175;113;56;31;78;145;179;196;81;90;165;40;185;106;178;3;14;144;62;9;148;102;49;52;55;57;92;129;82;120;2;101;1;97;152;124;94;63;79;80;176;137;23;186;89;183;143;117;0;51;118;59;115;46;68;139;193;41;5;42;181;159;69;108;18;22;146;34;160;48;54;177;10;190;184;43;116;65;131;149;123;162;151,6582396980207103405,0.009075
greedy_intra:nodes_start:greedy,162,72407,23736,48671,27573,4,72;151;133;135;70;154;180;53;121;100;26;86;75;44;25;16;171;175;113;56;31;78;145;179;196;81;90;40;165;185;106;178;3;14;144;62;9;148;102;49;52;55;92;57;129;82;120;2;101;1;97;152;124;94;63;79;80;176;137;23;186;89;183;143;117;0;51;118;59;115;46;68;139;193;41;5;42;181;159;69;108;18;22;146;34;160;48;54;177;10;112;4;84;184;43;116;65;149;123;162,8845316641776114279,0.002000
greedy_intra:nodes_start:greedy,163,71664,23175,48489,49594,7,140;68;139;46;115;59;118;51;0;117;143;183;89;186;23;137;176;80;79;63;94;124;152;97;1;101;2;120;82;129;92;57;55;52;49;102;148;9;62;144;14;3;178;106;185;165;40;90;81;196;179;145;78;31;56;113;175;171;16;25;44;75;86;26;100;121;53;180;154;70;135;133;151;162;127;123;149;65;116;43;184;84;190;10;177;54;48;160;34;181;42;5;41;193;159;146;22;18;69;108,860395108119705356,0.002979
greedy_intra:nodes_start:greedy,164,72157,23629,48528,36549,5,164;7;95;39;165;138;14;144;62;9;148;102;49;178;106;52;55;57;92;129;2;152;97;1;101;100;53;180;154;135;70;127;123;162;149;65;116;43;184;177;54;48;160;34;146;22;18;108;69;159;181;42;5;41;193;139;68;140;93;117;143;183;89;23;137;0;46;115;59;118;51;151;133;176;80;79;63;94;26;86;75;120;44;25;16;171;175;113;56;31;78;145;179;196;81;185;40;90;27;58,4415186057240408582,0.002028
greedy_intra:nodes_start:greedy,165,71455,23393,48062,19412,1,165;40;185;90;81;196;179;145;78;31;56;113;175;171;16;25;44;120;75;86;26;124;94;63;79;80;176;133;151;51;118;59;115;46;0;137;23;186;89;183;143;117;93;140;68;139;193;41;5;42;181;159;69;108;18;22;146;34;160;48;54;177;10;190;84;184;43;116;65;131;149;162;123;127;70;135;154;180;53;100;101;1;97;152;2;129;92;57;55;52;106;178;49;102;148;9;62;144;14;138,2443588947577232879,0.000998
greedy_intra:nodes_start:greedy,166,71847,23302,48545,69799,9,35;184;190;10;177;54;48;160;34;146;22;18;108;69;159;181;42;5;41;193;139;68;140;93;117;143;183;89;186;23;137;176;80;79;63;94;124;152;97;1;101;2;120;82;129;92;57;55;52;49;102;148;9;62;144;14;3;178;106;185;40;165;90;81;196;179;145;78;31;56;113;175;171;16;25;44;75;86;26;100;121;53;180;154;135;70;127;123;162;133;151;51;0;46;115;118;59;116;65;43,3457053006479614161,0.003446
greedy_intra:nodes_start:greedy,167,72658,24082,48576,24414,2,167;148;9;62;102;144;14;49;178;106;165;39;95;7;164;58;27;90;81;196;40;185;52;55;57;129;92;179;145;78;31;56;113;175;171;16;25;44;120;2;75;101;1;152;97;26;100;86;53;154;70;135;180;63;79;133;51;118;59;115;46;0;89;183;143;117;93;140;68;139;193;41;5;42;181;159;69;108;18;22;146;34;160;48;54;177;184;43;116;65;149;123;127;162;151;80;176;137;94;124,2692734220721291663,0.001001
greedy_intra:nodes_start:greedy,168,71981,23666,48315,167707,18,157;145;179;196;81;90;165;40;185;106;178;3;14;144;62;9;148;102;49;52;55;57;92;129;2;101;1;97;26;100;53;180;154;135;70;127;123;162;149;131;65;116;43;184;190;10;177;54;48;160;34;146;22;18;108;69;159;181;42;5;41;193;139;68;140;93;117;143;183;89;186;23;137;0;46;115;59;118;51;151;133;176;80;79;63;94;124;152;86;75;120;44;25;16;171;175;113;56;31;78,7699256524102849599,0.007045
greedy_intra:nodes_start:greedy,169,71301,23106,48195,125005,15,119;40;185;165;138;14;144;62;9;148;102;49;178;106;52;55;57;92;129;2;101;1;97;26;100;53;180;154;135;70;127;123;162;149;131;65;116;43;184;190;10;177;54;48;160;34;146;22;18;108;69;159;181;42;5;41;193;139;68;140;93;117;143;183;89;186;23;137;0;46;115;59;118;51;151;133;176;80;79;63;94;124;152;86;75;120;44;25;16;171;175;113;56;31;78;145;179;196;81;90,1438310296037033827,0.005107
greedy_intra:nodes_start:greedy,170,71142,22581,48561,120669,13,143;117;0;46;68;139;115;193;41;5;42;181;159;69;108;18;22;146;34;160;48;54;177;10;4;112;84;184;43;116;65;59;118;51;151;133;162;123;127;70;135;154;180;53;121;100;26;86;75;44;25;16;171;175;113;56;31;78;145;179;196;81;90;165;40;185;106;178;3;14;144;62;9;148;102;49;52;55;57;92;129;82;120;2;101;1;97;152;124;94;63;79;80;176;137;23;186;89;183;153,4244705911416000125,0.004999
greedy_intra:nodes_start:greedy,171,71937,23797,48140,53300,8,16;175;113;56;31;78;145;92;179;196;81;90;165;40;185;106;178;3;14;144;62;9;148;102;49;52;55;57;129;2;152;1;97;26;100;53;180;154;135;70;127;123;162;149;131;65;116;43;184;84;190;10;177;54;48;160;34;146;22;18;108;69;159;181;42;5;41;193;139;68;140;93;117;143;183;89;186;23;137;0;46;115;59;118;51;151;133;176;80;79;63;94;124;101;86;75;120;44;25;171,8864067457318999380,0.002699
greedy_intra:nodes_start:greedy,172,72135,23670,48465,88602,13,152;167;148;9;62;102;144;14;49;178;106;165;39;27;90;81;196;40;185;52;55;57;129;92;179;145;78;31;56;113;175;171;16;25;44;120;2;75;86;101;124;94;63;79;80;176;133;151;51;118;59;115;46;0;137;23;186;89;183;143;117;93;140;68;139;193;41;5;42;181;159;69;108;18;22;146;34;160;48;54;177;184;43;116;65;131;149;162;123;127;70;135;154;180;53;121;26;97;1;100,970458677002236377,0.004003
greedy_intra:nodes_start:greedy,173,72192,23056,49136,228395,26,136;154;135;70;158;53;121;100;26;86;75;101;1;97;152;94;124;148;102;49;178;106;52;55;57;92;129;2;120;44;25;16;171;175;113;56;31;78;145;179;196;81;90;165;40;185;138;14;144;62;9;15;114;186;89;183;23;137;176;80;151;162;123;149;65;116;43;184;177;54;48;160;34;146;22;18;108;69;159;181;42;5;41;193;139;68;140;93;117;143;0;46;115;59;118;51;133;79;63;180,4753179028434819988,0.010004
greedy_intra:nodes_start:greedy,174,71562,23500,48062,30606,4,196;40;185;179;145;78;31;56;113;175;171;16;25;44;120;75;86;26;124;94;63;79;80;176;133;151;51;118;59;115;46;0;137;23;186;89;183;143;117;93;140;68;139;193;41;5;42;181;159;69;108;18;22;146;34;160;48;54;177;10;190;84;184;43;116;65;131;149;162;123;127;70;135;154;180;53;100;101;1;97;152;2;129;92;57;55;52;106;178;49;102;148;9;62;144;14;138;165;90;81,6148952785455020901,0.002061
greedy_intra:nodes_start:greedy,175,71785,23645,48140,42005,5,175;113;56;31;145;78;92;179;196;81;90;165;40;185;106;178;3;14;144;62;9;148;102;49;52;55;57;129;2;152;97;1;26;100;53;180;154;135;70;127;123;162;149;131;65;116;43;184;84;190;10;177;54;48;160;34;146;22;18;108;69;159;181;42;5;41;193;139;68;140;93;117;143;183;89;186;23;137;0;46;115;59;118;51;151;133;176;80;79;63;94;124;101;86;75;120;44;25;16;171,1076908002460314884,0.002181
greedy_intra:nodes_start:greedy,176,72684,24122,48562,27684,2,137;80;79;63;94;124;152;97;1;101;2;120;82;129;57;92;55;52;49;102;148;9;62;144;14;3;178;106;185;165;40;90;81;196;179;145;78;31;56;113;175;171;16;25;44;75;86;26;100;121;53;180;154;135;70;127;123;162;133;151;149;131;65;116;43;184;84;190;10;177;54;48;160;34;146;22;18;108;69;159;181;42;5;41;193;139;68;46;115;59;118;51;0;117;143;183;89;186;23;176,5888036240587415408,0.001003
greedy_intra:nodes_start:greedy,177,71789,23549,48240,119859,14,10;54;48;34;160;42;181;195;146;22;18;108;69;159;193;41;139;68;140;93;117;143;183;89;186;23;137;176;80;79;63;94;124;152;97;1;101;2;120;82;129;92;57;55;52;49;102;148;9;62;144;14;3;178;106;185;40;165;90;81;196;179;145;78;31;56;113;175;171;16;25;44;75;86;26;100;121;53;180;154;135;70;127;123;162;133;151;51;0;46;115;118;59;65;116;43;184;84;112;177,3952181074660465961,0.005000
greedy_intra:nodes_start:greedy,178,71338,23276,48062,30592,2,178;49;102;148;9;62;144;14;138;185;40;165;90;81;196;179;145;78;31;56;113;175;171;16;25;44;120;75;86;26;124;94;63;79;80;176;133;151;51;118;59;115;46;0;137;23;186;89;183;143;117;93;140;68;139;193;41;5;42;181;159;69;108;18;22;146;34;160;48;54;177;10;190;84;184;43;116;65;131;149;162;123;127;70;135;154;180;53;100;101;1;97;152;2;129;92;57;55;52;106,5960119704977569878,0.001671
greedy_intra:nodes_start:greedy,179,71956,23599,48357,52635,6,196;145;78;31;56;113;175;171;16;25;44;120;75;86;26;124;94;63;79;80;176;133;151;51;118;59;115;46;0;137;23;186;89;183;143;117;93;140;68;139;193;41;5;42;181;159;69;108;18;22;146;34;160;48;54;177;10;190;84;184;43;116;65;131;149;162;123;127;70;135;154;180;53;100;101;1;97;152;2;129;92;57;55;52;49;102;148;9;62;144;14;3;178;106;185;40;165;90;81;157,3415559500403191571,0.002004
greedy_intra:nodes_start:greedy,180,71750,23180,48570,12491,0,180;135;70;154;158;53;121;100;26;86;75;101;1;97;152;94;124;148;102;49;178;106;52;55;57;92;129;2;120;44;25;16;171;175;113;56;31;78;145;179;196;81;90;185;40;165;138;14;144;62;9;15;114;186;89;183;23;137;176;80;151;162;127;123;149;65;116;43;184;177;54;48;160;34;146;22;18;108;69;159;181;42;5;41;193;139;68;140;93;117;143;0;46;115;59;118;51;133;79;63,557499299100941015,0.001000
greedy_intra:nodes_start:greedy,181,71022,23049,47973,51346,7,181;34;160;48;54;177;10;190;4;112;84;184;42;43;116;65;149;123;127;162;151;133;135;70;154;180;53;121;100;26;86;75;44;25;16;171;175;113;56;31;78;145;179;196;81;90;165;40;185;106;178;3;14;144;62;9;148;102;49;52;55;57;92;129;82;120;2;101;1;97;152;124;94;63;79;80;176;137;23;186;89;183;143;117;0;51;118;59;115;46;68;139;41;193;159;69;108;18;22;146,898054581568994369,0.003022
greedy_intra:nodes_start:greedy,182,71802,23232,48570,23585,2,158;121;100;26;86;75;101;1;97;152;94;124;148;102;49;178;106;52;55;57;92;129;2;120;44;25;16;171;175;113;56;31;78;145;179;196;81;90;165;40;185;138;14;144;62;9;15;114;186;89;183;23;137;176;80;151;162;127;123;149;65;116;43;184;177;54;48;160;34;146;22;18;108;69;159;181;42;5;41;193;139;68;140;93;117;143;0;46;115;59;118;51;133;79;63;180;135;70;154;53,8103520477637804481,0.000000
greedy_intra:nodes_start:greedy,183,71503,23298,48205,68489,5,143;89;186;23;137;176;80;79;63;94;124;152;97;1;101;2;120;82;129;92;57;55;52;49;102;148;9;62;144;14;3;178;106;185;40;165;90;81;196;179;145;78;31;56;113;175;171;16;25;44;75;86;26;100;121;53;180;154;135;70;127;123;162;133;151;51;118;59;65;116;43;184;84;112;4;190;10;177;54;48;160;34;146;22;18;108;69;159;181;42;5;193;41;115;139;68;46;0;117;183,1886903399695750759,0.003647
greedy_intra:nodes_start:greedy,184,71867,23367,48500,30816,2,184;43;65;116;59;118;115;46;0;51;151;133;162;123;127;70;135;154;180;53;121;100;26;86;75;44;25;16;171;175;113;56;31;78;145;179;196;81;90;40;165;185;106;178;3;14;144;62;9;148;102;49;52;55;57;92;129;82;120;2;101;1;97;152;124;94;63;79;80;176;137;23;186;89;183;143;117;93;140;68;139;193;41;5;42;181;159;69;108;18;22;146;34;160;48;54;177;10;190;84,2829341131688762901,0.001001
greedy_intra:nodes_start:greedy,185,71455,23393,48062,21946,2,185;90;81;196;179;145;78;31;56;113;175;171;16;25;44;120;75;86;26;124;94;63;79;80;176;133;151;51;118;59;115;46;0;137;23;186;89;183;143;117;93;140;68;139;193;41;5;42;181;159;69;108;18;22;146;34;160;48;54;177;10;190;84;184;43;116;65;131;149;162;123;127;70;135;154;180;53;100;101;1;97;152;2;129;92;57;55;52;106;178;49;102;148;9;62;144;14;138;165;40,8750270011478149849,0.001031
greedy_intra:nodes_start:greedy,186,70703,22498,48205,99056,8,23;89;183;143;117;0;46;68;139;115;193;41;5;42;181;159;69;108;18;22;146;34;160;48;54;177;10;190;4;112;84;184;43;116;65;59;118;51;151;133;162;123;127;70;135;154;180;53;121;100;26;86;75;44;25;16;171;175;113;56;31;78;145;179;196;81;90;165;40;185;106;178;3;14;144;62;9;148;102;49;52;55;57;92;129;82;120;2;101;1;97;152;124;94;63;79;80;176;137;186,24770528622987865,0.004000
greedy_intra:nodes_start:greedy,187,71719,23614,48105,19108,3,27;81;196;40;185;179;145;78;31;56;113;175;171;16;25;44;120;75;86;26;124;94;63;79;80;176;133;151;51;118;59;115;46;0;137;23;186;89;183;143;117;93;140;68;139;193;41;5;42;181;159;69;108;18;22;146;34;160;48;54;177;10;190;184;43;116;65;131;149;162;123;127;70;135;154;180;53;100;101;1;97;152;2;129;92;57;55;52;106;178;49;102;148;9;62;144;14;138;165;90,5961308564907667275,0.000999
greedy_intra:nodes_start:greedy,188,71959,23644,48315,123572,14,157;31;78;145;92;179;196;81;90;165;40;185;106;178;3;14;144;62;9;148;102;49;52;55;57;129;2;101;1;97;26;100;53;180;154;135;70;127;123;162;149;131;65;116;43;184;190;10;177;54;48;160;34;146;22;18;108;69;159;181;42;5;41;193;139;68;140;93;117;143;183;89;186;23;137;0;46;115;59;118;51;151;133;176;80;79;63;94;124;152;86;75;120;44;25;16;171;175;113;56,978248926601984369,0.006112
greedy_intra:nodes_start:greedy,189,72127,23067,49060,52765,4,152;94;124;148;102;49;178;106;52;55;57;92;129;2;120;44;25;16;171;175;113;56;31;78;145;179;196;81;90;40;185;165;138;14;144;62;9;15;114;186;89;183;23;137;176;80;151;162;123;149;65;116;43;184;177;54;48;160;34;146;22;18;108;69;159;181;42;5;41;193;139;68;140;93;117;143;0;46;115;59;118;51;133;79;63;180;135;70;154;158;53;121;100;26;86;75;101;1;97;189,1285895870899201540,0.003033
greedy_intra:nodes_start:greedy,190,71612,23435,48177,111043,14,190;10;177;54;48;160;34;181;42;146;22;18;108;69;159;41;193;139;68;46;115;118;59;65;116;43;184;35;131;149;123;162;133;151;51;0;117;143;183;89;23;137;176;80;79;63;94;124;152;97;1;101;2;120;82;129;92;57;55;52;49;102;148;9;62;144;14;3;178;106;185;40;165;90;81;196;179;145;78;31;56;113;175;171;16;25;44;75;86;26;100;121;53;180;154;135;70;127;112;4,1410185511854913199,0.005757
greedy_intra:nodes_start:greedy,191,72312,23513,48799,32961,3,139;193;41;5;42;181;159;69;108;18;22;146;34;160;48;54;177;10;190;84;184;43;116;65;149;123;127;162;151;133;135;70;154;180;53;121;100;26;86;75;44;25;16;171;175;113;56;31;78;145;179;196;81;90;40;165;185;106;178;3;14;144;62;9;148;102;49;52;55;92;57;129;82;120;2;101;1;97;152;124;94;63;79;80;176;137;23;186;89;183;143;117;0;51;118;59;115;46;68;198,5537965082177832969,0.000999
greedy_intra:nodes_start:greedy,192,71856,23009,48847,117092,11,42;5;96;41;193;139;68;140;93;117;143;183;89;186;23;137;176;80;79;63;94;124;152;97;1;101;2;120;82;129;92;57;55;52;49;102;148;9;62;144;14;3;178;106;185;40;165;90;81;196;179;145;78;31;56;113;175;171;16;25;44;75;86;26;100;121;53;180;154;135;70;127;123;162;133;151;51;0;46;115;118;59;65;116;43;184;190;10;177;54;48;160;34;146;22;18;108;69;159;181,8365609997706774546,0.005000
greedy_intra:nodes_start:greedy,193,71489,23366,48123,75876,7,193;139;68;46;115;59;118;51;0;117;143;183;89;186;23;137;176;80;79;63;94;124;152;97;1;101;2;120;82;129;92;57;55;52;49;102;148;9;62;144;14;3;178;106;185;40;165;90;81;196;179;145;78;31;56;113;175;171;16;25;44;75;86;26;100;121;53;180;154;70;135;133;151;162;127;123;149;65;116;43;184;84;112;4;10;177;54;48;160;34;146;22;18;108;69;159;181;42;5;41,3366361870911737304,0.003657
greedy_intra:nodes_start:greedy,194,72479,23508,48971,19972,2,194;127;123;162;133;151;149;131;65;116;43;184;190;10;177;54;48;160;34;146;22;18;108;69;159;181;42;5;41;193;139;68;46;115;59;118;51;0;117;143;183;89;186;23;137;176;80;79;63;94;124;152;97;1;101;2;120;82;129;57;92;55;52;49;102;148;9;62;144;14;3;178;106;185;40;165;90;81;196;179;145;78;31;56;113;175;171;16;25;44;75;86;26;100;121;180;53;154;70;135,2293744958134685050,0.001000
greedy_intra:nodes_start:greedy,195,71624,23437,48187,26655,3,195;181;34;160;48;54;177;10;4;112;84;184;42;43;116;65;149;123;127;162;151;133;135;70;154;180;53;121;100;26;86;75;44;25;16;171;175;113;56;31;78;145;179;196;81;90;40;165;185;106;178;3;14;144;62;9;148;102;49;52;55;92;57;129;82;120;2;101;1;97;152;124;94;63;79;80;176;137;23;186;89;183;143;117;0;51;118;59;115;46;68;139;41;193;159;69;108;18;22;146,8536289704887584147,0.000998
greedy_intra:nodes_start:greedy,196,72407,23890,48517,105458,11,157;81;90;165;40;185;106;178;3;14;144;62;9;148;102;49;52;55;57;129;92;179;145;78;82;2;101;1;97;26;100;53;180;154;135;70;127;123;162;149;131;65;116;43;184;10;177;54;48;160;34;146;22;18;108;69;159;181;42;5;41;193;139;68;140;93;117;143;183;89;186;23;137;0;46;115;59;118;51;151;133;176;80;79;63;94;124;152;86;75;120;44;25;16;171;175;113;56;31;196,2226097478616546100,0.005529
greedy_intra:nodes_start:greedy,197,72023,23224,48799,32631,5,198;46;68;139;193;41;5;42;181;159;69;108;18;22;146;34;160;48;54;177;10;190;84;184;43;116;65;149;123;127;162;151;133;135;70;154;180;53;121;100;26;86;75;44;25;16;171;175;113;56;31;78;145;179;196;81;90;40;165;185;106;178;3;14;144;62;9;148;102;49;52;55;57;92;129;82;120;2;101;1;97;152;124;94;63;79;80;176;137;23;186;89;183;143;117;0;51;118;59;115,1869380471876264728,0.001000
greedy_intra:nodes_start:greedy,198,71804,23681,48123,94177,10,46;68;115;59;118;51;0;117;143;183;89;186;23;137;176;80;79;63;94;124;152;97;1;101;2;120;82;129;92;57;55;52;49;102;148;9;62;144;14;3;178;106;185;165;40;90;81;196;179;145;78;31;56;113;175;171;16;25;44;75;86;26;100;121;53;180;154;70;135;133;151;162;127;123;149;65;116;43;184;84;112;4;10;177;54;48;160;34;146;22;18;108;69;159;181;42;5;41;193;139,6178431240736578717,0.005002
greedy_intra:nodes_start:greedy,199,71304,22988,48316,99118,9,93;68;46;139;115;59;118;51;0;117;143;183;89;186;23;137;176;80;79;63;94;124;152;97;1;101;2;120;82;129;92;57;55;52;49;102;148;9;62;144;14;3;178;106;185;40;165;90;81;196;179;145;78;31;56;113;175;171;16;25;44;75;86;26;100;121;53;180;154;70;135;133;151;162;127;123;149;65;116;43;184;84;190;10;177;54;48;160;34;181;42;5;41;193;159;146;22;18;108;140,722185169086179772,0.004434
greedy_intra:edges_start:random,0,73521,23335,50186,637242,491,180;158;53;86;100;26;97;1;101;75;120;129;92;145;78;25;44;16;171;175;113;56;31;81;196;179;185;40;119;90;27;164;39;165;8;138;14;144;15;148;37;62;9;102;49;178;106;52;55;57;2;152;189;124;94;63;79;80;176;137;183;143;0;117;93;140;68;46;115;139;41;193;159;108;18;22;146;181;34;54;184;160;42;43;116;65;47;131;149;59;118;51;151;133;162;123;127;70;135;154,130010749895200331,0.077184
greedy_intra:edges_start:random,1,72536,23678,48858,721832,487,52;55;185;165;90;40;196;31;56;113;175;171;16;78;145;179;92;57;129;25;44;120;2;152;97;1;101;75;86;100;26;124;94;53;70;135;154;180;63;79;80;176;133;162;151;51;59;118;46;198;115;5;42;181;160;184;43;116;65;47;131;149;123;127;35;84;112;4;190;10;177;30;54;48;34;22;18;159;193;41;139;68;140;93;117;0;143;183;89;186;23;137;148;9;62;144;14;49;178;106,4363496252997577765,0.087390
greedy_intra:edges_start:random,2,73787,25402,48385,640493,463,43;42;184;160;181;41;193;159;18;22;34;48;54;177;10;4;112;127;70;135;162;151;133;180;154;53;121;100;26;86;101;75;120;82;44;25;16;175;171;113;56;31;196;81;90;27;119;40;185;165;39;95;164;21;14;3;178;106;52;55;57;179;145;78;92;129;2;1;97;152;167;49;102;144;62;9;148;124;94;63;79;80;176;51;118;137;89;183;143;0;117;68;46;139;115;59;123;149;65;116,5369020692500355309,0.076698
greedy_intra:edges_start:random,3,72734,23171,49563,676559,475,54;177;184;84;112;123;127;70;135;154;158;53;100;26;97;1;101;2;152;94;124;148;37;15;9;62;102;144;14;138;49;178;3;106;52;55;57;179;185;40;165;90;81;31;56;113;175;171;16;78;145;92;129;25;44;120;75;86;121;182;63;180;79;133;162;151;51;80;176;137;23;89;183;153;0;143;117;93;140;108;18;22;159;193;41;115;139;68;46;118;59;149;65;116;43;42;181;34;160;48,7313509366212351242,0.075771
greedy_intra:edges_start:random,4,72318,23228,49090,731503,478,176;80;51;118;59;115;116;65;47;43;42;5;96;41;193;139;68;46;0;143;117;108;18;22;146;159;181;34;160;48;54;177;10;184;35;131;149;123;127;70;135;162;151;133;79;122;63;94;124;148;9;62;102;49;178;106;52;55;57;92;129;2;152;1;97;26;100;121;180;154;53;86;101;75;120;44;25;16;171;175;113;56;31;78;145;179;196;81;90;119;40;185;165;14;144;186;89;183;23;137,3693531979410663330,0.080244
greedy_intra:edges_start:random,5,72406,24219,48187,676767,469,2;129;92;25;44;120;75;101;1;97;86;100;26;121;53;180;154;135;70;127;123;112;4;84;184;35;131;149;59;115;139;116;65;47;43;5;42;160;177;54;34;146;22;181;41;193;159;18;108;140;93;68;46;117;0;143;183;89;186;23;137;80;176;51;151;162;133;79;63;94;124;148;9;62;144;14;102;49;178;106;185;40;165;90;81;196;31;56;113;175;171;16;78;145;179;57;55;52;167;152,6108466525453677838,0.082067
greedy_intra:edges_start:random,6,74131,24308,49823,592546,499,145;78;196;185;40;119;165;49;102;148;124;94;122;63;180;158;154;135;70;127;59;118;51;176;80;79;133;151;162;123;112;4;10;177;184;160;34;181;42;43;131;149;65;116;115;139;41;193;159;22;18;69;108;117;0;143;183;89;23;137;186;15;9;62;144;14;138;39;90;81;157;31;56;113;175;171;16;25;44;82;120;75;101;86;53;121;100;26;97;1;152;2;129;92;52;106;178;55;57;179,3891619130757892652,0.081908
greedy_intra:edges_start:random,7,73501,22689,50812,813315,513,9;62;148;137;23;186;89;183;143;117;93;140;108;18;22;146;34;160;48;54;177;10;190;4;112;84;184;35;131;149;47;65;59;118;116;105;43;5;42;181;159;193;41;139;115;198;46;68;0;51;72;151;176;80;79;133;162;123;127;194;135;70;154;180;53;121;63;94;152;97;1;101;86;75;2;120;44;25;16;171;175;113;31;78;145;179;92;129;57;55;52;106;185;40;165;178;3;49;14;144,6215355810819053558,0.085490
greedy_intra:edges_start:random,8,75232,24238,50994,657086,415,118;51;151;133;79;63;122;80;176;137;23;0;117;143;183;89;186;15;144;21;164;90;165;40;185;196;81;56;113;175;171;16;31;78;145;179;57;55;106;52;178;3;138;14;49;102;62;9;37;148;167;124;94;152;1;2;129;92;25;44;120;75;86;101;97;26;100;121;53;158;180;154;135;70;127;123;112;184;160;34;146;22;181;42;5;96;41;193;159;139;46;115;59;65;47;116;43;131;149;162,3206296248029388542,0.075978
greedy_intra:edges_start:random,9,73115,24009,49106,778432,479,2;1;97;26;100;86;101;75;120;44;25;78;31;16;171;175;113;196;81;90;27;39;165;119;40;185;179;145;92;129;57;55;52;106;178;3;14;49;102;144;62;9;15;148;124;94;63;79;80;51;176;137;23;89;183;0;143;117;93;140;108;18;22;146;181;5;42;184;160;34;54;177;112;127;123;35;131;149;65;116;47;43;115;41;193;139;46;118;59;162;151;133;135;70;154;180;158;53;121;152,6174939464672155210,0.087723
greedy_intra:edges_start:random,10,74560,25153,49407,649435,464,22;18;108;41;5;42;43;116;65;47;149;131;35;184;160;181;34;48;54;177;4;112;127;135;123;162;151;133;79;63;180;154;53;86;75;44;25;78;16;171;175;113;31;196;145;179;185;40;165;90;164;7;21;14;49;3;178;106;52;55;57;92;129;120;2;101;1;97;26;100;121;94;124;152;167;148;37;102;144;62;9;186;23;89;183;143;117;0;137;176;80;51;109;59;118;46;115;139;193;159,847984354225929118,0.079602
greedy_intra:edges_start:random,11,73883,24520,49363,531556,470,112;84;184;177;54;160;34;146;22;18;108;159;193;139;68;46;115;41;181;42;43;116;65;149;162;59;118;51;151;133;79;80;176;122;63;136;182;121;100;26;97;1;152;94;124;111;167;57;55;178;3;49;102;62;9;148;137;0;117;143;183;89;23;186;15;144;14;138;106;52;185;40;165;90;81;196;31;113;175;171;16;25;44;120;78;145;179;92;129;2;75;101;86;53;180;154;135;70;127;123,4645310980849690560,0.073264
greedy_intra:edges_start:random,12,72188,23037,49151,733778,505,80;176;137;23;89;183;143;0;46;115;139;198;68;117;93;140;108;18;22;159;193;41;181;34;48;54;30;177;10;4;112;35;149;131;184;160;42;43;116;65;59;118;51;72;151;162;123;127;135;154;180;158;53;121;100;26;86;75;101;1;97;152;2;129;82;120;44;25;16;171;175;113;31;196;81;40;119;90;165;185;179;145;78;92;57;55;52;106;178;49;14;144;62;9;15;148;94;63;79;133,3422780005880487945,0.083118
greedy_intra:edges_start:random,13,73767,23830,49937,570818,467,117;143;0;68;139;41;193;159;181;42;116;65;59;118;115;46;109;51;151;80;176;137;183;89;23;186;148;9;62;144;14;138;165;185;40;119;90;81;196;31;113;175;171;16;25;44;120;78;145;179;92;129;57;55;52;106;178;3;49;102;167;111;124;94;152;2;75;86;101;1;97;26;100;121;53;158;180;63;122;79;133;162;135;154;70;123;149;131;43;184;177;54;160;34;146;22;18;108;140;93,8054748783643894989,0.075335
greedy_intra:edges_start:random,14,74882,25378,49504,556935,463,40;185;179;145;78;92;129;57;55;52;178;106;14;144;49;102;62;9;186;23;89;183;0;143;117;108;18;159;22;34;181;5;42;160;184;54;177;10;4;112;127;70;158;86;75;101;97;26;100;189;121;53;180;154;135;123;162;151;133;63;79;80;176;51;118;59;149;65;116;43;115;41;193;139;46;137;12;94;124;148;167;152;1;2;82;120;44;25;16;171;175;113;56;31;81;90;27;39;165;119,5323947121109635859,0.079547
greedy_intra:edges_start:random,15,73192,24273,48919,588825,473,177;30;54;48;160;34;146;22;18;108;140;93;117;0;143;183;89;23;148;9;62;144;21;7;164;90;165;14;102;49;178;106;52;55;57;92;145;179;185;119;40;81;196;157;31;56;113;175;171;16;78;25;44;120;82;129;2;152;94;63;121;100;26;97;1;101;75;86;53;180;154;135;123;131;149;162;80;122;79;133;151;176;137;51;118;59;115;46;139;41;193;159;181;42;116;65;43;184;190;10,5890386953548390965,0.076430
greedy_intra:edges_start:random,16,72142,23666,48476,731823,497,106;178;3;14;144;49;102;62;9;148;15;186;89;183;23;137;124;94;63;79;133;80;176;51;118;115;139;68;46;0;143;117;108;18;22;159;193;41;5;116;43;42;181;34;160;184;48;54;177;10;4;112;149;65;59;151;162;123;127;194;135;70;154;180;53;121;100;26;97;101;86;75;1;152;2;129;120;44;25;16;171;175;113;31;78;145;196;81;90;27;39;165;40;119;185;179;92;57;55;52,1564365969548158677,0.081771
greedy_intra:edges_start:random,17,74166,24432,49734,695334,464,113;56;157;81;90;27;40;119;165;138;14;144;49;102;62;9;148;15;186;23;89;183;143;117;93;108;18;193;41;159;22;34;54;10;177;48;160;42;5;116;65;43;184;123;149;59;118;115;139;46;0;137;51;176;80;94;63;79;133;151;162;127;70;135;154;180;158;53;136;121;100;26;97;86;75;101;1;152;2;120;44;25;82;129;92;57;55;52;178;3;106;185;196;179;145;78;31;16;171;175,5340381477023245590,0.075106
greedy_intra:edges_start:random,18,73037,23653,49384,658076,524,70;135;133;151;59;118;115;41;193;159;96;5;42;43;116;65;47;131;149;162;123;127;112;4;190;10;177;54;184;160;34;181;195;146;22;18;108;140;93;68;139;46;0;117;143;183;89;114;186;23;137;176;80;79;63;189;26;100;86;75;101;1;97;152;2;120;129;92;44;25;16;171;175;113;31;78;145;179;57;55;52;185;40;81;90;165;106;178;14;49;144;9;62;148;94;121;53;158;180;154,5674454896911309344,0.082326
greedy_intra:edges_start:random,19,72843,23402,49441,765089,510,146;22;18;159;193;41;42;59;115;139;46;68;93;117;0;143;183;89;23;137;186;15;37;148;9;62;144;14;102;49;3;178;106;165;119;40;185;52;55;57;179;145;196;90;81;157;31;56;113;175;171;16;78;25;44;120;92;129;2;152;1;101;75;86;97;26;100;121;53;158;180;154;70;135;133;79;122;63;94;80;176;51;118;151;162;123;149;65;116;43;184;84;190;10;177;54;48;160;34;181,4470426552789582889,0.082327
greedy_intra:edges_start:random,20,75871,25104,50767,590765,475,106;167;148;89;183;143;117;68;139;41;193;159;22;146;34;181;160;184;54;177;4;112;127;123;65;116;43;42;59;115;46;0;137;51;151;162;133;79;80;176;122;63;182;136;180;135;70;154;158;53;86;75;101;1;97;26;100;121;189;94;124;152;2;120;44;25;78;31;16;171;175;113;56;157;145;179;92;82;129;57;55;52;185;165;119;40;196;81;90;27;164;21;144;62;9;102;49;14;3;178,3445343626607666520,0.081105
greedy_intra:edges_start:random,21,72643,23145,49498,745837,465,179;92;129;57;55;52;185;40;90;165;106;178;49;102;14;144;62;9;15;148;167;124;94;63;79;80;176;66;137;23;186;114;89;183;143;0;117;108;18;68;46;139;115;5;42;41;193;159;22;146;195;181;34;160;48;54;177;184;43;116;65;47;131;149;59;118;51;151;133;162;123;127;70;135;154;180;158;53;100;26;97;1;101;86;75;152;2;120;44;25;78;145;31;16;171;175;113;56;81;196,7048502431558470724,0.083106
greedy_intra:edges_start:random,22,73915,24701,49214,597867,482,158;53;180;133;151;162;51;137;176;80;79;63;94;124;148;37;167;152;1;97;121;26;100;86;75;101;2;129;92;179;145;78;31;25;120;44;16;171;175;113;56;81;196;40;119;90;165;185;52;57;55;106;178;3;138;14;49;144;62;9;15;114;186;23;89;183;143;117;0;68;139;108;18;22;159;193;41;42;5;115;46;118;59;131;149;65;116;43;160;34;54;177;184;84;112;123;127;70;135;154,6488013870901265088,0.073120
greedy_intra:edges_start:random,23,73009,23015,49994,611953,480,80;176;148;37;9;62;15;137;89;183;143;0;117;93;140;68;46;139;41;193;181;159;108;18;22;146;34;54;177;184;160;42;5;115;43;116;65;59;51;151;162;123;127;70;135;154;180;53;121;100;26;86;101;75;120;44;25;16;171;175;113;56;31;157;196;81;90;27;39;165;119;40;185;138;14;144;102;49;3;178;106;52;55;57;92;179;145;78;82;129;2;1;97;152;189;124;94;63;79;133,3107376300200868769,0.073533
greedy_intra:edges_start:random,24,72134,22613,49521,688045,483,44;120;2;152;1;101;75;86;97;26;100;121;94;63;53;158;180;154;135;70;127;123;162;151;133;79;122;80;176;137;51;118;59;116;43;65;149;131;35;184;177;54;48;160;34;181;42;5;115;46;139;41;193;159;146;22;18;108;117;0;143;183;89;23;186;15;148;9;62;144;102;49;14;3;178;106;165;90;81;40;119;185;196;157;31;56;113;175;171;16;78;145;179;57;55;52;92;129;82;25,6556051588081211523,0.075350
greedy_intra:edges_start:random,25,73960,24594,49366,641810,465,59;118;115;139;46;0;143;183;89;186;23;137;51;151;162;123;133;176;148;37;15;9;62;102;144;14;138;165;27;90;81;196;40;185;49;3;178;106;52;55;57;92;179;145;78;31;113;175;171;16;25;44;120;129;75;86;101;2;152;1;97;26;100;189;124;94;80;79;63;121;53;180;154;135;70;127;112;4;190;10;177;54;160;34;146;22;18;108;69;159;193;41;42;184;43;116;47;131;149;65,3046027784745855077,0.070911
greedy_intra:edges_start:random,26,72402,24149,48253,664603,477,145;81;90;27;165;119;40;185;106;14;144;186;89;183;0;143;117;93;140;68;46;115;139;41;193;159;69;108;18;22;146;181;34;160;48;54;177;10;190;4;112;84;184;42;43;116;65;118;59;149;131;35;123;162;151;72;51;137;176;80;63;79;133;127;70;135;154;180;53;100;26;86;101;1;97;152;94;124;148;9;62;102;49;178;52;55;57;92;129;2;75;120;44;25;16;171;175;113;31;78,8156829800314421012,0.080995
greedy_intra:edges_start:random,27,72574,23660,48914,564276,459,120;44;25;16;171;175;113;56;31;81;90;27;165;40;185;138;14;144;62;9;148;102;49;178;106;52;55;57;179;145;78;92;129;2;101;97;1;152;124;94;80;176;51;137;23;186;89;183;143;0;117;93;140;69;108;18;159;195;22;146;103;34;160;181;42;43;5;41;193;115;139;68;46;59;116;65;149;131;35;184;177;10;4;112;123;127;70;135;162;151;133;79;63;180;154;53;100;26;86;75,7466155794146768582,0.085035
greedy_intra:edges_start:random,28,74468,25081,49387,632941,443,154;53;121;100;26;97;152;1;101;86;75;2;129;57;92;82;120;44;25;78;145;31;16;171;175;113;56;196;81;90;27;165;119;40;185;3;138;14;144;62;9;102;49;178;106;52;55;167;148;15;186;23;89;183;137;176;80;122;94;124;63;79;180;133;51;151;162;123;149;131;43;65;116;59;118;115;198;46;68;0;143;117;18;22;159;193;41;139;42;184;48;160;181;34;54;177;112;127;70;135,2858276854553536932,0.078642
greedy_intra:edges_start:random,29,71863,23330,48533,719547,484,118;59;51;151;162;123;127;70;135;154;180;158;53;86;100;26;97;1;101;75;2;120;44;25;16;171;175;113;56;31;78;157;196;81;185;40;90;27;39;165;14;144;102;62;9;148;49;3;178;106;52;55;179;145;92;57;129;152;94;63;79;133;80;176;137;23;186;114;89;183;143;0;117;93;140;108;18;22;146;159;181;34;160;54;177;10;190;184;149;65;116;43;42;5;41;193;139;68;46;115,3968648814744545226,0.100700
greedy_intra:edges_start:random,30,73248,24081,49167,719052,501,144;14;138;106;178;49;148;167;152;129;92;57;55;52;185;40;119;165;90;81;196;145;31;113;175;171;16;78;25;44;120;2;75;86;101;1;97;26;100;53;154;135;127;123;162;151;133;79;180;63;94;124;80;176;51;109;118;59;198;46;68;139;193;41;115;116;65;43;131;149;112;4;190;10;177;54;48;34;160;184;42;181;146;22;18;108;93;117;0;170;143;183;89;23;137;186;15;9;62;102,4821424899907691709,0.079905
greedy_intra:edges_start:random,31,75441,25078,50363,631437,432,167;37;148;176;80;133;79;63;94;124;152;129;92;179;145;78;113;175;171;16;44;120;2;101;86;75;1;97;26;100;121;53;158;180;154;135;70;127;123;131;149;162;151;72;118;59;116;65;47;35;84;112;4;184;177;54;160;34;146;22;159;181;42;43;5;41;193;115;139;68;69;18;108;93;117;143;0;46;51;137;183;89;23;186;15;9;62;144;49;14;165;90;40;185;3;178;106;52;55;57,8306752404526860104,0.072072
greedy_intra:edges_start:random,32,75172,24570,50602,636909,468,185;165;90;119;40;179;92;78;145;196;81;31;113;175;171;16;25;44;120;75;86;101;1;152;74;2;129;57;55;52;106;178;49;102;62;9;148;167;124;12;122;79;63;94;189;97;26;100;121;53;158;180;154;135;70;133;80;176;51;118;59;151;162;127;123;149;65;116;43;42;181;160;34;54;177;184;41;115;139;193;159;22;18;108;68;46;0;117;170;143;183;89;23;137;186;114;15;144;14;138,413779048439730236,0.072953
greedy_intra:edges_start:random,33,75204,24471,50733,740816,490,75;86;101;1;97;26;100;53;94;124;176;109;51;80;133;79;122;63;180;154;135;127;123;112;35;131;149;162;151;72;118;59;65;116;43;42;5;115;41;193;181;160;184;177;54;34;22;159;18;108;139;46;68;93;117;143;170;0;153;183;89;137;23;186;15;148;37;9;62;102;144;14;49;3;178;106;52;55;185;165;90;40;196;113;175;171;16;31;78;145;179;57;92;129;152;2;82;25;44;120,7096201260429836794,0.080623
greedy_intra:edges_start:random,34,72667,25245,47422,566790,482,34;160;54;177;10;184;84;112;127;70;135;154;158;53;100;26;86;75;101;97;1;2;120;44;25;16;171;175;113;56;31;78;145;179;196;81;40;165;90;27;164;21;14;49;102;144;62;9;15;148;167;55;52;178;106;185;57;92;129;152;94;63;180;79;80;133;151;162;123;149;131;65;116;59;118;51;176;137;23;186;89;183;143;0;93;117;68;46;139;115;5;43;42;181;41;193;159;18;22;146,7248604215612350562,0.074404
greedy_intra:edges_start:random,35,76673,24755,51918,519520,431,14;138;165;119;40;185;196;179;52;55;57;92;129;2;152;189;124;94;63;122;80;79;133;162;151;118;51;176;137;23;89;183;143;0;117;93;68;115;46;198;139;41;193;22;34;160;54;184;131;149;43;42;116;65;59;123;127;70;135;154;180;158;53;136;182;121;100;26;97;1;101;86;75;120;44;82;145;78;25;16;171;175;113;31;81;90;164;21;144;114;15;62;9;148;167;49;102;178;106;3,2658838124328709388,0.066133
greedy_intra:edges_start:random,36,74392,25070,49322,544326,479,41;193;159;181;160;42;5;43;116;65;131;149;59;118;51;79;80;176;137;23;183;89;186;15;148;9;62;144;102;49;14;165;90;81;40;185;179;129;120;44;16;171;175;113;31;78;145;92;57;55;52;106;178;3;167;124;152;97;1;101;2;75;86;158;53;121;100;26;19;189;94;63;180;154;70;135;133;151;162;123;127;112;84;184;10;177;54;34;146;22;69;18;108;117;143;0;68;46;115;139,3558231634449823308,0.078789
greedy_intra:edges_start:random,37,73641,24975,48666,704088,452,158;154;180;79;80;151;51;118;59;116;43;65;131;149;162;133;135;70;127;123;112;84;184;177;54;48;34;160;42;181;146;22;159;193;41;115;46;68;139;18;108;93;117;0;143;183;89;186;23;137;176;9;62;144;14;106;178;49;102;148;94;63;121;189;97;1;152;2;82;129;92;57;55;52;179;196;185;40;119;165;90;81;157;31;56;113;175;171;16;78;145;25;44;120;75;101;26;100;86;53,1363445210688027762,0.073352
greedy_intra:edges_start:random,38,72475,24099,48376,632855,474,4;112;127;70;154;53;86;100;26;97;1;101;75;120;44;25;16;171;175;113;56;31;78;145;92;129;57;55;52;106;178;3;185;40;196;81;90;165;14;144;49;102;62;9;148;167;2;152;124;94;63;180;135;123;131;149;43;116;65;59;51;151;162;133;79;80;176;137;23;186;114;89;183;143;0;117;93;140;68;46;139;115;5;42;181;41;193;159;18;22;34;160;54;30;177;10;190;84;35;184,8422717496477448398,0.071143
greedy_intra:edges_start:random,39,73136,24599,48537,650438,475,52;167;148;9;62;144;102;49;14;3;178;106;185;40;119;165;90;81;196;179;145;31;113;175;171;16;44;120;2;75;86;101;1;152;97;26;100;121;53;158;180;154;135;70;127;123;162;151;118;115;139;68;46;0;137;23;89;183;143;117;93;108;18;193;159;22;146;181;34;160;54;177;4;112;84;184;42;41;5;43;116;47;131;149;65;59;51;176;80;133;79;63;94;124;129;25;78;92;57;55,2775292557477976086,0.075427
greedy_intra:edges_start:random,40,73432,22855,50577,560944,457,0;117;93;108;18;22;159;193;41;139;68;46;51;80;79;133;151;162;149;131;65;116;59;118;115;43;42;181;34;160;48;54;184;177;10;190;4;112;123;127;70;135;154;180;63;158;53;121;189;19;152;97;26;100;86;75;101;1;2;129;92;82;120;44;25;16;171;175;113;31;78;145;179;57;55;52;178;106;119;40;185;165;14;144;49;102;62;9;15;148;167;124;94;176;137;23;89;183;143;170,5593926405041567091,0.071118
greedy_intra:edges_start:random,41,71670,23167,48503,626470,492,94;124;152;97;1;101;86;75;2;129;120;44;25;16;171;175;113;56;31;157;196;81;40;90;27;39;165;185;179;145;78;92;57;55;52;106;178;14;144;49;102;62;9;148;137;23;89;183;143;117;93;140;108;18;22;146;159;193;41;139;115;46;176;80;79;63;180;133;162;151;51;118;59;65;116;43;42;181;34;160;48;54;177;10;190;184;84;4;112;131;149;123;127;70;135;154;53;100;26;121,8195576977013995275,0.081119
greedy_intra:edges_start:random,42,71702,23253,48449,605522,472,92;129;57;55;52;196;81;90;27;39;40;119;165;185;106;178;3;49;102;14;144;62;9;148;186;23;89;183;143;117;0;137;176;80;63;79;133;162;151;51;118;59;115;139;46;68;93;140;108;69;18;22;159;193;41;42;181;146;34;160;48;54;177;4;112;84;184;43;116;65;47;131;149;123;127;70;135;154;180;158;53;86;101;1;97;26;94;152;2;75;120;44;25;16;171;175;113;31;78;145,4034835896251551342,0.077674
greedy_intra:edges_start:random,43,72303,22869,49434,784052,530,53;86;75;2;129;82;120;44;25;78;16;171;175;113;31;196;81;90;165;119;40;185;179;145;92;57;55;52;106;178;3;14;144;49;102;62;9;148;137;186;23;89;183;143;117;0;46;139;41;193;18;159;195;22;146;181;34;160;48;54;30;177;10;190;84;184;43;42;5;115;118;51;59;116;65;47;131;149;162;123;127;70;135;154;180;79;133;151;176;80;63;94;124;152;1;101;97;26;100;121,4950915462725915902,0.085566
greedy_intra:edges_start:random,44,72886,24195,48691,775484,501,196;81;90;27;165;119;40;185;57;55;52;106;178;14;144;49;102;62;9;148;186;23;89;183;143;117;0;137;176;80;51;118;59;115;116;65;105;43;42;41;193;139;46;68;140;108;18;22;146;195;159;181;34;160;48;54;177;10;190;84;35;184;47;149;131;112;123;127;70;135;154;180;162;151;133;79;122;63;94;53;97;26;86;75;101;1;152;2;129;92;145;78;25;120;44;16;171;175;113;31,2041556039814505938,0.086601
greedy_intra:edges_start:random,45,73362,24044,49318,629378,476,31;113;175;171;16;145;78;25;44;120;82;129;2;75;101;86;100;26;97;1;152;124;94;121;53;158;154;180;63;79;133;80;176;51;151;162;65;116;42;43;47;131;149;135;70;127;123;112;184;177;54;48;160;34;146;22;18;108;159;193;41;139;115;59;118;46;198;68;140;93;117;0;143;183;137;23;186;15;148;9;62;144;14;49;3;178;106;165;27;90;40;185;52;55;57;92;179;196;81;157,564983698665511002,0.080745
greedy_intra:edges_start:random,46,73264,24233,49031,695582,500,100;26;97;152;1;101;86;75;2;129;120;44;25;16;171;175;113;56;31;157;81;196;179;145;78;92;57;55;185;40;90;165;14;144;62;9;102;49;178;106;52;167;37;148;15;186;137;23;89;183;143;170;117;0;46;118;51;176;80;63;94;79;133;151;59;65;47;116;43;42;115;139;68;108;69;18;22;146;159;193;41;181;34;160;184;54;177;10;190;4;112;149;162;123;127;135;154;180;158;53,8285362518766626069,0.081397
greedy_intra:edges_start:random,47,74258,24466,49792,586641,456,68;46;51;109;118;59;115;5;41;193;159;22;34;160;181;42;116;65;43;184;112;127;123;162;151;176;80;94;63;79;133;135;70;154;180;158;53;121;100;26;97;152;1;101;86;75;2;82;120;44;25;78;16;171;175;113;56;31;157;196;145;92;129;57;55;52;185;165;40;81;90;27;164;7;21;14;106;178;3;49;102;144;9;62;37;148;15;114;186;23;137;89;183;143;117;0;93;108;18;139,7574088105889441867,0.074904
greedy_intra:edges_start:random,48,72990,24775,48215,540366,482,127;123;149;131;65;47;43;160;184;84;112;4;190;10;177;54;34;181;41;193;159;22;18;108;139;68;117;143;0;46;115;5;42;116;59;118;51;137;23;186;114;183;89;15;9;62;144;102;49;178;106;14;138;165;90;81;40;185;52;55;57;129;92;78;145;196;31;56;113;175;171;16;25;44;120;2;152;97;1;101;75;86;26;100;121;53;63;94;124;148;176;80;151;162;133;79;180;154;135;70,316213102859719062,0.077556
greedy_intra:edges_start:random,49,72954,23237,49717,804930,491,151;133;79;63;80;176;51;109;118;59;115;5;42;181;160;48;184;43;116;65;149;131;35;112;4;190;10;177;54;34;22;18;159;193;41;139;46;0;183;89;23;137;148;94;124;167;55;52;178;49;102;9;62;144;14;138;106;185;40;119;165;39;164;27;90;81;196;179;145;78;31;56;113;175;171;16;25;44;120;92;57;129;2;152;97;1;101;75;86;26;100;53;158;180;154;135;70;127;123;162,1222151982034569019,0.086495
greedy_intra:edges_start:random,50,72855,24998,47857,642023,494,154;53;100;26;86;101;75;120;44;25;82;129;2;1;97;152;94;63;79;80;176;51;137;23;186;15;148;9;62;102;49;178;106;52;55;57;92;145;78;31;16;171;175;113;81;196;185;40;119;165;39;90;27;164;21;138;14;144;114;89;183;143;0;117;93;108;69;18;22;34;160;48;54;177;10;184;84;112;127;123;162;149;65;116;43;42;181;159;193;41;139;68;46;115;118;59;151;133;180;135,966111690449946088,0.079562
greedy_intra:edges_start:random,51,73048,23971,49077,650572,458,89;114;186;23;137;176;51;109;118;59;116;65;149;162;151;133;80;79;63;94;148;9;62;144;49;178;52;55;57;179;106;3;14;138;165;39;27;90;185;40;81;196;145;78;31;56;113;175;171;16;25;44;120;82;92;129;2;75;86;101;1;152;97;26;100;53;158;180;154;135;70;127;123;112;184;177;54;34;160;43;5;42;181;146;22;18;69;108;140;68;139;159;193;41;115;46;0;117;143;183,4851923824447634955,0.078020
greedy_intra:edges_start:random,52,73538,23553,49985,838421,496,14;49;3;178;106;52;57;55;185;40;165;90;81;196;31;113;175;171;16;44;25;78;145;179;92;129;120;2;1;97;101;75;86;26;100;121;53;158;70;135;154;180;63;122;79;133;151;162;123;112;4;84;35;131;149;47;65;59;118;115;116;43;5;42;184;177;54;160;34;22;18;108;69;159;193;41;139;68;46;0;143;183;89;114;15;186;23;137;51;176;80;94;124;152;167;148;37;9;62;144,2467126039158045559,0.076338
greedy_intra:edges_start:random,53,73126,24051,49075,637036,505,148;176;80;133;79;63;94;124;152;2;75;86;101;1;97;26;100;121;136;53;158;180;154;135;70;127;112;177;54;48;160;184;42;43;116;65;47;131;149;123;162;151;51;118;59;115;46;68;139;41;193;159;181;34;22;18;108;117;0;143;183;89;23;137;186;15;62;144;49;178;106;52;55;57;129;120;44;25;16;171;175;113;56;31;157;78;145;92;179;196;81;90;119;40;185;165;14;138;102;9,8952527617284743137,0.081380
greedy_intra:edges_start:random,54,74589,23260,51329,763373,464,113;56;85;31;78;145;179;157;196;81;90;165;119;40;185;106;178;3;49;138;14;144;102;62;9;15;148;37;128;167;111;124;94;63;122;80;176;137;23;186;89;183;143;0;117;93;108;18;22;34;54;177;184;160;42;43;116;65;149;59;115;41;193;139;46;118;51;79;133;151;162;123;112;127;70;135;154;180;53;86;75;101;100;26;97;1;152;2;129;57;55;52;92;82;120;44;25;16;171;175,3831835297109826043,0.076087
greedy_intra:edges_start:random,55,72500,23246,49254,731581,483,183;89;137;176;51;118;59;115;193;41;5;42;116;65;162;151;133;80;79;63;94;124;152;167;148;9;62;102;49;144;14;3;178;106;52;55;57;185;40;119;165;27;90;81;196;31;56;113;175;171;16;25;78;145;179;92;129;44;120;2;75;86;101;1;97;26;100;121;53;180;154;70;135;194;127;123;149;131;43;184;84;112;4;190;10;177;54;160;34;181;195;146;22;159;18;139;46;0;117;143,1324750336295969354,0.085875
greedy_intra:edges_start:random,56,72743,22565,50178,734185,503,123;112;131;149;47;65;116;43;42;184;177;54;160;34;181;146;22;195;159;18;108;69;193;41;139;115;46;68;117;0;170;143;183;89;23;137;148;9;62;102;49;144;14;3;178;106;52;55;185;40;165;90;81;196;179;57;92;145;78;31;113;175;171;16;25;44;120;129;2;152;94;124;80;176;51;109;118;59;72;151;162;133;79;63;136;86;75;101;1;97;26;100;121;53;158;180;154;135;70;127,1055694960297262907,0.077797
greedy_intra:edges_start:random,57,73417,23875,49542,681442,486,14;138;165;90;40;185;179;145;78;31;56;113;171;175;16;44;25;92;57;129;120;2;75;101;86;121;100;26;97;1;152;189;124;94;63;122;176;80;79;133;180;53;154;135;70;127;123;112;4;10;177;54;184;43;65;47;131;149;162;151;51;118;59;116;5;42;181;160;34;146;22;18;159;193;41;115;139;68;46;0;117;143;183;89;23;137;186;15;148;167;55;52;106;178;3;49;102;62;9;144,105640605994319740,0.070815
greedy_intra:edges_start:random,58,73693,23245,50448,646202,438,178;52;55;57;92;129;2;101;1;97;152;189;124;94;63;79;133;162;151;80;176;137;89;183;143;117;0;46;68;139;115;41;193;22;146;181;34;160;54;177;10;190;184;4;112;84;35;43;42;116;65;118;59;149;131;123;127;70;135;154;180;158;53;121;100;26;86;75;120;82;44;25;16;171;175;113;56;31;196;78;145;179;185;119;40;81;90;27;39;165;106;138;14;49;102;144;62;9;148;167,4213887580254898236,0.070540
greedy_intra:edges_start:random,59,74254,22954,51300,858018,516,43;184;160;34;181;41;193;159;146;22;18;108;93;117;0;143;183;89;23;186;15;9;62;148;167;49;102;144;14;3;178;106;52;55;57;92;78;145;179;185;40;165;27;90;81;196;157;31;56;113;175;171;16;25;44;120;129;2;75;86;101;1;152;97;26;100;121;53;136;182;79;122;63;189;94;124;137;176;80;151;162;133;180;154;135;127;123;149;131;47;65;59;51;118;115;46;139;5;42;116,6688147312507965578,0.085242
greedy_intra:edges_start:random,60,73128,23825,49303,708403,498,42;41;139;198;115;59;118;51;151;162;65;149;131;116;43;184;160;34;48;54;177;10;4;112;123;127;135;154;180;53;86;100;26;97;152;75;101;1;2;129;120;44;25;78;16;171;175;113;56;31;196;81;90;165;40;185;179;145;92;57;55;52;106;178;3;32;138;14;49;102;144;62;9;15;37;148;94;124;63;79;133;80;176;137;23;89;183;143;0;46;68;117;93;108;18;193;159;22;146;181,6106841871112552854,0.088637
greedy_intra:edges_start:random,61,72015,23103,48912,720390,491,151;59;65;116;43;42;5;41;193;115;139;68;46;118;51;176;80;133;79;122;94;124;189;63;180;135;70;154;158;53;121;100;26;97;152;1;101;86;75;2;129;120;44;25;16;171;175;113;31;78;145;179;92;57;55;52;178;106;185;40;81;90;165;138;14;49;102;144;62;9;148;137;23;89;183;143;0;117;93;140;108;18;22;146;195;159;181;34;160;184;48;54;177;10;190;4;112;127;123;162,4112808593437206621,0.080771
greedy_intra:edges_start:random,62,73155,22589,50566,744619,520,0;143;117;108;18;22;146;103;34;160;181;159;193;41;139;198;68;46;118;51;151;162;72;59;115;5;42;43;116;65;47;149;131;184;84;112;123;127;70;135;154;180;158;53;100;26;86;75;101;1;97;152;2;129;120;44;25;16;171;175;113;31;145;78;196;81;90;165;119;40;185;179;92;57;55;52;106;178;49;14;144;102;62;9;15;148;167;124;94;63;122;79;133;80;176;137;23;89;183;153,8591396252666923124,0.086129
greedy_intra:edges_start:random,63,75179,23787,51392,717045,480,120;75;86;158;53;121;100;26;97;101;1;152;2;129;92;57;55;167;124;94;63;122;79;151;162;133;180;154;135;123;112;177;54;184;160;34;22;159;193;41;115;5;42;43;116;65;131;149;59;118;51;80;176;137;23;0;46;139;68;117;143;183;89;186;114;15;148;37;9;62;144;14;138;102;49;3;178;106;52;185;40;119;165;27;90;81;196;179;145;157;31;56;113;175;171;16;78;82;25;44,3729832288091748342,0.090106
greedy_intra:edges_start:random,64,74298,24376,49922,616865,475,154;70;135;194;127;123;162;151;79;122;63;180;158;53;121;100;86;101;97;26;94;124;152;1;75;2;129;120;44;25;78;145;57;92;179;196;31;16;171;175;113;56;81;90;165;40;185;106;52;55;3;178;49;102;14;144;62;9;148;23;137;183;143;0;46;68;139;115;193;41;5;43;42;181;159;18;22;146;103;34;160;48;54;177;10;4;112;84;184;35;131;149;116;65;59;118;51;176;80;133,870270321197307536,0.076065
greedy_intra:edges_start:random,65,72739,23454,49285,659462,476,143;183;89;23;186;114;15;62;9;144;102;49;14;138;165;185;40;119;90;81;196;145;78;157;31;56;113;175;171;16;25;44;120;129;92;57;55;52;106;178;3;167;148;124;94;63;189;152;97;1;101;2;75;86;26;100;121;53;180;154;135;127;123;162;59;118;51;151;133;79;80;176;137;46;68;139;115;41;5;42;116;65;43;184;190;10;177;54;160;34;181;146;22;159;193;18;108;93;117;0,4132949348155933738,0.086008
greedy_intra:edges_start:random,66,75049,25120,49929,583540,472,9;62;144;102;49;14;138;32;3;178;106;52;55;57;179;196;185;40;119;165;27;90;81;31;113;175;171;16;78;145;92;25;44;120;129;167;148;124;152;2;75;86;101;1;97;26;100;53;121;189;94;63;79;80;176;137;51;151;133;180;154;135;70;127;123;162;118;59;149;131;65;116;115;46;41;5;43;42;181;160;35;184;10;177;54;48;34;146;22;18;159;193;139;117;143;0;183;89;186;15,3190385187767029288,0.070918
greedy_intra:edges_start:random,67,75454,23951,51503,723060,442,80;176;51;109;0;170;143;183;89;23;137;186;15;9;62;144;14;49;102;148;124;94;122;63;180;136;182;121;100;26;97;101;1;152;2;129;82;78;145;179;92;57;55;52;178;106;185;119;165;90;40;196;31;56;113;175;171;16;25;44;120;75;86;53;158;154;70;135;162;123;127;112;4;177;184;160;34;42;43;131;149;65;116;115;139;193;41;22;18;108;93;117;68;46;118;59;72;151;133;79,7153718468786493207,0.077416
greedy_intra:edges_start:random,68,73896,24207,49689,757355,504,160;54;177;184;43;42;5;116;65;131;149;151;133;162;123;127;194;135;70;154;180;158;53;121;182;63;79;80;176;51;118;59;115;46;23;137;124;94;189;26;100;86;75;101;1;97;152;2;120;44;25;129;92;57;55;52;178;106;185;119;40;145;78;16;171;175;113;56;31;196;81;90;27;165;14;144;102;49;167;148;9;62;15;186;89;183;143;0;117;68;139;41;193;159;108;18;22;146;181;34,4673281081599295274,0.091416
greedy_intra:edges_start:random,69,72606,24108,48498,629828,450,70;127;123;162;133;79;80;151;51;109;118;59;42;43;116;65;149;131;112;4;84;190;10;177;54;48;184;160;34;181;41;193;159;22;18;108;68;139;115;46;0;117;143;153;183;89;186;23;137;176;15;9;62;144;14;185;40;119;165;90;81;196;31;56;113;175;171;16;78;145;179;92;57;55;52;106;178;3;49;102;148;94;152;97;1;2;129;25;44;120;75;101;86;100;26;53;63;180;154;135,3502744596861282528,0.072665
greedy_intra:edges_start:random,70,72965,23177,49788,647297,481,118;59;149;123;180;154;135;70;127;112;84;35;184;177;54;48;160;43;65;116;5;42;181;34;103;146;22;18;69;108;159;193;41;139;115;46;0;143;183;89;114;186;23;137;176;80;94;124;167;148;9;62;144;14;102;49;178;106;52;55;57;92;129;82;25;78;145;179;185;40;119;165;90;81;31;56;113;175;171;16;44;120;2;152;97;1;101;75;86;26;100;53;63;122;79;133;162;151;72;51,2312667156354014828,0.076529
greedy_intra:edges_start:random,71,72626,22898,49728,596514,468,185;40;119;165;90;81;196;31;56;113;175;171;16;78;145;92;57;129;82;25;44;120;2;75;101;86;100;26;97;1;152;94;63;79;53;158;180;154;135;70;127;162;123;112;4;177;54;34;160;48;184;35;131;149;77;47;65;116;43;42;181;195;146;22;159;193;41;139;115;59;72;151;133;80;176;51;118;46;68;18;108;140;93;117;0;143;183;89;137;148;9;62;144;49;14;3;178;106;52;55,2544466027237391884,0.079725
greedy_intra:edges_start:random,72,74903,25335,49568,518622,427,101;1;97;53;154;135;70;127;123;162;151;65;149;112;84;35;184;10;177;54;43;116;42;160;34;146;22;18;108;117;143;183;89;186;137;23;0;46;139;159;193;41;115;59;118;51;176;80;79;133;180;63;94;124;148;167;152;2;82;129;92;57;55;52;178;3;49;102;9;62;144;14;138;106;185;40;119;165;39;27;90;81;196;157;179;145;78;31;85;56;113;175;171;16;44;120;75;86;100;26,5406060193617629176,0.064682
greedy_intra:edges_start:random,73,73342,24264,49078,676719,444,40;185;55;52;106;178;3;14;49;102;144;9;62;15;137;51;176;80;122;79;133;151;59;118;115;5;42;43;116;65;149;123;162;135;70;127;112;184;177;54;160;34;181;193;41;159;22;18;139;46;68;140;93;117;0;143;183;89;23;186;148;167;124;94;63;136;180;154;158;53;86;75;101;100;26;97;1;152;2;129;92;57;179;145;31;78;120;44;25;16;171;175;113;56;196;81;90;27;165;119,7780417647472905854,0.077029
greedy_intra:edges_start:random,74,74278,24049,50229,593589,441,124;148;137;23;89;183;143;117;93;0;51;176;80;79;133;151;162;59;118;46;68;18;108;22;146;103;34;54;177;48;160;181;159;193;41;139;115;96;5;42;43;116;65;149;131;184;84;4;112;123;127;70;135;154;180;158;53;86;100;26;97;1;101;75;2;120;44;25;16;171;175;113;56;31;78;145;179;196;40;165;185;92;82;129;57;55;52;106;178;3;49;14;144;62;9;167;152;63;122;94,7149819692897180979,0.077232
greedy_intra:edges_start:random,75,73731,23987,49744,666327,506,112;84;35;127;70;135;154;180;158;53;100;26;97;1;101;86;75;120;44;25;78;145;31;16;171;175;113;196;185;40;90;165;14;144;62;9;102;49;178;106;52;55;57;179;92;129;2;152;189;94;124;167;148;186;89;183;23;137;176;80;79;122;63;133;151;162;123;149;131;47;77;43;42;116;65;59;118;109;51;0;143;117;93;108;18;68;46;115;139;41;193;159;22;146;34;160;184;54;177;4,6660827666337459939,0.088533
greedy_intra:edges_start:random,76,72796,22914,49882,649203,448,113;31;78;145;92;57;55;52;178;106;185;40;90;165;138;14;144;49;102;62;9;148;15;186;80;122;79;133;176;137;23;89;183;143;0;46;198;139;68;108;18;22;146;195;159;193;41;5;42;181;34;160;48;30;54;177;10;190;4;112;184;131;149;65;116;43;115;59;118;109;51;151;162;123;127;70;135;154;180;53;63;94;124;152;97;26;100;86;75;101;1;2;129;82;120;44;25;16;171;175,6865785590067611518,0.070494
greedy_intra:edges_start:random,77,74746,24646,50100,642537,487,5;42;181;146;22;18;108;69;159;193;191;139;198;46;68;117;0;170;143;183;89;23;137;176;51;72;151;162;133;80;79;63;94;124;121;100;26;97;1;152;2;129;92;145;57;55;40;165;90;27;164;21;144;62;9;15;148;37;102;49;14;3;178;106;52;185;196;113;175;171;16;31;78;25;44;120;75;101;86;53;180;154;135;70;127;123;112;184;177;54;48;34;160;43;116;65;59;118;115;41,8944194107354884952,0.076103
greedy_intra:edges_start:random,78,74854,24429,50425,740138,469,115;41;193;159;181;5;42;184;10;177;54;160;34;146;22;18;108;69;139;46;68;140;93;117;0;143;183;89;114;15;9;62;102;144;14;49;167;37;148;186;23;137;176;51;162;151;133;79;80;94;124;189;152;97;1;2;129;92;78;145;57;55;52;178;106;185;40;165;90;113;175;171;16;31;25;44;120;75;101;86;26;100;121;63;180;53;158;154;135;127;123;149;131;77;43;47;65;116;59;118,4463720213633648596,0.076730
greedy_intra:edges_start:random,79,72603,23964,48639,638201,484,48;54;177;184;35;84;4;112;127;70;135;154;180;158;53;97;1;101;86;75;2;120;44;25;16;171;175;113;56;31;78;145;196;81;90;165;119;40;185;55;52;106;178;14;144;49;102;62;9;15;186;89;183;143;0;23;137;148;167;57;92;129;152;124;94;63;79;80;176;51;118;59;162;151;133;194;123;149;131;47;65;116;43;42;181;159;193;41;115;139;46;68;117;93;108;18;22;146;34;160,5703955949534193541,0.081333
greedy_intra:edges_start:random,80,73174,22758,50416,670341,478,56;31;157;145;78;82;129;92;57;179;196;81;90;27;39;165;119;40;185;55;52;106;178;3;138;14;49;144;62;9;15;148;37;167;124;94;63;122;79;80;51;176;137;89;183;143;0;117;108;18;22;159;193;41;139;68;46;198;115;59;149;131;47;65;116;43;42;181;34;160;184;177;4;112;123;127;70;135;162;151;133;180;154;53;100;26;97;152;1;101;86;75;2;120;44;25;16;171;175;113,6889939984713494632,0.079294
greedy_intra:edges_start:random,81,73567,21783,51784,821414,473,117;68;46;115;139;41;193;159;22;146;34;160;54;177;10;184;112;127;70;135;154;180;158;53;136;182;121;100;26;86;75;101;97;1;152;2;129;82;120;44;25;16;171;175;113;31;78;145;179;92;57;55;52;106;178;3;185;40;90;27;165;14;49;102;144;62;9;148;167;124;94;189;63;122;79;133;151;162;123;149;65;47;43;42;116;59;118;51;80;176;137;23;186;15;114;89;183;143;170;0,4662280683697261074,0.083500
greedy_intra:edges_start:random,82,74796,25384,49412,577213,485,149;123;162;59;51;151;133;80;176;137;183;89;23;186;114;15;62;9;148;167;152;2;129;92;179;55;57;52;178;49;144;14;138;106;185;165;119;40;39;27;90;81;196;113;175;171;16;31;145;78;25;44;120;75;101;86;100;26;1;97;124;94;121;53;158;180;136;63;79;154;135;70;127;112;4;84;35;184;10;177;54;160;34;181;146;22;18;143;0;46;115;139;159;193;41;5;42;43;116;65,2268158233669287848,0.083292
greedy_intra:edges_start:random,83,73989,25295,48694,578809,474,25;16;171;175;113;56;31;78;145;157;196;81;90;27;164;7;21;144;14;49;3;178;106;165;119;40;185;52;55;57;179;92;129;152;63;94;124;148;9;62;186;89;23;137;51;176;80;79;133;151;162;123;149;59;118;115;41;139;46;0;183;143;117;93;108;18;22;146;159;193;181;34;160;54;184;42;43;116;65;35;84;4;112;127;135;154;180;158;53;121;100;26;97;1;101;86;75;2;120;44,6176591124407957437,0.080102
greedy_intra:edges_start:random,84,74364,25471,48893,678294,479,144;14;49;3;106;178;52;185;40;119;165;90;81;196;56;113;175;171;16;31;179;55;57;129;92;145;78;25;44;120;82;2;75;86;101;1;100;26;97;152;167;148;94;63;79;80;133;151;59;65;116;43;131;149;123;162;194;135;180;121;53;158;154;70;127;112;184;10;177;54;48;34;146;22;18;108;93;117;143;0;68;46;139;41;193;159;181;160;42;5;115;118;51;176;137;23;89;183;9;62,1449876959586411432,0.078977
greedy_intra:edges_start:random,85,73081,23721,49360,687821,448,145;92;129;2;167;9;62;144;14;49;102;148;137;51;176;80;122;63;79;133;151;162;123;149;131;47;65;59;118;46;0;89;183;143;117;93;140;108;18;22;159;193;41;139;115;96;5;116;43;42;181;34;160;48;54;177;10;184;84;4;112;127;70;135;154;180;53;121;94;124;152;1;97;26;100;86;101;75;120;44;25;78;16;171;175;113;56;31;81;90;165;40;185;106;3;178;52;55;57;179,4710255608154582935,0.075397
greedy_intra:edges_start:random,86,73192,25002,48190,602867,511,113;31;196;81;90;165;40;185;55;52;106;178;3;138;14;144;49;102;62;9;148;15;186;23;89;183;143;0;117;93;108;18;139;41;193;159;22;146;181;5;42;160;34;54;184;177;10;4;112;35;43;115;46;118;59;116;65;131;149;123;127;135;70;162;133;151;51;137;176;80;122;79;63;180;154;53;121;94;26;100;86;75;2;101;1;97;152;167;57;145;179;92;129;120;44;25;78;16;171;175,6923634638211860301,0.085205
greedy_intra:edges_start:random,87,73011,24514,48497,546135,420,183;23;137;51;176;80;63;79;133;151;59;115;46;0;143;117;68;139;41;193;159;69;108;18;22;146;34;30;54;177;4;112;84;35;184;48;160;42;5;43;116;65;149;123;127;70;135;154;180;53;121;100;26;86;75;101;97;1;2;44;120;25;78;145;16;171;175;56;113;31;81;196;185;40;165;90;164;21;14;3;178;106;52;55;57;92;129;152;94;124;148;102;49;144;62;9;15;114;186;89,3930055587960133989,0.060545
greedy_intra:edges_start:random,88,72951,23833,49118,604474,509,162;151;59;65;116;43;42;115;139;198;46;68;0;170;143;117;93;140;108;69;18;22;146;195;159;193;41;181;34;160;54;177;184;84;4;112;131;149;123;127;135;154;180;53;86;100;26;97;152;1;101;75;2;129;120;44;25;16;171;175;113;56;31;81;90;165;138;14;49;178;106;52;55;185;119;40;196;179;145;78;92;57;167;148;9;62;144;15;186;89;183;23;137;176;51;80;94;63;79;133,6889010582457812200,0.084797
greedy_intra:edges_start:random,89,73511,24051,49460,588848,463,149;35;84;112;4;190;10;177;184;54;48;34;160;42;181;22;159;193;41;116;43;65;59;118;115;46;198;139;68;117;0;143;183;137;23;186;15;148;62;9;144;102;49;14;165;39;164;27;90;81;40;185;3;178;106;52;55;57;129;92;78;145;196;31;56;113;175;171;16;25;44;120;75;86;158;154;180;53;100;26;97;1;101;2;152;124;94;63;122;79;133;80;176;51;151;162;135;70;127;123,7440500916210939909,0.068594
greedy_intra:edges_start:random,90,72793,23581,49212,735998,487,146;22;195;159;18;193;41;5;42;43;116;65;47;149;131;59;118;115;139;68;46;0;117;143;183;89;114;15;9;62;144;102;49;148;186;23;137;176;80;51;151;162;133;79;63;94;124;152;1;2;129;92;145;179;57;55;52;106;178;14;138;165;185;40;119;90;81;196;157;31;56;113;175;171;16;78;25;44;120;75;86;101;97;26;53;158;180;154;135;127;123;112;84;184;10;177;54;160;34;181,7028982968375080906,0.081018
greedy_intra:edges_start:random,91,73290,23631,49659,682988,505,54;48;184;42;160;34;181;41;193;159;22;18;108;139;68;117;143;0;153;183;89;23;137;176;133;151;162;123;127;70;135;154;158;53;121;100;26;86;75;101;1;97;152;2;120;44;25;78;16;171;175;113;56;31;157;81;196;179;145;92;129;57;55;52;106;178;3;185;40;165;90;39;138;14;49;144;62;9;148;124;94;63;180;79;122;80;51;59;118;46;198;115;116;65;43;131;149;112;4;177,5853385358882874116,0.090511
greedy_intra:edges_start:random,92,72430,24079,48351,719218,466,123;149;131;65;116;59;118;51;80;176;137;23;186;89;183;143;0;46;68;117;93;108;18;139;115;5;43;42;41;193;159;22;146;34;160;48;54;177;184;84;4;112;127;70;135;154;180;53;121;189;97;26;100;86;101;1;152;2;75;120;44;25;78;16;171;175;113;56;31;196;145;92;129;57;179;185;40;165;90;27;164;21;144;14;55;52;106;178;3;49;62;9;148;124;94;63;79;133;151;162,8886628238679471874,0.070789
greedy_intra:edges_start:random,93,74016,22876,51140,829336,513,127;70;135;154;180;53;100;26;97;152;1;101;86;75;2;120;44;25;82;129;92;57;55;91;179;145;78;16;171;175;113;56;31;157;196;81;40;119;90;27;39;165;185;52;106;178;3;138;14;49;102;144;62;9;148;124;94;63;122;79;80;176;51;137;23;89;183;143;0;139;18;22;193;41;181;34;160;54;177;10;190;4;112;123;149;131;35;184;42;5;43;47;65;116;115;118;59;151;133;162,7082466099675824054,0.083756
greedy_intra:edges_start:random,94,73125,24965,48160,543481,420,127;70;135;154;180;133;162;149;131;47;43;42;41;193;139;46;115;116;65;59;118;51;137;176;80;151;79;63;94;53;26;101;86;75;1;97;152;2;120;44;16;171;175;113;31;145;78;25;129;92;179;185;165;119;40;196;81;90;27;164;14;144;49;3;178;106;52;55;57;167;148;9;62;15;186;89;183;143;170;0;117;93;140;108;69;18;159;22;146;181;34;160;184;54;177;10;190;4;112;123,7268871934193606647,0.063515
greedy_intra:edges_start:random,95,72193,23581,48612,567317,498,59;151;133;79;63;121;26;100;53;158;180;154;135;70;127;162;123;112;4;190;10;177;54;34;160;48;184;35;131;149;65;116;43;42;5;115;139;41;193;159;146;22;18;108;68;46;117;0;143;183;89;186;23;137;148;9;62;129;92;57;55;52;106;178;49;102;144;14;138;165;27;90;81;196;40;119;185;179;145;78;31;56;113;175;171;16;44;120;2;75;86;101;1;97;152;94;80;176;51;118,6581649976139471178,0.074558
greedy_intra:edges_start:random,96,72888,24837,48051,720956,486,157;78;145;92;179;196;81;90;27;164;39;165;40;185;14;144;15;186;89;183;153;0;117;143;23;137;148;9;62;102;49;178;106;55;52;57;129;2;1;101;26;100;97;152;94;176;80;79;133;162;151;51;59;118;46;68;139;115;41;193;159;69;108;18;22;146;181;34;160;54;177;10;4;112;84;184;42;43;116;65;131;149;123;127;135;154;180;63;53;86;75;120;44;25;16;171;175;113;56;31,1163629201537010470,0.083243
greedy_intra:edges_start:random,97,75112,23891,51221,639587,473,179;145;78;92;57;129;152;97;1;101;26;100;121;182;136;63;180;53;86;75;2;120;44;25;16;171;175;113;31;157;196;81;90;165;40;185;106;178;3;14;144;49;102;62;9;15;114;186;23;137;183;143;0;117;68;46;115;139;41;42;116;43;184;160;181;193;159;22;146;34;54;177;112;127;70;154;135;123;149;131;47;65;59;118;109;51;72;151;162;133;79;80;176;122;94;124;148;167;52;55,3488005775581553761,0.083620
greedy_intra:edges_start:random,98,74474,22837,51637,786114,477,160;54;184;131;149;151;162;123;127;70;135;154;180;158;53;100;26;97;101;86;75;1;152;2;129;92;57;55;52;178;3;106;185;179;145;78;82;120;44;25;16;171;175;113;56;31;196;81;90;27;40;119;165;138;14;144;49;102;62;9;15;186;23;89;183;153;143;117;0;137;148;124;94;189;121;182;136;63;122;79;133;80;176;51;118;59;65;116;43;42;193;41;115;46;68;139;18;22;146;34,1003067018941083945,0.082567
greedy_intra:edges_start:random,99,74250,23210,51040,610314,445,53;158;180;154;135;127;123;149;131;65;116;43;35;112;84;184;177;54;34;160;42;181;22;159;193;41;115;59;118;51;151;162;133;79;63;122;80;176;137;23;0;46;198;139;68;117;170;143;183;89;186;15;62;9;148;167;124;94;189;26;101;1;97;152;2;82;129;92;57;55;52;106;178;3;49;102;144;14;138;165;90;40;185;179;145;196;81;31;113;175;171;16;78;25;44;120;75;86;100;121,200708185308957532,0.074650
greedy_intra:edges_start:random,100,73118,23722,49396,652422,467,63;180;154;135;123;112;4;10;177;184;160;54;34;146;22;159;18;139;193;41;42;43;131;149;65;116;115;46;68;140;93;117;0;143;183;89;23;137;186;15;9;62;144;102;49;14;3;178;106;52;55;185;40;119;165;27;90;81;196;179;57;92;145;78;157;31;56;113;175;171;16;25;44;120;82;129;152;1;2;75;86;101;97;26;100;53;121;189;94;124;148;176;51;118;59;162;151;133;80;79,8677990546462776346,0.079622
greedy_intra:edges_start:random,101,71874,23253,48621,623653,484,70;127;123;112;4;190;10;177;54;48;160;34;181;42;184;43;116;65;131;149;59;118;115;41;193;159;22;18;108;139;46;68;140;93;117;0;143;183;89;23;137;186;15;148;9;62;144;102;49;55;52;106;178;3;14;138;165;90;81;196;40;119;185;179;145;78;157;31;56;113;175;171;16;25;44;120;129;92;57;2;75;86;101;1;97;152;124;94;80;176;151;162;133;79;63;53;158;180;154;135,7926725968135421588,0.083742
greedy_intra:edges_start:random,102,73986,24059,49927,606082,472,146;34;48;54;177;10;184;43;116;65;131;149;123;127;135;70;154;180;63;121;53;86;100;26;97;101;1;152;74;2;75;120;44;25;82;129;92;179;145;78;16;171;175;113;31;196;81;90;165;119;40;185;57;55;52;106;178;3;14;49;102;144;62;9;148;186;23;89;183;137;109;51;176;80;124;94;122;79;133;151;162;59;118;46;0;143;117;68;115;42;160;181;195;159;193;41;139;108;18;22,8590234808522752249,0.078130
greedy_intra:edges_start:random,103,72213,23755,48458,759132,454,97;152;2;75;120;44;25;16;171;175;113;56;31;78;145;92;57;129;179;196;81;90;165;119;40;185;55;52;106;178;3;49;14;144;102;62;9;148;124;94;180;63;122;80;79;133;151;72;118;59;65;116;115;139;68;46;51;176;137;186;23;89;183;143;0;117;108;18;22;146;181;159;193;41;42;160;34;54;177;10;4;112;84;35;184;43;149;162;123;127;70;135;154;158;53;100;26;86;101;1,130763437618481917,0.081145
greedy_intra:edges_start:random,104,74250,24477,49773,664025,477,154;180;63;79;122;94;124;148;137;176;80;133;151;162;135;127;123;112;4;10;177;54;34;160;184;43;42;5;116;65;149;59;118;51;115;41;193;22;18;108;140;68;139;46;0;117;143;183;89;23;186;114;15;37;49;102;9;62;144;14;165;27;90;119;40;185;106;3;178;52;55;57;179;145;78;196;81;157;31;113;175;171;16;25;44;120;92;129;2;75;101;86;100;26;97;1;152;189;121;53,721660802228704368,0.079201
greedy_intra:edges_start:random,105,73759,25269,48490,604814,467,162;59;118;115;46;139;108;18;159;193;41;42;181;22;146;34;160;54;177;10;184;43;116;65;149;123;127;135;154;180;63;53;121;94;124;148;49;14;178;106;52;55;57;92;129;82;2;152;97;1;101;26;100;86;75;120;44;25;145;78;16;171;175;113;56;31;157;179;196;81;119;40;185;165;90;27;164;7;21;144;102;62;9;186;89;183;143;117;93;140;0;23;137;51;176;80;122;79;133;151,4692983195264869124,0.073067
greedy_intra:edges_start:random,106,72567,23303,49264,710469,479,178;106;52;55;57;129;82;92;185;40;165;90;81;196;179;145;78;31;113;175;171;16;25;44;120;2;152;97;1;101;75;86;100;26;53;180;154;135;70;127;133;151;162;123;112;4;84;190;10;177;54;184;131;149;47;65;116;105;43;42;181;160;34;146;22;18;108;69;159;193;41;5;96;115;59;118;139;46;0;117;143;183;89;186;23;137;176;109;51;80;79;63;94;124;148;9;62;49;144;14,941492219769818964,0.079382
greedy_intra:edges_start:random,107,74227,23669,50558,660754,504,120;25;16;171;175;113;56;31;78;145;179;196;81;90;165;119;40;185;106;178;3;138;14;144;102;49;52;55;57;92;129;2;152;97;189;94;12;124;167;148;9;62;15;137;176;80;51;118;115;46;0;183;143;117;93;68;139;41;193;159;22;146;34;54;160;42;43;184;35;84;177;10;4;112;127;123;149;131;65;116;59;72;151;162;133;79;63;135;70;154;180;53;121;100;26;1;101;86;75;44,1441602853070159808,0.079462
greedy_intra:edges_start:random,108,71374,22323,49051,554471,476,138;14;144;62;9;148;49;3;178;106;52;55;57;92;129;2;152;124;94;63;79;133;151;162;59;118;109;51;80;176;137;23;186;89;183;143;117;0;46;68;139;198;115;41;193;159;69;108;18;22;146;103;195;181;34;160;54;177;10;4;112;84;184;42;43;116;65;131;149;123;127;70;135;154;180;53;121;100;26;86;97;1;101;75;120;44;25;16;171;175;113;31;78;145;196;81;90;165;40;185,328387196251199150,0.084148
greedy_intra:edges_start:random,109,75044,23629,51415,626791,502,93;140;108;69;18;22;159;193;41;42;181;34;48;160;43;116;65;47;77;149;131;35;184;54;177;10;4;112;127;135;70;194;123;162;151;133;176;80;79;63;94;124;121;53;180;154;158;86;75;101;100;26;97;1;152;2;120;44;25;16;171;175;78;145;129;92;57;55;52;185;40;90;27;165;106;178;49;14;144;62;9;37;148;15;183;89;23;186;137;51;109;118;59;115;139;68;46;0;143;117,4890163974273224578,0.078698
greedy_intra:edges_start:random,110,72309,23870,48439,650486,478,59;149;131;184;84;4;112;190;10;177;54;48;160;42;181;34;22;18;159;193;41;5;43;65;116;115;139;68;46;0;117;143;183;89;186;23;137;176;80;79;63;94;53;86;101;1;75;2;120;44;25;16;171;175;113;31;78;145;179;196;81;90;27;39;165;40;185;52;106;178;3;14;144;49;102;62;9;15;148;37;167;55;57;92;129;152;97;26;100;180;154;70;135;127;123;162;133;151;51;118,7664219590926882573,0.071544
greedy_intra:edges_start:random,111,73904,25259,48645,618133,469,22;146;34;160;54;177;10;184;42;43;131;149;65;116;115;193;41;139;68;46;118;59;72;151;162;133;79;63;180;154;135;123;4;112;127;70;53;121;100;26;94;124;152;97;86;75;101;1;2;82;120;44;25;78;31;56;113;175;171;16;157;81;196;179;145;92;129;57;55;52;178;106;185;40;119;90;27;165;138;14;49;144;62;9;148;176;80;51;137;23;186;89;183;143;0;117;93;108;18;159,2224749202656996413,0.078059
greedy_intra:edges_start:random,112,71526,23360,48166,702164,465,190;10;177;54;34;160;48;184;43;5;42;181;146;22;159;41;193;18;69;108;140;68;46;198;139;115;116;65;59;118;51;151;162;133;79;80;176;137;0;117;143;183;89;23;186;15;148;9;62;102;49;144;14;178;106;52;55;57;129;92;145;179;185;40;119;165;90;81;196;157;78;31;113;175;171;16;25;44;120;2;75;86;101;1;97;152;94;63;53;180;154;135;70;127;123;131;149;112;4;84,5183139087661378865,0.081153
greedy_intra:edges_start:random,113,74669,23887,50782,700868,463,136;182;121;100;26;97;1;101;86;75;2;129;120;44;25;16;171;175;113;56;31;157;196;81;179;145;78;92;57;55;52;185;40;119;90;165;106;178;49;102;14;144;62;9;15;148;167;152;189;124;94;63;122;79;80;176;137;89;183;143;0;117;93;68;139;108;18;22;159;193;41;96;5;181;42;43;116;47;65;59;115;46;118;51;151;133;162;123;184;160;34;54;177;112;127;135;154;180;158;53,7248251160495660902,0.083885
greedy_intra:edges_start:random,114,73712,24611,49101,741758,469,4;112;127;123;162;194;135;70;154;180;63;94;53;86;101;26;97;152;1;75;2;129;82;120;44;25;16;171;175;113;56;31;78;145;92;57;55;52;185;40;81;90;165;106;178;14;144;49;9;62;148;15;186;89;183;143;0;117;108;18;68;46;23;137;176;80;79;133;151;51;118;59;116;65;47;77;149;131;35;184;43;5;42;181;41;115;139;193;159;22;146;34;160;48;54;30;177;10;190;84,3150038411241214324,0.077130
greedy_intra:edges_start:random,115,71728,23193,48535,874729,515,62;9;148;124;94;137;23;186;89;183;143;0;117;108;18;22;146;159;193;41;115;139;68;46;118;59;109;51;176;80;63;79;133;151;162;149;65;116;5;42;181;34;48;54;177;10;4;112;84;184;160;43;131;123;127;70;135;154;180;158;53;121;100;26;86;101;97;152;1;75;2;129;120;44;25;78;16;171;175;113;31;196;81;90;165;119;40;185;179;145;92;57;55;52;106;178;3;49;14;144,7495399162933903983,0.082823
greedy_intra:edges_start:random,116,75567,24092,51475,731883,497,116;65;47;131;149;72;51;109;118;59;115;42;41;193;159;22;18;139;46;68;140;93;117;143;170;0;153;183;89;23;186;114;15;9;62;144;14;102;49;178;106;165;90;81;40;185;52;55;57;92;129;179;145;78;31;113;175;171;16;44;120;75;86;101;1;97;26;100;53;158;154;70;135;180;121;152;2;167;37;148;137;176;80;94;63;122;79;133;151;162;194;127;123;112;177;54;34;160;184;43,3974102518769926111,0.086105
greedy_intra:edges_start:random,117,73083,24940,48143,707754,512,171;175;113;31;78;157;196;81;90;165;40;185;52;55;57;179;145;92;129;2;152;97;26;86;53;158;180;63;79;80;176;133;151;51;46;68;139;115;118;59;116;43;65;47;131;149;123;162;154;135;70;127;112;4;10;177;54;34;160;184;42;181;146;22;195;41;193;159;18;108;93;117;0;143;183;89;23;137;186;15;9;62;102;144;14;106;178;49;148;124;94;121;100;1;101;75;120;44;25;16,5587525887654432203,0.082004
greedy_intra:edges_start:random,118,74166,23242,50924,711373,414,123;149;131;184;34;160;181;146;22;159;18;108;139;193;41;42;43;65;116;115;46;0;117;143;183;89;186;23;137;118;59;72;151;162;51;176;80;133;79;122;63;94;124;97;1;101;152;2;82;78;145;179;92;129;57;55;52;106;178;3;167;37;148;15;9;62;144;102;49;14;138;185;40;119;165;90;81;196;157;31;56;113;175;171;16;25;44;120;75;86;26;100;121;53;158;180;154;135;70;127,4131378285332608189,0.079815
greedy_intra:edges_start:random,119,74714,26005,48709,635798,455,56;113;175;171;16;25;82;44;120;2;75;86;101;1;26;97;100;53;154;180;63;122;80;79;133;162;135;70;127;123;112;184;177;54;34;103;146;22;181;160;42;43;65;116;41;193;159;18;139;115;46;117;143;0;118;59;151;51;176;137;23;186;89;183;114;15;144;102;62;9;148;124;94;152;129;92;57;55;52;179;185;106;178;3;49;14;138;21;7;164;27;90;165;119;40;81;196;78;145;31,5935688182623262617,0.073638
greedy_intra:edges_start:random,120,75090,25061,50029,640269,497,54;48;184;160;34;181;146;22;159;193;18;69;108;68;139;41;96;115;198;46;118;59;51;80;176;137;0;117;143;183;144;14;178;106;185;40;119;165;90;81;196;56;113;175;171;16;31;78;25;44;120;82;92;129;145;179;57;55;52;49;9;62;148;124;94;19;189;121;100;26;97;101;1;152;2;75;86;53;154;70;135;180;63;79;133;151;162;65;116;5;42;43;131;149;123;127;112;4;10;177,643644127925467870,0.074743
greedy_intra:edges_start:random,121,73642,24848,48794,538824,482,148;167;152;1;101;97;26;94;137;89;183;143;0;117;93;108;18;68;46;139;115;59;149;131;47;65;116;43;5;96;41;193;159;22;146;181;42;184;48;160;34;54;177;10;190;4;112;123;162;151;51;176;80;133;79;63;180;135;127;70;154;53;86;75;2;129;120;44;25;16;171;175;113;56;31;78;145;179;92;57;55;52;196;81;90;27;165;185;40;138;14;106;178;49;102;144;62;9;15;37,1770869814948313990,0.082463
greedy_intra:edges_start:random,122,73981,22045,51936,634286,439,115;118;59;72;109;51;176;80;79;133;151;162;123;149;65;116;43;42;41;193;159;22;146;34;160;54;177;10;184;84;112;127;194;135;70;154;180;158;53;136;63;94;124;189;121;100;26;97;86;75;101;1;152;2;120;44;16;171;175;113;31;78;25;82;129;92;57;179;145;157;196;81;90;27;39;165;119;40;185;55;52;106;178;3;138;14;49;102;144;62;9;148;137;183;143;117;0;46;68;139,9185010329657711157,0.077176
greedy_intra:edges_start:random,123,73090,24058,49032,629020,468,41;181;34;160;54;177;10;4;112;84;184;35;149;131;43;42;115;116;65;59;118;51;151;176;80;122;63;79;133;162;123;127;70;135;154;180;158;53;100;26;97;152;1;101;86;75;2;55;52;57;129;120;44;16;171;175;113;31;78;145;92;179;196;81;90;165;185;40;119;106;178;3;138;14;144;49;102;62;9;15;148;124;189;121;94;137;23;186;89;183;143;117;0;46;139;108;18;22;159;193,3814716034895677776,0.075936
greedy_intra:edges_start:random,124,74751,25057,49694,497238,465,139;41;193;159;18;22;146;181;42;43;184;160;34;54;177;112;127;135;123;149;131;65;116;59;115;46;118;51;151;162;133;79;63;180;154;158;53;86;101;75;120;44;25;82;92;145;78;31;16;171;175;113;56;157;196;81;90;40;119;165;14;144;62;9;15;186;148;37;167;102;49;3;178;106;52;55;185;179;57;129;2;1;97;26;100;121;189;152;94;80;176;137;23;89;183;143;0;117;93;68,7235723236157659033,0.074031
greedy_intra:edges_start:random,125,71985,23550,48435,704686,483,75;86;26;100;121;53;158;180;154;135;70;127;123;162;149;43;42;184;84;112;4;10;177;30;54;48;160;34;181;146;22;18;159;193;41;139;46;115;116;65;59;118;51;151;133;79;63;94;124;80;176;137;23;0;93;117;143;183;89;186;15;148;9;62;144;14;49;3;178;106;52;55;57;92;78;145;179;185;40;119;165;27;90;81;196;31;16;171;175;113;56;25;44;120;129;2;152;97;1;101,2168041548327752316,0.081902
greedy_intra:edges_start:random,126,73563,24321,49242,727719,479,42;43;184;160;181;159;18;22;34;48;54;177;4;112;84;35;123;127;70;154;135;149;131;47;65;116;59;118;51;151;162;133;79;122;63;180;158;53;121;100;26;97;101;86;75;1;152;2;129;92;120;44;25;16;171;175;113;56;31;78;145;81;196;179;57;55;52;185;40;90;165;106;178;49;102;14;144;62;9;148;167;124;94;80;176;137;23;186;114;89;183;143;117;0;46;115;139;193;41;5,5451800244818308362,0.079551
greedy_intra:edges_start:random,127,74919,25564,49355,460163,480,198;46;0;143;117;68;139;41;159;193;18;108;22;146;34;160;54;177;4;112;84;184;181;42;5;43;65;116;59;131;149;123;127;70;135;162;133;79;63;180;154;158;53;136;121;189;100;26;97;1;101;86;75;2;152;129;57;92;82;120;44;25;16;171;175;113;56;31;179;145;78;196;81;90;165;40;185;52;55;167;124;94;148;9;62;49;178;106;14;144;186;89;183;137;80;176;151;51;118;115,1217498713129754782,0.072567
greedy_intra:edges_start:random,128,72801,22930,49871,725374,480,92;129;57;55;52;106;178;3;14;49;102;144;62;9;148;167;124;94;63;122;79;80;176;51;118;137;23;186;114;89;183;143;0;117;68;46;198;115;139;18;193;41;159;22;146;34;160;54;177;10;190;184;43;42;5;116;65;149;59;151;133;162;123;127;70;135;154;180;158;53;121;26;100;86;101;75;1;97;152;2;82;120;44;25;16;171;175;113;31;157;81;196;90;165;119;40;185;179;78;145,1521762996118570541,0.084735
greedy_intra:edges_start:random,129,72467,23313,49154,684081,528,63;79;133;151;162;123;149;65;116;43;42;181;193;41;139;93;140;108;69;18;159;22;34;160;184;48;54;177;10;4;112;127;70;135;154;180;53;121;94;100;26;86;75;101;1;97;152;2;120;44;25;16;171;175;113;56;31;157;78;145;92;57;55;52;179;196;40;90;165;119;185;106;178;49;138;14;144;102;62;9;37;148;15;186;137;23;89;183;143;0;117;68;46;115;59;118;51;176;80;122,7021853660261534284,0.087225
greedy_intra:edges_start:random,130,74691,24484,50207,626608,494,14;49;178;106;52;185;165;27;90;40;31;113;175;171;16;78;145;179;25;44;120;82;129;92;57;55;148;186;23;137;176;80;51;118;46;68;139;198;115;59;116;65;47;131;149;162;151;133;79;122;94;124;152;97;1;101;2;75;86;53;63;180;154;135;70;127;123;112;4;84;184;177;54;48;160;43;42;5;41;193;159;181;34;146;22;18;108;140;93;117;0;143;183;89;83;114;15;9;62;144,7382496072278543553,0.079223
greedy_intra:edges_start:random,131,73309,23678,49631,640674,483,94;26;97;1;101;75;86;100;121;53;158;70;127;123;135;154;180;63;79;80;176;133;162;151;51;118;59;42;43;116;65;149;112;84;184;190;10;177;54;160;34;146;22;18;159;193;41;139;115;46;0;117;143;183;89;137;23;186;9;62;102;144;14;49;3;178;106;52;55;185;40;119;165;27;90;81;169;196;157;113;56;175;171;16;31;78;145;179;57;92;129;82;25;44;120;2;152;167;148;124,6486591652145310823,0.085392
greedy_intra:edges_start:random,132,74943,26160,48783,678711,504,0;176;80;51;118;59;131;149;162;151;133;79;63;94;97;1;2;152;129;92;78;145;179;40;119;185;3;178;106;52;55;57;167;148;137;183;89;23;186;9;62;102;49;14;144;21;164;165;90;81;196;157;38;31;56;113;175;171;16;25;44;82;120;75;101;86;26;53;158;180;154;135;70;127;123;112;184;177;190;10;54;48;160;34;22;18;108;139;159;193;41;42;43;65;116;115;46;68;117;143,7469740800977597525,0.080380
greedy_intra:edges_start:random,133,74205,23378,50827,624198,498,176;80;63;79;133;162;151;72;51;137;23;89;183;153;0;143;117;68;46;139;41;193;159;18;22;146;34;48;54;177;10;184;160;42;5;43;116;115;118;59;65;47;149;131;123;127;70;135;154;180;53;136;182;121;100;26;189;94;124;167;52;55;57;92;129;2;152;97;1;101;86;75;120;44;25;78;145;179;31;16;171;175;113;56;81;196;185;40;90;165;106;178;3;14;49;102;144;62;9;148,629372129676239172,0.088485
greedy_intra:edges_start:random,134,74558,26333,48225,579109,466,65;149;131;59;118;115;139;198;46;68;117;93;140;108;18;22;195;146;103;34;160;54;177;10;4;112;127;70;135;154;86;101;75;120;44;25;92;129;57;179;145;78;16;171;175;113;56;31;196;81;90;165;119;40;185;55;52;106;178;49;14;144;62;9;186;89;183;143;0;23;137;51;151;133;79;80;176;94;63;124;148;2;1;152;97;26;53;180;162;123;35;84;184;43;42;181;159;193;41;116,7900120423736070904,0.076672
greedy_intra:edges_start:random,135,72799,24567,48232,598912,443,186;89;183;143;0;117;108;18;22;159;193;41;139;68;46;115;116;59;118;51;137;176;80;124;94;63;79;133;151;72;162;123;149;131;65;43;42;160;34;54;177;10;184;35;84;112;127;70;135;154;180;158;53;86;100;26;97;152;2;1;101;75;120;44;25;78;16;171;175;113;56;31;145;179;92;129;57;55;52;106;185;196;81;40;119;165;90;27;164;21;14;3;178;49;102;144;62;9;148;15,1102130328513604345,0.079532
greedy_intra:edges_start:random,136,73535,24062,49473,701627,484,52;106;178;14;138;185;40;119;165;39;90;27;164;21;144;49;62;9;148;15;186;23;137;89;183;143;0;117;68;46;115;118;59;65;47;116;43;42;139;41;193;159;22;146;34;160;48;54;177;10;190;4;112;127;70;135;123;35;184;131;149;162;151;72;51;176;80;79;133;180;154;53;63;94;121;100;26;86;1;97;152;2;101;75;120;44;25;145;78;16;171;175;113;31;196;179;92;129;57;55,7146370730914131425,0.082215
greedy_intra:edges_start:random,137,73093,23783,49310,668729,455,139;69;18;108;140;93;68;117;0;143;183;89;23;137;186;15;148;9;62;102;144;14;49;178;106;185;40;119;165;90;81;196;179;145;92;52;55;57;129;82;25;78;31;56;113;175;171;16;44;120;2;152;75;86;101;1;97;26;100;124;94;80;79;63;182;121;53;158;180;154;135;123;162;133;151;176;51;46;115;59;65;116;42;43;131;149;112;84;184;177;54;48;160;34;181;146;22;159;193;41,8210150263803688496,0.072979
greedy_intra:edges_start:random,138,72330,23114,49216,795983,505,143;183;89;137;122;79;63;121;94;124;148;9;62;144;102;49;14;3;178;106;52;55;57;185;40;165;90;81;196;179;145;78;31;113;175;171;16;44;25;120;82;92;129;2;152;1;101;75;86;97;26;100;53;180;154;135;70;127;123;149;131;35;84;112;4;190;10;177;184;54;30;48;160;181;34;146;22;18;159;193;41;139;46;115;5;42;43;47;65;116;59;118;51;151;162;133;80;176;0;117,3405474151605654533,0.084093
greedy_intra:edges_start:random,139,74443,24849,49594,763220,465,124;167;148;62;89;183;143;0;117;93;68;46;139;193;41;115;116;65;47;149;131;43;42;181;159;18;22;146;34;160;184;48;54;177;10;190;84;4;112;123;162;151;72;59;118;51;137;176;80;79;122;63;133;194;127;70;135;154;180;158;53;136;121;100;26;86;75;120;44;25;16;171;175;113;31;78;145;81;90;164;21;144;14;49;178;106;165;40;185;52;55;57;92;129;2;101;1;97;152;94,7786850174909543231,0.078365
greedy_intra:edges_start:random,140,74751,24317,50434,640010,490,26;97;1;152;2;129;92;57;148;124;94;63;180;158;154;135;70;127;123;149;131;35;184;177;54;48;160;34;146;22;181;42;5;43;116;65;59;72;151;162;133;79;122;80;51;118;115;198;139;41;193;159;18;108;140;93;68;46;0;117;143;183;89;137;176;15;9;62;144;102;49;14;138;3;178;106;52;55;196;81;90;27;165;40;119;185;179;145;78;113;175;171;16;44;120;75;101;86;53;100,3836724146550214358,0.079042
greedy_intra:edges_start:random,141,73370,23799,49571,647122,482,55;129;2;75;86;101;1;97;26;100;121;182;189;152;148;124;94;80;176;51;151;133;79;63;180;53;158;154;135;70;127;123;112;131;149;162;59;118;46;115;42;116;65;43;184;177;54;48;160;34;181;146;22;159;193;41;139;18;108;140;93;117;0;170;143;183;89;23;137;15;9;62;102;144;14;49;3;178;106;52;185;40;119;165;90;81;196;31;56;113;175;171;16;25;44;120;78;145;92;57,9056329527592221641,0.081477
greedy_intra:edges_start:random,142,72921,23282,49639,692965,483,34;146;181;42;43;116;65;47;149;131;35;123;162;59;118;115;46;139;41;193;159;22;18;108;93;117;143;183;89;23;137;176;80;151;79;122;63;94;124;148;15;9;62;102;144;14;49;178;106;52;55;185;40;119;165;90;81;145;31;56;113;175;171;16;44;25;78;92;57;129;82;120;2;75;86;101;1;152;97;26;100;121;53;154;180;133;135;70;127;112;4;84;184;190;10;177;30;54;48;160,7393112558248535308,0.081126
greedy_intra:edges_start:random,143,73125,24271,48854,818339,505,159;193;41;139;69;108;18;22;146;34;160;54;184;84;112;127;70;154;135;123;131;149;59;118;51;151;162;133;79;80;176;122;63;180;158;53;86;100;26;97;152;129;92;57;55;52;178;106;185;40;119;165;39;95;7;164;27;90;81;196;145;31;56;113;175;171;16;78;25;44;120;2;75;101;1;94;124;148;9;62;49;14;144;15;137;23;89;183;143;0;117;68;46;115;116;65;43;5;42;181,1016209957956456082,0.094488
greedy_intra:edges_start:random,144,72636,23954,48682,625336,454,22;146;34;48;54;177;10;184;84;112;127;123;149;65;116;43;42;160;181;195;159;193;41;139;68;46;198;115;59;118;51;176;80;63;79;133;151;162;135;70;154;180;158;53;100;26;86;75;101;1;97;152;94;124;148;37;167;57;92;129;2;82;120;44;25;16;171;175;113;31;78;145;196;179;55;52;178;106;185;40;81;90;165;14;49;102;144;62;9;15;137;23;89;183;143;0;117;108;69;18,3841060205040931923,0.076058
greedy_intra:edges_start:random,145,73664,24619,49045,653901,484,80;176;51;151;133;162;72;118;59;116;65;47;131;149;123;112;4;177;54;184;160;34;146;22;181;42;43;5;115;41;193;159;18;139;46;68;140;93;117;0;143;183;89;137;23;148;9;62;102;144;14;138;49;178;106;52;185;40;165;27;90;81;196;179;145;31;56;113;175;171;16;78;92;57;55;129;82;25;44;120;75;101;97;1;2;152;124;94;121;100;26;86;53;154;70;127;135;180;63;79,2912847676190263415,0.081407
greedy_intra:edges_start:random,146,71890,23288,48602,832682,516,57;129;92;145;78;31;113;175;171;16;25;44;120;2;75;86;101;1;152;94;124;97;26;100;53;63;180;154;135;70;127;123;112;184;190;10;177;54;34;146;22;18;108;69;139;115;41;193;159;195;181;160;42;43;116;65;47;131;149;162;151;133;79;80;176;51;59;118;46;68;140;93;117;0;143;183;89;23;137;186;114;15;148;37;9;62;102;49;144;14;3;178;106;165;90;81;40;185;52;55,4985545562040335516,0.088594
greedy_intra:edges_start:random,147,73077,24004,49073,730607,513,84;112;4;10;177;54;48;160;34;181;42;115;139;41;193;159;146;22;18;69;108;68;46;0;143;183;89;23;137;186;15;148;9;62;144;21;164;90;165;40;185;106;138;14;49;3;178;52;55;57;179;145;31;56;113;175;171;16;44;25;78;92;129;82;120;2;152;1;101;75;86;26;97;53;94;63;80;176;51;118;59;72;151;162;133;79;180;154;70;135;194;127;123;149;131;65;116;43;184;35,7779413437898412796,0.083279
greedy_intra:edges_start:random,148,73945,24068,49877,674503,510,14;49;102;144;62;9;15;148;167;152;124;94;63;122;79;80;176;51;59;118;137;23;186;89;183;143;0;46;115;42;41;193;139;108;18;159;22;146;195;181;34;160;184;177;10;4;112;43;116;65;149;123;127;162;151;133;194;135;70;154;180;158;53;121;100;26;97;1;101;86;75;2;120;44;82;129;92;57;55;52;179;196;145;78;25;16;171;175;113;56;31;81;90;165;119;40;185;106;178;3,6431179850445138896,0.086743
greedy_intra:edges_start:random,149,73272,22973,50299,788668,479,56;31;196;81;40;119;90;27;39;165;8;185;106;178;3;138;14;144;49;102;62;9;148;15;114;186;137;23;89;183;143;0;46;68;139;69;108;18;22;146;159;193;41;42;5;115;118;59;65;47;116;43;184;160;34;54;177;112;123;127;70;135;162;151;51;176;80;79;133;122;94;63;180;154;158;53;86;26;97;152;1;101;75;2;120;44;25;82;129;92;57;55;52;179;145;78;16;171;175;113,7511069005563348817,0.090657
greedy_intra:edges_start:random,150,74836,23960,50876,680274,497,121;180;63;79;133;151;162;149;131;77;47;65;116;59;118;51;80;176;137;23;186;89;183;143;0;117;93;46;68;198;139;41;193;159;69;108;18;22;34;160;181;42;5;115;43;184;177;10;4;112;123;127;70;135;154;158;53;100;26;97;101;86;75;1;152;2;129;92;145;78;120;44;16;171;175;113;31;90;27;165;40;185;57;55;52;106;178;49;14;144;102;62;9;15;148;167;111;124;94;189,2513520240993472563,0.079096
greedy_intra:edges_start:random,151,74669,25190,49479,641234,466,183;143;23;137;148;167;124;94;176;59;118;46;0;117;93;108;18;139;115;41;193;42;181;22;146;34;160;54;177;184;43;116;65;47;131;149;123;127;135;154;180;162;151;133;79;80;122;63;53;100;26;86;75;101;1;97;152;2;129;120;44;25;78;16;171;175;113;56;31;157;145;92;57;55;52;178;3;106;179;196;81;185;40;119;165;39;90;27;164;7;21;144;14;49;102;62;9;15;186;89,5872280996953186706,0.081660
greedy_intra:edges_start:random,152,73699,23899,49800,740711,478,116;43;149;131;35;112;4;177;54;184;160;34;181;42;5;41;193;159;146;22;18;69;108;93;117;143;183;89;23;186;148;9;62;102;144;14;49;178;106;52;55;185;165;90;40;196;31;113;175;171;16;25;78;145;179;57;92;129;44;120;2;75;101;1;97;152;189;124;94;63;122;79;136;121;100;26;86;53;158;180;154;135;127;123;162;151;133;80;176;51;137;0;46;68;139;115;118;59;65;47,7666690188576209450,0.080972
greedy_intra:edges_start:random,153,72648,22560,50088,742831,465,25;44;120;2;152;97;1;101;26;100;86;75;82;78;145;179;92;129;57;55;52;167;124;94;63;122;79;133;180;53;158;154;135;70;127;123;162;151;80;176;51;59;118;46;139;115;116;65;43;42;184;160;34;181;41;193;159;22;18;108;140;93;117;0;143;183;89;23;137;186;15;148;9;62;102;49;144;14;138;3;178;106;185;40;119;165;39;95;164;27;90;81;196;157;31;56;113;175;171;16,218576167193405979,0.082812
greedy_intra:edges_start:random,154,72116,22793,49323,584690,500,102;144;14;49;178;106;52;55;57;92;185;40;119;165;90;81;196;31;113;175;171;16;78;145;25;44;120;129;2;1;101;75;86;53;100;26;97;152;94;63;122;79;80;176;66;51;109;118;59;65;116;43;42;160;184;149;162;151;133;180;154;135;70;127;123;112;4;190;10;177;54;34;181;146;22;18;108;69;159;193;41;139;115;198;46;68;140;93;117;143;0;153;183;89;186;23;137;148;9;62,1395735128473313742,0.081779
greedy_intra:edges_start:random,155,72535,23847,48688,655831,441,116;43;42;181;193;41;139;115;46;68;0;143;117;93;140;108;18;159;22;146;34;160;54;177;184;84;112;123;127;70;135;154;180;158;53;121;100;26;86;75;101;1;97;2;82;120;44;25;78;92;145;31;16;171;175;113;196;81;90;165;40;185;106;138;14;144;62;9;102;49;178;52;55;57;129;152;124;167;148;15;114;186;89;183;23;137;176;80;122;94;63;79;133;162;151;51;118;59;65;47,9187601093177262591,0.075785
greedy_intra:edges_start:random,156,74149,23266,50883,746880,489,80;176;51;118;59;149;112;84;184;54;160;34;22;193;41;181;42;43;65;116;115;139;46;68;93;117;0;143;183;89;23;137;186;114;102;144;62;9;15;37;148;167;55;52;106;178;3;49;14;138;185;40;165;27;90;81;196;157;56;113;175;171;16;31;179;145;78;25;44;120;82;92;57;129;2;152;1;101;75;86;97;26;100;121;53;158;180;154;135;70;127;123;162;151;133;79;122;63;94;124,5843095705481772967,0.095760
greedy_intra:edges_start:random,157,73653,25577,48076,480339,491,118;116;115;41;193;159;146;22;18;108;140;93;68;139;46;51;176;80;63;94;124;137;0;117;143;183;89;23;186;15;148;9;62;144;14;49;178;106;52;55;57;92;179;145;78;196;185;40;119;165;39;164;27;90;81;31;56;113;175;171;16;25;44;120;82;129;152;97;1;101;2;75;86;53;180;154;135;70;79;133;151;72;162;123;149;131;112;4;10;177;54;48;34;181;160;184;42;43;65;59,759099728094171022,0.089800
greedy_intra:edges_start:random,158,72321,23099,49222,691474,496,54;34;160;43;116;65;131;149;123;194;162;133;151;51;109;118;59;5;42;181;22;18;159;193;41;139;115;46;68;117;0;143;183;89;114;15;186;23;137;176;80;79;122;63;94;124;148;9;62;102;49;144;14;3;178;106;55;52;185;40;165;90;81;196;31;113;175;171;16;25;44;120;78;145;92;57;129;2;75;86;101;1;152;97;26;100;121;53;180;154;135;70;127;112;4;84;184;177;190;10,6517308817089009518,0.092521
greedy_intra:edges_start:random,159,72061,22485,49576,831054,489,79;133;151;162;135;70;154;180;158;53;121;100;26;97;86;75;101;1;2;120;44;25;78;145;179;31;16;171;175;113;56;196;81;90;27;39;165;119;40;185;106;178;52;55;57;92;129;152;94;124;148;9;62;49;14;144;15;186;137;23;89;183;143;117;0;46;115;139;41;193;159;22;146;181;42;116;43;160;34;48;54;177;10;190;184;84;4;112;127;123;149;131;65;59;118;109;51;176;80;63,8136005727458639837,0.080583
greedy_intra:edges_start:random,160,73261,24504,48757,589076,456,39;164;7;21;14;144;49;102;62;9;186;23;89;183;143;117;46;0;137;148;124;94;63;122;176;80;79;133;162;151;51;118;59;115;139;41;193;159;108;18;22;181;42;116;65;43;184;160;34;48;54;177;4;112;123;127;70;135;154;180;158;53;136;121;100;26;97;152;1;101;86;75;2;120;44;25;129;92;57;55;52;178;106;185;119;40;196;179;145;78;16;171;175;113;56;31;157;81;90;165,1955535295688644007,0.078529
greedy_intra:edges_start:random,161,72958,23502,49456,606934,493,14;49;102;144;62;9;15;148;124;94;63;79;151;51;118;59;162;133;80;176;137;23;89;183;46;115;5;42;181;159;193;41;139;68;93;140;108;18;22;146;34;54;177;10;4;112;84;35;184;48;160;43;116;65;149;123;127;194;135;70;154;180;53;86;100;26;97;152;1;101;75;2;129;120;44;25;16;171;175;113;56;31;145;78;92;179;196;81;90;27;39;165;119;40;185;57;55;52;106;178,560100882125792119,0.083163
greedy_intra:edges_start:random,162,73608,24058,49550,874150,477,185;40;90;165;138;14;144;62;9;15;148;124;94;63;122;80;79;133;151;162;149;131;65;116;118;59;51;176;137;23;186;114;89;183;143;117;93;108;18;159;22;193;41;139;46;115;43;42;181;34;160;54;177;184;84;112;123;127;70;135;154;180;158;53;121;189;152;1;97;26;100;86;101;75;2;82;120;44;25;78;16;171;175;113;31;81;196;179;145;92;129;57;55;52;167;102;49;3;178;106,2564352052425036630,0.078089
greedy_intra:edges_start:random,163,73610,23878,49732,751927,509,31;145;196;81;40;165;185;52;55;57;92;129;2;152;167;148;37;9;62;102;49;3;178;106;14;144;15;186;137;23;89;183;143;170;0;117;68;46;59;65;116;43;42;160;181;159;193;41;115;139;69;108;18;22;146;34;48;54;177;10;184;84;4;112;131;149;162;123;127;194;135;70;154;180;79;133;151;51;176;80;63;94;124;121;53;100;26;97;1;101;86;75;120;44;25;78;16;171;175;113,1518968646130282780,0.081824
greedy_intra:edges_start:random,164,73243,24125,49118,696541,491,56;31;145;179;196;81;90;165;119;40;185;14;144;15;186;23;89;183;143;0;117;93;140;108;18;69;139;68;46;115;116;65;43;42;181;41;193;159;22;34;160;54;177;184;35;131;149;123;127;162;133;79;180;154;135;70;86;100;26;97;152;124;94;189;121;53;63;80;176;151;59;118;51;137;148;37;9;62;102;49;3;178;106;52;55;57;92;129;2;1;101;75;120;44;25;78;16;171;175;113,3911013142605531990,0.084822
greedy_intra:edges_start:random,165,72991,23418,49573,930935,489,171;175;113;31;196;81;90;119;40;185;165;138;14;106;52;178;3;49;102;144;62;9;37;148;15;186;23;89;183;143;117;0;46;51;137;176;80;63;79;133;151;162;123;131;149;59;118;65;116;43;42;5;96;115;139;41;193;159;18;22;146;34;160;48;54;177;10;190;184;84;112;127;70;135;154;180;158;53;100;121;94;124;152;97;26;1;101;86;75;2;120;44;25;129;55;57;92;145;78;16,5622498222215566315,0.091358
greedy_intra:edges_start:random,166,74187,23729,50458,651905,484,151;133;79;80;176;137;183;89;186;15;148;9;62;144;102;49;14;138;3;178;106;185;40;165;27;90;81;196;157;31;56;113;175;171;16;25;44;120;78;145;92;129;57;55;52;167;124;152;97;189;94;122;63;182;121;100;26;101;1;2;75;86;53;180;154;135;70;127;123;112;184;177;54;48;160;34;22;159;193;41;139;18;108;93;117;143;170;0;46;115;118;51;109;59;116;42;43;65;149;162,654247714493034169,0.082844
greedy_intra:edges_start:random,167,73321,25017,48304,703989,466,115;5;43;116;65;131;149;59;118;51;72;151;133;79;63;80;176;137;46;68;93;117;0;143;183;89;23;148;124;94;152;2;129;57;55;52;165;119;40;185;106;178;49;102;9;62;144;14;21;164;90;81;196;92;145;78;31;56;113;175;171;16;25;44;120;75;86;101;1;97;26;100;53;158;180;154;70;135;162;123;127;112;184;177;54;48;34;160;42;41;193;159;181;195;146;22;18;108;69;139,6207488086281023412,0.075694
greedy_intra:edges_start:random,168,74221,25158,49063,621991,446,80;79;122;63;94;124;152;97;26;100;121;180;135;70;154;158;53;86;1;101;75;2;120;44;25;78;31;16;171;175;113;196;81;40;90;27;39;165;185;179;145;92;129;57;55;52;106;49;178;14;144;102;62;9;148;137;186;23;89;183;143;170;0;117;93;108;18;193;41;159;22;146;181;5;42;160;34;54;177;10;184;43;116;65;35;112;127;123;149;162;133;151;51;109;118;59;115;139;46;176,5519712566990037066,0.068084
greedy_intra:edges_start:random,169,73074,24802,48272,566756,452,93;108;18;22;146;159;193;41;139;46;68;115;43;184;84;112;4;10;177;54;160;34;181;42;116;65;47;131;149;123;162;59;118;51;151;133;79;63;180;154;135;127;70;158;53;121;100;26;86;97;152;1;101;75;120;44;25;16;171;175;113;31;78;81;90;165;40;185;106;178;52;55;57;179;145;92;129;82;2;167;49;14;144;62;9;148;124;94;80;176;137;15;114;186;23;89;183;143;0;117,6639180998064047318,0.076719
greedy_intra:edges_start:random,170,72589,23490,49099,664628,475,102;144;14;138;165;27;90;81;196;40;119;185;179;145;78;31;56;113;175;171;16;25;44;120;129;92;57;55;52;106;178;3;49;167;148;124;94;121;100;26;97;1;152;2;75;101;86;53;154;70;135;180;63;79;133;80;176;51;151;162;127;123;149;131;43;116;65;59;118;115;42;160;184;10;177;54;48;34;22;18;108;159;193;41;139;198;46;68;117;0;143;183;89;23;137;186;114;15;9;62,7507957543443983870,0.077095
greedy_intra:edges_start:random,171,73880,23946,49934,639576,470,119;40;185;57;92;129;120;44;25;145;78;16;171;175;113;56;31;157;196;81;90;27;39;165;138;14;144;49;102;62;9;15;114;186;23;89;183;143;0;117;108;18;159;22;146;181;193;41;42;160;34;54;184;43;116;65;59;118;115;139;46;51;151;133;162;123;112;127;70;135;154;180;158;53;121;189;100;26;97;1;101;86;75;2;152;124;94;63;122;79;80;176;137;148;167;55;52;106;178;3,6877300778565766460,0.079975
greedy_intra:edges_start:random,172,73816,24496,49320,621874,485,59;118;51;80;176;137;148;124;94;100;26;97;1;101;86;75;2;152;167;49;52;106;178;55;179;57;92;129;82;120;44;25;16;171;175;113;56;31;78;145;196;185;40;119;165;39;90;27;164;7;21;14;144;62;9;15;186;89;183;143;117;108;18;22;146;34;160;54;177;184;84;4;112;35;43;42;159;193;41;139;46;115;116;65;149;123;127;70;135;154;180;158;53;121;63;122;79;133;151;162,1787192137534622433,0.079573
greedy_intra:edges_start:random,173,73691,23887,49804,582025,442,55;185;40;119;165;39;27;90;81;145;78;31;113;175;171;16;25;44;120;82;129;92;179;57;167;148;94;121;100;26;97;152;2;75;1;101;86;53;158;180;63;122;176;80;79;133;154;135;70;127;123;162;151;51;118;59;149;35;84;112;4;184;177;54;160;34;146;22;18;159;193;41;139;5;181;42;43;65;116;115;46;0;143;183;89;23;137;186;114;15;9;62;144;14;102;49;3;178;106;52,2931142488235446276,0.069636
greedy_intra:edges_start:random,174,74838,23791,51047,574164,466,86;75;101;1;120;44;25;16;171;175;56;113;31;78;145;157;196;81;40;119;8;165;39;90;27;164;7;21;138;3;49;102;14;144;62;9;148;167;55;52;178;106;185;179;57;92;129;2;152;97;26;94;122;79;133;162;151;80;176;137;23;186;89;183;143;117;0;46;68;139;115;41;193;159;22;146;34;181;42;160;184;43;116;65;59;118;51;149;131;123;127;70;135;154;158;180;63;53;121;100,2843567350106351542,0.072809
greedy_intra:edges_start:random,175,71157,22660,48497,957283,488,54;48;160;34;146;22;195;181;42;5;43;47;65;116;115;139;193;41;159;18;108;140;68;46;0;117;143;183;89;23;137;176;51;118;59;149;123;162;151;133;79;80;63;94;124;148;15;9;62;144;102;49;14;178;106;52;55;57;92;179;185;40;119;165;90;81;196;145;78;31;56;113;175;171;16;25;44;120;129;2;75;86;101;1;152;97;26;100;121;53;180;154;135;70;127;112;84;35;184;177,5185050269802725707,0.099593
greedy_intra:edges_start:random,176,74023,24599,49424,795898,495,160;34;181;42;5;43;116;65;149;59;118;115;46;139;41;193;159;22;18;108;140;93;68;117;143;0;153;183;89;23;186;114;15;9;62;102;49;3;178;106;52;55;167;148;144;14;138;185;40;165;90;81;196;57;92;145;78;113;175;171;16;44;120;129;2;75;101;1;86;121;100;26;97;152;94;124;137;51;176;80;79;63;53;158;180;154;135;70;127;133;151;162;123;4;112;84;35;184;177;54,4873813504483770199,0.081989
greedy_intra:edges_start:random,177,75621,25223,50398,564855,440,47;77;43;131;35;112;84;184;177;54;160;42;34;146;22;159;193;41;115;198;139;68;46;51;137;23;0;117;143;183;89;186;15;9;62;102;49;144;14;178;129;92;57;55;52;106;138;21;164;27;90;165;40;185;196;31;113;175;171;16;78;145;25;44;120;2;75;101;86;158;53;121;100;26;97;1;152;167;37;148;124;94;176;80;79;63;180;154;135;70;127;123;149;162;133;151;118;59;116;65,7086444983850991592,0.068003
greedy_intra:edges_start:random,178,72956,23287,49669,611288,430,23;137;176;51;118;151;133;80;79;63;121;189;94;124;167;148;9;62;144;102;49;14;138;3;178;106;52;55;185;40;165;27;90;81;31;113;175;171;16;78;145;92;57;129;25;44;120;2;75;86;101;1;152;97;26;100;53;158;180;154;135;70;194;162;127;123;149;131;35;84;112;4;10;177;54;48;34;160;184;43;116;65;59;5;42;181;146;22;18;159;193;41;139;115;46;0;117;143;183;89,145086269815341515,0.067632
greedy_intra:edges_start:random,179,72837,23818,49019,729094,501,101;26;97;152;1;75;2;120;44;25;129;92;55;57;179;145;78;31;16;171;175;113;56;85;157;196;81;90;27;165;119;40;185;52;106;178;14;49;102;144;62;9;148;124;94;15;186;137;23;89;183;143;0;117;68;139;41;193;159;18;22;146;181;42;160;34;48;54;177;10;190;184;84;4;112;123;149;131;43;65;116;115;46;118;59;51;176;80;151;162;133;79;63;180;154;135;70;158;53;86,4492307669236544406,0.084940
greedy_intra:edges_start:random,180,71621,22030,49591,527437,429,44;16;171;175;113;56;31;157;196;81;90;165;40;119;185;55;52;106;178;3;138;14;49;102;144;62;9;15;148;124;94;63;122;79;133;162;151;80;176;137;89;183;143;0;117;93;68;46;139;115;118;109;51;59;149;131;65;116;43;42;5;41;193;159;18;22;146;181;34;160;48;54;177;184;84;112;123;127;70;135;154;180;158;53;100;26;97;152;2;1;101;86;75;120;129;57;92;145;78;25,6435979023653403804,0.072253
greedy_intra:edges_start:random,181,72609,23653,48956,625111,452,102;49;3;178;106;52;55;57;129;120;44;25;78;92;179;145;31;16;171;175;113;56;196;81;90;119;40;185;165;138;14;144;62;137;23;89;183;143;0;117;93;108;18;22;146;103;34;181;42;41;193;139;46;115;43;116;65;131;149;59;118;51;176;80;122;79;133;151;162;123;35;184;160;48;54;177;10;4;112;127;70;135;154;180;63;121;53;100;26;97;1;101;86;75;2;152;94;124;148;9,7732143838875488909,0.081032
greedy_intra:edges_start:random,182,74265,24932,49333,567049,440,148;9;62;15;186;89;183;143;0;117;68;139;198;46;118;59;149;65;116;43;115;41;193;159;18;22;181;42;160;34;54;177;184;84;112;123;127;70;154;135;194;162;133;151;51;23;137;176;80;79;180;63;94;124;121;53;100;26;86;101;1;97;152;2;75;120;44;25;16;171;175;113;56;31;78;145;157;196;81;90;27;119;40;185;165;138;14;144;102;49;3;178;106;52;55;57;179;92;129;167,7068132959839621938,0.068508
greedy_intra:edges_start:random,183,75368,24988,50380,739274,504,151;72;51;80;79;133;176;137;183;89;23;186;15;9;62;144;49;14;138;165;39;27;90;81;196;157;145;179;40;185;106;3;178;52;55;57;129;92;78;38;31;56;113;175;171;16;25;44;120;82;2;75;101;1;97;152;167;148;124;94;63;86;53;180;154;135;127;112;184;43;42;160;54;34;181;159;146;22;18;108;193;41;139;68;140;93;117;143;0;46;115;118;59;116;65;47;131;149;123;162,6688997472731232472,0.081282
greedy_intra:edges_start:random,184,73384,24460,48924,613735,454,10;177;34;146;22;181;160;184;43;42;41;193;159;18;139;115;46;68;93;117;0;143;183;89;23;137;186;114;15;148;94;124;26;97;1;101;2;152;167;49;9;62;144;14;178;106;52;185;40;119;165;90;81;196;31;56;113;175;171;16;25;78;145;179;55;57;92;129;82;44;120;75;86;100;53;158;180;154;135;70;127;194;162;151;133;79;63;80;176;51;118;59;116;65;131;149;123;112;4;190,2707825830022860893,0.077977
greedy_intra:edges_start:random,185,74181,25206,48975,606482,444,118;109;51;59;65;116;43;115;139;41;42;160;48;177;54;34;181;195;146;22;159;193;18;69;108;68;46;0;93;117;143;183;89;23;137;186;15;148;9;62;144;102;49;14;165;90;81;40;185;145;78;31;113;175;171;16;44;25;120;2;129;92;57;55;52;106;178;167;124;94;152;1;101;75;86;26;97;100;121;53;158;63;180;154;135;70;127;112;84;184;131;149;123;162;151;133;79;122;80;176,2627768497335347218,0.068580
greedy_intra:edges_start:random,186,74671,24290,50381,696369,451,184;84;112;4;10;177;54;48;34;146;22;193;41;139;46;0;117;143;183;89;23;137;186;114;15;9;62;102;144;14;138;165;185;40;90;81;157;31;56;113;175;171;16;25;78;145;196;179;52;55;57;92;129;82;44;120;2;75;1;97;26;101;86;158;154;180;53;121;100;189;152;167;106;178;49;148;124;94;63;122;80;176;51;118;59;162;151;133;79;135;70;127;123;149;65;116;115;43;42;160,7529041108487270202,0.080714
greedy_intra:edges_start:random,187,73051,23591,49460,659391,471,92;78;145;179;185;40;165;27;90;81;196;157;31;56;113;175;171;16;25;44;120;82;129;2;75;101;86;26;100;97;1;152;124;94;121;136;53;158;154;180;63;79;133;151;80;176;137;51;59;162;135;70;127;123;112;4;177;54;34;160;184;43;65;116;42;181;41;139;46;115;193;159;22;18;69;108;93;117;0;143;183;89;23;186;114;15;148;167;37;9;62;144;102;14;49;178;106;52;55;57,7787987426189662706,0.076330
greedy_intra:edges_start:random,188,73175,23267,49908,771113,527,137;186;114;15;9;37;148;167;124;94;80;176;51;118;59;162;151;133;79;122;63;121;100;26;101;1;97;152;2;82;129;92;78;145;91;179;57;55;52;106;178;49;102;62;144;14;138;185;40;119;165;39;27;90;81;196;31;113;175;171;16;25;44;120;75;86;53;180;154;135;70;127;123;112;4;10;177;54;184;160;34;22;181;42;43;65;116;115;139;41;193;159;18;108;117;0;143;183;89;23,7266697350227559352,0.084667
greedy_intra:edges_start:random,189,73276,23746,49530,625029,502,113;56;31;157;78;145;179;196;81;90;27;165;119;40;185;57;92;129;55;52;106;178;3;138;14;49;102;144;9;62;148;124;94;63;180;79;122;80;133;151;51;176;137;23;186;89;183;143;0;117;108;18;22;159;193;41;139;68;46;198;115;116;43;184;42;181;34;160;48;54;177;112;149;65;59;162;123;127;70;135;154;158;53;121;100;26;97;1;152;2;101;86;75;120;82;44;25;16;171;175,5170309795550283686,0.072443
greedy_intra:edges_start:random,190,72998,24047,48951,682555,467,84;4;112;127;70;135;154;180;123;149;131;65;116;43;42;5;115;59;162;133;151;51;176;80;79;122;63;94;124;121;53;100;26;86;75;101;1;97;152;2;129;92;82;120;44;25;16;171;175;113;31;56;78;145;179;157;196;81;90;165;40;185;57;55;52;106;178;49;14;144;102;62;9;148;15;137;23;114;186;89;183;143;0;46;68;108;18;139;41;193;159;22;146;34;160;184;54;177;10;190,8611657538987211494,0.073554
greedy_intra:edges_start:random,191,75897,26712,49185,534263,458,152;2;129;57;55;52;179;40;119;185;106;178;14;49;94;124;176;80;63;180;154;79;133;151;162;70;135;127;123;112;84;184;131;149;47;65;116;59;118;46;115;96;5;43;42;181;160;48;54;177;190;10;30;34;146;22;195;159;193;41;139;18;108;117;143;183;89;23;137;148;9;62;144;21;164;27;90;165;81;196;145;157;31;113;175;171;16;78;92;25;44;120;75;101;100;53;86;26;97;1,5305502528123424796,0.082649
greedy_intra:edges_start:random,192,73721,23730,49991,565691,454,62;9;148;94;122;79;63;133;162;123;35;184;48;160;42;5;115;43;77;131;149;47;65;116;59;118;51;72;151;80;176;137;23;89;183;143;117;93;108;18;69;68;0;46;139;41;193;159;22;146;181;34;54;177;4;112;127;70;135;154;180;53;121;100;26;97;86;75;101;1;152;2;82;120;44;25;16;171;175;113;56;31;145;78;179;129;92;57;55;52;185;40;90;165;106;178;14;49;102;144,6067610001518421310,0.079057
greedy_intra:edges_start:random,193,73780,25209,48571,580164,472,131;47;65;43;116;59;118;51;80;176;137;148;167;55;52;185;40;81;90;165;106;178;3;138;14;49;144;62;9;186;89;183;46;115;139;68;0;143;117;93;108;18;159;22;146;34;160;181;193;41;5;42;184;48;54;177;10;190;4;112;123;127;70;135;180;154;53;86;75;120;44;25;78;16;171;175;113;31;196;145;92;57;129;2;152;97;1;101;26;100;121;189;124;94;63;79;133;151;162;149,6761226278196600379,0.070292
greedy_intra:edges_start:random,194,74062,23920,50142,692397,492,118;51;176;137;94;189;124;148;9;62;144;14;49;3;178;52;106;55;57;145;179;185;40;165;27;90;81;196;31;56;113;175;171;16;78;25;44;120;92;129;2;152;1;101;75;86;97;26;100;121;53;158;180;136;182;63;122;79;80;151;133;154;135;70;127;123;162;149;131;65;116;43;5;42;160;184;177;54;34;181;41;193;159;22;18;69;108;140;93;117;143;183;89;23;0;68;46;139;115;59,271165091615798563,0.078225
greedy_intra:edges_start:random,195,74022,23619,50403,697568,504,68;46;0;89;183;143;117;93;108;18;22;159;193;41;181;34;160;54;177;184;4;112;84;35;131;149;123;135;154;162;151;133;79;63;180;158;53;121;94;97;26;86;101;1;152;2;75;120;44;25;16;171;175;113;56;31;78;145;92;129;57;179;196;81;90;27;165;119;40;185;55;52;106;178;3;14;144;102;49;167;148;37;9;62;15;137;176;80;51;118;59;65;116;105;47;77;43;42;115;139,2123743937551877724,0.080372
greedy_intra:edges_start:random,196,73256,24647,48609,707649,501,72;151;133;162;123;127;112;4;84;35;131;149;43;116;65;59;118;115;139;41;193;159;42;160;184;10;177;54;48;34;181;146;22;18;68;46;0;117;143;183;89;186;15;9;62;102;144;14;49;3;178;106;52;185;40;165;90;81;196;179;145;78;31;113;175;171;16;25;44;120;129;92;57;55;2;75;86;101;1;97;152;167;148;124;94;63;121;26;100;53;158;70;135;154;180;79;80;176;137;51,3443601799613061258,0.089655
greedy_intra:edges_start:random,197,73012,23475,49537,702043,466,51;118;59;72;151;162;133;80;79;180;63;94;124;167;148;186;114;15;9;62;144;102;49;14;138;3;178;106;185;40;165;27;90;81;196;179;52;55;57;92;145;31;113;175;171;16;78;25;44;120;82;129;2;75;86;101;152;1;97;26;53;158;154;135;70;127;123;149;131;47;65;116;43;42;184;177;54;160;34;181;146;22;18;108;159;193;41;115;139;68;46;0;117;143;153;183;89;23;137;176,6213914655495794185,0.076324
greedy_intra:edges_start:random,198,74438,25268,49170,701514,474,160;34;22;18;159;181;42;43;149;65;116;5;41;193;139;68;140;93;117;143;183;89;23;186;15;114;9;62;144;102;49;14;165;119;40;90;81;196;185;106;178;52;55;57;129;92;179;145;78;31;56;113;175;171;16;25;44;120;82;2;75;86;101;1;97;26;100;189;121;53;154;180;133;151;51;176;80;79;63;94;152;167;148;137;0;46;115;118;59;162;194;135;70;127;123;112;177;54;48;184,6553440811510197278,0.087653
greedy_intra:edges_start:random,199,74222,24053,50169,741888,482,86;100;26;101;1;97;152;94;122;79;63;53;158;180;154;70;135;194;133;80;176;137;51;118;59;151;162;123;127;112;4;84;190;10;177;54;34;22;159;193;41;42;181;160;184;35;131;149;47;65;116;43;115;139;18;68;46;0;143;183;89;23;186;15;148;167;37;9;62;144;14;138;102;49;3;178;106;165;90;40;185;52;55;57;129;92;78;145;196;31;56;113;175;171;16;25;44;120;2;75,2490115191069371323,0.081351
greedy_intra:edges_start:greedy,0,70810,22605,48205,76729,7,0;117;143;183;89;186;23;137;176;80;79;63;94;124;152;97;1;101;2;129;92;57;55;52;49;102;148;9;62;144;14;3;178;106;185;165;40;90;81;196;179;145;78;31;56;113;175;171;16;25;44;82;120;75;86;26;100;121;53;180;154;135;70;127;123;162;133;151;51;118;59;65;116;43;184;84;112;4;190;10;177;54;48;160;34;146;22;18;108;69;159;181;42;5;41;193;115;139;68;46,5651509756862566603,0.003847
greedy_intra:edges_start:greedy,1,71633,23444,48189,49964,4,1;101;75;86;53;154;70;135;180;63;79;133;162;127;123;149;65;116;43;184;10;177;54;48;160;34;146;22;18;108;69;159;181;42;5;41;193;139;68;140;93;117;143;0;46;115;59;118;51;151;80;176;137;23;183;89;186;114;15;9;62;144;14;138;165;185;40;90;81;196;179;145;78;31;56;113;175;171;16;25;44;120;2;129;92;57;55;52;106;178;49;102;148;124;94;121;100;26;97;152,1515800410562517023,0.002170
greedy_intra:edges_start:greedy,2,71405,23265,48140,46547,5,2;129;92;57;55;52;49;102;148;9;62;144;14;3;178;106;185;40;165;90;81;196;179;145;78;31;56;113;175;171;16;25;44;120;75;86;53;180;154;135;70;127;123;162;149;131;65;116;43;184;84;190;10;177;54;48;160;34;146;22;18;108;69;159;181;42;5;41;193;139;68;140;93;117;143;183;89;186;23;137;0;46;115;59;118;51;151;133;176;80;79;63;94;124;26;100;101;1;97;152,6809201901139748827,0.002970
greedy_intra:edges_start:greedy,3,71301,23107,48194,64541,7,138;14;144;62;9;148;102;49;178;106;52;55;57;92;129;2;152;97;1;101;26;100;121;94;63;79;80;176;133;151;51;118;59;115;46;0;137;23;186;89;183;143;117;93;140;68;139;193;41;5;42;181;159;69;108;18;22;146;34;160;48;54;177;10;190;84;184;43;116;65;131;149;162;123;127;70;135;154;180;53;86;75;120;44;25;16;171;175;113;56;31;78;145;179;196;81;90;40;185;165,3692259477842126542,0.002360
greedy_intra:edges_start:greedy,4,71516,23339,48177,96743,8,4;190;10;177;54;48;34;160;181;42;146;22;18;108;69;159;193;41;139;68;46;115;118;59;65;116;43;184;35;131;149;123;162;133;151;51;0;117;143;183;89;23;137;176;80;79;63;94;124;152;97;1;101;2;82;129;92;57;55;52;49;102;148;9;62;144;14;3;178;106;185;40;165;90;81;196;179;145;78;31;56;113;175;171;16;25;44;120;75;86;26;100;121;53;180;154;135;70;127;112,5844111623154886429,0.004072
greedy_intra:edges_start:greedy,5,71287,23164,48123,75930,7,5;43;116;65;149;123;127;162;151;133;135;70;154;180;53;121;100;26;86;75;82;120;44;25;16;171;175;113;56;31;78;145;179;196;81;90;165;40;185;106;178;3;14;144;62;9;148;102;49;52;55;57;92;129;2;101;1;97;152;124;94;63;79;80;176;137;23;186;89;183;143;117;0;51;118;59;115;46;68;139;41;193;159;69;108;18;22;146;181;34;160;48;54;177;10;4;112;84;184;42,3174319619903084337,0.003449
greedy_intra:edges_start:greedy,6,71505,22935,48570,93764,10,158;70;135;154;180;63;79;80;133;151;162;127;123;149;65;116;43;184;177;54;48;160;34;146;22;18;108;69;159;181;42;5;41;193;139;68;140;93;117;143;0;46;115;59;118;51;176;137;23;183;89;186;114;15;9;62;144;14;138;165;185;40;90;81;196;179;145;78;31;56;113;175;171;16;25;44;120;2;129;92;57;55;52;106;178;49;102;148;124;94;152;97;1;101;75;86;26;100;121;53,1803447023763547524,0.004973
greedy_intra:edges_start:greedy,7,72063,24098,47965,51086,6,7;21;144;62;9;148;102;14;49;178;106;52;55;185;165;40;179;145;78;92;57;129;2;152;124;94;63;79;80;176;133;151;51;118;59;115;46;0;137;23;89;183;143;117;93;140;68;139;193;41;5;42;181;159;69;108;18;22;146;34;160;48;54;177;184;43;116;65;149;162;123;127;70;135;154;180;53;100;26;97;1;101;86;75;120;44;25;16;171;175;113;56;31;157;196;81;90;27;95;164,1006959202157939175,0.002001
greedy_intra:edges_start:greedy,8,71353,23248,48105,51470,6,27;165;40;185;138;14;144;62;9;148;102;49;178;106;52;55;57;92;129;2;152;97;1;101;26;124;94;63;79;80;176;133;151;51;118;59;115;46;0;137;23;186;89;183;143;117;93;140;68;139;193;41;5;42;181;159;69;108;18;22;146;34;160;48;54;177;10;190;184;43;116;65;131;149;162;123;127;70;135;154;180;53;100;86;75;120;44;25;16;171;175;113;56;31;78;145;179;196;81;90,8966702131314314451,0.003002
greedy_intra:edges_start:greedy,9,71369,23307,48062,45101,4,9;148;102;49;178;106;52;55;57;92;129;2;152;97;1;101;26;124;94;63;79;80;176;133;151;51;118;59;115;46;0;137;23;186;89;183;143;117;93;140;68;139;193;41;5;42;181;159;69;108;18;22;146;34;160;48;54;177;10;190;84;184;43;116;65;131;149;162;123;127;70;135;154;180;53;100;86;75;120;44;25;16;171;175;113;56;31;78;145;179;196;81;90;40;185;165;138;14;144;62,6357924195146619610,0.003665
greedy_intra:edges_start:greedy,10,71502,23325,48177,87338,8,10;190;4;112;127;70;135;154;180;53;121;100;26;86;75;44;25;16;171;175;113;56;31;78;145;179;196;81;90;165;40;185;106;178;3;14;144;62;9;148;102;49;52;55;57;92;129;82;120;2;101;1;97;152;124;94;63;79;80;176;137;23;89;183;143;117;0;51;151;133;162;123;149;131;35;184;43;116;65;59;118;115;46;68;139;41;193;159;69;108;18;22;146;181;42;34;160;48;54;177,1195047404687260389,0.004000
greedy_intra:edges_start:greedy,11,70961,22756,48205,113713,11,190;10;177;54;48;160;34;181;146;22;18;108;69;159;193;41;5;42;43;116;65;118;51;59;115;139;68;46;0;117;143;183;89;186;23;137;176;80;79;63;94;124;152;97;1;101;2;120;82;129;92;57;55;52;49;102;148;9;62;144;14;3;178;106;185;40;165;90;81;196;179;145;78;31;56;113;175;171;16;25;44;75;86;26;100;121;53;180;154;70;135;133;151;162;123;127;112;4;84;184,5155057536643881720,0.005015
greedy_intra:edges_start:greedy,12,72239,23272,48967,52351,4,124;94;152;97;1;101;2;82;129;57;92;179;145;78;31;56;113;175;171;16;25;44;120;75;86;26;100;121;53;158;154;70;135;180;63;79;133;162;123;149;65;116;43;184;177;54;48;160;34;146;22;18;108;69;159;181;42;5;41;193;139;68;140;93;117;143;0;46;115;59;118;51;151;80;176;137;23;183;89;186;114;15;9;62;144;14;138;165;90;81;196;40;185;55;52;106;178;49;102;148,9219605886799692292,0.002001
greedy_intra:edges_start:greedy,13,71876,23561,48315,62181,7,157;31;56;113;175;171;16;25;44;120;75;86;100;53;180;154;135;70;127;123;162;149;131;65;116;43;184;190;10;177;54;48;160;34;146;22;18;108;69;159;181;42;5;41;193;139;68;140;93;117;143;183;89;186;23;137;0;46;115;59;118;51;151;133;176;80;79;63;94;124;26;101;1;97;152;2;129;57;55;52;49;102;148;9;62;144;14;3;178;106;185;40;165;90;81;196;179;92;145;78,3360095887983801549,0.002002
greedy_intra:edges_start:greedy,14,71314,23252,48062,36590,3,14;144;62;9;148;102;49;178;106;52;55;57;92;129;2;152;97;1;101;26;124;94;63;79;80;176;133;151;51;118;59;115;46;0;137;23;186;89;183;143;117;93;140;68;139;193;41;5;42;181;159;69;108;18;22;146;34;160;48;54;177;10;190;84;184;43;116;65;131;149;162;123;127;70;135;154;180;53;100;86;75;120;44;25;16;171;175;113;56;31;78;145;179;196;81;90;165;40;185;138,4659900927600542266,0.002001
greedy_intra:edges_start:greedy,15,71534,23512,48022,20879,2,15;144;14;138;165;40;185;90;81;196;179;145;78;31;56;113;175;171;16;25;44;120;75;86;26;124;94;63;79;80;176;133;151;51;118;59;115;46;0;137;23;186;89;183;143;117;93;140;68;139;193;41;5;42;181;159;69;108;18;22;146;34;160;48;54;177;10;190;184;43;116;65;131;149;162;123;127;70;135;154;180;53;100;101;1;97;152;2;129;92;57;55;52;106;178;49;102;62;9;148,1887908774921710775,0.000980
greedy_intra:edges_start:greedy,16,71465,23325,48140,71606,7,16;25;44;120;75;86;101;1;97;26;100;53;180;154;135;70;127;123;162;149;131;65;116;43;184;84;190;10;177;54;48;160;34;146;22;18;108;69;159;181;42;5;41;193;139;68;140;93;117;143;183;89;186;23;137;0;46;115;59;118;51;151;133;176;80;79;63;94;124;152;2;129;57;55;52;49;102;148;9;62;144;14;3;178;106;185;40;165;90;81;196;179;92;78;145;31;56;113;175;171,2168598659402030975,0.002973
greedy_intra:edges_start:greedy,17,72949,24119,48830,71800,10,119;40;196;157;31;56;113;175;171;16;25;44;120;75;101;1;97;26;86;53;180;154;135;70;127;123;162;149;65;116;43;184;177;54;48;160;34;146;22;18;108;159;181;42;41;193;139;68;140;93;117;143;183;89;23;137;0;46;115;59;118;51;151;133;176;80;79;63;94;152;2;82;78;145;179;92;129;57;55;52;49;102;148;9;62;144;14;3;178;106;185;165;39;95;7;164;58;27;90;81,6710266450844862528,0.003001
greedy_intra:edges_start:greedy,18,71455,23205,48250,90252,9,18;22;146;159;193;41;5;42;181;34;160;48;54;177;10;4;112;84;184;43;116;65;149;123;127;162;151;133;135;70;154;180;53;121;100;26;86;75;120;82;44;25;16;171;175;113;56;31;78;145;179;196;81;90;165;40;185;106;178;3;14;144;62;9;148;102;49;52;55;57;92;129;2;101;1;97;152;124;94;63;79;80;176;137;51;118;59;115;139;68;46;0;89;183;143;117;93;140;108;69,3063450401089109967,0.004000
greedy_intra:edges_start:greedy,19,71608,22548,49060,48217,4,189;94;124;148;102;49;178;106;52;55;57;92;129;2;120;44;25;16;171;175;113;56;31;78;145;179;196;81;90;165;40;185;138;14;144;62;9;15;114;186;89;183;23;137;176;80;51;118;59;115;46;0;143;117;93;140;68;139;193;41;5;42;181;159;69;108;18;22;146;34;160;48;54;177;184;43;116;65;149;123;162;151;133;79;63;180;135;70;154;158;53;121;100;26;86;75;101;1;97;152,5630510283033893782,0.001000
greedy_intra:edges_start:greedy,20,71904,22926,48978,49625,5,199;22;146;159;193;41;5;42;181;34;160;48;54;177;10;190;84;184;43;116;65;149;123;127;162;151;133;135;70;154;180;53;121;100;26;86;75;44;25;16;171;175;113;56;31;78;145;179;196;81;90;165;40;185;106;178;3;14;144;62;9;148;102;49;52;55;57;92;129;82;120;2;101;1;97;152;124;94;63;79;80;176;137;51;118;59;115;139;68;46;0;89;183;143;117;93;140;108;69;18,6381644430676697140,0.002002
greedy_intra:edges_start:greedy,21,71742,23837,47905,62916,7,21;14;138;165;185;40;90;81;196;179;145;78;31;56;113;175;171;16;25;44;120;75;86;101;1;26;100;53;180;154;135;70;127;123;162;149;131;65;116;43;184;190;10;177;54;48;160;34;146;22;18;108;69;159;181;42;5;41;193;139;68;140;93;117;143;183;89;186;23;137;0;46;115;59;118;51;151;133;176;80;79;63;94;124;97;152;2;129;92;57;55;52;106;178;49;102;148;9;62;144,3174553974700635944,0.001972
greedy_intra:edges_start:greedy,22,70998,23025,47973,69241,6,22;146;181;34;160;48;54;177;10;190;4;112;84;184;42;43;116;65;149;123;127;162;151;133;135;70;154;180;53;121;100;26;86;75;120;82;44;25;16;171;175;113;56;31;78;145;179;196;81;90;165;40;185;106;178;3;14;144;62;9;148;102;49;52;55;57;92;129;2;101;1;97;152;124;94;63;79;80;176;137;23;186;89;183;143;117;0;51;118;59;115;46;68;139;41;193;159;69;108;18,7403047738458674672,0.002969
greedy_intra:edges_start:greedy,23,70663,22458,48205,97000,8,23;137;176;80;79;63;94;124;152;97;1;101;2;129;92;57;55;52;49;102;148;9;62;144;14;3;178;106;185;40;165;90;81;196;179;145;78;31;56;113;175;171;16;25;44;82;120;75;86;26;100;121;53;180;154;135;70;127;123;162;133;151;51;118;59;65;116;43;184;84;112;4;190;10;177;54;48;160;34;146;22;18;108;69;159;181;42;5;41;193;115;139;68;46;0;117;143;183;89;186,5595518436472945419,0.003767
greedy_intra:edges_start:greedy,24,71826,23264,48562,58224,5,131;149;123;127;162;151;133;135;70;154;180;53;121;100;26;86;75;82;129;57;92;55;52;49;102;148;9;62;144;14;3;178;106;185;40;165;90;81;196;179;145;78;31;56;113;175;171;16;25;44;120;2;101;1;97;152;124;94;63;79;80;176;137;23;186;89;183;143;117;0;51;118;59;115;46;68;139;193;41;5;42;181;159;69;108;18;22;146;34;160;48;54;177;10;190;84;184;43;116;65,5060438777466341693,0.002000
greedy_intra:edges_start:greedy,25,71358,23218,48140,93592,9,25;44;120;75;86;101;1;26;100;53;180;154;135;70;127;123;162;149;131;65;116;43;184;84;190;10;177;54;48;160;34;146;22;18;108;69;159;181;42;5;41;193;139;68;140;93;117;143;183;89;186;23;137;0;46;115;59;118;51;151;133;176;80;79;63;94;124;97;152;2;129;92;57;55;52;49;102;148;9;62;144;14;3;178;106;185;40;165;90;81;196;179;145;78;31;56;113;175;171;16,8941114154617645508,0.004000
greedy_intra:edges_start:greedy,26,71291,23265,48026,46111,3,26;97;152;94;124;148;102;49;178;106;52;55;57;92;129;2;120;44;25;16;171;175;113;56;31;78;145;179;196;81;90;40;185;165;138;14;144;62;9;15;114;186;89;183;23;137;176;80;51;118;59;115;46;0;143;117;93;140;68;139;193;41;5;42;181;159;69;108;18;22;146;34;160;48;54;177;10;190;184;43;116;65;149;123;127;162;151;133;79;63;180;135;70;154;53;86;75;101;1;100,3859721160552491418,0.002000
greedy_intra:edges_start:greedy,27,72157,23629,48528,16075,1,27;58;164;7;95;39;165;138;14;144;62;9;148;102;49;178;106;52;55;57;92;129;2;152;97;1;101;100;53;180;154;135;70;127;123;162;149;65;116;43;184;177;54;48;160;34;146;22;18;108;69;159;181;42;5;41;193;139;68;140;93;117;143;183;89;23;137;0;46;115;59;118;51;151;133;176;80;79;63;94;26;86;75;120;44;25;16;171;175;113;56;31;78;145;179;196;81;185;40;90,1513767579389923055,0.002432
greedy_intra:edges_start:greedy,28,71787,23180,48607,67147,6,35;43;65;116;131;149;123;127;162;151;133;135;70;154;180;53;121;100;26;86;75;120;44;25;16;171;175;113;56;31;78;145;179;196;81;90;165;40;185;106;178;3;14;144;62;9;148;102;49;52;55;57;92;129;82;2;101;1;97;152;124;94;63;79;80;176;137;23;186;89;183;143;117;0;51;59;118;115;46;68;139;193;41;5;42;181;159;69;108;18;22;146;34;160;48;54;177;10;190;184,514574327989724925,0.003029
greedy_intra:edges_start:greedy,29,71061,22454,48607,107200,11,149;123;162;151;133;135;70;154;180;53;121;100;26;86;75;120;44;25;16;171;175;113;56;31;78;145;179;196;81;90;165;40;185;106;178;3;14;144;62;9;148;102;49;52;55;57;92;129;82;2;101;1;97;152;124;94;63;79;80;176;137;23;186;89;183;143;117;0;46;68;139;115;118;51;59;65;116;43;42;5;41;193;159;69;108;18;22;146;181;34;160;48;54;177;184;35;84;4;112;131,3914617389471757179,0.004760
greedy_intra:edges_start:greedy,30,71604,23040,48564,93687,10,48;54;177;10;190;84;184;43;116;65;59;118;115;46;0;51;151;133;162;123;127;70;135;154;180;53;121;100;26;86;75;120;82;44;25;16;171;175;113;56;31;78;145;179;196;81;90;165;40;185;106;178;3;14;144;62;9;148;102;49;52;55;57;92;129;2;101;1;97;152;124;94;63;79;80;176;137;23;186;89;183;143;117;93;140;68;139;41;193;159;69;108;18;22;146;195;181;42;160;34,594627567542120997,0.003695
greedy_intra:edges_start:greedy,31,71763,23623,48140,37595,4,31;145;78;92;179;196;81;90;165;40;185;106;178;3;14;144;62;9;148;102;49;52;55;57;129;2;152;97;1;101;26;124;94;63;79;80;176;133;151;51;118;59;115;46;0;137;23;186;89;183;143;117;93;140;68;139;193;41;5;42;181;159;69;108;18;22;146;34;160;48;54;177;10;190;84;184;43;116;65;131;149;162;123;127;70;135;154;180;53;100;86;75;120;44;25;16;171;175;113;56,2292793795041301771,0.001000
greedy_intra:edges_start:greedy,32,71121,23059,48062,85641,9,138;14;144;62;9;148;102;49;178;106;52;55;57;92;129;2;152;124;94;63;79;80;176;133;151;51;118;59;115;46;0;137;23;186;89;183;143;117;93;140;68;139;193;41;5;42;181;159;69;108;18;22;146;34;160;48;54;177;10;190;84;184;43;116;65;131;149;162;123;127;70;135;154;180;53;100;26;86;97;1;101;75;120;44;25;16;171;175;113;56;31;78;145;179;196;81;90;165;40;185,193694737233356107,0.003000
greedy_intra:edges_start:greedy,33,71402,22870,48532,59663,7,37;102;49;178;106;52;55;57;92;129;2;152;97;1;101;26;100;121;94;63;79;80;176;133;151;51;118;59;115;46;0;137;23;186;89;183;143;117;93;140;68;139;193;41;5;42;181;159;69;108;18;22;146;34;160;48;54;177;10;190;184;43;116;65;131;149;162;123;127;70;135;154;180;53;86;75;120;44;25;16;171;175;113;56;31;78;145;179;196;81;90;165;40;185;138;14;144;62;9;148,8440751473302495785,0.003509
greedy_intra:edges_start:greedy,34,71199,23226,47973,55726,5,34;181;146;22;18;108;69;159;193;41;139;68;46;115;59;118;51;0;117;143;183;89;186;23;137;176;80;79;63;94;124;152;97;1;101;2;129;57;92;55;52;49;102;148;9;62;144;14;3;178;106;185;40;165;90;81;196;179;145;78;31;56;113;175;171;16;25;44;82;120;75;86;26;100;121;53;180;154;70;135;133;151;162;127;123;149;65;116;43;42;184;84;112;4;190;10;177;54;48;160,1980228645745728905,0.002637
greedy_intra:edges_start:greedy,35,71245,22995,48250,80971,8,35;84;4;112;127;123;162;151;133;135;70;154;180;53;121;100;26;86;75;120;44;25;16;171;175;113;56;31;78;145;179;196;81;90;165;40;185;106;178;3;14;144;62;9;148;102;49;52;55;57;92;129;82;2;101;1;97;152;124;94;63;79;80;176;137;23;186;89;183;143;117;0;51;59;118;46;68;139;115;65;116;43;42;5;41;193;159;69;108;18;22;146;181;34;160;48;54;177;10;184,8070478275417082684,0.004005
greedy_intra:edges_start:greedy,36,72068,22900,49168,48165,4,36;108;69;18;22;146;159;193;41;5;42;181;34;160;48;54;177;10;190;84;184;43;116;65;149;123;127;162;151;133;135;70;154;180;53;121;100;26;86;75;44;25;16;171;175;113;56;31;78;145;179;196;81;90;165;40;185;106;178;3;14;144;62;9;148;102;49;52;55;57;92;129;82;120;2;101;1;97;152;124;94;63;79;80;176;137;51;118;59;115;139;68;46;0;89;183;143;117;93;140,3632290740846335662,0.001982
greedy_intra:edges_start:greedy,37,71587,23187,48400,39531,3,37;102;49;178;106;52;55;57;92;129;2;152;97;1;101;26;124;94;63;79;80;176;133;151;51;118;59;115;46;0;137;23;186;89;183;143;117;93;140;68;139;193;41;5;42;181;159;69;108;18;22;146;34;160;48;54;177;10;190;184;43;116;65;131;149;162;123;127;70;135;154;180;53;100;86;75;120;44;25;16;171;175;113;56;31;78;145;179;196;81;90;185;40;165;138;14;144;62;9;148,498881741644837509,0.000996
greedy_intra:edges_start:greedy,38,71831,23516,48315,54380,7,157;78;145;92;179;196;81;90;165;40;185;106;178;3;14;144;62;9;148;102;49;52;55;57;129;2;152;97;1;101;100;26;124;94;63;79;80;176;133;151;51;118;59;115;46;0;137;23;186;89;183;143;117;93;140;68;139;193;41;5;42;181;159;69;108;18;22;146;34;160;48;54;177;10;190;184;43;116;65;131;149;162;123;127;70;135;154;180;53;86;75;120;44;25;16;171;175;113;56;31,7328058308160329949,0.002396
greedy_intra:edges_start:greedy,39,71757,23551,48206,54150,4,39;95;7;164;27;90;40;185;81;196;179;145;78;31;56;113;175;171;16;25;44;120;75;101;1;97;26;100;86;53;180;154;135;70;127;123;162;149;65;116;43;184;177;54;48;160;34;146;22;18;108;69;159;181;42;5;41;193;139;68;140;93;117;143;183;89;23;137;0;46;115;59;118;51;151;133;176;80;79;63;94;124;152;2;129;92;57;55;52;106;178;49;102;148;9;62;144;14;138;165,2452087913749415557,0.001996
greedy_intra:edges_start:greedy,40,71455,23393,48062,26287,2,40;165;138;14;144;62;9;148;102;49;178;106;52;55;57;92;129;2;152;97;1;101;100;53;180;154;135;70;127;123;162;149;131;65;116;43;184;84;190;10;177;54;48;160;34;146;22;18;108;69;159;181;42;5;41;193;139;68;140;93;117;143;183;89;186;23;137;0;46;115;59;118;51;151;133;176;80;79;63;94;124;26;86;75;120;44;25;16;171;175;113;56;31;78;145;179;196;81;90;185,8517706160209965449,0.000987
greedy_intra:edges_start:greedy,41,71369,23246,48123,55770,6,41;5;42;181;159;69;108;18;22;146;34;160;48;54;177;10;190;4;112;184;43;116;65;149;123;127;162;151;133;135;70;154;180;53;121;100;26;86;75;120;44;25;16;171;175;113;56;31;78;145;179;196;81;90;165;40;185;106;178;3;14;144;62;9;148;102;49;52;55;57;92;129;82;2;101;1;97;152;124;94;63;79;80;176;137;23;186;89;183;143;117;0;51;118;59;115;46;68;139;193,7288313790307564396,0.003216
greedy_intra:edges_start:greedy,42,71477,23354,48123,74979,7,42;5;41;193;139;68;46;115;59;118;51;0;117;143;183;89;186;23;137;176;80;79;63;94;124;152;97;1;101;2;129;92;57;55;52;49;102;148;9;62;144;14;3;178;106;185;40;165;90;81;196;179;145;78;31;56;113;175;171;16;25;44;120;82;75;86;26;100;121;53;180;154;70;135;133;151;162;127;123;149;65;116;43;184;84;112;4;10;177;54;48;160;34;146;22;18;108;69;159;181,9115675441394724428,0.004381
greedy_intra:edges_start:greedy,43,71548,23048,48500,80479,6,43;116;65;59;118;115;46;0;51;151;133;162;123;127;70;135;154;180;53;121;100;26;86;75;120;44;25;16;171;175;113;56;31;78;145;179;196;81;90;165;40;185;106;178;3;14;144;62;9;148;102;49;52;55;57;92;129;82;2;101;1;97;152;124;94;63;79;80;176;137;23;186;89;183;143;117;93;140;68;139;193;41;5;42;181;159;69;108;18;22;146;34;160;48;54;177;10;190;84;184,6268060878715042309,0.001999
greedy_intra:edges_start:greedy,44,71258,23118,48140,61782,6,44;25;16;171;175;113;56;31;78;145;179;196;81;90;165;40;185;106;178;3;14;144;62;9;148;102;49;52;55;57;92;129;2;101;1;97;152;124;94;63;79;80;176;133;151;51;118;59;115;46;0;137;23;186;89;183;143;117;93;140;68;139;193;41;5;42;181;159;69;108;18;22;146;34;160;48;54;177;10;190;84;184;43;116;65;131;149;162;123;127;70;135;154;180;53;100;26;86;75;120,3014151869021539000,0.003000
greedy_intra:edges_start:greedy,45,72257,23429,48828,61558,6,72;162;127;123;149;65;116;43;184;84;190;10;177;54;48;160;34;146;22;18;108;69;159;181;42;5;41;193;139;68;46;115;59;118;51;0;117;143;183;89;186;23;137;176;80;79;63;94;124;152;97;1;101;2;82;129;57;92;55;52;49;102;148;9;62;144;14;3;178;106;185;40;165;90;81;196;179;145;78;31;56;113;175;171;16;25;44;120;75;86;26;100;121;53;180;154;70;135;133;151,4173391487641245115,0.002728
greedy_intra:edges_start:greedy,46,71833,23710,48123,25514,2,46;115;59;118;51;0;117;143;183;89;186;23;137;176;80;79;63;94;124;152;97;1;101;2;120;82;129;57;92;55;52;49;102;148;9;62;144;14;3;178;106;185;165;40;90;81;196;179;145;78;31;56;113;175;171;16;25;44;75;86;26;100;121;53;180;154;70;135;133;151;162;127;123;149;65;116;43;184;112;4;190;10;177;54;48;160;34;146;22;18;108;69;159;181;42;5;41;193;139;68,9104331667974676325,0.001001
greedy_intra:edges_start:greedy,47,71618,23056,48562,89056,8,131;149;123;127;162;151;133;135;70;154;180;53;121;100;26;86;75;82;120;44;25;16;171;175;113;56;31;78;145;179;196;81;90;165;40;185;106;178;3;14;144;62;9;148;102;49;52;55;57;92;129;2;101;1;97;152;124;94;63;79;80;176;137;23;186;89;183;143;117;0;51;118;59;115;46;68;139;193;41;5;42;181;159;69;108;18;22;146;34;160;48;54;177;10;190;84;184;43;116;65,846885720490761786,0.004000
greedy_intra:edges_start:greedy,48,71794,23230,48564,93349,8,48;160;34;42;181;195;146;22;18;108;69;159;41;193;139;68;140;93;117;143;183;89;186;23;137;176;80;79;63;94;124;152;97;1;101;2;129;92;57;55;52;49;102;148;9;62;144;14;3;178;106;185;40;165;90;81;196;179;145;78;31;56;113;175;171;16;25;44;82;120;75;86;26;100;121;53;180;154;135;70;127;123;162;133;151;51;0;46;115;118;59;116;65;43;184;84;190;10;177;54,8011960500157905323,0.004000
greedy_intra:edges_start:greedy,49,71269,23207,48062,36018,3,49;178;106;52;55;57;92;129;2;152;97;1;101;100;26;124;94;63;79;80;176;133;151;51;118;59;115;46;0;137;23;186;89;183;143;117;93;140;68;139;193;41;5;42;181;159;69;108;18;22;146;34;160;48;54;177;10;190;84;184;43;116;65;131;149;162;123;127;70;135;154;180;53;86;75;120;44;25;16;171;175;113;56;31;78;145;179;196;81;90;165;40;185;138;14;144;62;9;148;102,7401822860511336328,0.000999
greedy_intra:edges_start:greedy,50,71877,23562,48315,68702,9,157;145;78;92;179;196;81;90;165;40;185;106;178;3;14;144;62;9;148;102;49;52;55;57;129;2;152;97;1;101;100;26;124;94;63;79;80;176;133;151;51;118;59;115;46;0;137;23;186;89;183;143;117;93;140;68;139;193;41;5;42;181;159;69;108;18;22;146;34;160;48;54;177;10;190;184;43;116;65;131;149;162;123;127;70;135;154;180;53;86;75;120;44;25;16;171;175;113;56;31,6483728931889870943,0.003967
greedy_intra:edges_start:greedy,51,71833,23710,48123,14590,2,51;118;59;115;46;68;139;193;41;5;42;181;159;69;108;18;22;146;34;160;48;54;177;10;190;4;112;184;43;116;65;149;123;127;162;151;133;135;70;154;180;53;121;100;26;86;75;44;25;16;171;175;113;56;31;78;145;179;196;81;90;40;165;185;106;178;3;14;144;62;9;148;102;49;52;55;92;57;129;82;120;2;101;1;97;152;124;94;63;79;80;176;137;23;186;89;183;143;117;0,6722659932911958717,0.000972
greedy_intra:edges_start:greedy,52,71436,23374,48062,34882,3,52;178;106;49;102;148;9;62;144;14;138;165;185;40;90;81;196;179;145;78;31;56;113;175;171;16;25;44;120;75;86;100;53;180;154;135;70;127;123;162;149;131;65;116;43;184;84;190;10;177;54;48;160;34;146;22;18;108;69;159;181;42;5;41;193;139;68;140;93;117;143;183;89;186;23;137;0;46;115;59;118;51;151;133;176;80;79;63;94;124;26;101;1;97;152;2;129;92;57;55,7552077224903152904,0.001000
greedy_intra:edges_start:greedy,53,71468,22898,48570,34708,2,53;158;154;70;135;180;63;79;133;151;162;127;123;149;65;116;43;184;177;54;48;160;34;146;22;18;108;69;159;181;42;5;41;193;139;68;140;93;117;143;0;46;115;59;118;51;80;176;137;23;183;89;186;114;15;9;62;144;14;138;165;185;40;90;81;196;179;145;78;31;56;113;175;171;16;25;44;120;2;129;92;57;55;52;106;178;49;102;148;124;94;152;97;1;101;75;86;26;100;121,3521764138156586211,0.001000
greedy_intra:edges_start:greedy,54,71623,23059,48564,76558,7,54;48;34;160;42;181;195;146;22;18;108;69;159;193;41;139;68;140;93;117;143;183;89;186;23;137;176;80;79;63;94;124;152;97;1;101;2;120;44;25;16;171;175;113;56;31;78;145;179;196;81;90;165;40;185;106;178;3;14;144;62;9;148;102;49;52;55;57;92;129;82;75;86;26;100;121;53;180;154;135;70;127;123;162;133;151;51;0;46;115;118;59;65;116;43;184;84;190;10;177,4421899261173753343,0.003234
greedy_intra:edges_start:greedy,55,71314,23252,48062,51827,4,55;52;106;178;49;102;148;9;62;144;14;138;185;40;165;90;81;196;179;145;78;31;56;113;175;171;16;25;44;120;75;86;100;53;180;154;135;70;127;123;162;149;131;65;116;43;184;84;190;10;177;54;48;160;34;146;22;18;108;69;159;181;42;5;41;193;139;68;140;93;117;143;183;89;186;23;137;0;46;115;59;118;51;151;133;176;80;79;63;94;124;26;101;1;97;152;2;129;92;57,6138492410870525709,0.002001
greedy_intra:edges_start:greedy,56,71467,23327,48140,64419,7,56;31;78;145;92;179;196;81;90;165;40;185;106;178;3;14;144;62;9;148;102;49;52;55;57;129;2;152;124;94;63;79;80;176;133;151;51;118;59;115;46;0;137;23;186;89;183;143;117;93;140;68;139;193;41;5;42;181;159;69;108;18;22;146;34;160;48;54;177;10;190;84;184;43;116;65;131;149;162;123;127;70;135;154;180;53;100;86;26;97;1;101;75;120;44;25;16;171;175;113,114382776814783352,0.003034
greedy_intra:edges_start:greedy,57,71573,23433,48140,29672,4,57;55;52;49;102;148;9;62;144;14;3;178;106;185;165;40;90;81;196;179;145;78;31;56;113;175;171;16;25;44;120;75;86;26;100;53;180;154;135;70;127;123;162;149;131;65;116;43;184;84;190;10;177;54;48;160;34;146;22;18;108;69;159;181;42;5;41;193;139;68;140;93;117;143;183;89;186;23;137;0;46;115;59;118;51;151;133;176;80;79;63;94;124;101;1;97;152;2;129;92,7896476925090180615,0.001993
greedy_intra:edges_start:greedy,58,72451,24164,48287,52889,4,58;95;27;90;81;196;157;31;56;113;175;171;16;25;44;120;75;86;53;180;154;135;70;127;123;162;149;65;116;43;184;177;54;48;160;34;146;22;18;108;69;159;181;42;5;41;193;139;68;140;93;117;143;183;89;23;137;0;46;115;59;118;51;151;133;176;80;79;63;94;100;26;101;1;97;152;2;129;57;92;78;145;179;40;165;185;55;52;106;178;49;14;102;148;9;62;144;21;7;164,44347348069680979,0.001000
greedy_intra:edges_start:greedy,59,71681,23558,48123,41936,4,59;115;46;68;139;193;41;5;42;181;159;69;108;18;22;146;34;160;48;54;177;10;190;4;112;184;43;116;65;149;123;127;162;151;133;135;70;154;180;53;121;100;26;86;75;82;129;57;92;55;52;49;102;148;9;62;144;14;3;178;106;185;40;165;90;81;196;179;145;78;31;56;113;175;171;16;25;44;120;2;101;1;97;152;124;94;63;79;80;176;137;23;186;89;183;143;117;0;51;118,8644460042824161457,0.001000
greedy_intra:edges_start:greedy,60,71550,23427,48123,90665,12,68;117;0;143;183;89;186;23;137;176;80;79;63;94;124;152;97;1;101;2;120;82;129;57;92;55;52;49;102;148;9;62;144;14;3;178;106;185;40;165;90;81;196;179;145;78;31;56;113;175;171;16;25;44;75;86;26;100;121;53;180;154;70;135;133;151;162;127;123;149;65;116;43;184;84;112;4;10;177;54;48;160;34;146;22;18;108;69;159;181;42;5;41;193;139;115;59;118;51;46,6020795173650500176,0.004000
greedy_intra:edges_start:greedy,61,71312,23290,48022,57011,8,15;144;14;138;165;185;40;90;81;196;179;145;78;31;56;113;175;171;16;25;44;120;75;86;26;97;1;101;100;53;180;154;135;70;127;123;162;149;131;65;116;43;184;190;10;177;54;48;160;34;146;22;18;108;69;159;181;42;5;41;193;139;68;140;93;117;143;183;89;186;23;137;0;46;115;59;118;51;151;133;176;80;79;63;94;124;152;2;129;92;57;55;52;106;178;49;102;62;9;148,1227239802187672920,0.003068
greedy_intra:edges_start:greedy,62,71153,23091,48062,86594,8,62;144;14;138;185;40;165;90;81;196;179;145;78;31;56;113;175;171;16;25;44;120;75;86;101;97;26;100;53;180;154;135;70;127;123;162;149;131;65;116;43;184;84;190;10;177;54;48;160;34;146;22;18;108;69;159;181;42;5;41;193;139;68;140;93;117;143;183;89;186;23;137;0;46;115;59;118;51;151;133;176;80;79;63;94;124;152;1;2;129;92;57;55;52;106;178;49;102;148;9,3732657727417774513,0.004000
greedy_intra:edges_start:greedy,63,71460,22890,48570,38895,3,63;180;135;70;154;158;53;121;100;26;86;75;101;1;97;152;94;124;148;102;49;178;106;52;55;57;92;129;2;120;44;25;16;171;175;113;56;31;78;145;179;196;81;90;165;40;185;138;14;144;62;9;15;114;186;89;183;23;137;176;51;118;59;115;46;0;143;117;93;140;68;139;193;41;5;42;181;159;69;108;18;22;146;34;160;48;54;177;184;43;116;65;149;123;127;162;151;133;80;79,7346378064803682716,0.000993
greedy_intra:edges_start:greedy,64,72283,22764,49519,34505,2,64;114;186;89;183;23;137;176;51;118;59;115;46;0;143;117;93;140;68;139;193;41;5;42;181;159;69;108;18;22;146;34;160;48;54;177;184;43;116;65;149;123;162;151;80;133;79;63;180;135;70;154;158;53;121;100;26;86;75;101;1;97;152;94;124;148;9;62;102;49;178;106;52;55;57;92;129;2;120;44;25;16;171;175;113;56;31;78;145;179;196;81;90;40;185;165;138;14;144;15,5240354103508919255,0.001002
greedy_intra:edges_start:greedy,65,71373,23250,48123,76556,7,65;149;123;127;162;151;133;135;70;154;180;53;121;100;26;86;75;120;44;25;16;171;175;113;56;31;78;145;179;196;81;90;165;40;185;106;178;3;14;144;62;9;148;102;49;52;55;57;92;129;82;2;101;1;97;152;124;94;63;79;80;176;137;23;186;89;183;143;117;0;51;118;59;115;46;68;139;193;41;5;42;181;159;69;108;18;22;146;34;160;48;54;177;10;4;112;84;184;43;116,3730999989648865598,0.003997
greedy_intra:edges_start:greedy,66,72531,24041,48490,36465,3,23;51;118;59;115;46;0;89;183;143;117;93;140;68;139;193;41;5;42;181;159;69;108;18;22;146;34;160;48;54;177;10;190;84;184;43;116;65;149;123;127;162;151;133;135;70;154;180;53;121;100;26;86;75;44;25;16;171;175;113;56;31;78;145;179;196;81;90;165;40;185;106;178;3;14;144;62;9;148;102;49;52;55;92;57;129;82;120;2;101;1;97;152;124;94;63;79;80;176;137,5117815368363268160,0.001031
greedy_intra:edges_start:greedy,67,72063,22895,49168,67990,7,36;108;69;18;22;146;159;193;41;5;42;181;34;160;48;54;177;10;190;84;184;43;116;65;149;123;127;162;151;133;135;70;154;180;53;121;100;26;86;75;82;129;92;57;55;52;49;102;148;9;62;144;14;3;178;106;185;40;165;90;81;196;179;145;78;31;56;113;175;171;16;25;44;120;2;101;1;97;152;124;94;63;79;80;176;137;51;118;59;115;139;68;46;0;89;183;143;117;93;140,8041602566641899086,0.003015
greedy_intra:edges_start:greedy,68,71686,23563,48123,28709,3,68;46;115;59;118;51;0;117;143;183;89;186;23;137;176;80;79;63;94;124;152;97;1;101;2;120;82;129;57;92;55;52;49;102;148;9;62;144;14;3;178;106;185;40;165;90;81;196;179;145;78;31;56;113;175;171;16;25;44;75;86;26;100;121;53;180;154;70;135;133;151;162;127;123;149;65;116;43;184;112;4;190;10;177;54;48;160;34;146;22;18;108;69;159;181;42;5;41;193;139,1087481187597765591,0.001031
greedy_intra:edges_start:greedy,69,71906,23055,48851,25886,3,69;108;18;199;22;146;159;193;41;5;42;181;34;160;48;54;177;10;190;84;184;43;116;65;149;123;127;162;151;133;135;70;154;180;53;121;100;26;86;75;44;25;16;171;175;113;56;31;78;145;179;196;81;90;40;165;185;106;178;3;14;144;62;9;148;102;49;52;55;57;92;129;82;120;2;101;1;97;152;124;94;63;79;80;176;137;23;186;89;183;143;117;0;51;118;59;115;46;68;139,335646146439125052,0.000982
greedy_intra:edges_start:greedy,70,71468,22898,48570,36573,2,70;154;158;53;121;100;26;86;75;101;1;97;152;94;124;148;102;49;178;106;52;55;57;92;129;2;120;44;25;16;171;175;113;56;31;78;145;179;196;81;90;40;185;165;138;14;144;62;9;15;114;186;89;183;23;137;176;80;51;118;59;115;46;0;143;117;93;140;68;139;193;41;5;42;181;159;69;108;18;22;146;34;160;48;54;177;184;43;116;65;149;123;127;162;151;133;79;63;180;135,8801678733113255085,0.002004
greedy_intra:edges_start:greedy,71,72133,23605,48528,26490,2,58;164;7;95;39;165;138;14;144;62;9;148;102;49;178;106;52;55;57;92;129;2;152;97;1;101;26;94;63;79;80;176;133;151;51;118;59;115;46;0;137;23;89;183;143;117;93;140;68;139;193;41;5;42;181;159;69;108;18;22;146;34;160;48;54;177;184;43;116;65;149;162;123;127;70;135;154;180;53;100;86;75;120;44;25;16;171;175;113;56;31;78;145;179;196;81;185;40;90;27,6375399131092493043,0.000979
greedy_intra:edges_start:greedy,72,72026,23156,48870,64886,7,109;51;0;117;143;183;89;186;23;137;176;80;79;63;94;124;152;97;1;101;2;129;92;57;55;52;49;102;148;9;62;144;14;3;178;106;185;165;40;90;81;196;179;145;78;31;56;113;175;171;16;25;44;82;120;75;86;26;100;121;53;180;154;70;135;133;151;162;127;123;149;65;116;43;184;84;190;10;177;54;48;160;34;146;22;18;108;69;159;181;42;5;41;193;139;68;46;115;59;118,6351775269539504543,0.002931
greedy_intra:edges_start:greedy,73,71761,23401,48360,68147,11,15;148;37;9;62;102;49;178;106;52;55;57;92;129;2;152;97;1;101;26;124;94;63;79;80;176;133;151;51;118;59;115;46;0;137;23;186;89;183;143;117;93;140;68;139;193;41;5;42;181;159;69;108;18;22;146;34;160;48;54;177;10;184;43;116;65;131;149;162;123;127;70;135;154;180;53;100;86;75;120;44;25;16;171;175;113;56;31;78;145;179;196;81;90;40;185;165;138;14;144,894804847364207851,0.004000
greedy_intra:edges_start:greedy,74,71680,23039,48641,74186,7,189;94;124;148;102;49;178;106;52;55;57;92;129;2;120;44;25;16;171;175;113;56;31;78;145;179;196;81;90;165;40;185;138;14;144;62;9;15;114;186;89;183;23;137;176;51;118;59;115;46;0;143;117;93;140;68;139;193;41;5;42;181;159;69;108;18;22;146;34;160;48;54;177;184;43;116;65;149;123;127;162;151;133;80;79;63;180;135;70;154;53;86;75;101;1;152;97;26;100;121,3666983786028329567,0.002999
greedy_intra:edges_start:greedy,75,71874,23400,48474,74703,8,75;82;120;44;25;16;171;175;113;56;31;78;145;179;196;81;90;165;40;185;106;178;3;14;144;62;9;148;102;49;52;55;92;57;129;2;152;97;1;101;26;100;121;94;63;79;80;176;133;151;51;118;59;115;46;0;137;23;186;89;183;143;117;93;140;68;139;193;41;5;42;181;159;69;108;18;22;146;34;160;48;54;177;10;190;184;43;116;65;131;149;162;123;127;70;135;154;180;53;86,7554546576289944467,0.002972
greedy_intra:edges_start:greedy,76,71797,22908,48889,63553,9,170;143;183;89;23;186;114;15;9;62;144;14;138;185;40;165;90;81;196;179;145;78;31;56;113;175;171;16;25;44;120;2;129;92;57;55;52;106;178;49;102;148;124;94;152;97;1;101;75;86;26;100;121;53;158;154;70;135;180;63;79;133;151;162;127;123;149;65;116;43;184;10;177;54;48;160;34;146;22;18;108;69;159;181;42;5;41;193;139;68;46;115;59;118;51;80;176;137;0;117,3188586966201902055,0.003000
greedy_intra:edges_start:greedy,77,71748,23330,48418,61645,7,149;59;118;115;46;0;51;151;133;162;123;127;70;135;154;180;53;121;100;26;86;75;120;44;25;16;171;175;113;56;31;78;145;179;196;81;90;40;165;185;106;178;3;14;144;62;9;148;102;49;52;55;57;92;129;82;2;101;1;97;152;124;94;63;79;80;176;137;23;186;89;183;143;117;93;140;68;139;193;41;5;42;181;159;69;108;18;22;146;34;160;48;54;177;10;190;184;43;116;65,3351476282558189884,0.002973
greedy_intra:edges_start:greedy,78,71382,23110,48272,47011,7,78;31;56;113;175;171;16;25;44;120;75;86;53;180;154;135;70;127;123;162;149;131;65;116;43;184;84;190;10;177;54;48;160;34;146;22;18;108;69;159;181;42;5;41;193;139;68;140;93;117;143;183;89;186;23;137;0;46;115;59;118;51;151;133;176;80;79;63;94;121;100;26;101;1;97;152;2;129;92;57;55;52;49;102;148;9;62;144;14;3;178;106;185;40;165;90;81;196;179;145,5498947658040729283,0.001999
greedy_intra:edges_start:greedy,79,71895,23009,48886,42146,4,79;80;176;133;151;51;118;59;115;46;0;137;23;186;89;183;143;117;93;140;68;139;193;41;5;42;181;159;69;108;18;22;146;34;160;48;54;177;184;43;116;65;131;149;162;123;127;70;135;154;180;158;53;121;100;26;86;75;44;25;16;171;175;113;56;31;78;145;179;196;81;90;165;40;185;106;178;3;14;144;62;9;148;102;49;52;55;57;92;129;82;120;2;101;1;97;152;124;94;63,7644975515349434573,0.001993
greedy_intra:edges_start:greedy,80,71809,23247,48562,35975,3,80;79;63;94;124;152;97;1;101;2;82;129;57;92;55;52;49;102;148;9;62;144;14;3;178;106;185;165;40;90;81;196;179;145;78;31;56;113;175;171;16;25;44;120;75;86;26;100;121;53;180;154;135;70;127;123;162;133;151;149;131;65;116;43;184;84;190;10;177;54;48;160;34;146;22;18;108;69;159;181;42;5;41;193;139;68;46;115;59;118;51;0;117;143;183;89;186;23;137;176,4936017534759346728,0.001974
greedy_intra:edges_start:greedy,81,71360,23298,48062,48915,4,81;196;40;185;179;145;78;31;56;113;175;171;16;25;44;120;75;86;26;100;53;180;154;135;70;127;123;162;149;131;65;116;43;184;84;190;10;177;54;48;160;34;146;22;18;108;69;159;181;42;5;41;193;139;68;140;93;117;143;183;89;186;23;137;0;46;115;59;118;51;151;133;176;80;79;63;94;124;152;97;101;1;2;129;92;57;55;52;106;178;49;102;148;9;62;144;14;138;165;90,7533012903071773895,0.002001
greedy_intra:edges_start:greedy,82,71982,23640,48342,45740,5,82;2;75;86;100;53;180;154;135;70;127;123;162;149;131;65;116;43;184;190;10;177;54;48;160;34;146;22;18;108;69;159;181;42;5;41;193;139;68;140;93;117;143;183;89;186;23;137;0;46;115;59;118;51;151;133;176;80;79;63;94;124;26;101;1;97;152;129;57;92;55;52;49;102;148;9;62;144;14;3;178;106;185;40;165;90;81;196;179;145;78;31;56;113;175;171;16;25;44;120,8926735148687286354,0.002001
greedy_intra:edges_start:greedy,83,71416,23120,48296,45559,6,114;89;183;143;117;0;46;68;139;115;41;193;5;42;181;159;69;108;18;22;146;34;160;48;54;177;10;4;112;84;184;43;116;65;59;118;51;151;133;162;123;127;70;135;154;180;53;121;100;26;86;75;44;25;16;171;175;113;56;31;78;145;179;196;81;90;40;165;185;106;178;3;14;144;62;9;148;102;49;52;55;92;57;129;82;120;2;101;1;97;152;124;94;63;79;80;176;137;23;186,7423309757246633437,0.001997
greedy_intra:edges_start:greedy,84,70987,22737,48250,116229,11,84;4;112;127;123;162;151;133;135;70;154;180;53;121;100;26;86;75;120;44;25;16;171;175;113;56;31;78;145;179;196;81;90;165;40;185;106;178;3;14;144;62;9;148;102;49;52;55;92;57;129;82;2;101;1;97;152;124;94;63;79;80;176;137;23;186;89;183;143;0;117;68;46;139;115;118;51;59;65;116;43;42;5;41;193;159;69;108;18;22;146;181;34;160;48;54;177;10;184;35,1714112061790495816,0.004000
greedy_intra:edges_start:greedy,85,71898,23583,48315,84800,9,157;145;179;196;81;90;165;40;185;106;178;3;14;144;62;9;148;102;49;52;55;92;57;129;2;152;124;94;63;79;80;176;133;151;51;118;59;115;46;0;137;23;186;89;183;143;117;93;140;68;139;193;41;5;42;181;159;69;108;18;22;146;34;160;48;54;177;10;190;184;43;116;65;131;149;162;123;127;70;135;154;180;53;100;26;97;1;101;86;75;120;44;25;78;31;16;171;175;113;56,7214852510009674601,0.003000
greedy_intra:edges_start:greedy,86,71545,22975,48570,30132,2,86;75;101;1;97;152;94;124;148;102;49;178;106;52;55;57;92;129;2;120;44;25;16;171;175;113;56;31;78;145;179;196;81;90;165;40;185;138;14;144;62;9;15;114;186;89;183;23;137;176;80;151;51;118;59;115;46;0;143;117;93;140;68;139;193;41;5;42;181;159;69;108;18;22;146;34;160;48;54;177;184;43;116;65;149;123;127;162;133;79;63;180;135;70;154;158;53;121;100;26,4914034039885037058,0.001000
greedy_intra:edges_start:greedy,87,71875,23370,48505,136964,18,121;53;180;154;135;70;127;123;162;149;131;65;116;43;184;10;177;54;48;160;34;146;22;18;108;69;159;181;42;5;41;193;139;68;140;93;117;143;183;89;186;23;137;0;46;115;59;118;51;151;133;176;80;79;63;94;124;152;2;129;92;57;55;52;49;102;148;9;62;144;14;3;178;106;185;165;40;90;81;196;179;145;78;31;56;113;175;171;16;25;44;82;120;75;101;1;97;86;26;100,7160875769372969325,0.006643
greedy_intra:edges_start:greedy,88,71926,23584,48342,69100,8,82;120;75;86;100;53;180;154;135;70;127;123;162;149;131;65;116;43;184;190;10;177;54;48;160;34;146;22;18;108;69;159;181;42;5;41;193;139;68;140;93;117;143;183;89;186;23;137;0;46;115;59;118;51;151;133;176;80;79;63;94;124;26;101;1;97;152;2;129;57;55;52;49;102;148;9;62;144;14;3;178;106;185;40;165;90;81;196;179;92;145;78;31;56;113;175;171;16;25;44,4563365930064324587,0.002010
greedy_intra:edges_start:greedy,89,70599,22099,48500,99498,8,89;186;23;137;176;80;79;63;94;124;152;97;1;101;2;82;129;92;57;55;52;49;102;148;9;62;144;14;3;178;106;185;40;165;90;81;196;179;145;78;31;56;113;175;171;16;25;44;120;75;86;26;100;121;53;180;154;135;70;127;123;162;133;151;51;118;59;65;116;43;184;84;190;10;177;54;48;160;34;146;22;18;108;69;159;181;42;5;41;193;139;115;46;68;140;93;117;0;143;183,5804593200551746096,0.004045
greedy_intra:edges_start:greedy,90,71401,23339,48062,49177,4,90;40;185;81;196;179;145;78;31;56;113;175;171;16;25;44;120;75;101;1;97;26;86;100;53;180;154;135;70;127;123;162;149;131;65;116;43;184;84;190;10;177;54;48;160;34;146;22;18;108;69;159;181;42;5;41;193;139;68;140;93;117;143;183;89;186;23;137;0;46;115;59;118;51;151;133;176;80;79;63;94;124;152;2;129;92;57;55;52;106;178;49;102;148;9;62;144;14;138;165,8522892263021392539,0.003000
greedy_intra:edges_start:greedy,91,71774,23459,48315,45902,5,157;179;145;78;31;56;113;175;171;16;25;44;120;75;86;100;53;180;154;135;70;127;123;162;149;131;65;116;43;184;190;10;177;54;48;160;34;146;22;18;108;69;159;181;42;5;41;193;139;68;140;93;117;143;183;89;186;23;137;0;46;115;59;118;51;151;133;176;80;79;63;94;124;26;101;1;97;152;2;129;92;57;55;52;49;102;148;9;62;144;14;3;178;106;185;40;165;90;81;196,7501951179957071646,0.002237
greedy_intra:edges_start:greedy,92,71597,23457,48140,41736,5,92;129;2;152;97;1;101;26;124;94;63;79;80;176;133;151;51;118;59;115;46;0;137;23;186;89;183;143;117;93;140;68;139;193;41;5;42;181;159;69;108;18;22;146;34;160;48;54;177;10;190;84;184;43;116;65;131;149;162;123;127;70;135;154;180;53;100;86;75;120;44;25;16;171;175;113;56;31;78;145;179;196;81;90;40;165;185;106;178;3;14;144;62;9;148;102;49;52;55;57,4212831750475841850,0.002968
greedy_intra:edges_start:greedy,93,71463,23213,48250,68725,7,93;140;108;69;18;22;146;159;193;41;5;42;181;34;160;48;54;177;10;190;4;112;184;43;116;65;149;123;127;162;151;133;135;70;154;180;53;121;100;26;86;75;82;120;44;25;16;171;175;113;56;31;78;145;179;196;81;90;165;40;185;106;178;3;14;144;62;9;148;102;49;52;55;57;92;129;2;101;1;97;152;124;94;63;79;80;176;137;51;118;59;115;139;68;46;0;89;183;143;117,1626365377309755430,0.002226
greedy_intra:edges_start:greedy,94,71750,23180,48570,12480,0,94;152;97;1;101;75;86;26;100;121;53;158;154;70;135;180;63;79;133;51;118;59;115;46;0;143;117;93;140;68;139;193;41;5;42;181;159;69;108;18;22;146;34;160;48;54;177;184;43;116;65;149;123;127;162;151;80;176;137;23;183;89;186;114;15;9;62;144;14;138;165;40;185;90;81;196;179;145;78;31;56;113;175;171;16;25;44;120;2;129;92;57;55;52;106;178;49;102;148;124,6222760174203759001,0.001001
greedy_intra:edges_start:greedy,95,72112,23584,48528,27507,3,95;7;164;58;27;90;40;185;81;196;179;145;78;31;56;113;175;171;16;25;44;120;75;86;26;100;53;180;154;135;70;127;123;162;149;65;116;43;184;177;54;48;160;34;146;22;18;108;69;159;181;42;5;41;193;139;68;140;93;117;143;183;89;23;137;0;46;115;59;118;51;151;133;176;80;79;63;94;97;1;101;152;2;129;92;57;55;52;106;178;49;102;148;9;62;144;14;138;165;39,4497864503415578553,0.001000
greedy_intra:edges_start:greedy,96,71299,23176,48123,48882,6,5;43;116;65;149;123;127;162;151;133;135;70;154;180;53;121;100;26;86;75;44;25;16;171;175;113;56;31;78;145;179;196;81;90;165;40;185;106;178;3;14;144;62;9;148;102;49;52;55;57;92;129;82;120;2;101;1;97;152;124;94;63;79;80;176;137;23;186;89;183;143;117;0;51;118;59;115;46;68;139;41;193;159;69;108;18;22;146;181;34;160;48;54;177;10;4;112;84;184;42,4707166472463263261,0.002000
greedy_intra:edges_start:greedy,97,71493,23304,48189,64627,5,97;152;1;101;75;86;53;154;70;135;180;63;79;80;133;151;162;127;123;149;65;116;43;184;10;177;54;48;160;34;146;22;18;108;69;159;181;42;5;41;193;139;68;140;93;117;143;0;46;115;59;118;51;176;137;23;183;89;186;114;15;9;62;144;14;138;185;40;165;90;81;196;179;145;78;31;56;113;175;171;16;25;44;120;2;129;92;57;55;52;106;178;49;102;148;124;94;121;100;26,342861536886529202,0.001999
greedy_intra:edges_start:greedy,98,72460,23855,48605,98273,10,119;90;27;164;39;165;185;106;178;3;14;144;62;9;148;102;49;52;55;57;129;92;179;145;78;82;2;152;94;63;79;80;176;133;151;51;118;59;115;46;0;137;23;89;183;143;117;93;140;68;139;193;41;5;42;181;159;69;108;18;22;146;34;160;48;54;177;184;43;116;65;149;162;123;127;70;135;154;180;53;86;100;26;97;1;101;75;120;44;25;16;171;175;113;56;31;157;196;81;40,9174727890883696331,0.004157
greedy_intra:edges_start:greedy,99,71717,23147,48570,53370,4,121;100;26;97;86;75;101;1;152;94;124;148;102;49;178;106;52;55;57;92;129;2;120;44;25;16;171;175;113;56;31;78;145;179;196;81;90;40;185;165;138;14;144;62;9;15;114;186;89;183;23;137;176;80;151;51;118;59;115;46;0;143;117;93;140;68;139;193;41;5;42;181;159;69;108;18;22;146;34;160;48;54;177;184;43;116;65;149;123;127;162;133;79;63;180;135;70;154;158;53,8088660750434798253,0.000998
greedy_intra:edges_start:greedy,100,71600,23030,48570,22467,2,100;26;86;75;101;1;97;152;94;124;148;102;49;178;106;52;55;57;92;129;2;120;44;25;16;171;175;113;56;31;78;145;179;196;81;90;40;185;165;138;14;144;62;9;15;114;186;89;183;23;137;176;80;151;51;118;59;115;46;0;143;117;93;140;68;139;193;41;5;42;181;159;69;108;18;22;146;34;160;48;54;177;184;43;116;65;149;123;127;162;133;79;63;180;135;70;154;158;53;121,1009462241196135983,0.001000
greedy_intra:edges_start:greedy,101,71578,23389,48189,37546,4,101;1;152;97;26;100;121;94;124;148;102;49;178;106;52;55;57;92;129;2;120;44;25;16;171;175;113;56;31;78;145;179;196;81;90;165;40;185;138;14;144;62;9;15;114;186;89;183;23;137;176;80;151;51;118;59;115;46;0;143;117;93;140;68;139;193;41;5;42;181;159;69;108;18;22;146;34;160;48;54;177;10;184;43;116;65;149;123;127;162;133;79;63;180;135;70;154;53;86;75,1466071247700246599,0.002029
greedy_intra:edges_start:greedy,102,71098,23036,48062,76203,7,102;148;9;62;144;14;138;185;40;165;90;81;196;179;145;78;31;56;113;175;171;16;25;44;120;75;101;1;97;100;26;86;53;180;154;135;70;127;123;162;149;131;65;116;43;184;84;190;10;177;54;48;160;34;146;22;18;108;69;159;181;42;5;41;193;139;68;140;93;117;143;183;89;186;23;137;0;46;115;59;118;51;151;133;176;80;79;63;94;124;152;2;129;92;57;55;52;106;178;49,2013976191529384803,0.004000
greedy_intra:edges_start:greedy,103,71010,23037,47973,48279,6,181;34;160;48;54;177;10;190;4;112;84;184;42;43;116;65;149;123;127;162;151;133;135;70;154;180;53;121;100;26;86;75;82;120;44;25;16;171;175;113;56;31;78;145;179;196;81;90;165;40;185;106;178;3;14;144;62;9;148;102;49;52;55;57;92;129;2;101;1;97;152;124;94;63;79;80;176;137;23;186;89;183;143;117;0;51;118;59;115;46;68;139;41;193;159;69;108;18;22;146,8473309163531339189,0.002000
greedy_intra:edges_start:greedy,104,71524,22866,48658,86883,11,30;54;48;34;160;42;181;195;146;22;18;108;69;159;193;41;139;68;140;93;117;143;183;89;186;23;137;176;80;79;63;94;124;152;97;1;101;2;82;129;92;57;55;52;49;102;148;9;62;144;14;3;178;106;185;40;165;90;81;196;179;145;78;31;56;113;175;171;16;25;44;120;75;86;26;100;121;53;180;154;135;70;127;123;162;133;151;51;0;46;115;118;59;65;116;43;184;190;10;177,1169446081833820330,0.005155
greedy_intra:edges_start:greedy,105,71961,23229,48732,72896,7,47;116;43;184;84;190;10;177;54;48;160;34;146;22;18;108;69;159;181;42;5;41;193;139;68;46;115;59;118;51;0;117;143;183;89;186;23;137;176;80;79;63;94;124;152;97;1;101;2;129;92;57;55;52;49;102;148;9;62;144;14;3;178;106;185;165;40;90;81;196;179;145;78;31;56;113;175;171;16;25;44;120;82;75;86;26;100;121;53;180;154;70;135;133;151;162;127;123;149;65,6912835329195224770,0.002997
greedy_intra:edges_start:greedy,106,71386,23324,48062,28603,2,106;178;49;102;148;9;62;144;14;138;165;40;185;90;81;196;179;145;78;31;56;113;175;171;16;25;44;120;75;86;53;180;154;135;70;127;123;162;149;131;65;116;43;184;84;190;10;177;54;48;160;34;146;22;18;108;69;159;181;42;5;41;193;139;68;140;93;117;143;183;89;186;23;137;0;46;115;59;118;51;151;133;176;80;79;63;94;124;26;100;101;1;97;152;2;129;92;57;55;52,3200921501469567859,0.000999
greedy_intra:edges_start:greedy,107,72133,23605,48528,29915,4,27;58;164;7;95;39;165;138;14;144;62;9;148;102;49;178;106;52;55;57;92;129;2;152;97;1;101;26;94;63;79;80;176;133;151;51;118;59;115;46;0;137;23;89;183;143;117;93;140;68;139;193;41;5;42;181;159;69;108;18;22;146;34;160;48;54;177;184;43;116;65;149;162;123;127;70;135;154;180;53;100;86;75;120;44;25;16;171;175;113;56;31;78;145;179;196;81;185;40;90,7017039377414523862,0.001971
greedy_intra:edges_start:greedy,108,71735,22884,48851,78046,7,108;69;139;68;46;115;59;118;51;0;117;143;183;89;186;23;137;176;80;79;63;94;124;152;97;1;101;2;129;92;57;55;52;49;102;148;9;62;144;14;3;178;106;185;40;165;90;81;196;179;145;78;31;56;113;175;171;16;25;44;82;120;75;86;26;100;121;53;180;154;70;135;133;151;162;127;123;149;65;116;43;184;84;190;10;177;54;48;160;34;181;42;5;41;193;159;146;22;199;18,8150709843367291946,0.003259
greedy_intra:edges_start:greedy,109,71252,22652,48600,93872,10,109;118;115;59;65;116;43;184;84;112;4;10;177;54;48;160;34;146;22;18;108;69;159;181;42;5;41;193;139;68;46;0;117;143;183;89;186;23;137;176;80;79;63;94;124;152;97;1;101;2;82;129;92;57;55;52;49;102;148;9;62;144;14;3;178;106;185;40;165;90;81;196;179;145;78;31;56;113;175;171;16;25;44;120;75;86;26;100;121;53;180;154;135;70;127;123;162;133;151;51,8065961013583908771,0.004008
greedy_intra:edges_start:greedy,110,71852,23053,48799,105748,9,198;115;59;118;51;0;117;143;183;89;186;23;137;176;80;79;63;94;124;152;97;1;101;2;129;92;57;55;52;49;102;148;9;62;144;14;3;178;106;185;40;165;90;81;196;179;145;78;31;56;113;175;171;16;25;44;82;120;75;86;26;100;121;53;180;154;70;135;133;151;162;127;123;149;65;116;43;184;84;190;10;177;54;48;160;34;146;22;18;108;69;159;181;42;5;41;193;139;68;46,8860418936826745452,0.003999
greedy_intra:edges_start:greedy,111,72480,23884,48596,33489,3,167;148;9;62;102;144;14;49;178;106;165;39;95;164;27;90;81;196;40;185;52;55;57;129;92;179;145;78;31;56;113;175;171;16;25;44;120;2;152;97;1;101;75;86;26;100;121;53;158;154;70;135;180;63;79;133;80;151;162;127;123;149;65;116;43;184;177;54;48;160;34;146;22;18;108;69;159;181;42;5;41;193;139;68;140;93;117;143;183;89;0;46;115;59;118;51;176;137;94;124,8559894827501997097,0.001998
greedy_intra:edges_start:greedy,112,71235,22985,48250,90013,9,112;4;84;35;184;10;177;54;48;160;34;181;146;22;18;108;69;159;193;41;5;42;43;65;116;115;139;68;46;118;59;51;0;117;143;183;89;186;23;137;176;80;79;63;94;124;152;97;1;101;2;82;129;92;57;55;52;49;102;148;9;62;144;14;3;178;106;185;40;165;90;81;196;179;145;78;31;56;113;175;171;16;25;44;120;75;86;26;100;121;53;180;154;70;135;133;151;162;123;127,2834665527732070590,0.003999
greedy_intra:edges_start:greedy,113,71514,23374,48140,83650,10,113;56;31;78;145;92;179;196;81;90;165;40;185;106;178;3;14;144;62;9;148;102;49;52;55;57;129;2;101;97;1;152;124;94;63;79;80;176;133;151;51;118;59;115;46;0;137;23;186;89;183;143;117;93;140;68;139;193;41;5;42;181;159;69;108;18;22;146;34;160;48;54;177;10;190;84;184;43;116;65;131;149;162;123;127;70;135;154;180;53;100;26;86;75;120;44;25;16;171;175,6729134676716614365,0.003984
greedy_intra:edges_start:greedy,114,71509,22939,48570,34647,2,114;186;89;183;23;137;176;51;118;59;115;46;0;143;117;93;140;68;139;193;41;5;42;181;159;69;108;18;22;146;34;160;48;54;177;184;43;116;65;149;123;127;162;151;133;80;79;63;180;135;70;154;158;53;121;100;26;86;75;101;1;97;152;94;124;148;9;62;102;49;178;106;52;55;57;92;129;2;120;44;25;16;171;175;113;56;31;78;145;179;196;81;90;185;40;165;138;14;144;15,1641737855319760382,0.001473
greedy_intra:edges_start:greedy,115,71837,23714,48123,15934,3,115;59;118;51;0;117;143;183;89;186;23;137;176;80;79;63;94;124;152;97;1;101;2;120;82;129;57;92;55;52;49;102;148;9;62;144;14;3;178;106;185;165;40;90;81;196;179;145;78;31;56;113;175;171;16;25;44;75;86;26;100;121;53;180;154;70;135;133;151;162;127;123;149;65;116;43;184;84;112;4;10;177;54;48;160;34;146;22;18;108;69;159;181;42;5;41;193;139;68;46,3937126407770110833,0.001260
greedy_intra:edges_start:greedy,116,71833,23710,48123,19974,2,116;43;184;112;4;190;10;177;54;48;160;34;146;22;18;108;69;159;181;42;5;41;193;139;68;46;115;59;118;51;0;117;143;183;89;186;23;137;176;80;79;63;94;124;152;97;1;101;2;120;82;129;57;92;55;52;49;102;148;9;62;144;14;3;178;106;185;165;40;90;81;196;179;145;78;31;56;113;175;171;16;25;44;75;86;26;100;121;53;180;154;70;135;133;151;162;127;123;149;65,2209829984943786659,0.000999
greedy_intra:edges_start:greedy,117,70882,22677,48205,60053,5,117;0;46;68;139;115;41;193;5;42;181;159;69;108;18;22;146;34;160;48;54;177;10;190;4;112;84;184;43;116;65;59;118;51;151;133;162;123;127;70;135;154;180;53;121;100;26;86;75;82;120;44;25;16;171;175;113;56;31;78;145;179;196;81;90;165;40;185;106;178;3;14;144;62;9;148;102;49;52;55;92;57;129;2;101;1;97;152;124;94;63;79;80;176;137;23;186;89;183;143,5171246294117202352,0.001970
greedy_intra:edges_start:greedy,118,71896,23773,48123,22904,3,118;115;46;68;139;193;41;5;42;181;159;69;108;18;22;146;34;160;48;54;177;10;4;112;84;184;43;116;65;149;123;127;162;151;133;135;70;154;180;53;121;100;26;86;75;44;25;16;171;175;113;56;31;78;145;179;196;81;90;40;165;185;106;178;3;14;144;62;9;148;102;49;52;55;92;57;129;82;120;2;101;1;97;152;124;94;63;79;80;176;137;23;186;89;183;143;117;0;51;59,4191876900119521608,0.001002
greedy_intra:edges_start:greedy,119,71071,22876,48195,53113,4,119;40;185;138;14;144;62;9;148;102;49;178;106;52;55;57;92;129;2;101;1;97;152;124;94;63;79;80;176;133;151;51;118;59;115;46;0;137;23;186;89;183;143;117;93;140;68;139;193;41;5;42;181;159;69;108;18;22;146;34;160;48;54;177;10;190;184;43;116;65;131;149;162;123;127;70;135;154;180;53;100;26;86;75;120;44;25;16;171;175;113;56;31;78;145;179;196;81;90;165,4618685630416455366,0.003030
greedy_intra:edges_start:greedy,120,71201,23061,48140,73606,8,120;75;101;1;97;26;100;86;53;180;154;135;70;127;123;162;149;131;65;116;43;184;84;190;10;177;54;48;160;34;146;22;18;108;69;159;181;42;5;41;193;139;68;140;93;117;143;183;89;186;23;137;0;46;115;59;118;51;151;133;176;80;79;63;94;124;152;2;129;92;57;55;52;49;102;148;9;62;144;14;3;178;106;185;40;165;90;81;196;179;145;78;31;56;113;175;171;16;25;44,6269088910936183704,0.003017
greedy_intra:edges_start:greedy,121,71647,23077,48570,24203,1,121;100;26;97;86;75;101;1;152;94;124;148;102;49;178;106;52;55;57;92;129;2;120;44;25;16;171;175;113;56;31;78;145;179;196;81;90;185;40;165;138;14;144;62;9;15;114;186;89;183;23;137;176;80;51;118;59;115;46;0;143;117;93;140;68;139;193;41;5;42;181;159;69;108;18;22;146;34;160;48;54;177;184;43;116;65;149;123;127;162;151;133;79;63;180;135;70;154;158;53,9000224282030411634,0.001000
greedy_intra:edges_start:greedy,122,72136,22926,49210,60094,5,122;176;80;79;133;151;51;118;59;115;46;0;137;23;89;183;143;117;93;140;68;139;193;41;5;42;181;159;69;108;18;22;146;34;160;48;54;177;184;43;116;65;131;149;162;123;127;70;135;154;180;158;53;121;100;26;86;75;82;129;92;57;55;52;49;102;148;9;62;144;14;3;178;106;185;40;165;90;81;196;179;145;78;31;56;113;175;171;16;25;44;120;2;101;1;97;152;124;94;63,4993342810721263225,0.003001
greedy_intra:edges_start:greedy,123,71712,23150,48562,45165,4,123;162;133;151;149;131;65;116;43;184;84;190;10;177;54;48;160;34;146;22;18;108;69;159;181;42;5;41;193;139;68;46;115;59;118;51;0;117;143;183;89;186;23;137;176;80;79;63;94;124;152;97;1;101;2;129;92;57;55;52;49;102;148;9;62;144;14;3;178;106;185;165;40;90;81;196;179;145;78;31;56;113;175;171;16;25;44;120;82;75;86;26;100;121;53;180;154;135;70;127,61997107841856464,0.002695
greedy_intra:edges_start:greedy,124,71600,23030,48570,45865,3,124;148;102;49;178;106;52;55;57;92;129;2;120;44;25;16;171;175;113;56;31;78;145;179;196;81;90;40;185;165;138;14;144;62;9;15;114;186;89;183;23;137;176;80;151;51;118;59;115;46;0;143;117;93;140;68;139;193;41;5;42;181;159;69;108;18;22;146;34;160;48;54;177;184;43;116;65;149;123;127;162;133;79;63;180;135;70;154;158;53;121;100;26;86;75;101;1;97;152;94,5608107327103098938,0.002000
greedy_intra:edges_start:greedy,125,72862,23381,49481,52229,5,74;2;120;82;129;92;57;179;145;78;31;56;113;175;171;16;25;44;75;86;53;154;70;135;180;63;79;133;162;123;149;65;116;43;184;177;54;48;160;34;146;22;18;108;69;159;181;42;5;41;193;139;68;140;93;117;143;0;46;115;59;118;51;151;80;176;137;23;183;89;186;114;15;9;62;144;14;138;165;90;81;196;40;185;55;52;106;178;49;102;148;124;94;121;100;26;101;1;97;152,8392681654786691191,0.001972
greedy_intra:edges_start:greedy,126,71208,22601,48607,100780,10,149;112;4;84;35;184;177;54;48;160;34;181;146;22;18;108;69;159;193;41;5;42;43;116;65;59;51;118;115;139;68;46;0;117;143;183;89;186;23;137;176;80;79;63;94;124;152;97;1;101;2;129;92;57;55;52;49;102;148;9;62;144;14;3;178;106;185;40;165;90;81;196;179;145;78;31;56;113;175;171;16;25;44;120;82;75;86;26;100;121;53;180;154;70;135;133;151;162;123;131,1768244169528785443,0.004032
greedy_intra:edges_start:greedy,127,71949,23444,48505,51028,4,127;70;135;154;180;53;121;100;26;86;75;82;129;57;92;55;52;49;102;148;9;62;144;14;3;178;106;185;40;165;90;81;196;179;145;78;31;56;113;175;171;16;25;44;120;2;101;1;97;152;124;94;63;79;80;176;133;151;51;118;59;115;46;0;137;23;186;89;183;143;117;93;140;68;139;193;41;5;42;181;159;69;108;18;22;146;34;160;48;54;177;10;184;43;116;65;131;149;162;123,3199779572490954992,0.002165
greedy_intra:edges_start:greedy,128,71358,23189,48169,97509,14,3;49;14;144;102;62;9;148;167;178;55;52;57;92;129;2;152;124;94;63;79;80;176;133;151;51;118;59;115;46;0;137;23;186;89;183;143;117;93;140;68;139;193;41;5;42;181;159;69;108;18;22;146;34;160;48;54;177;10;190;184;43;116;65;131;149;162;123;127;70;135;154;180;53;100;26;97;1;101;86;75;120;44;25;16;171;175;113;56;31;78;145;179;196;81;90;165;40;185;106,8035415962487792845,0.006426
greedy_intra:edges_start:greedy,129,71382,23110,48272,73716,7,129;92;57;55;52;49;102;148;9;62;144;14;3;178;106;185;40;165;90;81;196;179;145;78;31;56;113;175;171;16;25;44;120;75;86;53;180;154;135;70;127;123;162;149;131;65;116;43;184;84;190;10;177;54;48;160;34;146;22;18;108;69;159;181;42;5;41;193;139;68;140;93;117;143;183;89;186;23;137;0;46;115;59;118;51;151;133;176;80;79;63;94;121;100;26;101;1;97;152;2,7073389307394263599,0.003976
greedy_intra:edges_start:greedy,130,71468,22898,48570,51373,6,124;148;102;49;178;106;52;55;57;92;129;2;120;44;25;16;171;175;113;56;31;78;145;179;196;81;90;40;185;165;138;14;144;62;9;15;114;186;89;183;23;137;176;80;51;118;59;115;46;0;143;117;93;140;68;139;193;41;5;42;181;159;69;108;18;22;146;34;160;48;54;177;184;43;116;65;149;123;127;162;151;133;79;63;180;135;70;154;158;53;121;100;26;86;75;101;1;97;152;94,922920685422442376,0.002025
greedy_intra:edges_start:greedy,131,71765,23203,48562,45568,4,131;149;123;127;162;151;133;135;70;154;180;53;121;100;26;86;75;82;120;44;25;16;171;175;113;56;31;78;145;179;196;81;90;40;165;185;106;178;3;14;144;62;9;148;102;49;52;55;57;92;129;2;101;1;97;152;124;94;63;79;80;176;137;23;186;89;183;143;117;0;51;118;59;115;46;68;139;193;41;5;42;181;159;69;108;18;22;146;34;160;48;54;177;10;190;84;184;43;116;65,32776667934080986,0.002158
greedy_intra:edges_start:greedy,132,71834,23929,47905,60276,7,21;14;138;165;185;40;90;81;196;179;145;78;31;56;113;175;171;16;25;44;120;75;86;100;53;180;154;135;70;127;123;162;149;131;65;116;43;184;190;10;177;54;48;160;34;146;22;18;108;69;159;181;42;5;41;193;139;68;140;93;117;143;183;89;186;23;137;0;46;115;59;118;51;151;133;176;80;79;63;94;124;26;101;1;97;152;2;129;92;57;55;52;106;178;49;102;148;9;62;144,8394319500620145101,0.003000
greedy_intra:edges_start:greedy,133,72096,23591,48505,28767,3,133;151;51;118;59;115;46;0;137;23;186;89;183;143;117;93;140;68;139;193;41;5;42;181;159;69;108;18;22;146;34;160;48;54;177;10;184;43;116;65;131;149;162;123;127;70;135;154;180;53;121;100;26;86;75;82;129;57;92;55;52;49;102;148;9;62;144;14;3;178;106;185;165;40;90;81;196;179;145;78;31;56;113;175;171;16;25;44;120;2;101;1;97;152;124;94;63;79;80;176,8338707728632006383,0.002115
greedy_intra:edges_start:greedy,134,71794,22729,49065,90473,10,199;69;18;108;139;68;46;115;59;118;51;0;117;143;183;89;186;23;137;176;80;79;63;94;124;152;97;1;101;2;82;129;92;57;55;52;49;102;148;9;62;144;14;3;178;106;185;40;165;90;81;196;179;145;78;31;56;113;175;171;16;25;44;120;75;86;26;100;121;53;180;154;70;135;133;151;162;127;123;149;65;116;43;184;190;10;177;54;48;160;34;181;42;5;41;193;159;195;146;22,8972779157232216202,0.003073
greedy_intra:edges_start:greedy,135,71545,22975,48570,33773,2,135;70;154;158;53;121;100;26;86;75;101;1;97;152;94;124;148;102;49;178;106;52;55;57;92;129;2;120;44;25;16;171;175;113;56;31;78;145;179;196;81;90;165;40;185;138;14;144;62;9;15;114;186;89;183;23;137;176;80;151;51;118;59;115;46;0;143;117;93;140;68;139;193;41;5;42;181;159;69;108;18;22;146;34;160;48;54;177;184;43;116;65;149;123;127;162;133;79;63;180,4086754719814897539,0.000999
greedy_intra:edges_start:greedy,136,72296,23597,48699,45306,5,158;121;100;26;86;75;82;120;44;25;16;171;175;113;56;31;78;145;179;196;81;90;165;40;185;106;178;3;14;144;62;9;148;102;49;52;55;92;57;129;2;101;1;97;152;124;94;63;79;80;176;137;23;186;89;183;143;117;0;51;118;59;115;46;68;139;193;41;5;42;181;159;69;108;18;22;146;34;160;48;54;177;10;190;84;184;43;116;65;149;123;127;162;151;133;180;135;70;154;53,4628919619815154569,0.001774
greedy_intra:edges_start:greedy,137,71600,23030,48570,34433,2,137;23;183;89;186;114;15;9;62;144;14;138;165;185;40;90;81;196;179;145;78;31;56;113;175;171;16;25;44;120;2;129;92;57;55;52;106;178;49;102;148;124;94;152;97;1;101;75;86;26;100;121;53;158;154;70;135;180;63;79;133;162;127;123;149;65;116;43;184;177;54;48;160;34;146;22;18;108;69;159;181;42;5;41;193;139;68;140;93;117;143;0;46;115;59;118;51;151;80;176,741712148613304867,0.002001
greedy_intra:edges_start:greedy,138,71269,23207,48062,33479,3,138;14;144;62;9;148;102;49;178;106;52;55;57;92;129;2;152;97;1;101;100;26;124;94;63;79;80;176;133;151;51;118;59;115;46;0;137;23;186;89;183;143;117;93;140;68;139;193;41;5;42;181;159;69;108;18;22;146;34;160;48;54;177;10;190;84;184;43;116;65;131;149;162;123;127;70;135;154;180;53;86;75;120;44;25;16;171;175;113;56;31;78;145;179;196;81;90;165;40;185,9189813887444606396,0.001000
greedy_intra:edges_start:greedy,139,71373,23250,48123,67470,7,139;68;46;115;59;118;51;0;117;143;183;89;186;23;137;176;80;79;63;94;124;152;97;1;101;2;82;129;92;57;55;52;49;102;148;9;62;144;14;3;178;106;185;40;165;90;81;196;179;145;78;31;56;113;175;171;16;25;44;120;75;86;26;100;121;53;180;154;70;135;133;151;162;127;123;149;65;116;43;184;84;112;4;10;177;54;48;160;34;146;22;18;108;69;159;181;42;5;41;193,850489416982662020,0.003000
greedy_intra:edges_start:greedy,140,71626,23376,48250,44325,5,140;108;69;18;22;146;159;193;41;5;42;181;34;160;48;54;177;10;4;112;84;184;43;116;65;149;123;127;162;151;133;135;70;154;180;53;121;100;26;86;75;44;25;16;171;175;113;56;31;78;145;179;196;81;90;40;165;185;106;178;3;14;144;62;9;148;102;49;52;55;57;92;129;82;120;2;101;1;97;152;124;94;63;79;80;176;137;51;118;59;115;139;68;46;0;89;183;143;117;93,3763589574777519920,0.001773
greedy_intra:edges_start:greedy,141,71055,22464,48591,64362,9,23;186;114;89;183;143;0;117;93;140;68;46;115;139;193;41;5;42;181;159;69;108;18;22;146;34;160;48;54;177;10;190;184;43;116;65;59;118;51;151;133;162;123;127;70;135;154;180;53;121;100;26;86;75;44;25;16;171;175;113;56;31;78;145;179;196;81;90;40;165;185;106;178;3;14;144;62;9;148;102;49;52;55;57;92;129;82;120;2;101;1;97;152;124;94;63;79;80;176;137,4396550877999520637,0.003001
greedy_intra:edges_start:greedy,142,72235,23436,48799,35345,5,198;139;68;46;115;59;118;51;0;117;143;183;89;186;23;137;176;80;79;63;94;124;152;97;1;101;2;120;82;129;92;57;55;52;49;102;148;9;62;144;14;3;178;106;185;165;40;90;81;196;179;145;78;31;56;113;175;171;16;25;44;75;86;26;100;121;53;180;154;70;135;133;151;162;127;123;149;65;116;43;184;84;190;10;177;54;48;160;34;146;22;18;108;69;159;181;42;5;41;193,407086796874437080,0.002970
greedy_intra:edges_start:greedy,143,70682,22477,48205,72267,6,143;117;0;46;68;139;115;193;41;5;42;181;159;69;108;18;22;146;34;160;48;54;177;10;190;4;112;84;184;43;116;65;59;118;51;151;133;162;123;127;70;135;154;180;53;121;100;26;86;75;82;129;92;57;55;52;49;102;148;9;62;144;14;3;178;106;185;40;165;90;81;196;179;145;78;31;56;113;175;171;16;25;44;120;2;101;1;97;152;124;94;63;79;80;176;137;23;186;89;183,3540547426422423990,0.003000
greedy_intra:edges_start:greedy,144,71369,23307,48062,44685,4,144;14;138;165;185;40;90;81;196;179;145;78;31;56;113;175;171;16;25;44;120;75;86;100;53;180;154;135;70;127;123;162;149;131;65;116;43;184;84;190;10;177;54;48;160;34;146;22;18;108;69;159;181;42;5;41;193;139;68;140;93;117;143;183;89;186;23;137;0;46;115;59;118;51;151;133;176;80;79;63;94;124;26;101;1;97;152;2;129;92;57;55;52;106;178;49;102;148;9;62,7342457985569006035,0.002018
greedy_intra:edges_start:greedy,145,71651,23511,48140,46023,4,145;179;196;81;90;165;40;185;106;178;3;14;144;62;9;148;102;49;52;55;92;57;129;2;152;97;1;101;26;124;94;63;79;80;176;133;151;51;118;59;115;46;0;137;23;186;89;183;143;117;93;140;68;139;193;41;5;42;181;159;69;108;18;22;146;34;160;48;54;177;10;190;84;184;43;116;65;131;149;162;123;127;70;135;154;180;53;100;86;75;120;44;25;16;171;175;113;56;31;78,1969328289022956833,0.003003
greedy_intra:edges_start:greedy,146,71145,23172,47973,64738,5,146;181;34;160;48;54;177;10;190;4;112;84;184;42;43;116;65;149;123;127;162;151;133;135;70;154;180;53;121;100;26;86;75;120;82;44;25;16;171;175;113;56;31;78;145;179;196;81;90;40;165;185;106;178;3;14;144;62;9;148;102;49;52;55;57;92;129;2;101;1;97;152;124;94;63;79;80;176;137;23;186;89;183;143;117;0;51;118;59;115;46;68;139;41;193;159;69;108;18;22,621287652490598712,0.002999
greedy_intra:edges_start:greedy,147,71616,22958,48658,148977,18,30;177;10;190;184;43;116;65;59;118;115;46;0;51;151;133;162;123;127;70;135;154;180;53;121;100;26;86;75;120;82;44;25;16;171;175;113;56;31;78;145;179;196;81;90;165;40;185;106;178;3;14;144;62;9;148;102;49;52;55;57;92;129;2;101;1;97;152;124;94;63;79;80;176;137;23;186;89;183;143;117;93;140;68;139;41;193;159;69;108;18;22;146;195;181;42;160;34;48;54,7408776141668784412,0.006958
greedy_intra:edges_start:greedy,148,71222,23160,48062,78995,7,148;102;49;178;106;52;55;57;92;129;2;152;97;124;94;63;79;80;176;133;151;51;118;59;115;46;0;137;23;186;89;183;143;117;93;140;68;139;193;41;5;42;181;159;69;108;18;22;146;34;160;48;54;177;10;190;84;184;43;116;65;131;149;162;123;127;70;135;154;180;53;100;26;1;101;86;75;120;44;25;16;171;175;113;56;31;78;145;179;196;81;90;165;40;185;138;14;144;62;9,2885774776208494141,0.002977
greedy_intra:edges_start:greedy,149,71624,23501,48123,60532,6,149;123;127;162;151;133;135;70;154;180;53;121;100;26;86;75;82;120;44;25;16;171;175;113;56;31;78;145;179;196;81;90;40;165;185;106;178;3;14;144;62;9;148;102;49;52;55;57;92;129;2;101;1;97;152;124;94;63;79;80;176;137;23;186;89;183;143;117;0;51;118;59;115;46;68;139;193;41;5;42;181;159;69;108;18;22;146;34;160;48;54;177;10;4;112;84;184;43;116;65,5574607616614219396,0.003340
greedy_intra:edges_start:greedy,150,72903,23422,49481,98369,10,74;2;129;92;57;179;145;78;31;56;113;175;171;16;25;44;82;120;75;1;101;86;53;154;70;135;180;63;79;133;162;123;149;65;116;43;184;177;54;48;160;34;146;22;18;108;69;159;181;42;5;41;193;139;68;140;93;117;143;0;46;115;59;118;51;151;80;176;137;23;183;89;186;114;15;9;62;144;14;138;165;90;81;196;40;185;55;52;106;178;49;102;148;124;94;121;100;26;97;152,7595335270687623303,0.004000
greedy_intra:edges_start:greedy,151,71565,23003,48562,59660,5,151;133;162;123;127;70;135;154;180;53;121;100;26;86;75;82;120;44;25;16;171;175;113;56;31;78;145;179;196;81;90;165;40;185;106;178;3;14;144;62;9;148;102;49;52;55;57;92;129;2;101;1;97;152;124;94;63;79;80;176;137;23;186;89;183;143;117;0;51;118;59;115;46;68;139;193;41;5;42;181;159;69;108;18;22;146;34;160;48;54;177;10;190;84;184;43;116;65;131;149,2374657370594630775,0.002998
greedy_intra:edges_start:greedy,152,71633,23444,48189,46187,4,152;1;101;75;86;53;154;70;135;180;63;79;133;162;127;123;149;65;116;43;184;10;177;54;48;160;34;146;22;18;108;69;159;181;42;5;41;193;139;68;140;93;117;143;0;46;115;59;118;51;151;80;176;137;23;183;89;186;114;15;9;62;144;14;138;165;185;40;90;81;196;179;145;78;31;56;113;175;171;16;25;44;120;2;129;92;57;55;52;106;178;49;102;148;124;94;121;100;26;97,4049779815842992731,0.002999
greedy_intra:edges_start:greedy,153,71092,22958,48134,92498,12,93;0;46;68;139;115;193;41;5;42;181;159;69;108;18;22;146;34;160;48;54;177;10;4;112;84;184;43;116;65;59;118;51;151;133;162;123;127;70;135;154;180;53;121;100;26;86;75;82;120;44;25;16;171;175;113;56;31;78;145;179;196;81;90;165;40;185;106;178;3;14;144;62;9;148;102;49;52;55;57;92;129;2;101;1;97;152;124;94;63;79;80;176;137;23;186;89;183;143;117,5691853551579587199,0.004001
greedy_intra:edges_start:greedy,154,71545,22975,48570,32945,2,154;158;53;121;100;26;86;75;101;1;97;152;94;124;148;102;49;178;106;52;55;57;92;129;2;120;44;25;16;171;175;113;56;31;78;145;179;196;81;90;165;40;185;138;14;144;62;9;15;114;186;89;183;23;137;176;80;151;51;118;59;115;46;0;143;117;93;140;68;139;193;41;5;42;181;159;69;108;18;22;146;34;160;48;54;177;184;43;116;65;149;123;127;162;133;79;63;180;135;70,6637803340264859946,0.001000
greedy_intra:edges_start:greedy,155,71481,23576,47905,55784,6,21;14;138;185;40;165;90;81;196;179;145;78;31;56;113;175;171;16;25;44;120;75;86;101;1;97;26;100;53;180;154;135;70;127;123;162;149;131;65;116;43;184;190;10;177;54;48;160;34;146;22;18;108;69;159;181;42;5;41;193;139;68;140;93;117;143;183;89;186;23;137;0;46;115;59;118;51;151;133;176;80;79;63;94;124;152;2;129;92;57;55;52;106;178;49;102;148;9;62;144,6127584435179969562,0.003004
greedy_intra:edges_start:greedy,156,71542,22935,48607,116876,14,149;123;162;151;133;135;70;154;180;53;121;100;26;86;75;120;82;44;25;16;171;175;113;56;31;78;145;179;196;81;90;165;40;185;106;178;3;14;144;62;9;148;102;49;52;55;57;92;129;2;101;1;97;152;124;94;63;79;80;176;137;23;186;89;183;143;117;0;51;59;118;46;68;139;115;116;65;43;42;5;41;193;159;69;108;18;22;146;181;34;160;48;54;177;184;35;84;4;112;131,8198005672173053602,0.005794
greedy_intra:edges_start:greedy,157,71538,23223,48315,73693,7,157;196;81;90;165;40;185;106;178;3;14;144;62;9;148;102;49;52;55;179;145;78;92;57;129;2;152;124;94;63;79;80;176;133;151;51;118;59;115;46;0;137;23;186;89;183;143;117;93;140;68;139;193;41;5;42;181;159;69;108;18;22;146;34;160;48;54;177;10;190;184;43;116;65;131;149;162;123;127;70;135;154;180;53;86;26;100;97;1;101;75;120;44;25;16;171;175;113;56;31,2309885925840036617,0.003000
greedy_intra:edges_start:greedy,158,71413,22843,48570,35051,2,158;154;70;135;180;63;79;133;151;162;127;123;149;65;116;43;184;177;54;48;160;34;146;22;18;108;69;159;181;42;5;41;193;139;68;140;93;117;143;0;46;115;59;118;51;80;176;137;23;183;89;186;114;15;9;62;144;14;138;185;40;165;90;81;196;179;145;78;31;56;113;175;171;16;25;44;120;2;129;92;57;55;52;106;178;49;102;148;124;94;152;97;1;101;75;86;26;100;121;53,6691498765051892751,0.001000
greedy_intra:edges_start:greedy,159,71687,23437,48250,73003,7,159;146;22;18;69;108;140;93;117;143;183;89;0;68;46;139;115;59;118;51;137;176;80;79;63;94;124;152;97;1;101;2;129;57;92;55;52;49;102;148;9;62;144;14;3;178;106;185;40;165;90;81;196;179;145;78;31;56;113;175;171;16;25;44;82;120;75;86;26;100;121;53;180;154;70;135;133;151;162;127;123;149;65;116;43;184;84;112;4;10;177;54;48;160;34;181;42;5;41;193,620686114131901246,0.002000
greedy_intra:edges_start:greedy,160,70906,22933,47973,64685,5,160;48;54;177;10;190;4;112;84;184;42;43;116;65;149;123;127;162;151;133;135;70;154;180;53;121;100;26;86;75;120;44;25;16;171;175;113;56;31;78;145;179;196;81;90;165;40;185;106;178;3;14;144;62;9;148;102;49;52;55;57;92;129;82;2;101;1;97;152;124;94;63;79;80;176;137;23;186;89;183;143;117;0;51;118;59;115;46;68;139;41;193;159;69;108;18;22;146;181;34,4370570026670815402,0.003005
greedy_intra:edges_start:greedy,161,71610,22824,48786,87328,12,127;162;151;133;135;70;154;180;158;53;121;100;26;86;75;120;44;25;16;171;175;113;56;31;78;145;179;196;81;90;165;40;185;106;178;3;14;144;62;9;148;102;49;52;55;57;92;129;82;2;101;1;97;152;124;94;63;79;80;176;137;23;186;89;183;143;117;0;51;118;59;115;46;68;139;193;41;5;42;181;159;69;108;18;22;146;34;160;48;54;177;10;190;184;43;116;65;131;149;123,6099284962647978075,0.005001
greedy_intra:edges_start:greedy,162,71570,23447,48123,42784,5,162;151;133;135;70;154;180;53;121;100;26;86;75;120;44;25;16;171;175;113;56;31;78;145;179;196;81;90;165;40;185;106;178;3;14;144;62;9;148;102;49;52;55;92;57;129;82;2;101;1;97;152;124;94;63;79;80;176;137;23;186;89;183;143;117;0;51;118;59;115;46;68;139;193;41;5;42;181;159;69;108;18;22;146;34;160;48;54;177;10;190;4;112;184;43;116;65;149;123;127,4874058008665772795,0.001998
greedy_intra:edges_start:greedy,163,72036,23547,48489,43519,5,140;139;68;46;115;59;118;51;0;117;143;183;89;186;23;137;176;80;79;63;94;124;152;97;1;101;2;120;44;25;16;171;175;113;56;31;78;145;179;196;81;90;40;165;185;106;178;3;14;144;62;9;148;102;49;52;55;92;57;129;82;75;86;26;100;121;53;180;154;70;135;133;151;162;127;123;149;65;116;43;184;84;190;10;177;54;48;160;34;181;42;5;41;193;159;146;22;18;69;108,3802819748941041626,0.001906
greedy_intra:edges_start:greedy,164,72157,23629,48528,13865,1,164;7;95;39;165;138;14;144;62;9;148;102;49;178;106;52;55;57;92;129;2;152;97;1;101;100;53;180;154;135;70;127;123;162;149;65;116;43;184;177;54;48;160;34;146;22;18;108;69;159;181;42;5;41;193;139;68;140;93;117;143;183;89;23;137;0;46;115;59;118;51;151;133;176;80;79;63;94;26;86;75;120;44;25;16;171;175;113;56;31;78;145;179;196;81;185;40;90;27;58,6360587537707301859,0.001000
greedy_intra:edges_start:greedy,165,71431,23369,48062,30369,3,165;40;185;90;81;196;179;145;78;31;56;113;175;171;16;25;44;120;75;86;100;53;180;154;135;70;127;123;162;149;131;65;116;43;184;84;190;10;177;54;48;160;34;146;22;18;108;69;159;181;42;5;41;193;139;68;140;93;117;143;183;89;186;23;137;0;46;115;59;118;51;151;133;176;80;79;63;94;124;26;101;1;97;152;2;129;92;57;55;52;106;178;49;102;148;9;62;144;14;138,4395013700182104762,0.000999
greedy_intra:edges_start:greedy,166,71791,23246,48545,58720,8,35;184;190;10;177;54;48;160;34;146;22;18;108;69;159;181;42;5;41;193;139;68;140;93;117;143;183;89;186;23;137;176;80;79;63;94;124;152;97;1;101;2;120;82;129;92;57;55;52;49;102;148;9;62;144;14;3;178;106;185;40;165;90;81;196;179;145;78;31;56;113;175;171;16;25;44;75;86;26;100;121;53;180;154;135;70;127;123;162;133;151;51;0;46;115;118;59;65;116;43,1827497943019392956,0.003568
greedy_intra:edges_start:greedy,167,72630,24054,48576,36348,3,167;148;9;62;102;144;14;49;178;106;165;39;95;7;164;58;27;90;81;196;40;185;52;55;57;129;92;179;145;78;31;56;113;175;171;16;25;44;120;2;75;101;1;152;97;26;100;86;53;154;70;135;180;63;79;133;80;151;162;127;123;149;65;116;43;184;177;54;48;160;34;146;22;18;108;69;159;181;42;5;41;193;139;68;140;93;117;143;183;89;0;46;115;59;118;51;176;137;94;124,1593326820845899410,0.001820
greedy_intra:edges_start:greedy,168,71611,23164,48447,92729,11,157;31;56;113;175;171;16;25;44;120;75;86;53;180;154;135;70;127;123;162;149;131;65;116;43;184;190;10;177;54;48;160;34;146;22;18;108;69;159;181;42;5;41;193;139;68;140;93;117;143;183;89;186;23;137;0;46;115;59;118;51;151;133;176;80;79;63;94;121;100;26;101;1;97;152;2;129;92;57;55;52;49;102;148;9;62;144;14;3;178;106;185;40;165;90;81;196;179;145;78,990438296561065446,0.004030
greedy_intra:edges_start:greedy,169,71693,23456,48237,37257,7,157;179;145;78;31;56;113;175;171;16;25;44;120;75;86;100;53;180;154;135;70;127;123;162;149;131;65;116;43;184;190;10;177;54;48;160;34;146;22;18;108;69;159;181;42;5;41;193;139;68;140;93;117;143;183;89;186;23;137;0;46;115;59;118;51;151;133;176;80;79;63;94;124;26;101;1;97;152;2;129;92;57;55;52;106;178;49;102;148;9;62;144;14;138;165;185;40;90;81;196,2024713177198765313,0.001927
greedy_intra:edges_start:greedy,170,71015,22391,48624,76562,8,170;117;0;46;68;139;115;41;193;5;42;181;159;69;108;18;22;146;34;160;48;54;177;10;4;112;84;184;43;116;65;59;118;51;151;133;162;123;127;70;135;154;180;53;121;100;26;86;75;120;44;25;16;171;175;113;56;31;78;145;179;196;81;90;165;40;185;106;178;3;14;144;62;9;148;102;49;52;55;57;92;129;82;2;101;1;97;152;124;94;63;79;80;176;137;23;186;89;183;143,5235197032934005463,0.003001
greedy_intra:edges_start:greedy,171,71865,23725,48140,28770,4,171;175;113;56;31;145;78;92;179;196;81;90;40;165;185;106;178;3;14;144;62;9;148;102;49;52;55;57;129;2;152;97;1;101;100;26;124;94;63;79;80;176;133;151;51;118;59;115;46;0;137;23;186;89;183;143;117;93;140;68;139;193;41;5;42;181;159;69;108;18;22;146;34;160;48;54;177;10;190;84;184;43;116;65;131;149;162;123;127;70;135;154;180;53;86;75;120;44;25;16,513855254973376573,0.000997
greedy_intra:edges_start:greedy,172,71469,23004,48465,103997,10,124;167;148;9;62;102;144;14;49;178;106;165;39;27;90;81;196;40;185;52;55;57;129;92;179;145;78;31;56;113;175;171;16;25;44;120;2;75;101;1;152;97;86;26;100;121;53;180;154;135;70;127;123;162;149;131;65;116;43;184;177;54;48;160;34;146;22;18;108;69;159;181;42;5;41;193;139;68;140;93;117;143;183;89;186;23;137;0;46;115;59;118;51;151;133;176;80;79;63;94,2281651640140516454,0.004021
greedy_intra:edges_start:greedy,173,71673,23103,48570,61857,6,127;135;180;63;79;80;133;151;162;123;149;65;116;43;184;177;54;48;160;34;146;22;18;108;69;159;181;42;5;41;193;139;68;140;93;117;143;0;46;115;59;118;51;176;137;23;183;89;186;114;15;9;62;144;14;138;165;185;40;90;81;196;179;145;78;31;56;113;175;171;16;25;44;120;2;129;92;57;55;52;106;178;49;102;148;124;94;152;97;1;101;75;86;26;100;121;53;158;154;70,8789726362228746312,0.002000
greedy_intra:edges_start:greedy,174,71562,23500,48062,43741,11,196;40;185;179;145;78;31;56;113;175;171;16;25;44;120;75;86;26;124;94;63;79;80;176;133;151;51;118;59;115;46;0;137;23;186;89;183;143;117;93;140;68;139;193;41;5;42;181;159;69;108;18;22;146;34;160;48;54;177;10;190;84;184;43;116;65;131;149;162;123;127;70;135;154;180;53;100;101;1;97;152;2;129;92;57;55;52;106;178;49;102;148;9;62;144;14;138;165;90;81,1069051530154913063,0.002793
greedy_intra:edges_start:greedy,175,71794,23654,48140,38443,4,175;113;56;31;78;145;92;179;196;81;90;40;165;185;106;178;3;14;144;62;9;148;102;49;52;55;57;129;2;152;97;1;101;26;124;94;63;79;80;176;133;151;51;118;59;115;46;0;137;23;186;89;183;143;117;93;140;68;139;193;41;5;42;181;159;69;108;18;22;146;34;160;48;54;177;10;190;84;184;43;116;65;131;149;162;123;127;70;135;154;180;53;100;86;75;120;44;25;16;171,6599911936067635284,0.002439
greedy_intra:edges_start:greedy,176,71565,23003,48562,65969,5,176;80;79;63;94;124;152;97;1;101;2;129;92;57;55;52;49;102;148;9;62;144;14;3;178;106;185;40;165;90;81;196;179;145;78;31;56;113;175;171;16;25;44;120;82;75;86;26;100;121;53;180;154;135;70;127;123;162;133;151;149;131;65;116;43;184;84;190;10;177;54;48;160;34;146;22;18;108;69;159;181;42;5;41;193;139;68;46;115;59;118;51;0;117;143;183;89;186;23;137,1046554260545406134,0.003258
greedy_intra:edges_start:greedy,177,71735,23171,48564,85713,7,177;54;48;34;160;42;181;195;146;22;18;108;69;159;41;193;139;68;140;93;117;143;183;89;186;23;137;176;80;79;63;94;124;152;97;1;101;2;129;92;57;55;52;49;102;148;9;62;144;14;3;178;106;185;40;165;90;81;196;179;145;78;31;56;113;175;171;16;25;44;82;120;75;86;26;100;121;53;180;154;135;70;127;123;162;133;151;51;0;46;115;118;59;116;65;43;184;84;190;10,6953804561502415709,0.002997
greedy_intra:edges_start:greedy,178,71071,23009,48062,45915,5,178;49;102;148;9;62;144;14;138;165;185;40;90;81;196;179;145;78;31;56;113;175;171;16;25;44;120;75;86;101;1;97;26;100;53;180;154;135;70;127;123;162;149;131;65;116;43;184;84;190;10;177;54;48;160;34;146;22;18;108;69;159;181;42;5;41;193;139;68;140;93;117;143;183;89;186;23;137;0;46;115;59;118;51;151;133;176;80;79;63;94;124;152;2;129;92;57;55;52;106,4442104357215431065,0.001000
greedy_intra:edges_start:greedy,179,71299,23159,48140,44691,5,179;145;78;31;56;113;175;171;16;25;44;120;75;86;101;1;97;26;100;53;180;154;135;70;127;123;162;149;131;65;116;43;184;84;190;10;177;54;48;160;34;146;22;18;108;69;159;181;42;5;41;193;139;68;140;93;117;143;183;89;186;23;137;0;46;115;59;118;51;151;133;176;80;79;63;94;124;152;2;129;92;57;55;52;49;102;148;9;62;144;14;3;178;106;185;165;40;90;81;196,1279496772330561858,0.001992
greedy_intra:edges_start:greedy,180,71460,22890,48570,45559,3,180;135;70;154;158;53;121;100;26;86;75;101;1;97;152;94;124;148;102;49;178;106;52;55;57;92;129;2;120;44;25;16;171;175;113;56;31;78;145;179;196;81;90;165;40;185;138;14;144;62;9;15;114;186;89;183;23;137;176;51;118;59;115;46;0;143;117;93;140;68;139;193;41;5;42;181;159;69;108;18;22;146;34;160;48;54;177;184;43;116;65;149;123;127;162;151;133;80;79;63,3083333089212997743,0.001683
greedy_intra:edges_start:greedy,181,71022,23049,47973,35671,3,181;34;160;48;54;177;10;190;4;112;84;184;42;43;116;65;149;123;127;162;151;133;135;70;154;180;53;121;100;26;86;75;44;25;16;171;175;113;56;31;78;145;179;196;81;90;165;40;185;106;178;3;14;144;62;9;148;102;49;52;55;57;92;129;82;120;2;101;1;97;152;124;94;63;79;80;176;137;23;186;89;183;143;117;0;51;118;59;115;46;68;139;41;193;159;69;108;18;22;146,4679797441292716577,0.001000
greedy_intra:edges_start:greedy,182,71460,22890,48570,65046,5,158;154;70;135;180;63;79;80;133;151;162;127;123;149;65;116;43;184;177;54;48;160;34;146;22;18;108;69;159;181;42;5;41;193;139;68;140;93;117;143;0;46;115;59;118;51;176;137;23;183;89;186;114;15;9;62;144;14;138;185;40;165;90;81;196;179;145;78;31;56;113;175;171;16;25;44;120;2;129;92;57;55;52;106;178;49;102;148;124;94;152;97;1;101;75;86;26;100;121;53,2097931821801881102,0.002000
greedy_intra:edges_start:greedy,183,70721,22516,48205,67268,6,183;89;186;23;137;176;80;79;63;94;124;152;97;1;101;2;129;92;57;55;52;49;102;148;9;62;144;14;3;178;106;185;40;165;90;81;196;179;145;78;31;56;113;175;171;16;25;44;82;120;75;86;26;100;121;53;180;154;135;70;127;123;162;133;151;51;118;59;65;116;43;184;84;112;4;190;10;177;54;48;160;34;146;22;18;108;69;159;181;42;5;115;41;193;139;68;46;0;117;143,6766357787130252414,0.002969
greedy_intra:edges_start:greedy,184,71787,23287,48500,77497,6,184;43;116;65;59;118;115;46;0;51;151;133;162;123;127;70;135;154;180;53;121;100;26;86;75;120;82;44;25;16;171;175;113;56;31;78;145;179;196;81;90;40;165;185;106;178;3;14;144;62;9;148;102;49;52;55;57;92;129;2;101;1;97;152;124;94;63;79;80;176;137;23;186;89;183;143;117;93;140;68;139;193;41;5;42;181;159;69;108;18;22;146;34;160;48;54;177;10;190;84,4022189978451711369,0.003004
greedy_intra:edges_start:greedy,185,71288,23226,48062,63202,6,185;165;138;14;144;62;9;148;102;49;178;106;52;55;57;92;129;2;152;97;26;100;53;180;154;135;70;127;123;162;149;131;65;116;43;184;84;190;10;177;54;48;160;34;146;22;18;108;69;159;181;42;5;41;193;139;68;140;93;117;143;183;89;186;23;137;0;46;115;59;118;51;151;133;176;80;79;63;94;124;1;101;86;75;120;44;25;16;171;175;113;56;31;78;145;179;196;81;90;40,5536548500163636249,0.002999
greedy_intra:edges_start:greedy,186,71088,22883,48205,23978,2,186;89;183;143;117;0;46;68;139;193;41;115;5;42;181;159;69;108;18;22;146;34;160;48;54;177;10;190;4;112;84;184;43;116;65;59;118;51;151;133;162;123;127;70;135;154;180;53;121;100;26;86;75;82;129;57;92;55;52;49;102;148;9;62;144;14;3;178;106;185;165;40;90;81;196;179;145;78;31;56;113;175;171;16;25;44;120;2;101;1;97;152;124;94;63;79;80;176;137;23,3035226387122736373,0.000000
greedy_intra:edges_start:greedy,187,71627,23390,48237,64926,8,27;81;196;40;185;179;145;78;31;56;113;175;171;16;25;44;120;75;86;53;180;154;135;70;127;123;162;149;131;65;116;43;184;190;10;177;54;48;160;34;146;22;18;108;69;159;181;42;5;41;193;139;68;140;93;117;143;183;89;186;23;137;0;46;115;59;118;51;151;133;176;80;79;63;94;121;100;26;101;1;97;152;2;129;92;57;55;52;106;178;49;102;148;9;62;144;14;138;165;90,5976039711742664529,0.003000
greedy_intra:edges_start:greedy,188,71978,23663,48315,59357,7,157;31;56;113;175;171;16;25;44;120;75;86;53;180;154;135;70;127;123;162;149;131;65;116;43;184;190;10;177;54;48;160;34;146;22;18;108;69;159;181;42;5;41;193;139;68;140;93;117;143;183;89;186;23;137;0;46;115;59;118;51;151;133;176;80;79;63;94;124;26;100;101;1;97;152;2;129;57;55;52;49;102;148;9;62;144;14;3;178;106;185;165;40;90;81;196;179;92;145;78,8202418071260535645,0.003031
greedy_intra:edges_start:greedy,189,71740,22680,49060,35233,2,189;94;124;148;102;49;178;106;52;55;57;92;129;2;120;44;25;16;171;175;113;56;31;78;145;179;196;81;90;165;40;185;138;14;144;62;9;15;114;186;89;183;23;137;176;80;151;51;118;59;115;46;0;143;117;93;140;68;139;193;41;5;42;181;159;69;108;18;22;146;34;160;48;54;177;184;43;116;65;149;123;162;133;79;63;180;135;70;154;158;53;121;100;26;86;75;101;1;97;152,6101538233109302773,0.002000
greedy_intra:edges_start:greedy,190,71722,23545,48177,68382,6,190;10;177;54;48;34;160;42;181;146;22;18;108;69;159;193;41;139;68;46;115;118;59;116;65;43;184;35;131;149;123;162;151;133;51;0;117;143;183;89;23;137;176;80;79;63;94;124;152;97;1;101;2;129;92;57;55;52;49;102;148;9;62;144;14;3;178;106;185;165;40;90;81;196;179;145;78;31;56;113;175;171;16;25;44;120;82;75;86;26;100;121;53;180;154;135;70;127;112;4,8065933985651319628,0.002997
greedy_intra:edges_start:greedy,191,71876,23077,48799,66107,6,198;115;59;118;51;0;117;143;183;89;186;23;137;176;80;79;63;94;124;152;97;1;101;2;120;82;129;92;57;55;52;49;102;148;9;62;144;14;3;178;106;185;40;165;90;81;196;179;145;78;31;56;113;175;171;16;25;44;75;86;26;100;121;53;180;154;70;135;133;151;162;127;123;149;65;116;43;184;84;190;10;177;54;48;160;34;146;22;18;108;69;159;181;42;5;41;193;139;68;46,7637203431618758900,0.002971
greedy_intra:edges_start:greedy,192,71740,22893,48847,101907,10,96;5;42;181;159;69;108;18;22;146;34;160;48;54;177;10;190;184;43;116;65;59;118;115;46;0;51;151;133;162;123;127;70;135;154;180;53;121;100;26;86;75;120;44;25;16;171;175;113;56;31;78;145;179;196;81;90;165;40;185;106;178;3;14;144;62;9;148;102;49;52;55;57;92;129;82;2;101;1;97;152;124;94;63;79;80;176;137;23;186;89;183;143;117;93;140;68;139;193;41,3738522063522225994,0.004033
greedy_intra:edges_start:greedy,193,71915,23792,48123,27552,2,193;139;68;46;115;59;118;51;0;117;143;183;89;186;23;137;176;80;79;63;94;124;152;97;1;101;2;120;82;129;57;92;55;52;49;102;148;9;62;144;14;3;178;106;185;165;40;90;81;196;179;145;78;31;56;113;175;171;16;25;44;75;86;26;100;121;53;180;154;70;135;133;151;162;127;123;149;65;116;43;184;84;4;112;10;177;54;48;160;34;146;22;18;108;69;159;181;42;5;41,1822720911095571140,0.001997
greedy_intra:edges_start:greedy,194,72136,23165,48971,41214,3,194;127;123;162;133;151;149;131;65;116;43;184;190;10;177;54;48;160;34;146;22;18;108;69;159;181;42;5;41;193;139;68;46;115;59;118;51;0;117;143;183;89;186;23;137;176;80;79;63;94;124;152;97;1;101;2;120;82;129;92;57;55;52;49;102;148;9;62;144;14;3;178;106;185;165;40;90;81;196;179;145;78;31;56;113;175;171;16;25;44;75;86;26;100;121;53;180;154;70;135,1494515602604645039,0.001999
greedy_intra:edges_start:greedy,195,71624,23437,48187,28603,3,195;181;34;160;48;54;177;10;4;112;84;184;42;43;116;65;149;123;127;162;151;133;135;70;154;180;53;121;100;26;86;75;44;25;16;171;175;113;56;31;78;145;179;196;81;90;40;165;185;106;178;3;14;144;62;9;148;102;49;52;55;92;57;129;82;120;2;101;1;97;152;124;94;63;79;80;176;137;23;186;89;183;143;117;0;51;118;59;115;46;68;139;41;193;159;69;108;18;22;146,8067951526808974095,0.002001
greedy_intra:edges_start:greedy,196,71978,23329,48649,59781,8,196;81;90;165;40;185;106;178;3;14;144;62;9;148;102;49;52;55;57;129;92;179;145;78;82;2;152;97;1;101;26;100;121;94;63;79;80;176;133;151;51;118;59;115;46;0;137;23;186;89;183;143;117;93;140;68;139;193;41;5;42;181;159;69;108;18;22;146;34;160;48;54;177;10;184;43;116;65;131;149;162;123;127;70;135;154;180;53;86;75;120;44;25;16;171;175;113;56;31;157,3587450069167647068,0.003000
greedy_intra:edges_start:greedy,197,71999,23200,48799,79439,8,198;46;68;139;193;41;5;42;181;159;69;108;18;22;146;34;160;48;54;177;10;190;84;184;43;116;65;149;123;127;162;151;133;135;70;154;180;53;121;100;26;86;75;120;82;44;25;16;171;175;113;56;31;78;145;179;196;81;90;40;165;185;106;178;3;14;144;62;9;148;102;49;52;55;57;92;129;2;101;1;97;152;124;94;63;79;80;176;137;23;186;89;183;143;117;0;51;118;59;115,3290881336199561500,0.002975
greedy_intra:edges_start:greedy,198,71369,23246,48123,63109,7,68;46;115;59;118;51;0;117;143;183;89;186;23;137;176;80;79;63;94;124;152;97;1;101;2;82;129;92;57;55;52;49;102;148;9;62;144;14;3;178;106;185;40;165;90;81;196;179;145;78;31;56;113;175;171;16;25;44;120;75;86;26;100;121;53;180;154;70;135;133;151;162;127;123;149;65;116;43;184;112;4;190;10;177;54;48;160;34;146;22;18;108;69;159;181;42;5;41;193;139,4008535285551924702,0.003000
greedy_intra:edges_start:greedy,199,71467,23151,48316,78714,10,140;108;18;22;146;159;193;41;5;42;181;34;160;48;54;177;10;190;84;184;43;116;65;149;123;127;162;151;133;135;70;154;180;53;121;100;26;86;75;120;44;25;16;171;175;113;56;31;78;145;179;196;81;90;165;40;185;106;178;3;14;144;62;9;148;102;49;52;55;92;57;129;82;2;101;1;97;152;124;94;63;79;80;176;137;23;186;89;183;143;117;0;51;118;59;115;46;139;68;93,2825250559433545820,0.004004
