method,run,objective,tour_length,selected_costs,evaluations,improvements,final_selected,seed,duration_ms
steepest_intra:nodes_start:random,0,261787,161070,100717,1,0,14;99;182;174;105;0;40;143;19;49;95;185;165;159;61;189;170;42;137;102;70;91;136;63;17;183;41;90;198;27;78;114;30;89;111;135;85;87;16;138;120;32;187;110;167;139;108;166;194;162;104;26;107;69;186;21;145;158;68;23;117;197;103;64;199;163;179;192;157;168;50;116;44;146;152;36;39;124;132;73;3;119;51;13;169;2;66;57;122;88;46;77;20;54;60;173;133;100;121;34,8993114680935334661,0.000000
steepest_intra:nodes_start:random,1,263442,161008,102434,1,0,38;192;112;153;96;183;117;74;64;20;75;54;122;123;180;169;118;125;116;69;158;57;131;199;87;32;2;160;83;24;4;166;11;80;76;62;191;49;41;19;26;127;60;105;159;103;179;170;113;31;167;172;139;138;77;78;25;55;65;39;72;129;35;91;142;198;86;21;140;156;95;99;68;109;28;132;92;59;18;102;14;182;36;137;6;7;107;164;10;84;173;194;130;63;8;71;29;100;9;51,5716059494862726663,0.000000
steepest_intra:nodes_start:random,2,251800,160191,91609,2,1,167;136;116;64;48;155;151;130;104;58;24;66;106;175;138;35;153;3;20;184;112;57;31;176;168;63;19;183;0;113;6;188;90;179;17;132;73;22;177;87;67;37;128;75;29;191;18;186;118;178;185;14;86;76;148;43;93;163;71;33;11;53;193;84;70;162;5;120;34;124;119;40;107;26;145;108;158;195;85;101;80;111;181;52;15;160;30;96;2;7;115;170;99;78;147;49;198;137;165;32,7491811333229759592,0.000000
steepest_intra:nodes_start:random,3,267598,172791,94807,1,0,52;156;1;58;101;119;44;75;159;150;9;18;53;13;46;190;72;121;98;152;54;89;70;33;8;180;90;118;151;149;197;79;117;168;10;106;65;3;28;82;57;108;49;12;114;37;165;145;199;80;99;14;96;51;59;185;147;88;192;166;0;189;107;31;142;143;2;139;42;92;77;154;195;19;126;39;109;105;45;115;20;167;95;182;43;34;137;172;5;22;198;132;50;130;32;136;78;56;36;187,1225013710276457614,0.000000
steepest_intra:nodes_start:random,4,253430,160292,93138,1,0,168;49;0;67;18;102;150;66;14;90;19;72;103;199;64;160;44;65;192;134;137;20;47;29;91;121;48;167;131;158;197;53;140;55;138;170;71;120;56;173;75;177;155;41;1;196;100;54;89;3;106;145;144;16;13;156;133;112;129;32;127;143;42;77;60;191;178;10;17;62;157;148;34;27;101;25;28;85;23;113;194;2;189;74;115;8;61;180;125;182;164;26;37;7;185;186;146;108;96;70,1109336404822108108,0.000000
steepest_intra:nodes_start:random,5,259865,158996,100869,1,0,120;66;114;55;123;199;60;52;198;149;171;126;113;1;65;184;141;74;35;153;92;156;108;22;12;169;135;40;71;106;150;189;174;144;50;168;136;44;128;99;155;46;54;34;30;43;56;5;90;27;196;80;85;81;154;19;148;105;188;119;146;121;28;3;97;87;147;48;112;177;159;58;181;139;10;160;107;125;25;110;11;23;145;104;57;64;38;91;61;86;151;183;166;76;173;103;62;176;192;132,4560158261058580252,0.000000
steepest_intra:nodes_start:random,6,263813,171181,92632,2,1,128;106;71;0;143;171;186;104;84;31;170;162;193;62;48;15;22;40;4;60;188;83;52;14;13;117;187;82;17;116;134;20;179;153;119;130;189;58;75;3;137;6;110;100;115;195;105;136;140;166;157;165;97;184;56;53;16;158;168;147;135;86;42;61;178;142;38;63;70;46;96;185;131;111;29;155;146;59;163;51;144;44;120;112;65;43;21;26;5;77;66;36;34;69;85;79;108;152;124;74,6349845476004347683,0.000000
steepest_intra:nodes_start:random,7,269988,170274,99714,1,0,81;87;173;86;61;39;5;66;183;7;180;76;191;3;155;94;16;151;187;63;123;132;142;106;57;31;128;160;144;135;114;148;28;154;194;38;95;105;13;127;156;36;22;64;170;35;15;121;68;186;147;172;12;184;32;166;34;181;33;8;30;99;89;19;37;98;111;47;165;92;20;152;102;130;58;137;110;122;88;46;9;27;169;69;14;145;54;193;177;107;117;112;42;175;104;10;109;149;167;120,1218947573088910733,0.000000
steepest_intra:nodes_start:random,8,267171,163712,103459,2,1,49;73;23;175;143;193;162;177;27;81;89;76;7;47;51;93;144;150;98;43;153;4;111;118;88;99;161;133;168;45;67;106;100;110;113;21;90;181;5;65;125;84;94;138;87;170;6;57;56;24;189;191;52;195;131;178;130;25;26;123;80;198;68;137;9;167;46;128;166;196;83;152;188;69;75;186;16;140;105;112;158;33;185;15;169;124;187;103;77;38;163;28;173;134;48;11;114;194;59;122,2722378584131712550,0.000000
steepest_intra:nodes_start:random,9,282736,177138,105598,1,0,49;29;98;87;53;171;17;166;73;163;195;175;113;104;6;19;174;157;21;9;1;72;161;23;162;82;156;52;44;134;164;55;131;102;58;198;110;22;74;155;149;84;13;138;177;59;7;24;78;112;107;152;75;191;38;28;25;173;50;127;169;63;101;89;93;170;182;68;83;181;187;172;111;151;64;4;188;27;142;197;85;179;123;184;39;125;185;135;8;137;48;144;146;121;61;32;60;86;97;62,48575287528114547,0.000503
steepest_intra:nodes_start:random,10,271012,177256,93756,1,0,59;198;100;180;26;24;120;174;117;96;107;131;58;42;22;150;156;70;144;176;183;172;73;52;122;20;40;199;133;195;140;45;126;94;79;47;123;128;191;181;25;17;4;143;39;67;116;112;175;163;0;197;194;115;44;16;8;132;66;6;190;189;146;63;93;57;18;148;34;71;136;78;193;109;102;185;168;111;27;30;83;99;33;149;160;170;145;23;105;138;188;104;5;113;37;177;164;54;127;162,3602121400660626920,0.000000
steepest_intra:nodes_start:random,11,248263,153121,95142,2,1,66;155;70;76;41;99;126;145;12;43;112;15;27;8;97;23;159;86;26;10;59;38;122;57;137;173;114;4;9;130;141;2;128;164;72;161;158;74;75;117;55;64;102;148;50;118;105;16;46;129;22;103;166;187;168;106;182;176;34;69;100;28;29;78;14;127;189;186;144;172;88;1;80;89;147;198;19;177;63;167;17;143;178;101;115;79;125;123;32;95;160;36;62;116;90;107;149;196;163;77,5016190691787297342,0.000000
steepest_intra:nodes_start:random,12,272011,171227,100784,2,1,102;28;156;60;94;22;4;119;87;76;36;170;189;33;108;190;160;146;148;5;109;163;69;64;126;34;10;47;67;92;150;143;81;15;104;49;139;120;77;90;171;129;35;93;106;147;0;61;40;18;183;91;74;21;30;17;185;42;172;142;8;43;135;187;41;32;110;193;12;141;176;29;56;114;19;86;97;80;6;194;99;55;72;26;117;136;179;66;192;130;165;198;14;50;177;25;140;51;37;82,8701343468141501328,0.000000
steepest_intra:nodes_start:random,13,257049,154337,102712,2,1,181;36;141;161;143;82;184;93;41;103;48;70;173;120;69;84;177;29;86;31;44;2;32;149;146;34;111;55;118;30;188;137;104;65;51;191;159;113;61;109;87;83;152;139;58;64;178;71;153;117;164;196;114;12;25;90;19;169;106;163;6;50;192;190;142;72;138;189;15;101;9;166;21;60;17;132;199;28;168;1;145;68;150;185;39;108;134;126;186;91;37;135;66;13;3;49;96;160;175;92,4970536100648242132,0.000000
steepest_intra:nodes_start:random,14,266163,170851,95312,2,1,37;67;151;46;52;182;191;18;128;90;196;22;123;15;29;135;171;31;184;65;16;13;76;57;73;91;30;14;169;78;6;149;168;87;51;152;132;27;8;161;71;107;61;5;159;68;94;66;44;39;77;64;137;79;144;178;155;40;165;92;190;164;175;189;146;7;198;55;72;50;1;2;108;127;9;106;59;98;112;19;163;141;95;96;177;188;69;21;32;33;54;139;26;126;93;119;89;10;3;74,7228855182155081340,0.000000
steepest_intra:nodes_start:random,15,262771,166456,96315,2,1,168;99;159;68;176;37;77;152;90;48;140;181;49;92;143;7;20;41;133;30;195;25;46;93;33;38;16;70;29;73;104;191;179;22;162;62;107;47;194;56;185;199;163;126;121;72;132;134;112;128;3;65;193;96;40;186;180;189;145;51;149;59;89;147;26;42;4;174;108;69;101;118;60;5;83;10;91;17;63;2;34;11;131;52;98;24;105;88;109;15;28;120;45;124;13;138;78;136;154;18,1442105977783473452,0.000000
steepest_intra:nodes_start:random,16,272054,170541,101513,1,0,54;105;122;30;16;102;93;129;120;104;78;107;82;161;55;118;150;69;67;166;33;183;0;14;52;142;10;88;97;144;143;197;42;199;110;171;58;43;137;23;83;53;56;100;170;39;87;59;45;7;99;123;66;57;17;19;29;130;44;193;74;47;195;90;114;31;186;6;76;38;146;94;86;124;119;192;177;12;134;71;20;164;111;175;11;68;168;157;154;72;61;141;145;32;159;22;92;9;106;194,5981563739690553724,0.000000
steepest_intra:nodes_start:random,17,272576,166518,106058,2,1,178;78;195;168;94;4;46;71;121;3;95;52;6;147;182;21;42;120;177;36;37;118;55;157;176;137;164;190;12;44;165;124;91;77;117;17;122;9;127;110;65;187;166;96;16;15;155;130;119;167;138;140;67;80;160;93;50;150;154;58;99;35;156;131;179;174;109;142;29;53;170;97;76;169;45;141;152;104;116;11;172;162;7;24;38;81;75;108;114;20;43;66;73;8;161;125;189;14;62;163,5232836590842465818,0.000000
steepest_intra:nodes_start:random,18,262192,168701,93491,1,0,97;48;6;151;60;29;153;198;91;84;175;180;28;187;137;193;159;141;148;135;182;3;49;177;160;34;51;16;43;116;64;174;66;15;140;54;52;20;156;106;158;42;37;188;9;21;95;154;119;85;199;100;77;63;89;39;80;56;41;122;79;155;61;31;22;164;132;33;128;62;178;72;81;2;166;172;74;146;98;26;67;46;126;92;120;104;190;4;17;149;167;7;138;123;68;57;197;1;108;165,1988116862786491851,0.000000
steepest_intra:nodes_start:random,19,267076,170475,96601,1,0,34;192;59;92;156;183;57;127;63;21;86;54;112;18;198;115;132;13;128;163;131;170;191;143;66;178;78;88;114;129;166;189;22;6;97;26;89;105;81;169;72;23;109;44;90;119;4;82;117;10;180;133;85;69;64;83;135;32;67;196;1;96;106;181;138;70;74;61;7;161;95;11;60;27;187;148;47;184;19;87;100;3;190;35;79;111;29;55;108;175;177;12;58;84;145;62;140;172;75;195,4709581235545989246,0.000000
steepest_intra:nodes_start:random,20,265235,163650,101585,2,1,44;154;22;45;179;90;0;111;150;23;176;6;194;34;122;167;9;134;158;192;153;100;114;165;53;85;38;41;142;171;43;35;88;119;51;26;89;78;118;73;79;65;64;133;48;77;32;163;161;28;182;12;29;20;164;60;199;21;115;173;166;198;19;104;124;105;149;13;121;135;30;109;56;123;93;61;170;174;91;54;42;46;151;95;138;52;190;80;128;68;187;7;177;11;113;59;15;40;155;37,7836353743533337416,0.000000
steepest_intra:nodes_start:random,21,252918,157306,95612,2,1,35;41;67;77;89;178;195;69;74;47;3;84;42;0;66;79;36;190;48;82;192;33;155;73;127;199;139;107;102;9;96;181;38;145;70;117;146;5;156;95;97;160;183;28;54;137;22;34;121;8;151;18;27;94;148;135;122;133;101;174;44;187;172;57;168;78;134;60;88;188;157;55;72;52;29;198;43;45;166;120;68;154;170;164;10;15;93;13;176;184;177;132;26;58;153;129;162;136;161;62,5961867737077783057,0.000000
steepest_intra:nodes_start:random,22,273996,171928,102068,2,1,103;169;85;138;95;24;172;74;190;152;156;131;184;29;189;100;181;123;199;114;108;22;13;87;34;154;147;174;178;121;195;109;197;56;20;144;37;168;54;110;112;60;28;165;63;49;62;97;149;124;76;90;134;4;71;83;33;7;25;127;47;158;175;43;146;5;51;170;125;162;14;10;151;155;188;173;52;18;92;21;122;75;148;130;73;96;160;196;193;142;194;118;94;3;45;157;105;64;163;171,1122243297254168605,0.000000
steepest_intra:nodes_start:random,23,261528,161974,99554,1,0,15;66;17;38;10;45;59;195;128;160;37;167;70;71;176;3;32;119;34;147;179;92;114;197;178;149;124;80;64;75;5;98;199;76;129;191;26;94;63;16;169;102;84;72;85;6;47;69;23;123;74;91;18;150;144;73;62;172;117;196;65;130;87;183;90;137;181;41;168;42;46;143;145;165;57;60;141;86;14;156;111;184;78;188;19;136;12;126;13;198;127;43;163;121;21;115;29;77;142;81,1827864570916125580,0.000000
steepest_intra:nodes_start:random,24,261499,166016,95483,1,0,107;13;16;106;96;136;37;70;148;8;59;186;39;57;86;163;108;187;44;118;42;63;127;69;125;31;5;30;140;162;60;0;141;182;138;130;165;189;58;175;92;4;112;85;17;28;149;71;119;142;56;79;1;76;133;50;161;177;27;181;102;188;38;47;32;29;170;111;116;68;164;151;64;36;26;171;14;81;129;139;53;2;185;6;91;169;43;157;82;183;61;54;52;117;154;15;144;114;191;180,6263089962389274417,0.000000
steepest_intra:nodes_start:random,25,273760,170799,102961,2,1,19;34;54;131;61;115;38;55;77;16;176;120;123;29;157;59;140;174;48;79;9;87;33;180;109;92;152;42;144;170;100;65;66;24;148;199;133;95;188;163;63;173;96;179;14;197;161;191;112;28;62;108;72;99;71;60;129;78;190;184;88;111;49;171;143;186;67;17;30;5;50;128;12;57;43;118;53;124;119;122;137;132;127;98;45;91;172;189;107;147;83;85;41;198;130;182;165;4;15;58,7458811108153685440,0.000000
steepest_intra:nodes_start:random,26,252490,155840,96650,1,0,72;131;65;168;14;171;148;106;144;140;18;151;28;88;119;56;154;91;139;186;165;111;134;178;20;13;194;82;12;158;80;7;53;150;172;155;179;112;78;118;49;156;15;19;9;135;185;121;5;29;122;99;157;190;25;8;175;33;137;193;149;22;98;116;60;160;6;17;146;66;105;32;167;183;181;117;141;4;161;138;95;16;10;97;125;114;189;37;83;67;59;68;96;63;69;196;74;180;142;0,2647633207610774552,0.000000
steepest_intra:nodes_start:random,27,264609,164917,99692,2,1,121;157;74;185;36;67;137;94;197;5;19;111;135;54;4;184;84;83;102;171;149;37;51;198;141;62;191;113;20;87;92;114;3;186;101;90;59;43;106;146;172;110;15;124;175;180;187;88;142;148;144;178;2;134;65;140;30;71;7;89;16;153;120;38;60;73;1;96;6;164;10;154;145;163;42;55;32;99;108;152;130;160;24;39;76;109;72;35;188;98;77;29;52;47;40;86;107;58;61;161,3382267868805879960,0.000000
steepest_intra:nodes_start:random,28,257002,158188,98814,1,0,18;4;97;159;43;136;149;174;132;68;81;122;20;128;185;39;180;29;102;133;120;141;127;59;34;45;104;12;13;16;64;183;140;176;48;25;138;101;10;142;152;146;51;46;186;70;167;191;145;126;88;189;130;108;79;74;86;5;177;71;119;178;56;40;173;31;78;61;158;121;195;96;21;193;192;87;85;54;2;52;172;83;157;90;76;19;44;66;58;164;188;125;190;194;161;82;123;93;63;187,7656980541311723926,0.000000
steepest_intra:nodes_start:random,29,260643,167592,93051,2,1,186;0;146;187;116;60;140;130;193;178;64;5;114;10;199;191;177;154;55;89;52;176;47;123;37;162;53;126;110;100;125;105;135;29;3;58;179;95;85;94;166;17;171;18;51;56;22;4;174;170;173;96;79;149;36;127;163;129;128;84;161;43;72;81;24;54;175;63;159;195;62;21;59;101;70;69;2;71;30;119;156;143;41;181;77;12;49;108;83;183;147;57;91;118;31;148;145;39;132;6,880668300649854789,0.000000
steepest_intra:nodes_start:random,30,267530,175942,91588,1,0,143;39;83;167;74;72;134;75;140;55;21;155;44;196;65;95;40;168;37;133;25;70;90;93;154;71;176;182;52;63;22;81;73;69;178;20;144;116;173;42;16;193;66;8;41;130;111;100;198;180;142;171;68;151;51;113;136;145;98;159;177;19;186;97;114;29;115;26;0;108;117;64;101;96;34;77;149;13;107;104;172;185;86;157;12;163;156;31;164;118;174;192;119;2;128;197;131;62;91;153,2133148044768206364,0.000000
steepest_intra:nodes_start:random,31,276066,172289,103777,1,0,85;180;108;199;130;141;59;167;35;138;40;26;134;29;67;6;198;110;103;124;92;196;173;100;77;25;75;69;38;98;88;22;106;16;87;150;46;109;93;140;30;60;5;113;111;116;170;171;147;81;148;78;39;11;164;122;127;105;190;47;82;143;176;139;56;153;33;66;24;119;4;133;10;64;158;160;151;145;186;73;162;72;18;13;115;50;28;157;51;96;83;91;45;183;156;0;126;194;49;74,7634031719536893216,0.000504
steepest_intra:nodes_start:random,32,263707,164198,99509,2,1,78;193;26;88;104;35;28;42;130;105;85;98;190;95;38;97;125;171;197;71;14;119;184;27;89;59;58;167;151;154;4;30;109;54;94;47;137;159;100;48;122;102;17;99;127;46;150;124;142;68;182;121;43;40;9;93;147;123;22;64;33;155;16;96;129;176;90;131;128;55;110;24;174;168;12;23;91;49;165;186;118;163;162;29;21;25;101;199;56;66;143;138;196;146;169;61;149;183;198;87,7584270383656070707,0.000000
steepest_intra:nodes_start:random,33,264012,159060,104952,1,0,136;30;90;7;104;14;94;132;57;65;41;182;139;163;62;167;64;116;26;72;173;89;3;50;9;134;70;5;17;137;125;153;63;60;117;15;47;97;118;91;53;177;162;115;174;107;151;170;44;145;176;29;187;76;110;4;61;142;102;84;138;168;119;179;93;164;32;59;106;13;108;74;11;148;85;165;130;67;69;188;8;172;52;80;99;150;2;154;87;46;127;40;82;25;73;45;189;161;33;171,1945920412598154377,0.000000
steepest_intra:nodes_start:random,34,264114,166989,97125,2,1,68;2;31;192;171;13;159;71;189;28;37;111;196;76;133;123;183;103;69;108;86;64;163;115;114;130;197;65;146;138;112;191;160;132;185;42;161;39;41;122;190;89;80;17;45;88;136;174;56;40;104;51;32;147;194;173;149;124;165;145;18;162;143;67;53;96;57;44;99;8;72;73;5;102;6;1;187;153;151;140;152;186;15;25;195;0;49;21;121;170;7;179;178;113;110;19;85;63;167;75,6957528129276360792,0.000000
steepest_intra:nodes_start:random,35,270885,178464,92421,2,1,71;123;127;106;15;147;0;180;17;45;187;19;188;189;27;66;164;139;100;141;185;84;110;24;44;9;31;35;133;166;46;171;105;13;193;114;151;190;169;174;102;197;21;53;160;82;92;172;51;78;152;183;177;14;75;16;30;117;143;77;86;36;1;137;119;125;199;69;196;83;121;194;140;118;38;81;64;52;97;48;49;29;22;2;62;74;91;179;159;87;103;173;88;68;167;149;135;42;79;161,1846689354776453725,0.000000
steepest_intra:nodes_start:random,36,281530,177075,104455,2,1,153;24;98;92;7;72;12;20;25;110;67;188;121;6;184;194;28;64;147;142;91;164;173;180;114;30;129;83;140;169;159;115;42;143;177;107;116;103;196;108;61;170;146;58;74;190;149;76;106;8;47;131;100;162;82;193;187;195;123;26;148;156;81;39;71;79;176;44;144;80;4;16;9;96;75;197;174;172;85;31;167;49;73;150;87;34;57;127;89;191;113;182;43;168;128;62;145;134;105;66,8180638941156653770,0.000000
steepest_intra:nodes_start:random,37,259136,162359,96777,2,1,67;59;64;0;128;29;108;106;114;141;124;135;139;140;119;165;54;198;102;98;33;17;18;161;63;95;92;180;112;129;47;118;123;138;43;168;153;131;66;175;185;42;49;178;3;94;154;130;84;77;194;1;25;97;69;24;79;132;151;149;36;31;184;14;148;37;110;179;167;150;19;4;99;35;11;40;134;13;120;197;136;50;30;172;159;62;39;82;15;51;56;103;28;91;125;182;7;5;115;89,71863879748664408,0.000000
steepest_intra:nodes_start:random,38,271582,170028,101554,1,0,182;68;35;117;50;130;196;184;125;127;66;189;29;143;53;114;116;103;72;149;14;27;177;120;159;67;173;124;73;83;87;135;174;43;59;11;15;44;16;121;52;110;178;25;99;95;105;57;157;4;82;55;69;170;32;100;128;140;64;129;39;8;134;111;115;94;194;132;42;61;46;36;88;193;45;19;71;172;113;65;163;23;12;119;80;131;102;198;101;22;150;112;192;195;145;77;13;63;144;1,5032865980938579456,0.000000
steepest_intra:nodes_start:random,39,259516,158937,100579,1,0,15;118;135;16;96;138;87;94;78;123;38;171;97;120;40;197;26;162;128;49;147;119;59;139;64;130;137;134;172;166;173;35;12;100;36;92;181;22;186;132;136;8;27;131;32;23;66;156;73;126;191;115;185;41;82;83;37;85;56;50;86;129;111;60;4;62;105;195;114;160;127;109;177;21;65;20;153;84;18;48;169;51;117;39;174;180;142;161;43;106;88;107;155;158;9;102;25;76;196;1,5903076760268280251,0.000000
steepest_intra:nodes_start:random,40,259409,162681,96728,1,0,186;196;58;16;97;38;60;76;52;81;34;154;53;192;18;61;84;19;59;44;99;198;1;144;145;151;179;148;138;185;159;83;66;104;108;47;24;156;87;49;137;74;69;50;92;48;117;172;0;105;115;51;11;171;94;199;23;6;120;73;25;32;82;67;71;27;122;45;176;140;134;170;121;166;194;189;57;26;107;42;89;177;168;33;9;54;21;101;85;63;153;4;187;146;139;40;116;127;7;64,4633541725189761727,0.000000
steepest_intra:nodes_start:random,41,253300,158977,94323,2,1,141;146;28;9;58;114;173;183;79;108;106;184;153;133;3;73;116;175;78;186;100;137;179;148;26;177;159;135;17;93;120;99;4;59;60;38;6;122;37;167;180;11;7;41;151;47;174;19;124;168;95;143;107;48;44;51;130;55;52;115;65;144;157;169;40;125;182;197;22;111;139;76;147;98;126;198;156;150;43;176;97;81;158;142;164;85;127;36;72;101;31;112;105;53;34;66;149;2;92;121,2282772564258070505,0.000000
steepest_intra:nodes_start:random,42,266378,169726,96652,2,1,141;41;56;134;47;85;117;180;33;140;52;189;199;113;147;22;193;31;174;170;125;122;175;179;120;167;188;136;89;61;184;97;7;40;17;19;164;198;2;155;192;107;70;5;4;82;8;100;71;138;130;128;28;171;166;126;9;101;23;160;106;1;55;95;129;16;197;163;38;169;191;18;116;14;58;115;111;43;48;10;76;165;46;127;34;59;90;152;154;181;133;54;103;151;110;105;30;104;64;91,3088432245917044555,0.000000
steepest_intra:nodes_start:random,43,256983,159047,97936,1,0,122;188;37;61;52;157;102;13;197;67;76;116;17;142;60;162;152;191;143;11;12;170;51;18;46;144;99;106;130;95;153;174;97;64;184;165;186;65;62;90;1;196;112;58;175;66;119;187;109;135;3;193;84;72;168;38;10;107;57;25;176;73;77;104;177;161;133;114;23;39;198;127;30;35;91;180;21;154;181;156;171;32;121;108;9;82;47;75;78;137;19;22;48;150;139;183;140;117;24;195,6064865101850806371,0.000000
steepest_intra:nodes_start:random,44,256676,158020,98656,1,0,61;86;150;45;174;101;121;30;130;89;168;175;23;177;136;181;147;146;117;99;3;11;6;148;31;55;154;38;155;40;68;139;64;152;14;166;195;193;180;76;151;53;103;24;92;158;159;42;81;104;182;141;18;122;5;189;13;15;131;184;75;77;39;173;116;108;125;196;50;172;113;60;100;109;25;46;110;44;22;58;95;160;8;74;57;52;65;143;67;115;12;2;90;142;190;1;51;69;105;91,3252849874940519484,0.000000
steepest_intra:nodes_start:random,45,270073,163823,106250,2,1,58;52;137;85;128;45;51;40;132;89;2;187;72;106;23;198;120;177;17;76;151;94;46;176;149;68;99;24;38;131;175;116;13;168;64;8;97;170;199;195;141;88;80;20;154;188;169;95;15;147;139;21;6;148;30;4;75;61;43;166;48;117;129;112;159;74;130;180;81;143;41;163;66;37;5;172;174;157;142;11;110;105;25;152;59;119;36;98;82;83;121;56;192;65;196;191;179;16;32;185,3717552664869125743,0.000000
steepest_intra:nodes_start:random,46,248864,154137,94727,1,0,106;114;76;152;80;3;139;2;134;107;9;47;153;99;159;110;62;185;190;118;23;170;69;164;35;63;38;145;12;157;130;101;58;125;11;51;113;8;37;72;147;65;36;27;33;6;109;32;115;95;144;183;143;4;120;154;116;96;175;42;158;86;146;176;199;104;66;124;88;97;53;45;49;61;192;0;103;52;138;178;172;39;186;163;20;44;64;56;137;46;54;161;189;191;119;21;79;133;34;1,41569319940398138,0.000000
steepest_intra:nodes_start:random,47,278958,176778,102180,1,0,56;107;117;82;195;128;94;100;68;13;66;34;16;60;12;69;101;73;86;120;197;103;113;125;7;14;110;187;62;106;162;163;37;11;116;154;182;24;123;157;199;6;47;5;159;85;18;121;88;45;95;74;150;93;79;70;140;3;75;141;72;1;25;184;22;98;105;127;164;50;188;15;84;39;42;144;27;26;63;143;112;167;161;49;147;114;77;132;65;190;67;20;179;44;64;186;76;109;166;31,2625673586386672913,0.000000
steepest_intra:nodes_start:random,48,276683,175995,100688,1,0,166;75;162;190;65;111;38;3;17;24;138;5;20;70;44;7;39;35;97;54;189;182;49;164;159;195;167;198;92;73;165;192;2;149;199;68;47;161;94;136;6;105;109;25;117;13;80;64;168;71;86;28;76;196;22;185;173;58;160;77;14;87;40;142;11;121;69;96;122;30;23;112;1;103;186;174;127;21;113;197;180;90;72;16;132;34;110;37;4;100;156;123;93;169;32;179;183;128;131;36,1660145116406759292,0.000000
steepest_intra:nodes_start:random,49,260617,160092,100525,1,0,108;38;155;165;171;158;64;74;66;146;16;177;162;127;190;148;180;84;100;71;17;61;46;89;175;189;161;6;13;49;187;136;105;174;149;157;131;117;130;121;55;62;88;81;111;156;3;140;80;68;10;115;154;48;95;21;110;67;195;26;2;183;60;159;104;54;47;113;139;169;176;188;112;73;128;35;99;172;168;86;96;181;163;65;125;137;199;182;1;78;30;94;85;93;186;31;164;119;32;114,6649727981281390824,0.000000
steepest_intra:nodes_start:random,50,274673,182284,92389,2,1,168;158;70;96;79;119;54;151;147;138;74;44;114;16;82;133;166;50;76;90;106;47;122;11;1;181;164;152;51;148;175;100;117;75;170;33;112;120;140;46;58;43;38;12;34;73;193;198;184;20;87;134;15;176;103;19;115;59;10;132;188;42;139;169;190;98;177;118;60;22;86;78;162;104;136;124;32;143;192;165;137;71;84;4;153;130;101;125;21;135;29;49;48;109;159;2;24;189;129;0,4316309263419181023,0.000000
steepest_intra:nodes_start:random,51,265050,162881,102169,1,0,20;192;77;168;179;72;28;123;163;106;55;125;2;23;122;0;85;155;116;21;50;34;181;157;93;81;186;172;110;124;101;109;104;141;183;131;193;90;189;75;7;164;82;145;8;11;31;184;121;37;154;166;41;127;19;195;87;120;67;102;142;6;119;43;48;70;84;169;194;197;147;136;92;63;114;52;187;46;188;173;162;130;25;115;10;47;171;156;95;129;86;1;74;146;138;12;94;38;161;100,7006889624750794743,0.000000
steepest_intra:nodes_start:random,52,254115,159054,95061,2,1,105;76;119;89;143;28;103;54;161;23;112;168;183;63;125;18;141;48;78;151;126;52;65;184;91;33;180;62;102;99;2;13;4;164;152;133;42;27;6;57;16;44;50;113;79;64;138;61;49;179;15;14;188;0;172;110;97;175;51;39;68;107;46;109;87;153;137;96;95;150;193;12;157;74;55;120;82;9;177;140;92;154;73;135;69;122;149;197;19;85;106;75;136;134;100;155;101;22;132;170,922675451672193396,0.000000
steepest_intra:nodes_start:random,53,276768,177099,99669,1,0,38;114;73;125;161;139;78;131;147;190;182;142;155;3;98;141;145;199;129;148;192;18;149;138;16;150;115;189;27;69;188;124;94;117;160;130;101;90;175;33;144;179;99;95;105;180;134;104;55;46;193;92;93;86;197;40;0;50;14;112;108;97;67;120;8;6;26;156;167;44;64;54;62;146;121;24;158;31;47;13;132;172;85;7;169;154;34;185;39;72;178;57;171;107;183;83;119;35;28;17,8898455887173222999,0.000000
steepest_intra:nodes_start:random,54,264887,167400,97487,1,0,130;82;132;60;171;79;164;101;185;20;194;144;30;134;128;113;123;99;148;188;111;179;11;159;40;81;4;19;1;24;13;119;172;115;23;197;189;61;173;35;181;131;106;87;34;143;97;135;27;193;43;37;12;10;33;129;126;76;133;95;110;157;65;91;94;49;178;15;105;2;88;22;152;125;191;182;150;57;90;149;84;136;93;146;160;42;18;112;68;170;86;107;177;66;83;56;183;45;78;158,7348007920381256388,0.000000
steepest_intra:nodes_start:random,55,262463,168230,94233,1,0,7;100;187;26;49;107;160;147;93;83;86;80;192;139;167;124;71;24;27;52;89;199;59;31;165;188;161;194;168;41;87;198;21;25;146;176;6;94;137;128;17;23;133;104;149;29;169;18;148;11;123;96;184;110;101;13;138;115;144;22;141;174;195;114;119;122;2;190;91;8;78;150;70;173;39;90;46;126;153;16;10;157;63;9;82;30;20;43;62;113;145;66;129;180;54;72;40;32;177;164,7771090582351498866,0.000000
steepest_intra:nodes_start:random,56,255683,158889,96794,2,1,23;152;71;98;59;84;58;118;191;106;11;124;65;22;149;64;38;175;27;18;114;94;120;3;117;32;121;168;87;141;119;172;53;21;102;14;182;183;41;161;123;68;16;81;130;29;72;163;30;131;88;31;158;186;93;70;44;198;63;60;6;144;128;167;97;178;101;85;115;7;57;73;13;99;126;196;95;96;188;197;165;194;142;180;56;166;135;160;55;113;162;54;24;40;89;92;83;61;74;153,6013905524214584888,0.000000
steepest_intra:nodes_start:random,57,264385,169194,95191,1,0,136;149;22;84;131;24;167;51;120;163;45;172;31;108;20;1;37;57;130;79;169;174;199;89;124;63;106;173;32;28;67;155;50;109;16;88;26;196;100;68;55;123;4;177;90;198;128;180;58;70;170;27;186;184;164;187;101;171;83;11;189;150;82;151;142;185;133;18;116;118;78;134;33;115;105;73;38;179;122;53;44;43;125;34;194;47;139;56;46;168;135;81;152;86;197;143;3;140;75;71,1191939940944623219,0.000000
steepest_intra:nodes_start:random,58,258412,167048,91364,1,0,102;55;53;35;5;178;90;139;128;98;21;93;122;105;109;79;146;0;150;7;54;165;197;46;87;142;28;101;112;185;194;166;33;129;13;116;155;179;59;114;123;106;44;117;141;26;42;76;61;99;108;110;156;97;107;159;160;151;29;50;111;1;145;148;152;92;36;3;49;140;167;121;193;62;125;103;47;158;137;40;51;162;173;12;190;63;174;134;176;70;27;48;38;37;65;184;43;175;177;127,6119265047118170945,0.000000
steepest_intra:nodes_start:random,59,256280,166697,89583,2,1,96;46;89;139;93;82;172;171;156;26;154;5;153;187;185;143;13;179;40;67;81;123;112;104;196;197;133;84;95;78;42;88;75;20;55;43;118;113;137;53;64;138;116;176;57;8;19;101;165;49;54;175;151;107;148;105;121;50;114;130;24;12;70;16;74;11;58;194;17;129;119;44;25;41;183;39;180;14;51;188;38;106;195;48;140;144;22;117;100;199;135;91;92;128;102;36;150;167;3;6,5632990129207550107,0.000000
steepest_intra:nodes_start:random,60,264723,172842,91881,1,0,129;42;11;78;98;186;22;165;19;187;103;185;51;28;75;133;123;46;145;162;137;7;27;80;12;191;40;111;96;130;91;144;131;181;25;126;179;163;77;158;31;65;105;79;93;132;34;148;47;70;84;35;169;90;180;0;59;128;37;68;14;127;32;13;150;76;61;33;24;71;60;177;102;26;97;95;23;121;114;188;69;195;16;139;62;154;151;152;104;82;74;2;160;1;138;159;53;5;125;45,3639171280466700387,0.000000
steepest_intra:nodes_start:random,61,254121,151254,102867,1,0,142;199;159;97;37;191;100;119;193;73;118;158;70;63;51;101;195;67;104;10;103;4;11;94;66;36;184;22;83;174;76;114;42;147;181;29;13;5;25;132;198;185;182;176;106;40;87;172;141;6;26;175;95;128;183;30;27;131;69;133;163;170;130;140;121;12;171;107;89;197;58;62;15;75;116;7;166;47;120;54;156;192;105;50;88;60;143;112;55;78;109;38;82;28;34;46;20;108;160;86,7531538688303419164,0.000000
steepest_intra:nodes_start:random,62,257901,156454,101447,2,1,9;8;27;23;169;0;185;58;85;117;57;124;121;64;162;155;196;73;173;40;86;34;81;55;118;144;44;88;12;137;174;91;52;97;151;166;77;101;123;191;134;154;100;104;22;111;195;51;147;21;35;106;146;143;61;33;189;5;192;38;119;142;115;145;25;130;62;131;96;99;46;188;71;2;153;66;112;94;122;164;180;116;149;76;113;125;68;60;150;11;72;83;84;15;59;98;48;47;120;45,3861441155420981964,0.000000
steepest_intra:nodes_start:random,63,256007,163866,92141,1,0,199;181;160;170;5;111;147;186;133;179;198;95;34;146;63;127;66;40;172;67;86;28;169;173;108;158;1;75;150;36;123;58;73;166;101;9;94;197;145;85;54;194;91;124;118;149;24;102;89;187;65;37;113;45;43;165;116;176;163;180;82;53;12;139;119;18;105;72;151;171;96;19;178;115;90;114;62;93;57;125;121;161;128;26;191;148;92;55;81;14;154;137;52;192;48;189;126;39;23;8,8982337183192769994,0.000000
steepest_intra:nodes_start:random,64,278379,175098,103281,1,0,13;106;125;85;164;23;11;158;14;174;72;47;61;83;165;19;194;124;134;86;184;117;149;7;170;2;123;54;185;177;140;21;126;132;189;127;5;190;70;37;79;59;81;159;172;128;95;136;26;98;179;169;103;155;22;75;29;16;122;195;88;162;130;99;4;167;181;112;145;84;92;120;191;34;144;74;67;108;10;69;38;65;141;186;76;187;63;192;50;197;129;42;109;156;6;160;163;168;78;25,8833974425080854530,0.000000
steepest_intra:nodes_start:random,65,251159,151780,99379,2,1,183;4;108;158;126;86;46;176;146;182;80;96;26;135;184;10;180;101;64;45;192;38;44;12;144;93;142;156;127;189;190;77;122;61;83;92;37;161;131;196;29;140;133;99;18;73;186;199;21;43;137;124;3;128;49;143;31;175;72;110;90;15;35;88;74;125;58;47;54;116;28;0;11;167;112;89;59;154;36;34;197;148;147;100;19;6;107;52;79;102;68;155;164;104;39;129;13;145;166;9,597785569115629610,0.000000
steepest_intra:nodes_start:random,66,260781,168828,91953,1,0,146;164;171;116;65;187;47;29;78;118;83;2;44;21;41;169;26;193;126;141;117;19;90;91;194;136;16;114;80;66;93;159;148;122;196;1;113;88;71;96;40;14;125;85;70;151;177;152;73;154;57;124;50;23;134;149;7;167;140;59;143;22;89;101;32;76;181;120;158;173;46;39;45;137;10;77;28;15;115;138;54;170;160;95;67;109;153;86;4;6;157;165;110;75;104;161;20;182;144;135,2863977446359318033,0.000000
steepest_intra:nodes_start:random,67,245174,148568,96606,1,0,100;0;130;159;87;135;96;76;146;89;111;190;139;184;158;82;1;6;28;133;34;125;55;51;90;160;179;37;11;54;3;40;115;65;33;17;24;162;19;124;39;32;36;104;72;175;57;75;151;165;22;42;61;114;112;197;14;99;140;62;4;80;170;64;9;101;18;137;195;12;43;41;189;35;141;2;70;45;58;97;152;15;148;83;71;98;168;10;110;166;50;91;169;16;127;172;86;171;119;157,3754695525203608202,0.000000
steepest_intra:nodes_start:random,68,263532,167124,96408,2,1,147;199;94;184;1;105;28;31;118;51;195;26;142;151;135;114;8;32;6;182;34;11;109;108;45;18;86;121;59;37;49;97;69;162;39;52;196;192;44;10;103;98;160;143;127;27;100;90;33;126;55;159;102;173;89;176;61;12;137;178;87;83;76;140;74;20;66;63;25;72;115;117;0;82;16;145;48;190;96;183;92;71;54;146;85;136;172;166;154;141;4;155;104;129;139;50;93;197;148;101,8165436302913184934,0.000000
steepest_intra:nodes_start:random,69,257726,157537,100189,2,1,0;44;27;140;154;36;190;108;73;25;64;71;184;197;46;186;130;137;143;75;132;92;88;191;175;83;59;144;12;155;62;180;9;114;160;51;118;181;149;30;109;159;145;153;111;133;138;142;198;188;19;87;43;38;150;169;61;194;167;11;161;35;136;50;81;106;177;103;13;79;82;196;123;57;1;60;32;178;139;107;126;91;77;129;2;100;127;52;185;37;74;89;162;97;171;68;24;31;33;76,5205752988996837175,0.000000
steepest_intra:nodes_start:random,70,265037,165372,99665,1,0,134;115;66;42;90;165;107;152;176;25;57;32;24;37;4;5;28;83;128;116;169;34;157;67;141;96;114;31;27;69;56;108;46;99;187;180;18;36;159;79;171;82;154;110;100;23;160;138;15;94;0;11;148;119;35;70;118;30;85;103;133;130;193;63;8;156;13;88;47;117;59;62;132;39;168;84;122;75;145;6;2;127;147;3;162;150;77;123;91;131;112;173;197;170;163;199;151;20;93;179,4731433244095411757,0.000000
steepest_intra:nodes_start:random,71,262101,163970,98131,1,0,79;198;108;134;171;64;53;137;57;84;196;164;52;23;120;65;33;168;176;167;100;157;186;95;89;4;76;191;114;127;45;99;107;181;116;72;21;102;128;88;153;180;177;54;85;42;61;139;187;163;193;86;140;9;27;81;175;98;5;184;131;158;47;92;35;160;44;24;43;20;124;111;192;199;156;104;159;174;123;194;18;101;49;70;50;28;17;82;189;148;13;161;46;6;145;73;93;146;22;172,3653681987812069981,0.000000
steepest_intra:nodes_start:random,72,269653,170070,99583,2,1,167;64;11;172;186;187;128;106;195;188;174;193;23;0;39;50;126;16;53;114;17;34;32;40;72;28;49;131;63;6;142;83;67;24;107;121;185;151;120;123;95;147;150;76;155;58;98;116;88;134;79;166;124;171;135;60;169;100;59;199;139;180;25;125;190;42;81;74;82;137;78;184;158;118;18;62;56;85;3;90;149;161;138;192;86;191;196;52;162;122;133;117;46;176;189;12;157;112;127;2,3659377468105845535,0.000000
steepest_intra:nodes_start:random,73,282017,180316,101701,1,0,1;5;180;6;177;193;85;103;91;30;59;9;154;116;17;27;64;3;80;141;156;96;32;115;84;195;139;38;61;31;98;184;151;106;153;60;157;130;95;199;71;166;113;86;183;176;78;67;56;163;189;182;23;122;0;33;107;14;83;159;129;123;138;43;125;65;34;146;89;133;19;55;171;169;45;41;117;100;73;29;77;24;58;134;121;20;150;142;164;149;198;110;186;148;102;104;49;147;26;39,1968560776645535619,0.000000
steepest_intra:nodes_start:random,74,266136,169517,96619,1,0,157;120;159;172;140;181;54;97;56;85;125;28;87;73;83;91;154;20;61;44;81;52;127;185;72;183;30;96;149;148;195;55;86;111;171;27;59;90;173;33;119;102;5;175;153;146;138;46;67;62;16;3;107;76;26;95;123;193;145;132;109;177;116;101;163;131;99;114;49;136;162;2;189;53;142;23;57;41;36;147;0;192;170;14;43;50;17;12;11;164;178;70;128;4;174;42;191;161;139;108,1028529798760431435,0.000000
steepest_intra:nodes_start:random,75,272133,180419,91714,1,0,21;123;80;194;73;35;188;1;32;70;198;16;176;61;79;107;163;115;155;171;96;153;45;26;165;189;0;124;157;116;56;10;66;128;93;154;178;148;42;86;75;166;172;84;74;126;7;187;183;2;142;98;119;137;94;71;54;110;117;63;85;76;67;145;65;136;164;46;193;58;59;159;48;127;180;44;132;109;135;82;146;19;18;150;43;60;34;108;112;22;151;15;57;105;55;27;24;36;186;12,6606578879638310528,0.000000
steepest_intra:nodes_start:random,76,263370,166456,96914,1,0,58;195;146;19;97;67;62;164;2;112;155;138;157;179;98;66;177;152;13;174;186;77;118;21;57;134;48;85;117;34;5;140;40;73;107;43;137;69;86;102;4;41;106;63;111;32;18;7;156;149;100;133;148;194;187;135;109;110;95;16;49;9;172;126;161;89;26;50;103;68;116;108;154;36;33;120;70;12;173;124;61;115;192;175;44;162;170;56;196;160;182;3;14;159;121;46;72;163;188;23,6117663364103715456,0.000000
steepest_intra:nodes_start:random,77,263164,165673,97491,1,0,32;5;86;88;78;2;34;79;193;29;11;164;16;0;191;107;47;190;38;83;35;140;39;171;68;172;44;56;67;22;49;13;156;77;36;161;94;149;130;82;14;181;64;33;176;40;99;103;199;148;72;133;8;26;183;158;15;112;142;23;145;178;157;159;101;65;194;24;60;129;51;150;143;53;166;116;111;196;179;19;189;188;174;198;59;12;146;90;109;4;147;31;18;105;100;185;120;126;54;98,3517941280545863766,0.000000
steepest_intra:nodes_start:random,78,254046,157219,96827,2,1,137;18;143;15;140;195;78;60;139;61;52;6;160;23;8;106;100;157;169;58;95;93;13;98;125;40;161;65;11;177;36;90;110;132;22;130;134;79;19;120;123;183;187;176;64;91;181;30;42;71;62;104;47;74;154;32;155;109;150;174;144;129;172;149;173;105;194;17;190;147;180;27;131;191;77;21;184;94;37;112;49;9;10;142;80;193;86;148;68;178;70;57;196;102;92;107;14;76;115;31,7637289877244942388,0.000000
steepest_intra:nodes_start:random,79,259251,170228,89023,2,1,43;3;16;20;74;64;162;156;47;63;19;45;165;187;25;57;84;166;117;197;106;103;54;176;75;59;28;105;50;18;151;92;122;149;21;127;118;119;35;112;186;173;42;160;174;15;177;199;178;8;121;13;113;111;128;78;29;146;102;120;110;104;86;26;90;170;137;4;55;100;155;138;158;96;97;135;2;134;126;91;115;31;89;136;139;6;7;142;52;0;44;34;79;23;68;184;185;163;116;154,2531032666779378711,0.000000
steepest_intra:nodes_start:random,80,260524,160801,99723,1,0,128;146;63;19;59;129;168;173;43;110;130;171;70;133;66;6;62;164;194;106;137;109;153;25;172;91;76;177;118;27;116;40;162;135;45;127;111;79;151;77;50;184;180;72;196;4;97;74;64;41;197;24;8;96;104;33;65;181;11;73;10;125;155;37;191;92;88;23;75;78;174;183;140;52;93;9;144;57;21;188;114;17;159;53;121;89;105;13;123;103;187;154;150;83;14;145;192;86;30;94,7241486251183819221,0.000000
steepest_intra:nodes_start:random,81,269162,171953,97209,1,0,181;150;74;90;28;188;82;130;63;64;157;197;190;73;42;6;86;179;123;177;38;187;140;19;158;97;5;33;156;69;23;98;89;0;78;3;137;100;110;117;148;10;75;165;164;76;142;182;48;128;55;57;112;199;40;101;46;49;166;70;138;54;149;37;185;163;195;12;87;47;196;184;119;114;32;145;34;65;183;135;50;144;131;44;24;61;161;102;62;80;153;36;106;105;72;7;162;124;85;191,560732905463808232,0.000000
steepest_intra:nodes_start:random,82,260104,158609,101495,1,0,39;99;59;14;38;175;186;118;41;104;132;77;193;102;88;20;117;42;131;21;181;5;29;156;36;1;31;47;139;52;6;182;53;187;141;176;133;169;121;90;13;28;160;153;45;113;147;3;37;85;122;82;158;8;80;189;185;159;24;64;15;87;110;57;83;23;55;73;184;67;178;17;2;97;150;48;56;40;127;130;137;155;136;66;63;98;163;120;197;146;30;106;62;100;92;126;58;196;0;71,5492174333644314028,0.000000
steepest_intra:nodes_start:random,83,277097,178879,98218,1,0,177;71;119;171;180;58;69;53;39;157;51;181;144;104;23;90;72;36;174;130;78;33;146;160;89;128;141;35;190;34;118;129;145;168;111;68;94;49;22;106;0;61;195;30;122;149;92;11;64;115;138;137;175;148;192;187;101;155;105;107;110;27;47;185;96;12;139;121;136;186;2;176;18;28;75;162;135;5;60;85;70;182;73;172;62;4;142;82;67;199;196;74;91;125;98;156;113;151;66;134,2360096782301502217,0.000000
steepest_intra:nodes_start:random,84,261663,158732,102931,2,1,89;13;158;92;153;190;138;117;33;91;102;82;126;2;4;11;21;79;1;188;45;168;125;175;185;24;83;139;107;51;104;5;196;32;174;145;127;161;70;165;112;191;195;29;109;194;141;137;172;136;124;41;184;39;133;60;48;179;146;120;56;94;58;183;69;59;28;152;6;67;114;119;93;166;159;0;71;61;142;75;46;30;99;121;96;131;17;101;78;197;151;110;40;186;180;128;49;129;118;35,4185054911056361368,0.000000
steepest_intra:nodes_start:random,85,281442,176794,104648,1,0,164;104;49;37;144;78;66;50;108;161;20;24;6;97;110;10;52;175;63;174;111;84;15;199;170;67;178;190;75;186;129;184;57;46;19;93;118;173;32;140;61;136;98;31;5;33;191;150;187;36;92;169;100;157;168;189;83;3;77;80;41;13;62;58;70;123;30;26;125;181;132;96;2;68;148;139;109;193;116;183;21;14;73;172;17;95;195;90;121;134;91;54;147;130;112;198;153;154;103;7,9182485640182132975,0.000000
steepest_intra:nodes_start:random,86,266364,166149,100215,2,1,178;39;131;22;168;140;105;41;45;14;70;125;92;7;95;151;181;75;174;5;6;52;34;183;136;109;51;65;25;156;94;150;46;38;73;30;121;119;47;192;160;33;69;126;155;83;82;186;179;199;139;28;101;2;3;85;9;97;188;167;132;84;11;58;72;89;111;18;166;80;187;118;59;149;145;158;20;113;23;107;175;144;108;110;137;32;13;66;124;86;198;29;185;103;133;104;53;50;169;180,8572119395212197922,0.000000
steepest_intra:nodes_start:random,87,270543,166305,104238,2,1,51;186;122;125;67;171;113;189;64;60;142;76;26;117;40;3;166;5;53;24;88;56;74;73;109;127;152;6;97;157;98;39;120;153;102;93;101;84;1;66;104;192;86;148;178;17;43;21;145;29;116;100;182;48;172;181;49;72;28;36;8;155;77;134;132;131;165;55;198;7;190;139;138;184;22;105;174;19;44;10;164;83;42;41;115;156;137;11;0;4;180;91;170;37;85;163;188;179;69;194,598362489054287630,0.000000
steepest_intra:nodes_start:random,88,267959,164100,103859,1,0,53;8;137;172;7;25;139;34;30;163;17;125;22;151;31;82;155;181;122;72;140;184;9;13;187;161;142;91;52;12;90;194;41;81;64;186;193;182;189;33;173;101;76;3;107;124;2;169;130;23;55;50;36;100;35;26;157;143;1;115;61;110;88;134;58;87;108;67;148;152;131;71;149;28;5;43;195;39;144;179;119;113;177;73;11;136;85;24;117;178;78;38;21;135;69;112;176;170;77;96,7649971335457573071,0.000000
steepest_intra:nodes_start:random,89,268703,171228,97475,2,1,44;30;63;82;52;142;95;10;89;131;83;21;116;1;106;120;130;110;75;100;159;27;178;88;49;186;154;108;101;74;188;96;28;50;124;25;73;145;117;111;37;64;54;12;59;17;22;65;179;114;23;160;39;79;70;94;57;45;92;78;42;152;128;163;181;150;8;35;187;104;147;0;69;91;143;61;4;26;134;146;170;19;173;81;165;155;151;198;32;62;98;31;171;174;156;109;56;84;77;9,3071561162063955179,0.000000
steepest_intra:nodes_start:random,90,267210,165166,102044,1,0,74;130;147;33;178;25;13;132;53;153;109;190;127;158;173;140;62;6;146;197;77;22;30;92;191;10;186;192;188;27;54;141;86;187;196;194;106;23;126;180;76;112;97;170;57;31;87;195;157;59;29;164;125;181;64;96;88;19;38;167;172;156;39;66;71;120;138;103;47;136;189;113;129;8;26;55;68;148;70;162;159;165;145;198;110;169;81;174;0;121;101;118;123;175;41;160;119;65;83;16,736137294221599549,0.000000
steepest_intra:nodes_start:random,91,268262,173965,94297,1,0,45;172;34;120;158;37;197;38;65;31;75;86;130;1;0;72;63;92;96;164;99;162;88;114;22;29;51;141;145;111;42;57;129;35;199;116;81;173;113;105;39;70;49;79;180;109;174;23;139;152;7;167;47;44;117;165;193;94;98;56;24;8;168;102;64;156;133;5;179;78;90;32;119;27;69;21;9;110;4;135;97;115;85;140;138;166;159;170;25;191;40;58;76;126;192;188;13;15;121;177,4261507172111246635,0.000000
steepest_intra:nodes_start:random,92,275551,179140,96411,1,0,157;115;84;199;190;197;32;26;193;154;9;22;186;58;171;41;98;128;59;24;137;51;45;56;147;21;130;47;85;11;25;150;90;57;116;37;184;78;43;10;145;162;117;8;86;72;107;69;35;112;127;160;134;95;121;198;156;65;7;80;191;23;114;48;82;151;155;54;20;104;166;55;91;153;28;101;42;175;34;143;177;29;182;61;120;87;94;180;77;88;99;161;71;194;106;113;195;109;173;1,1828939219533845109,0.000000
steepest_intra:nodes_start:random,93,271043,169029,102014,1,0,31;199;17;9;140;67;137;50;156;94;52;37;128;100;60;184;91;87;20;150;10;173;99;129;55;185;170;86;169;120;118;113;178;54;143;53;83;74;182;47;139;116;75;107;125;39;130;85;115;151;144;157;32;119;5;197;84;180;177;132;13;101;36;172;133;176;16;161;27;167;59;198;104;21;18;106;24;155;175;109;68;33;93;43;8;190;1;131;19;12;97;40;194;174;3;126;82;191;160;98,7819189450198829785,0.000000
steepest_intra:nodes_start:random,94,255912,155524,100388,2,1,159;128;164;149;101;99;78;98;52;169;12;155;158;113;150;54;65;11;129;197;75;165;122;170;88;73;93;23;168;31;29;0;74;48;77;30;120;34;166;177;192;198;41;58;18;89;53;163;153;156;108;185;57;26;151;6;5;46;191;125;76;43;132;105;35;15;70;116;61;2;162;145;189;134;115;49;181;124;131;188;186;63;87;102;182;157;72;1;117;96;20;37;7;154;147;126;199;143;36;184,906441236146251736,0.000000
steepest_intra:nodes_start:random,95,261742,168676,93066,2,1,117;89;158;62;138;102;1;79;6;29;139;151;95;4;18;75;161;194;178;183;171;33;147;141;53;64;122;119;176;108;169;48;134;59;90;54;166;142;14;132;160;101;77;181;115;47;45;124;12;116;39;152;80;27;3;51;68;113;42;118;19;56;146;28;174;35;96;121;196;76;87;58;198;32;179;10;92;123;67;11;197;172;78;170;144;43;26;126;16;135;112;157;70;71;74;165;57;24;63;149,4385553183497166173,0.000000
steepest_intra:nodes_start:random,96,266948,166772,100176,1,0,13;102;9;110;71;111;164;19;121;89;180;194;155;144;124;191;158;147;125;53;171;66;138;56;101;96;142;78;105;169;108;11;86;130;45;149;1;107;178;143;7;37;162;98;44;118;5;33;69;154;91;63;99;193;114;41;113;100;134;197;131;24;14;157;123;94;52;79;16;159;29;73;49;67;88;10;141;50;189;47;84;152;120;179;87;165;21;23;81;133;39;198;132;15;199;2;185;104;146;140,5125304005700038403,0.000000
steepest_intra:nodes_start:random,97,277886,182165,95721,1,0,161;73;7;2;181;108;168;176;186;104;95;165;75;129;89;132;56;111;9;118;87;47;78;151;199;4;147;62;107;185;13;166;31;45;91;27;61;117;137;193;72;157;52;22;131;179;177;90;103;16;135;97;138;143;92;41;159;60;128;33;20;79;29;94;142;21;44;35;14;187;196;68;149;58;36;195;98;59;70;121;172;99;17;38;192;169;162;171;112;86;110;133;15;10;163;184;82;115;124;81,474153846983831760,0.000000
steepest_intra:nodes_start:random,98,265892,169029,96863,1,0,72;11;130;143;54;102;163;103;172;175;69;22;79;179;116;136;73;108;121;67;193;59;170;100;9;184;188;162;51;98;21;146;118;124;106;111;66;90;164;159;57;139;144;197;131;2;82;178;126;166;160;37;84;34;91;169;115;99;55;182;49;132;47;128;28;20;46;123;120;149;65;70;147;137;58;25;0;6;1;71;194;74;35;26;60;107;76;30;3;117;45;167;56;190;185;15;61;80;112;12,7644229833141942163,0.000000
steepest_intra:nodes_start:random,99,294621,189571,105050,2,1,17;29;139;2;119;155;163;54;66;14;53;167;31;42;98;199;129;197;30;134;100;37;21;192;182;147;88;181;28;19;187;115;13;0;95;116;160;183;102;70;84;156;58;15;103;144;113;112;9;32;149;151;142;52;48;8;170;68;132;122;43;185;195;55;111;138;188;127;39;148;33;71;86;83;136;60;22;108;47;131;194;184;140;168;153;164;93;191;50;45;77;121;178;4;101;141;78;6;196;67,2451927350368738896,0.000000
steepest_intra:nodes_start:random,100,256555,162160,94395,1,0,33;35;76;69;159;79;136;73;194;59;74;179;156;37;22;116;92;29;132;47;4;83;96;172;40;154;72;13;177;164;46;158;56;44;171;173;152;68;174;9;129;170;114;183;149;169;133;51;61;176;53;23;38;196;32;31;144;191;71;58;75;2;55;3;107;189;118;180;112;168;41;134;157;81;139;143;25;126;111;14;121;27;62;94;97;190;113;119;54;148;187;63;195;162;87;185;19;163;192;102,6142165040904347257,0.000000
steepest_intra:nodes_start:random,101,271894,171287,100607,2,1,199;27;9;62;167;48;164;121;67;89;12;114;46;194;97;159;69;11;22;84;98;51;79;182;59;53;173;113;153;91;140;188;112;38;152;24;148;58;81;100;165;111;115;104;129;123;187;146;73;4;181;127;8;6;106;125;142;99;40;147;193;183;87;86;82;192;19;3;107;94;156;141;56;39;177;171;135;93;130;31;168;66;25;138;189;136;18;170;77;28;63;20;185;52;198;16;74;179;124;45,2221650526127144854,0.000000
steepest_intra:nodes_start:random,102,250950,156877,94073,1,0,157;150;11;199;186;34;145;20;72;158;38;10;110;84;21;27;15;126;71;25;119;183;95;62;99;1;104;166;86;174;74;26;57;184;122;33;123;14;194;185;98;198;191;92;180;16;29;143;43;73;197;117;102;138;85;53;140;51;112;69;40;106;70;12;19;149;47;108;181;65;167;159;176;173;131;151;46;125;172;0;134;5;61;165;41;170;13;196;80;6;18;152;129;135;44;68;52;9;168;164,6069350697360368263,0.000000
steepest_intra:nodes_start:random,103,259450,156809,102641,1,0,151;39;81;126;191;174;111;12;67;132;73;104;93;88;84;34;109;99;101;36;165;29;154;118;6;87;119;97;35;25;26;44;91;163;76;160;143;156;86;105;15;19;110;140;17;14;55;141;30;77;145;47;94;139;103;115;180;142;116;33;96;70;198;10;41;66;95;184;195;144;71;37;23;161;131;108;129;123;146;69;27;49;150;2;42;135;72;74;188;194;153;32;157;24;57;179;56;21;53;166,5745017630120560040,0.000000
steepest_intra:nodes_start:random,104,270124,170761,99363,2,1,48;45;175;34;151;147;155;23;193;183;137;117;92;98;43;142;16;126;7;70;12;162;76;21;168;82;140;1;121;96;149;39;152;101;77;18;46;47;190;194;199;49;187;17;108;5;107;146;61;50;9;90;173;3;177;181;106;68;8;27;186;86;153;124;131;120;113;72;179;171;53;154;99;83;191;134;150;38;85;10;141;169;119;6;2;20;118;33;112;111;164;95;36;59;13;135;54;145;144;109,4403292392402086592,0.000000
steepest_intra:nodes_start:random,105,263944,168438,95506,1,0,103;192;1;33;199;149;86;91;197;161;198;94;167;140;55;2;11;10;52;64;104;62;175;144;187;47;17;4;128;40;145;92;193;127;183;78;189;101;182;147;39;196;178;165;181;59;185;100;75;37;19;42;119;136;190;67;107;146;3;20;83;9;12;23;69;41;126;70;73;141;162;66;15;160;116;25;0;95;153;68;50;139;13;5;26;32;114;53;63;72;97;170;57;46;195;29;105;88;131;148,8675802164096530802,0.000000
steepest_intra:nodes_start:random,106,259979,162168,97811,2,1,198;58;168;61;196;94;128;89;154;152;127;23;141;22;88;24;109;47;2;191;72;0;25;48;186;104;108;15;169;6;123;85;34;185;149;19;7;71;87;27;16;163;68;83;33;1;37;63;5;78;101;73;156;60;13;117;199;190;176;17;49;57;62;122;189;3;50;41;43;115;158;80;170;111;54;151;26;150;147;121;155;167;66;174;69;177;143;21;75;93;162;148;53;11;119;90;52;175;29;44,8698546386888012307,0.000000
steepest_intra:nodes_start:random,107,242947,145080,97867,1,0,147;25;171;39;148;165;52;195;0;93;104;176;63;168;156;152;33;124;78;82;169;153;83;126;76;106;66;192;72;85;84;22;59;184;88;60;42;38;170;103;43;10;6;122;56;183;139;162;97;191;5;115;137;194;70;178;159;61;127;132;4;133;31;32;149;112;135;16;107;181;13;100;199;190;146;47;136;46;118;51;130;80;87;91;167;101;197;177;140;49;75;99;15;17;119;9;111;94;189;71,2070720547681333438,0.000000
steepest_intra:nodes_start:random,108,257460,166033,91427,1,0,63;89;43;65;171;127;166;128;98;124;72;64;177;39;117;11;41;186;151;70;66;101;1;26;182;108;165;93;42;137;3;48;138;95;77;81;173;47;197;190;88;156;94;167;32;16;57;62;135;111;148;79;110;38;161;149;194;44;106;132;9;14;144;184;76;71;170;119;185;183;157;97;73;36;21;115;34;120;192;10;54;113;87;176;58;103;61;116;187;60;168;37;18;96;84;114;159;136;22;19,5637617966074411787,0.000000
steepest_intra:nodes_start:random,109,251307,156559,94748,2,1,39;106;118;77;162;53;20;143;187;184;75;38;172;176;49;55;141;86;96;145;165;69;122;27;180;199;138;183;57;30;198;192;12;22;131;109;149;120;125;16;161;80;58;13;101;43;60;111;74;193;37;163;93;8;45;87;47;29;119;59;117;10;155;136;42;146;100;99;56;66;51;63;108;102;2;177;181;48;170;76;157;3;151;84;130;52;179;73;178;4;166;82;174;112;160;107;127;152;14;196,2886663797242294723,0.000000
steepest_intra:nodes_start:random,110,243198,149955,93243,1,0,36;100;82;120;57;136;53;74;122;156;8;15;199;42;171;149;76;65;25;80;95;7;144;70;48;89;59;88;101;135;51;12;108;150;185;66;114;137;5;116;35;117;33;14;142;19;105;153;67;37;163;166;86;172;176;29;98;90;145;188;124;75;56;45;179;93;58;140;184;181;55;106;52;1;175;22;6;4;54;60;2;128;147;109;121;165;44;21;180;119;16;91;125;84;167;195;190;143;131;138,6066593660411266454,0.000000
steepest_intra:nodes_start:random,111,270997,173970,97027,2,1,185;81;154;101;57;196;30;119;128;131;21;135;133;193;113;12;42;65;54;106;120;25;28;64;172;109;19;14;115;35;174;164;72;189;152;143;50;138;195;11;160;78;118;84;153;126;104;4;80;194;7;186;0;24;22;48;116;168;87;71;103;13;108;40;88;17;5;58;123;167;107;173;47;130;3;91;92;121;122;112;96;142;52;76;90;151;68;134;99;146;178;56;46;27;18;75;147;67;197;159,8386912092855985449,0.000000
steepest_intra:nodes_start:random,112,255492,153946,101546,2,1,19;33;76;68;114;14;197;98;167;17;62;7;100;87;50;32;107;34;93;141;152;1;16;44;70;86;104;192;137;129;160;42;26;174;20;61;78;15;31;5;82;130;63;99;96;12;186;91;81;163;71;52;67;180;48;149;125;53;27;77;161;59;28;128;146;124;155;22;97;95;194;150;90;199;131;195;182;123;85;6;183;39;119;23;193;102;168;8;106;138;169;148;184;105;18;84;153;92;45;135,1060895733595323104,0.000000
steepest_intra:nodes_start:random,113,257651,167354,90297,2,1,195;154;53;183;34;173;58;163;117;23;76;83;44;198;15;89;66;141;181;46;28;185;135;174;78;90;12;119;61;91;96;126;57;63;20;38;14;124;18;123;75;142;147;101;4;50;42;86;127;5;133;49;59;9;45;74;155;131;171;178;180;31;108;68;193;149;36;48;168;97;52;84;1;137;161;0;158;165;152;182;172;150;11;184;196;199;55;157;80;62;190;191;104;2;16;146;92;177;67;130,86930941851414925,0.000000
steepest_intra:nodes_start:random,114,260528,154375,106153,1,0,63;176;151;109;128;69;105;50;102;150;58;40;79;181;19;84;152;161;193;106;35;25;162;10;116;130;67;117;157;172;134;192;49;20;165;125;24;133;119;78;104;169;71;45;163;191;97;80;64;23;166;114;27;182;198;22;140;129;11;146;94;190;139;99;15;85;82;197;59;147;28;65;29;186;199;103;6;156;108;100;185;177;39;57;121;174;188;113;189;37;70;136;61;179;194;96;76;30;127;158,3229757483076581085,0.000000
steepest_intra:nodes_start:random,115,273134,178833,94301,1,0,126;120;15;178;146;138;25;16;101;35;30;98;55;115;155;170;179;152;131;95;154;147;27;106;65;70;23;153;140;69;12;40;28;151;196;53;39;167;105;50;184;60;190;11;164;134;92;156;74;193;6;71;157;117;86;149;107;165;123;4;121;183;129;187;77;90;67;43;42;112;26;158;88;132;7;58;166;133;163;180;135;32;96;171;191;110;51;127;130;114;103;143;136;172;48;99;160;116;31;10,3189714129525185447,0.000000
steepest_intra:nodes_start:random,116,254105,152176,101929,1,0,43;32;150;152;15;197;151;161;67;153;100;51;108;140;106;37;72;169;183;83;187;185;61;188;91;63;97;118;79;60;11;18;165;76;54;190;189;20;78;157;114;81;47;42;134;136;41;71;199;101;177;144;148;163;117;10;184;122;45;158;127;162;171;23;8;24;119;77;34;88;176;198;65;167;139;195;9;115;87;14;19;170;30;146;93;164;132;25;174;107;4;181;12;98;85;128;26;141;173;109,6069633777388266084,0.000000
steepest_intra:nodes_start:random,117,259677,163008,96669,2,1,195;123;1;151;85;189;14;193;176;180;41;54;59;47;7;18;181;102;36;28;31;52;121;62;88;118;104;140;57;50;179;64;82;79;89;24;58;119;120;177;199;99;136;150;94;112;197;115;13;74;22;25;86;170;72;81;129;154;105;61;20;71;77;67;174;107;182;147;117;134;194;109;9;146;135;143;2;114;95;73;100;144;49;196;87;43;23;44;198;33;34;63;130;186;125;116;187;92;155;190,6460679384317011174,0.000000
steepest_intra:nodes_start:random,118,281581,178394,103187,1,0,192;90;20;28;97;148;111;115;124;16;98;99;127;54;174;34;154;132;48;107;7;131;49;76;33;189;93;185;141;5;45;32;19;195;118;100;10;110;188;6;159;46;56;26;142;37;74;122;109;94;43;91;129;85;161;18;83;177;36;116;61;11;38;88;193;196;66;15;155;12;78;21;163;1;165;41;183;168;190;81;197;106;173;31;158;47;59;95;108;186;79;128;24;145;44;160;166;53;29;42,4201236765140164501,0.000000
steepest_intra:nodes_start:random,119,265403,166096,99307,1,0,34;70;98;56;153;141;119;190;27;42;121;116;105;159;156;173;44;182;10;194;20;58;6;94;177;100;131;64;72;19;46;63;125;115;79;38;154;184;109;163;9;187;172;161;31;28;169;53;185;103;18;47;113;101;145;168;144;15;146;37;91;114;183;43;167;26;122;8;143;137;61;106;69;96;52;188;170;110;150;120;108;164;102;23;155;81;11;71;14;35;171;3;126;138;17;33;51;140;77;162,3301989891014026738,0.000000
steepest_intra:nodes_start:random,120,240370,150524,89846,1,0,21;79;140;161;56;54;177;4;25;11;146;63;164;114;44;74;141;23;68;36;30;35;108;93;14;53;149;131;18;163;198;80;28;91;186;71;184;180;33;101;22;154;173;58;194;67;181;42;41;175;66;72;147;133;86;142;113;190;158;16;34;159;182;55;143;46;61;97;165;189;135;103;111;100;87;26;197;178;150;116;134;156;162;40;85;157;52;106;139;123;27;145;9;132;39;2;119;110;166;78,3469814318985754080,0.000000
steepest_intra:nodes_start:random,121,261824,169664,92160,2,1,18;121;14;21;138;143;85;53;110;169;162;184;177;78;173;34;61;133;93;154;5;73;67;117;125;165;153;135;69;127;120;176;42;188;140;16;195;37;131;79;6;13;170;74;181;104;76;41;119;152;71;106;98;49;63;28;40;99;68;129;32;193;45;155;94;8;55;26;60;151;115;161;180;22;137;12;15;191;56;31;46;146;199;84;116;50;29;9;144;114;105;27;189;126;52;11;97;148;20;118,8543463424382690830,0.000000
steepest_intra:nodes_start:random,122,272973,175274,97699,2,1,173;190;191;116;88;115;85;43;96;84;175;108;169;172;114;12;68;120;49;151;2;66;111;149;134;62;104;128;176;0;181;98;22;177;154;179;53;14;16;174;25;143;184;67;138;48;50;199;13;180;65;101;39;150;133;94;73;83;141;129;45;106;76;18;131;183;107;100;60;137;197;130;194;105;32;161;11;56;37;135;79;117;54;9;58;159;182;103;90;44;155;61;72;23;157;40;198;158;42;51,4108870297225465173,0.000000
steepest_intra:nodes_start:random,123,245650,149032,96618,2,1,171;1;57;70;185;157;172;14;122;124;112;47;23;85;149;73;153;3;19;120;134;133;66;159;179;8;118;192;145;184;64;16;91;13;37;125;129;22;35;24;17;0;181;11;6;41;117;168;186;177;34;136;194;42;127;163;182;79;137;62;53;38;97;146;7;161;82;56;138;132;144;69;126;51;52;173;167;60;197;148;189;2;100;114;108;32;21;116;68;98;165;45;141;143;18;106;26;156;59;39,5878121387318973379,0.000000
steepest_intra:nodes_start:random,124,276306,172558,103748,2,1,76;31;173;160;56;43;64;125;105;126;134;40;172;188;140;6;157;58;103;169;138;111;175;162;89;164;179;192;198;132;124;37;85;93;142;118;5;0;193;90;87;171;121;133;165;99;79;18;29;181;60;129;30;74;7;65;34;94;146;166;106;183;61;22;1;80;13;153;72;112;177;144;119;189;49;63;110;24;191;83;68;88;35;84;161;21;17;167;104;33;149;12;48;59;77;120;69;55;182;131,2199960166551831106,0.000000
steepest_intra:nodes_start:random,125,255082,162567,92515,2,1,40;125;6;184;179;19;95;60;2;46;129;90;71;56;96;158;183;31;72;178;12;77;135;97;15;83;163;171;170;49;194;61;189;93;195;76;65;47;16;68;150;196;138;126;4;22;162;86;159;143;33;176;172;0;197;85;113;180;175;8;109;119;18;94;26;69;181;123;137;122;141;140;7;131;169;25;102;157;105;55;154;155;185;112;11;48;79;164;145;121;27;44;116;91;120;45;134;128;75;130,3114627051792524096,0.000000
steepest_intra:nodes_start:random,126,270707,173726,96981,2,1,140;180;132;98;41;38;66;83;113;9;28;16;61;133;82;12;135;160;7;187;53;176;181;71;121;167;30;1;141;145;4;112;69;54;45;50;24;106;150;78;197;115;172;131;161;177;10;22;15;35;47;59;196;46;48;120;147;76;194;193;117;67;70;189;37;64;123;159;155;107;169;99;31;81;72;144;162;84;88;40;42;128;6;25;85;68;75;173;143;23;164;191;3;195;49;29;94;198;185;89,1409797678830359172,0.000000
steepest_intra:nodes_start:random,127,256556,165654,90902,1,0,81;176;94;105;98;107;10;22;157;191;33;51;171;118;84;29;136;93;9;0;28;7;167;16;44;95;30;156;90;160;195;47;1;58;113;76;46;67;52;2;57;152;45;147;53;112;65;129;19;34;142;165;173;62;170;116;162;172;166;144;61;109;5;196;68;106;92;82;139;122;54;97;185;120;64;66;114;194;138;168;70;134;141;56;79;15;55;35;78;31;87;145;153;41;188;39;181;12;180;40,440930353542851711,0.000000
steepest_intra:nodes_start:random,128,262181,166963,95218,1,0,87;69;17;193;143;57;92;51;182;131;106;149;79;123;108;5;99;183;168;152;74;113;44;81;56;76;138;144;198;172;32;195;136;47;45;192;7;116;139;160;115;169;151;50;28;120;66;135;96;41;58;35;31;10;39;62;14;70;150;63;94;98;33;13;24;88;157;117;67;185;121;146;194;43;159;163;25;166;164;110;174;145;4;34;119;179;1;23;19;16;125;148;105;102;122;37;162;91;111;78,1102149542692943441,0.000000
steepest_intra:nodes_start:random,129,256397,156357,100040,1,0,178;193;163;126;171;44;180;185;103;124;33;40;64;25;110;18;181;195;54;146;8;104;165;57;12;55;106;76;30;136;199;98;13;197;19;132;158;35;58;65;131;73;27;28;97;84;69;21;150;16;169;175;46;68;139;166;66;189;26;194;92;75;164;142;29;151;129;7;74;79;187;157;170;93;177;53;6;156;130;147;9;152;115;196;100;39;71;62;2;182;162;107;61;56;174;80;22;91;188;52,3383904842216792492,0.000000
steepest_intra:nodes_start:random,130,255248,159050,96198,1,0,144;88;113;109;175;170;27;127;117;74;197;161;43;28;11;42;13;133;101;70;184;45;32;94;80;118;21;172;93;63;53;95;55;179;16;9;167;35;176;163;191;177;158;143;186;153;8;100;96;141;120;139;154;66;138;4;44;130;106;131;48;76;99;140;136;115;85;92;147;61;54;62;86;137;123;148;195;198;135;18;169;83;108;105;187;156;166;114;173;65;1;192;68;125;79;52;132;111;30;46,511803584005056063,0.000000
steepest_intra:nodes_start:random,131,260404,166718,93686,1,0,29;192;199;10;108;98;195;59;63;79;150;18;153;95;35;141;102;173;121;136;128;80;4;107;76;61;2;172;118;9;174;19;52;140;109;67;197;191;166;143;32;106;171;193;180;156;133;12;179;72;183;27;113;188;43;78;177;117;165;5;45;11;187;146;138;184;81;120;122;93;82;101;158;70;97;149;124;37;50;104;21;115;159;62;176;164;46;134;135;31;167;162;8;130;42;160;175;116;123;137,708214365765110511,0.000000
steepest_intra:nodes_start:random,132,259133,164961,94172,1,0,4;131;62;171;0;174;176;111;79;40;78;94;183;17;59;132;135;106;173;172;18;12;145;188;69;146;29;28;89;14;75;67;34;192;158;116;164;123;74;80;150;93;63;102;20;68;144;193;148;196;128;155;26;71;76;91;41;72;65;83;127;180;96;122;87;60;81;38;137;1;139;86;27;181;46;30;39;52;105;179;23;167;130;25;184;90;32;121;125;119;56;66;55;45;186;48;194;99;147;189,1898398689616649689,0.000000
steepest_intra:nodes_start:random,133,270745,180738,90007,2,1,146;26;44;79;9;171;70;108;198;78;14;50;25;155;184;122;85;20;170;42;36;152;65;156;119;60;197;64;41;47;175;135;74;160;187;183;97;2;80;5;6;196;158;40;113;123;23;59;19;30;73;35;117;173;7;186;4;22;53;169;191;138;11;143;166;147;178;114;195;131;88;54;125;39;1;17;15;164;81;133;157;176;189;55;66;0;10;27;101;151;37;134;144;136;168;89;62;193;58;148,7660594043791226428,0.000000
steepest_intra:nodes_start:random,134,263061,167911,95150,1,0,186;159;115;1;117;188;54;82;21;53;26;34;64;46;67;97;24;45;5;182;25;30;180;141;47;20;122;184;91;29;154;160;14;193;9;62;195;63;33;59;13;17;75;86;58;92;166;113;79;108;51;104;151;8;4;138;50;162;15;44;100;49;125;187;127;69;150;149;198;173;123;136;94;137;194;61;171;128;176;90;146;147;199;6;7;196;77;42;170;129;153;43;156;143;109;31;37;172;118;174,4618313368687935976,0.000000
steepest_intra:nodes_start:random,135,258640,161829,96811,1,0,56;22;195;79;182;62;95;65;165;64;54;12;46;186;85;174;184;70;27;76;116;189;125;137;43;146;1;130;26;149;5;117;110;78;106;148;179;61;109;180;139;105;82;140;36;103;39;23;97;108;166;128;59;32;84;151;49;153;3;111;99;127;104;133;164;114;68;163;17;124;100;2;141;57;123;129;19;187;41;132;126;24;120;169;115;31;96;178;29;168;143;20;154;28;53;98;74;77;122;138,215288552746949650,0.000000
steepest_intra:nodes_start:random,136,282499,182771,99728,1,0,58;171;106;61;35;41;89;19;7;63;129;36;77;92;156;140;48;79;45;84;18;10;155;51;170;119;195;128;24;98;164;161;15;47;87;126;179;131;86;73;16;82;90;46;167;34;185;13;186;158;111;72;95;2;113;97;197;55;192;168;39;71;137;103;38;88;130;136;23;5;115;177;189;116;138;43;107;146;133;196;175;157;190;150;99;6;52;199;198;17;193;127;183;169;148;69;118;30;40;117,5588835562671443111,0.000000
steepest_intra:nodes_start:random,137,268227,162273,105954,1,0,135;74;165;167;17;176;73;11;85;16;91;177;88;114;123;43;50;156;172;76;99;70;19;158;170;2;105;181;61;41;100;141;1;37;8;108;134;36;173;7;164;192;180;96;130;90;186;137;38;68;97;125;0;113;75;182;81;133;86;169;89;171;127;55;59;78;150;104;191;128;193;107;140;124;28;184;6;60;166;45;110;112;119;178;4;160;126;52;32;103;46;198;23;163;151;66;71;13;53;12,9043686935988850220,0.000000
steepest_intra:nodes_start:random,138,256317,159807,96510,2,1,13;127;42;48;29;101;135;143;28;128;63;8;50;199;114;4;72;117;134;74;55;140;116;97;109;153;56;87;150;189;176;99;122;184;159;148;75;11;197;54;45;40;32;95;112;102;160;168;10;161;152;188;192;84;57;93;47;185;175;16;34;193;100;3;178;33;68;171;18;173;126;137;113;91;81;139;26;71;86;196;121;64;110;129;70;31;58;38;76;191;125;186;155;51;78;144;52;65;158;88,3348218343889950596,0.000000
steepest_intra:nodes_start:random,139,272593,174148,98445,2,1,79;191;93;115;173;99;5;110;54;182;83;197;95;94;13;188;150;80;51;2;49;20;107;55;199;72;168;34;16;1;4;116;179;71;120;160;175;114;154;149;29;21;167;185;19;24;121;129;22;139;39;124;109;142;96;58;178;140;151;131;166;189;190;32;103;73;77;26;125;101;31;108;12;172;147;187;69;195;45;196;105;155;90;41;40;53;198;170;145;18;82;37;106;136;111;60;177;164;78;186,1904859817648890287,0.000000
steepest_intra:nodes_start:random,140,283751,177285,106466,2,1,175;134;110;20;69;31;23;38;153;39;111;91;140;50;8;53;79;66;168;42;29;87;130;40;35;46;103;12;124;144;48;125;3;131;18;151;181;17;36;107;77;84;56;128;6;70;187;135;139;129;95;146;170;155;71;73;28;47;57;98;72;85;194;148;41;123;121;34;102;15;159;88;19;169;30;114;74;51;191;89;183;26;96;198;133;106;2;68;189;99;54;127;152;145;192;132;118;188;161;165,8313532192870759326,0.000000
steepest_intra:nodes_start:random,141,268156,162058,106098,1,0,127;10;192;50;165;12;151;173;48;11;101;51;126;150;176;20;133;75;49;169;66;197;114;76;138;28;145;186;32;58;45;130;166;64;34;129;195;74;23;182;18;37;184;38;93;90;105;14;22;112;35;60;1;135;178;119;36;143;194;134;188;33;86;118;17;174;73;148;167;146;87;180;168;16;25;179;170;191;181;69;128;94;82;175;44;131;104;147;100;71;67;97;46;125;139;84;155;136;3;187,1221552300095830303,0.000000
steepest_intra:nodes_start:random,142,269430,163573,105857,1,0,186;125;45;22;169;189;183;83;37;148;25;168;194;134;33;52;8;53;181;61;72;108;38;15;185;100;97;28;80;178;128;141;43;170;150;137;197;32;47;11;10;98;162;122;156;46;187;114;177;57;188;90;101;31;87;163;78;111;103;65;88;13;198;121;99;196;166;119;165;84;154;70;167;35;118;64;58;142;191;130;175;105;14;147;69;51;17;133;9;199;146;62;7;40;151;71;94;81;109;5,1211406120748013694,0.000000
steepest_intra:nodes_start:random,143,265852,161467,104385,2,1,161;64;168;1;139;52;8;22;174;49;0;33;98;131;181;157;17;76;51;35;189;87;114;61;171;129;89;97;133;107;126;173;99;141;137;75;113;39;81;166;19;128;93;20;24;140;44;26;153;196;125;37;32;57;127;4;38;15;144;178;10;156;48;197;159;74;58;190;132;160;187;123;199;94;105;195;151;147;149;82;14;7;67;31;27;54;53;50;138;194;45;95;63;47;66;180;55;193;77;108,341081812834009069,0.000000
steepest_intra:nodes_start:random,144,268949,170169,98780,1,0,35;104;76;198;122;129;95;111;34;74;159;113;155;88;179;80;60;69;21;157;40;103;36;101;30;120;20;130;110;52;0;41;149;65;19;77;33;100;15;182;118;18;97;152;16;135;84;134;158;82;102;138;64;142;23;109;156;85;78;184;27;57;59;127;13;71;193;167;197;176;12;148;61;119;79;73;146;164;47;6;125;28;116;91;10;114;195;43;136;123;49;191;14;54;24;93;169;75;173;81,6422233394974436163,0.000000
steepest_intra:nodes_start:random,145,247804,150572,97232,1,0,141;130;159;40;74;119;134;5;147;67;193;171;38;60;28;97;42;122;137;73;172;118;68;181;10;53;128;120;15;46;8;18;48;45;135;157;125;167;155;164;55;12;93;145;90;71;26;116;195;11;85;78;63;29;89;153;2;129;3;72;82;180;65;61;9;96;66;16;103;81;17;133;56;34;39;169;127;168;136;173;80;148;184;105;101;176;188;98;142;126;152;27;198;1;76;49;32;100;22;139,2931612886465802146,0.000000
steepest_intra:nodes_start:random,146,269780,169038,100742,2,1,103;24;174;144;37;160;100;28;157;188;22;180;153;30;156;94;92;55;73;27;133;64;90;167;49;147;39;152;109;119;60;99;54;163;150;173;159;195;70;7;129;23;141;95;142;69;120;2;170;172;82;184;10;42;74;199;194;88;123;155;182;197;198;136;186;9;66;4;183;135;106;25;91;8;112;189;61;29;35;17;193;107;93;97;75;72;43;158;84;118;78;46;79;191;48;58;140;117;56;137,2863284974739655590,0.000000
steepest_intra:nodes_start:random,147,267048,176672,90376,2,1,127;21;9;105;167;87;162;12;143;67;113;106;130;107;156;65;69;30;178;111;28;6;152;195;180;103;43;93;85;172;54;14;101;191;119;3;166;73;10;63;58;49;169;7;59;82;121;118;125;22;186;146;71;133;15;139;20;92;181;193;176;159;140;41;52;70;98;56;100;145;68;1;171;31;81;2;192;37;61;158;4;138;34;95;83;161;90;74;147;129;120;114;177;53;112;33;42;5;86;117,4708308637981576460,0.000000
steepest_intra:nodes_start:random,148,260033,166453,93580,2,1,112;124;144;199;136;171;0;10;191;176;85;56;192;64;41;174;101;89;159;193;21;194;178;23;195;146;37;118;175;102;43;88;49;24;22;47;45;2;109;123;128;40;151;65;52;105;156;70;69;115;103;182;100;188;54;1;168;173;35;44;169;160;158;121;75;143;84;152;63;6;161;157;58;17;15;95;145;94;93;180;57;184;91;28;97;181;18;8;19;165;74;107;9;147;12;167;76;80;39;104,1437954297891758092,0.000000
steepest_intra:nodes_start:random,149,260226,164341,95885,2,1,173;177;56;161;43;76;46;184;164;89;189;64;78;180;14;109;83;117;174;154;35;50;85;139;195;112;183;49;176;77;98;187;129;4;103;7;1;95;126;24;101;53;28;123;87;120;159;155;13;62;127;92;158;153;185;114;156;81;48;111;74;37;135;75;136;44;186;16;147;151;162;25;69;170;11;133;20;106;40;19;61;125;65;45;134;181;66;137;91;138;131;31;141;93;182;97;165;166;178;157,5502644387080037568,0.000000
steepest_intra:nodes_start:random,150,252417,157769,94648,1,0,185;189;151;97;150;89;77;96;127;40;182;59;124;108;16;10;18;187;44;86;41;36;11;138;134;169;85;82;65;19;145;116;84;62;153;162;58;136;137;64;31;126;168;55;125;6;101;3;7;112;17;50;71;91;154;4;160;135;115;47;12;51;32;148;54;1;122;30;111;83;42;198;48;24;34;183;176;99;132;155;75;57;178;159;103;21;144;190;164;22;166;27;161;158;186;49;114;98;173;87,1561627064664374681,0.000000
steepest_intra:nodes_start:random,151,265690,164465,101225,1,0,108;114;13;127;88;42;56;90;44;57;134;187;109;169;106;105;64;20;62;93;110;34;99;74;123;92;133;196;89;175;5;75;73;143;184;153;79;150;33;26;4;194;19;138;170;151;197;135;128;160;43;191;192;46;177;87;173;2;32;132;181;29;45;178;163;107;119;179;78;69;152;84;182;146;120;12;67;28;60;180;54;156;104;66;16;7;122;118;174;98;129;22;35;164;3;8;31;154;102;121,20040484504260652,0.000000
steepest_intra:nodes_start:random,152,269811,172475,97336,2,1,64;61;15;165;146;14;175;157;100;110;81;34;51;179;37;46;33;3;40;186;135;195;98;19;17;16;50;36;187;93;127;145;121;7;80;31;152;35;197;13;122;198;151;130;137;183;68;101;74;71;167;134;173;139;109;91;22;32;60;62;12;4;126;54;171;44;144;114;58;192;119;97;24;174;41;108;105;5;45;177;172;193;92;27;10;143;160;156;148;140;52;125;163;102;104;42;69;154;83;170,6053685754385622000,0.000000
steepest_intra:nodes_start:random,153,242703,142880,99823,1,0,96;112;121;67;1;126;60;33;25;193;173;108;195;5;104;7;186;110;161;190;77;181;155;16;171;118;83;115;39;140;124;169;17;184;122;18;23;93;57;99;66;70;160;125;24;87;101;119;53;178;174;86;79;14;81;37;59;170;117;6;103;199;134;20;34;162;61;185;182;175;11;137;84;159;28;65;153;142;133;131;92;109;32;64;63;149;105;102;98;97;3;19;52;75;123;107;88;143;42;51,2058080808736754530,0.000000
steepest_intra:nodes_start:random,154,273813,175482,98331,2,1,138;103;73;26;46;101;147;119;154;167;68;136;77;98;181;44;6;137;38;160;15;130;116;80;36;198;29;60;132;195;35;32;2;28;0;82;79;113;92;142;143;175;39;14;157;125;55;88;93;139;99;168;34;166;65;120;89;94;31;21;45;114;178;50;5;163;155;16;190;58;124;102;25;182;108;199;11;127;187;67;23;76;162;196;41;9;49;122;179;84;128;153;33;106;10;91;135;171;78;71,6149174166139777341,0.000000
steepest_intra:nodes_start:random,155,282451,184044,98407,1,0,168;98;175;33;104;127;178;79;107;148;128;69;38;164;114;124;102;21;116;12;27;48;101;5;35;125;44;119;144;160;179;59;145;73;40;85;86;192;186;115;24;71;83;11;78;146;55;10;129;190;165;170;82;6;137;134;2;96;62;20;132;167;106;155;182;122;117;180;99;103;197;92;181;113;156;142;17;75;123;121;198;138;66;161;65;151;68;171;141;67;46;39;143;54;30;133;199;50;159;158,5607442273395941093,0.000000
steepest_intra:nodes_start:random,156,284950,182331,102619,2,1,108;17;11;149;20;178;153;13;187;159;175;5;163;37;181;117;157;168;169;144;98;12;124;107;77;59;170;85;63;92;136;21;112;199;174;69;127;4;188;152;114;148;155;161;126;31;176;130;111;90;45;78;39;128;41;185;191;105;146;120;186;52;171;15;142;49;81;110;122;56;88;73;192;197;89;51;36;71;44;84;177;131;173;116;115;2;18;102;66;54;7;70;132;50;30;27;158;139;79;134,2599223302734541569,0.000000
steepest_intra:nodes_start:random,157,279070,176314,102756,1,0,155;17;10;86;180;29;31;65;50;54;190;87;178;154;20;187;79;96;109;76;75;32;74;24;133;114;36;56;22;118;99;150;77;94;153;119;21;37;127;162;97;182;111;136;131;91;44;81;83;48;125;58;156;18;25;78;61;2;121;186;177;107;116;193;115;128;198;146;90;149;184;167;70;169;135;158;165;104;113;72;144;43;108;60;175;192;66;166;137;173;105;126;71;26;191;73;188;199;170;0,1731363408995723651,0.000000
steepest_intra:nodes_start:random,158,259017,167312,91705,2,1,47;26;25;183;49;197;96;1;181;20;146;7;69;166;45;8;113;164;116;173;100;108;180;95;111;175;157;119;102;148;54;81;192;150;189;78;137;172;42;22;14;97;74;40;143;24;46;83;118;61;182;52;12;132;98;41;186;123;155;109;185;179;56;139;37;163;43;73;30;92;85;33;53;142;18;0;44;133;193;39;38;121;55;114;145;28;21;138;112;15;103;115;188;66;34;36;17;120;165;122,1097499700991640255,0.000000
steepest_intra:nodes_start:random,159,266666,164738,101928,1,0,11;130;128;71;195;160;50;161;129;184;188;182;55;47;93;59;151;137;164;26;90;65;169;102;17;61;44;126;23;118;27;172;57;170;99;174;113;36;176;66;135;110;88;150;181;8;179;43;52;1;46;85;82;141;190;153;77;76;134;53;148;98;183;3;91;86;18;42;32;157;166;9;48;125;111;72;20;139;168;178;14;37;119;89;114;34;0;60;81;167;106;155;101;162;186;62;192;94;21;33,4714229453494099300,0.000000
steepest_intra:nodes_start:random,160,278548,183583,94965,2,1,86;33;191;43;57;49;140;12;150;5;137;165;36;35;6;69;94;58;158;194;61;28;1;47;174;29;42;152;197;190;110;40;128;168;193;146;96;67;179;83;66;100;2;149;14;111;177;25;75;113;79;155;172;138;124;131;106;56;65;188;134;115;173;123;48;87;4;175;0;22;199;97;20;8;143;135;185;148;26;120;154;31;46;164;159;55;91;116;109;98;126;93;156;169;95;121;16;30;90;103,6921336703160234500,0.000000
steepest_intra:nodes_start:random,161,255955,153470,102485,2,1,11;26;117;107;32;19;142;65;74;6;66;141;61;123;27;138;87;56;47;181;52;159;39;9;163;17;175;111;30;174;29;164;124;108;93;176;169;78;64;126;195;45;43;131;59;118;76;183;90;128;23;73;166;20;116;101;161;173;15;188;60;170;121;130;95;100;136;148;25;70;97;187;98;151;171;46;3;75;127;5;152;106;7;31;34;147;167;192;154;110;144;145;44;50;133;143;158;150;94;22,7332898356697321780,0.000000
steepest_intra:nodes_start:random,162,257296,161179,96117,1,0,27;101;120;8;16;91;46;163;125;168;109;110;190;147;69;34;11;23;131;54;175;127;169;119;138;111;142;118;68;197;67;95;9;71;59;155;22;3;139;107;80;41;167;36;132;77;115;57;159;85;129;148;42;166;106;151;114;153;121;96;76;14;29;18;70;140;189;19;40;56;50;174;5;51;191;199;157;180;55;178;160;183;130;0;84;136;198;53;35;78;79;86;122;103;25;145;104;116;134;37,5281183202199878267,0.000000
steepest_intra:nodes_start:random,163,265096,162277,102819,1,0,103;32;144;102;97;52;182;100;78;60;91;33;15;162;126;42;112;176;2;145;122;94;83;164;159;58;108;0;82;25;118;157;47;30;1;121;143;191;120;177;111;5;192;95;172;90;179;69;104;129;50;26;194;55;110;86;87;140;49;152;8;197;88;117;105;51;28;158;196;134;189;136;132;31;141;68;107;27;61;24;63;54;85;156;12;119;133;155;109;6;142;130;151;101;127;125;13;53;75;16,8499851294182752909,0.000000
steepest_intra:nodes_start:random,164,244986,152367,92619,1,0,193;196;113;35;52;33;41;105;30;147;104;116;0;178;125;36;143;66;12;186;62;91;110;177;126;95;174;7;152;37;170;179;57;132;176;158;64;124;144;59;157;195;137;50;2;191;163;119;85;103;140;198;162;49;54;183;151;156;58;75;171;93;134;31;70;43;130;175;44;159;20;18;148;3;15;67;1;185;63;16;189;24;190;97;138;114;8;153;112;77;155;182;21;109;129;101;90;111;92;150,8430975538791812691,0.000000
steepest_intra:nodes_start:random,165,264744,177447,87297,1,0,110;134;59;91;54;118;160;166;150;68;139;198;193;70;47;181;1;180;75;15;162;93;182;61;22;53;74;88;11;109;189;10;188;84;12;164;148;185;28;21;168;41;44;153;101;176;157;71;129;58;199;161;51;165;69;82;30;3;143;111;135;65;73;105;36;14;64;67;86;163;49;94;106;32;31;90;46;35;171;2;175;187;173;125;119;103;154;57;127;42;145;146;34;96;92;116;4;196;183;56,7118421430526169567,0.000000
steepest_intra:nodes_start:random,166,265720,162807,102913,1,0,185;99;104;150;128;39;146;37;97;59;153;180;77;57;113;107;188;82;5;155;19;136;182;75;159;21;114;93;190;131;58;124;52;38;22;9;84;162;156;198;197;141;127;108;134;132;62;194;165;92;49;191;72;95;63;51;43;193;32;145;91;6;109;67;8;47;55;64;27;14;50;160;151;61;4;53;17;20;96;3;83;129;76;86;142;105;10;44;144;23;196;101;78;187;116;88;149;169;54;168,7315843798195825087,0.000000
steepest_intra:nodes_start:random,167,267534,174063,93471,1,0,103;149;4;115;63;95;164;41;88;85;117;158;152;133;26;0;119;67;154;13;138;139;15;160;30;53;153;163;16;159;90;106;126;199;172;198;14;191;132;2;44;135;46;124;77;80;128;94;36;118;136;28;78;175;184;141;11;185;111;176;193;110;49;108;122;178;86;52;129;19;183;188;130;58;83;56;96;120;81;84;182;145;140;196;71;142;47;156;23;54;5;187;127;177;109;192;169;150;61;48,1733764608317945148,0.000000
steepest_intra:nodes_start:random,168,250959,152115,98844,1,0,161;112;24;177;173;187;58;176;149;115;131;135;67;117;5;59;54;183;118;86;28;108;150;93;190;198;147;0;52;141;7;130;41;56;189;111;75;33;127;133;153;21;99;9;38;196;145;123;146;103;50;53;136;151;84;49;68;195;29;11;64;126;13;158;148;181;134;12;65;155;44;6;199;168;152;77;26;194;70;8;184;91;97;89;154;128;165;35;191;87;110;143;92;114;4;80;124;121;81;90,2003736016965012102,0.000000
steepest_intra:nodes_start:random,169,260654,161134,99520,1,0,49;32;74;187;29;80;112;144;98;101;136;111;167;15;16;122;107;195;133;157;116;39;0;31;19;102;37;11;175;188;69;115;151;65;53;123;192;140;180;189;48;45;190;1;125;90;97;67;40;20;2;154;43;4;191;196;179;73;174;64;172;38;18;135;46;13;8;152;119;121;156;88;117;138;126;150;176;72;162;71;3;164;132;153;78;30;28;59;21;12;86;96;142;139;91;134;131;182;118;198,7566784087091148481,0.000000
steepest_intra:nodes_start:random,170,267156,168160,98996,2,1,92;164;144;148;135;1;108;55;191;40;187;110;7;83;120;189;68;32;183;105;65;121;98;174;150;66;20;196;96;166;156;155;132;14;131;116;130;71;107;36;100;78;102;123;88;101;91;192;194;128;190;56;75;25;168;152;67;13;140;30;23;154;162;45;195;52;0;39;69;112;198;41;181;59;146;28;74;104;73;173;57;35;9;170;31;82;49;163;145;125;34;179;80;160;63;47;133;186;84;109,3416286244265775241,0.000000
steepest_intra:nodes_start:random,171,257324,150852,106472,1,0,183;103;192;63;128;112;16;81;199;140;161;83;32;150;17;13;40;158;193;6;80;92;12;119;26;1;23;129;25;164;148;197;10;74;173;145;19;135;39;42;56;90;162;57;147;60;28;82;107;98;102;172;170;65;76;96;99;20;191;58;189;155;168;54;66;165;88;160;146;157;61;182;144;52;38;115;69;97;71;109;166;184;108;142;198;105;89;194;116;24;196;159;48;104;11;151;44;79;8;153,186524817399594218,0.000000
steepest_intra:nodes_start:random,172,259623,164006,95617,2,1,177;159;134;181;199;10;59;12;80;63;72;71;144;125;4;117;140;106;58;166;69;67;16;151;145;105;11;19;192;112;1;171;178;83;34;21;94;45;47;131;124;99;182;184;101;39;146;122;175;128;154;156;100;148;180;28;25;188;92;137;33;185;179;57;96;150;195;14;108;50;95;160;38;116;176;158;15;153;135;30;167;20;3;40;174;73;113;147;6;87;27;121;52;23;42;29;164;13;115;107,1853644350337632812,0.000000
steepest_intra:nodes_start:random,173,257268,162374,94894,2,1,76;2;163;64;45;32;159;31;26;14;50;16;81;103;183;166;44;9;84;97;143;136;117;188;58;145;49;116;138;55;40;74;125;57;106;148;198;0;174;160;135;82;194;128;164;175;43;171;13;94;132;178;126;11;130;111;80;98;192;60;10;25;119;147;48;15;30;142;181;72;62;21;118;190;59;165;191;155;114;168;187;4;22;167;120;5;186;185;151;65;161;101;189;89;56;70;36;170;47;108,36928582133743189,0.000000
steepest_intra:nodes_start:random,174,274801,180366,94435,1,0,161;70;21;190;158;78;18;145;54;109;47;165;36;11;143;155;101;35;197;23;1;7;77;176;132;173;144;153;99;171;189;138;151;83;31;184;94;25;37;86;191;59;82;51;48;53;185;20;115;154;50;137;172;111;127;44;64;192;175;88;14;163;180;27;61;32;104;187;90;55;69;38;43;95;46;120;16;13;179;96;8;123;129;81;84;134;75;125;150;119;199;195;4;49;87;68;2;9;67;118,2367465232670619805,0.000000
steepest_intra:nodes_start:random,175,273507,178647,94860,1,0,42;197;23;185;70;39;40;43;54;31;146;2;20;11;188;97;172;121;154;1;4;178;133;187;151;150;8;88;163;170;49;65;108;86;110;191;175;60;93;79;180;183;7;99;78;196;122;94;177;14;83;143;105;148;199;167;157;103;134;37;29;28;44;176;96;109;158;186;174;77;61;36;82;72;52;90;41;139;12;10;35;144;142;9;156;171;0;120;68;85;50;141;58;59;56;76;136;173;101;152,8107628681299463694,0.000000
steepest_intra:nodes_start:random,176,261831,157497,104334,2,1,20;98;148;8;193;136;57;92;6;169;117;91;188;156;157;59;198;177;130;36;195;19;78;197;17;168;110;60;194;3;161;184;176;144;100;120;10;9;131;85;124;32;15;73;126;14;172;56;137;107;31;123;186;29;24;163;181;50;27;63;196;39;21;5;150;155;4;84;158;102;115;143;37;192;121;46;45;72;41;95;129;127;173;154;171;135;128;174;145;97;141;133;187;122;35;151;74;70;99;18,2083954207596307490,0.000000
steepest_intra:nodes_start:random,177,256553,161159,95394,2,1,93;162;168;16;191;64;15;110;185;156;10;36;4;134;32;171;199;97;189;35;136;24;53;90;12;48;89;177;85;106;145;100;42;150;152;5;11;121;26;0;178;112;118;164;120;188;29;72;144;66;159;186;62;139;28;176;166;111;77;17;37;125;40;154;140;165;55;167;105;6;68;192;38;119;83;175;7;47;172;187;163;51;117;34;79;131;43;183;56;81;84;195;98;91;78;44;129;135;101;76,8878241557320312320,0.000000
steepest_intra:nodes_start:random,178,282200,179026,103174,2,1,164;46;110;39;143;182;45;26;116;93;190;3;66;152;55;138;114;4;193;185;103;188;181;136;147;126;35;104;83;47;122;118;101;175;61;72;59;195;36;150;179;108;21;20;22;155;197;87;58;62;196;31;97;8;43;50;113;121;177;168;13;65;1;102;60;127;78;199;133;96;151;10;64;189;29;95;134;11;44;124;140;156;172;149;98;142;117;115;12;69;86;7;56;159;57;28;131;48;14;125,6420100066599918435,0.000000
steepest_intra:nodes_start:random,179,260529,163207,97322,1,0,186;199;193;84;177;86;185;30;80;157;154;129;171;167;44;160;170;141;150;28;97;104;128;20;9;59;142;115;187;179;148;17;175;168;62;51;159;85;192;32;40;99;119;2;65;74;130;29;67;15;16;169;144;143;147;55;102;178;162;66;152;4;0;132;114;109;106;183;52;126;25;163;105;155;188;145;101;61;79;89;103;38;123;140;8;173;139;166;10;174;18;110;39;138;125;198;94;87;113;112,7324891891391585436,0.000000
steepest_intra:nodes_start:random,180,266711,175214,91497,1,0,31;34;49;9;71;199;176;119;88;100;198;162;40;196;59;76;4;111;186;124;116;48;126;150;166;121;47;192;17;39;10;2;43;80;133;189;22;174;167;81;149;144;107;160;98;6;68;95;122;50;46;58;26;35;172;114;83;161;66;146;97;164;38;163;180;75;135;120;170;55;113;94;108;177;127;7;52;129;54;93;183;143;142;84;168;102;169;193;27;153;78;195;106;138;70;158;57;91;14;171,4910665801276489009,0.000000
steepest_intra:nodes_start:random,181,259033,160602,98431,2,1,113;28;137;104;166;92;14;25;18;79;103;60;95;161;170;184;118;185;189;125;100;187;136;194;109;116;33;159;99;47;75;1;67;80;130;158;121;89;129;197;70;5;176;198;64;17;156;91;20;54;154;97;74;10;57;151;105;0;183;24;175;182;143;180;8;56;174;132;72;90;196;124;63;68;179;112;6;153;50;142;126;193;173;131;192;106;190;139;45;138;53;73;160;114;146;93;135;11;26;16,7175340306444967087,0.000000
steepest_intra:nodes_start:random,182,261966,164502,97464,1,0,36;9;64;58;113;21;190;117;167;193;115;22;187;161;181;149;171;189;71;198;137;98;103;76;118;109;150;83;39;157;4;38;144;143;44;124;128;60;1;114;129;196;95;80;119;139;134;97;50;53;78;42;126;15;62;180;25;145;104;75;132;106;116;54;74;57;192;121;169;87;127;160;176;153;175;77;73;40;17;8;173;197;185;194;90;154;28;46;110;82;164;91;45;30;19;125;100;29;72;112,1265835556938139385,0.000000
steepest_intra:nodes_start:random,183,248636,151256,97380,2,1,22;189;125;59;148;36;156;110;159;135;77;150;18;75;48;134;154;69;32;55;25;113;30;176;43;186;12;35;81;137;109;97;126;146;112;8;26;132;106;39;50;19;158;161;65;181;175;61;185;9;105;151;53;118;99;172;92;128;28;130;117;27;85;3;63;29;37;173;166;98;44;78;124;15;162;72;140;93;155;31;6;41;21;108;73;0;40;80;168;182;33;84;46;183;122;157;127;138;87;143,5493139802530418825,0.000000
steepest_intra:nodes_start:random,184,265512,170014,95498,1,0,49;67;108;106;158;62;115;87;26;153;88;110;176;20;84;183;77;32;159;194;7;124;122;39;23;43;3;48;121;128;165;195;141;78;136;144;129;130;17;111;169;154;47;5;168;22;35;191;117;18;151;98;79;55;33;177;2;160;145;50;113;90;196;126;184;59;127;99;81;82;147;12;118;186;132;103;45;181;68;31;164;131;171;15;116;65;63;16;71;93;25;192;54;9;134;36;83;140;157;150,8697829001525675408,0.000000
steepest_intra:nodes_start:random,185,262552,168437,94115,2,1,145;37;39;48;32;22;74;96;41;35;173;91;43;184;105;129;138;55;142;34;113;23;195;87;156;116;181;196;62;3;151;146;27;157;137;5;9;136;153;71;139;155;176;109;174;99;130;95;182;21;144;63;84;29;18;16;57;4;197;85;45;7;77;83;120;187;154;190;107;88;50;118;141;53;180;119;97;81;40;148;162;66;189;135;150;70;164;149;93;76;169;86;186;147;117;175;115;42;133;90,7582664352270075195,0.000000
steepest_intra:nodes_start:random,186,252743,152950,99793,1,0,107;24;136;148;105;32;19;142;86;174;30;160;5;113;120;29;182;99;87;106;49;53;2;178;197;132;101;128;85;43;96;119;59;47;170;89;199;150;121;79;189;61;185;36;39;146;165;64;183;111;6;180;147;173;163;168;186;33;196;20;98;69;131;118;158;14;129;28;41;97;75;55;8;65;181;42;108;151;45;95;57;137;133;192;130;52;4;81;126;1;60;141;144;164;16;23;26;124;15;31,4424504310771014167,0.000000
steepest_intra:nodes_start:random,187,270487,168973,101514,1,0,44;190;104;60;12;47;102;29;125;34;142;181;84;28;2;189;161;111;170;19;134;4;156;191;75;30;43;36;171;124;143;35;17;127;79;74;129;8;105;157;117;174;5;136;66;65;149;178;38;57;116;121;96;172;77;50;196;33;147;3;159;9;122;152;146;154;76;160;18;128;130;145;113;115;72;114;177;95;106;148;21;27;16;176;118;32;109;0;91;68;163;126;71;41;40;192;70;78;183;155,7562687038121684596,0.000000
steepest_intra:nodes_start:random,188,265447,170355,95092,2,1,149;54;82;39;100;144;88;51;44;197;103;49;140;59;190;179;105;120;86;115;69;129;167;91;141;132;89;116;76;36;29;52;43;22;17;56;42;137;77;183;131;168;81;8;193;104;127;16;174;33;198;133;194;6;74;163;101;166;121;25;10;178;112;63;185;176;41;146;92;31;75;172;48;55;84;67;37;2;187;122;40;123;113;157;64;173;72;27;142;47;58;184;95;32;189;135;158;96;155;125,8662298329802654079,0.000013
steepest_intra:nodes_start:random,189,277315,177251,100064,1,0,107;65;43;98;137;111;130;166;117;9;54;61;152;163;78;96;113;27;198;179;20;114;174;86;24;182;189;10;124;155;14;150;97;171;134;66;84;123;186;131;169;164;178;187;118;197;143;190;47;17;2;40;83;59;185;18;73;62;106;7;188;67;126;192;194;32;100;37;60;175;172;19;72;112;77;165;82;35;167;147;120;69;151;57;75;115;38;108;95;116;176;15;58;122;1;74;195;21;140;88,4911631697377065719,0.000000
steepest_intra:nodes_start:random,190,252159,159651,92508,1,0,77;89;17;134;123;194;151;176;137;127;159;195;24;5;188;120;93;152;197;163;130;142;49;153;22;41;150;121;34;179;171;143;11;53;138;92;47;187;71;29;95;189;108;107;42;116;16;72;57;148;160;75;23;156;161;19;52;7;174;62;94;124;45;55;185;111;1;105;103;139;141;25;131;4;146;28;154;40;101;80;38;182;98;14;51;183;155;198;87;2;114;90;68;8;158;30;164;31;149;6,8512412853916577899,0.000000
steepest_intra:nodes_start:random,191,264895,173564,91331,1,0,110;7;127;35;4;171;106;45;40;36;26;187;165;118;98;85;100;120;144;147;142;180;102;140;66;97;183;129;43;48;12;117;44;162;116;193;78;123;49;145;182;126;194;176;125;153;8;30;178;149;92;54;64;131;55;63;19;191;69;121;62;52;70;71;139;190;10;81;22;13;41;133;39;112;169;96;47;148;90;143;124;155;138;56;91;89;137;87;82;174;111;141;192;168;27;65;172;32;115;20,7243086424105050738,0.000000
steepest_intra:nodes_start:random,192,271033,172658,98375,1,0,141;118;35;82;151;43;75;170;1;198;108;148;120;131;4;114;90;155;28;157;106;136;15;149;40;166;140;124;105;12;33;192;11;119;51;48;193;67;173;73;103;107;16;178;54;47;169;84;189;34;29;53;91;58;71;74;121;163;182;176;2;0;180;31;44;194;8;111;164;5;186;146;14;188;158;134;137;161;37;183;21;187;69;128;92;50;110;41;181;113;6;185;199;144;168;52;23;25;135;98,6710578798116488500,0.000000
steepest_intra:nodes_start:random,193,256424,164728,91696,1,0,163;147;72;46;183;154;94;118;142;171;89;167;65;146;58;99;143;21;62;8;64;181;165;164;191;186;110;184;91;123;56;121;176;35;39;5;127;104;175;130;59;97;185;189;79;138;179;117;102;2;133;152;173;13;197;109;38;113;55;161;7;124;40;49;108;194;51;3;126;17;149;174;193;112;80;27;29;81;145;15;106;136;52;85;101;28;132;120;43;195;96;42;155;0;41;12;172;169;6;23,8171830974253284563,0.000000
steepest_intra:nodes_start:random,194,257979,164569,93410,2,1,177;185;82;169;14;138;27;153;36;76;85;150;62;29;54;52;98;26;112;83;88;111;44;59;89;182;1;17;103;199;154;45;115;167;193;97;16;170;51;8;5;195;47;171;0;65;179;49;96;53;3;184;13;50;78;131;144;119;187;63;75;101;92;134;21;164;31;113;91;165;142;194;161;18;162;135;56;15;22;102;37;140;149;196;41;28;158;156;163;191;175;84;126;94;166;129;190;128;104;172,4751463425912598647,0.000000
steepest_intra:nodes_start:random,195,269605,173538,96067,2,1,189;113;155;85;3;103;156;157;20;12;140;124;48;24;129;96;39;100;199;145;56;81;10;168;167;37;45;149;49;139;51;177;115;43;196;2;78;136;59;101;1;150;73;194;52;178;141;5;71;44;33;67;161;193;147;120;15;175;38;117;181;7;148;197;162;131;6;57;42;179;152;144;151;25;183;146;84;132;97;22;106;16;153;64;31;170;126;4;185;104;13;60;128;89;76;172;134;46;119;66,4665061627385224519,0.000000
steepest_intra:nodes_start:random,196,273864,172439,101425,1,0,179;143;51;186;134;64;13;69;65;153;8;163;53;190;11;46;33;187;131;82;158;172;62;181;167;45;47;81;15;57;73;30;197;40;107;84;36;38;24;22;144;85;196;79;58;78;18;115;98;75;44;189;60;88;86;54;70;154;95;23;87;67;104;183;74;26;147;121;177;52;31;118;148;50;12;99;103;156;129;173;193;100;63;133;19;92;48;37;56;194;71;188;106;191;25;91;176;160;127;124,7859991290755049663,0.000000
steepest_intra:nodes_start:random,197,255568,154629,100939,1,0,51;120;177;92;91;123;128;192;170;139;199;167;173;55;72;81;40;12;23;1;197;35;175;113;77;28;66;102;174;60;118;17;133;86;75;153;89;149;195;7;47;148;80;33;82;34;83;41;178;182;46;116;11;100;56;159;59;142;132;15;140;50;79;121;146;43;190;99;97;169;45;52;8;90;0;131;126;163;107;44;125;150;2;181;74;161;168;187;106;16;5;151;48;160;27;138;117;103;32;166,2244670414415425687,0.000000
steepest_intra:nodes_start:random,198,275710,169039,106671,1,0,84;31;133;66;162;197;195;72;61;93;196;87;187;73;104;119;161;131;188;22;152;91;178;2;98;51;6;3;126;30;128;176;23;45;42;182;71;169;54;132;62;122;47;76;88;155;192;32;170;48;43;124;79;115;27;38;41;177;49;64;183;110;123;36;186;20;164;7;17;114;82;116;159;92;172;141;4;117;25;99;46;106;53;80;150;147;118;156;111;10;174;191;142;165;96;16;74;63;144;35,2639261399824774554,0.000000
steepest_intra:nodes_start:random,199,254595,158758,95837,2,1,39;58;199;30;48;121;104;23;178;98;167;90;177;67;35;17;9;52;89;100;92;75;196;190;93;74;173;4;36;146;103;185;164;87;171;148;34;130;59;65;133;143;73;97;149;163;46;134;101;170;15;94;79;82;2;191;53;166;151;158;114;16;64;78;66;61;152;32;71;156;181;8;62;142;96;179;150;24;1;31;145;14;84;175;37;169;193;3;168;12;153;132;126;68;91;112;111;139;120;99,6385319360253032939,0.000000
steepest_intra:nodes_start:greedy,0,71108,22981,48127,1,0,0;117;143;183;89;186;23;137;176;80;79;63;94;124;152;97;1;101;2;120;82;129;57;92;55;52;49;102;148;9;62;144;14;138;178;106;185;165;40;90;81;196;179;145;78;31;56;113;175;171;16;25;44;75;86;26;100;121;53;180;154;135;70;127;123;162;133;151;51;118;59;65;116;43;184;84;112;4;190;10;177;54;48;160;34;146;22;18;108;69;159;181;42;5;115;41;193;139;68;46,1249134453246094314,0.000000
steepest_intra:nodes_start:greedy,1,71933,23455,48478,1,0,1;101;75;86;53;154;70;135;180;63;79;133;51;118;59;115;46;0;143;117;93;140;68;139;193;41;5;42;181;159;69;108;18;22;146;34;160;48;54;177;190;184;43;116;65;149;123;127;162;151;80;176;137;23;183;89;186;114;15;9;62;144;14;138;165;40;185;90;81;196;179;145;78;31;56;113;175;171;16;25;44;120;2;129;92;57;55;52;106;178;49;102;148;124;94;189;100;26;97;152,5136712885572098595,0.000000
steepest_intra:nodes_start:greedy,2,71905,23579,48326,1,0,2;129;57;92;55;52;49;102;148;9;62;144;14;138;178;106;185;165;40;90;81;196;179;145;78;31;56;113;175;171;16;25;44;120;75;86;26;189;94;63;79;80;176;133;151;51;118;59;115;46;0;137;23;186;89;183;143;117;93;140;68;139;193;41;5;42;181;159;69;108;18;22;146;34;160;48;54;177;10;190;84;184;43;116;65;131;149;162;123;127;70;135;154;180;53;100;101;1;97;152,5462895232576953747,0.000000
steepest_intra:nodes_start:greedy,3,71813,23409,48404,1,0,3;14;144;62;9;148;102;49;178;106;52;55;57;92;129;2;152;97;1;101;100;53;180;154;135;70;127;123;162;149;131;65;116;43;184;84;190;10;177;54;48;160;34;146;22;18;108;69;159;181;42;5;41;193;139;68;140;93;117;143;183;89;186;23;137;0;46;115;59;118;51;151;133;176;80;79;63;94;189;26;86;75;120;44;25;16;171;175;113;56;31;78;145;179;196;81;90;185;40;165,3702182124832851579,0.000000
steepest_intra:nodes_start:greedy,4,72214,24115,48099,1,0,4;190;10;177;54;48;34;160;181;42;146;22;18;108;69;159;41;193;139;68;46;115;118;59;116;65;43;184;35;131;149;123;162;151;133;51;0;117;143;183;89;23;137;176;80;79;63;94;124;152;97;1;101;2;120;82;129;57;92;55;52;49;102;148;9;62;144;14;138;178;106;185;165;40;90;81;196;179;145;78;31;56;113;175;171;16;25;44;75;86;26;100;121;53;180;154;135;70;127;112,2210630367019794317,0.000000
steepest_intra:nodes_start:greedy,5,71757,23388,48369,1,0,5;43;116;65;149;123;127;162;151;133;135;70;154;180;53;121;100;26;86;75;44;25;16;171;175;113;56;31;78;145;179;196;81;90;40;165;185;106;178;138;14;144;62;9;148;102;49;52;55;92;57;129;82;120;2;101;1;97;152;124;94;63;79;80;176;137;23;186;89;183;143;117;0;51;118;59;115;46;68;139;41;193;159;69;108;18;22;146;181;34;160;48;54;177;10;190;4;84;184;42,2194413255418017713,0.000000
steepest_intra:nodes_start:greedy,6,72451,23177,49274,1,0,6;154;53;121;100;26;86;75;101;1;97;152;94;124;148;102;49;178;106;52;55;57;92;129;2;120;44;25;16;171;175;113;56;31;78;145;179;196;81;90;185;40;165;138;14;144;62;9;15;114;186;89;183;23;137;176;80;151;162;127;123;149;65;116;43;184;177;54;48;160;34;146;22;18;108;69;159;181;42;5;41;193;139;68;140;93;117;143;0;46;115;59;118;51;133;79;63;180;70;135,7273981416512695916,0.000000
steepest_intra:nodes_start:greedy,7,72637,24199,48438,1,0,7;21;144;62;9;148;102;14;49;178;106;52;55;165;185;40;179;145;78;92;57;129;2;152;97;1;101;100;53;180;154;135;70;127;123;162;149;65;116;43;184;177;54;48;160;34;146;22;18;108;69;159;181;42;5;41;193;139;68;140;93;117;143;183;89;23;137;0;46;115;59;118;51;151;133;176;80;79;63;94;189;26;86;75;120;44;25;16;171;175;113;56;31;157;196;81;90;27;71;164,340102956334846414,0.000000
steepest_intra:nodes_start:greedy,8,71847,23063,48784,1,0,8;165;40;185;90;81;196;179;145;78;31;56;113;175;171;16;25;44;120;75;86;26;189;94;63;79;80;176;133;151;51;118;59;115;46;0;137;23;186;89;183;143;117;93;140;68;139;193;41;5;42;181;159;69;108;18;22;146;34;160;48;54;177;10;190;184;43;116;65;131;149;162;123;127;70;135;154;180;53;100;101;1;97;152;2;129;92;57;55;52;106;178;49;102;148;9;62;144;14;138,9101077565905546760,0.000000
steepest_intra:nodes_start:greedy,9,71523,23197,48326,1,0,9;148;102;49;178;106;52;55;57;92;129;2;152;97;1;101;100;53;180;154;135;70;127;123;162;149;131;65;116;43;184;84;190;10;177;54;48;160;34;146;22;18;108;69;159;181;42;5;41;193;139;68;140;93;117;143;183;89;186;23;137;0;46;115;59;118;51;151;133;176;80;79;63;94;189;26;86;75;120;44;25;16;171;175;113;56;31;78;145;179;196;81;90;185;40;165;138;14;144;62,7727624505878855705,0.000000
steepest_intra:nodes_start:greedy,10,72214,24115,48099,1,0,10;190;4;112;127;70;135;154;180;53;121;100;26;86;75;44;25;16;171;175;113;56;31;78;145;179;196;81;90;40;165;185;106;178;138;14;144;62;9;148;102;49;52;55;92;57;129;82;120;2;101;1;97;152;124;94;63;79;80;176;137;23;89;183;143;117;0;51;133;151;162;123;149;131;35;184;43;65;116;59;118;115;46;68;139;193;41;159;69;108;18;22;146;42;181;160;34;48;54;177,6164937298273161230,0.000000
steepest_intra:nodes_start:greedy,11,72516,23391,49125,1,0,11;35;84;4;112;127;123;162;151;133;135;70;154;180;53;121;100;26;86;75;44;25;16;171;175;113;56;31;78;145;179;196;81;90;40;165;185;106;178;138;14;144;62;9;148;102;49;52;55;92;57;129;82;120;2;101;1;97;152;124;94;63;79;80;176;137;23;186;89;183;143;117;0;51;118;59;115;139;68;46;65;116;43;42;5;41;193;159;69;108;18;22;146;181;34;160;48;54;177;184,7351494329855324355,0.000000
steepest_intra:nodes_start:greedy,12,72899,23524,49375,1,0,12;94;152;97;1;101;2;120;82;129;57;92;179;145;78;31;56;113;175;171;16;25;44;75;86;26;100;121;53;158;154;70;135;180;63;79;133;51;118;59;115;46;0;143;117;93;140;68;139;193;41;5;42;181;159;69;108;18;22;146;34;160;48;54;177;184;43;116;65;149;123;162;151;80;176;137;23;183;89;186;114;15;9;62;144;14;138;165;90;81;196;40;185;55;52;106;178;49;102;148,2667614132036822268,0.000000
steepest_intra:nodes_start:greedy,13,72754,23520,49234,1,0,13;31;145;78;92;179;196;81;90;40;165;185;106;178;138;14;144;62;9;148;102;49;52;55;57;129;2;152;97;1;101;100;53;180;154;135;70;127;123;162;149;131;65;116;43;184;190;10;177;54;48;160;34;146;22;18;108;69;159;181;42;5;41;193;139;68;140;93;117;143;183;89;186;23;137;0;46;115;59;118;51;151;133;176;80;79;63;94;189;26;86;75;120;44;25;16;171;175;113;56,4288194801704103125,0.000000
steepest_intra:nodes_start:greedy,14,71523,23197,48326,1,0,14;144;62;9;148;102;49;178;106;52;55;57;92;129;2;152;97;1;101;100;53;180;154;135;70;127;123;162;149;131;65;116;43;184;84;190;10;177;54;48;160;34;146;22;18;108;69;159;181;42;5;41;193;139;68;140;93;117;143;183;89;186;23;137;0;46;115;59;118;51;151;133;176;80;79;63;94;189;26;86;75;120;44;25;16;171;175;113;56;31;78;145;179;196;81;90;185;40;165;138,3748952043518614926,0.000000
steepest_intra:nodes_start:greedy,15,71602,23316,48286,1,0,15;144;14;138;165;40;185;90;81;196;179;145;78;31;56;113;175;171;16;25;44;120;75;86;26;189;94;63;79;80;176;133;151;51;118;59;115;46;0;137;23;186;89;183;143;117;93;140;68;139;193;41;5;42;181;159;69;108;18;22;146;34;160;48;54;177;10;190;184;43;116;65;131;149;162;123;127;70;135;154;180;53;100;101;1;97;152;2;129;92;57;55;52;106;178;49;102;62;9;148,125459177361932784,0.000000
steepest_intra:nodes_start:greedy,16,72017,23691,48326,1,0,16;25;44;120;75;86;26;189;94;63;79;80;176;133;151;51;118;59;115;46;0;137;23;186;89;183;143;117;93;140;68;139;193;41;5;42;181;159;69;108;18;22;146;34;160;48;54;177;10;190;84;184;43;116;65;131;149;162;123;127;70;135;154;180;53;100;101;1;97;152;2;129;57;55;52;49;102;148;9;62;144;14;138;178;106;185;165;40;90;81;196;179;92;78;145;31;56;113;175;171,1553837963051198333,0.000000
steepest_intra:nodes_start:greedy,17,73438,23931,49507,1,0,17;196;81;90;27;71;164;7;95;39;165;40;185;106;178;138;14;144;62;9;148;102;49;52;55;57;129;92;179;145;78;82;2;152;97;1;101;53;180;154;135;70;127;123;162;149;65;116;43;184;177;54;48;160;34;146;22;18;108;159;181;42;41;193;139;68;140;93;117;143;183;89;23;137;0;46;115;59;118;51;151;133;176;80;79;63;94;26;86;75;120;44;25;16;171;175;113;56;31;157,4105893824465507645,0.000000
steepest_intra:nodes_start:greedy,18,71968,23472,48496,1,0,18;22;146;159;193;41;5;42;181;34;160;48;54;177;10;190;4;84;184;43;116;65;149;123;127;162;151;133;135;70;154;180;53;121;100;26;86;75;44;25;16;171;175;113;56;31;78;145;179;196;81;90;40;165;185;106;178;138;14;144;62;9;148;102;49;52;55;92;57;129;82;120;2;101;1;97;152;124;94;63;79;80;176;137;51;118;59;115;139;46;68;0;89;183;143;117;93;140;108;69,6197221611459630333,0.000000
steepest_intra:nodes_start:greedy,19,72190,22856,49334,1,0,19;94;124;148;102;49;178;106;52;55;57;92;129;2;120;44;25;16;171;175;113;56;31;78;145;179;196;81;90;185;40;165;138;14;144;62;9;15;114;186;89;183;23;137;176;80;151;162;123;149;65;116;43;184;177;54;48;160;34;146;22;18;108;69;159;181;42;5;41;193;139;68;140;93;117;143;0;46;115;59;118;51;133;79;63;180;135;70;154;158;53;121;100;26;86;75;101;1;97;152,2032694546844580845,0.000000
steepest_intra:nodes_start:greedy,20,72394,23430,48964,1,0,20;22;146;159;193;41;5;42;181;34;160;48;54;177;10;190;84;184;43;116;65;149;123;127;162;151;133;135;70;154;180;53;121;100;26;86;75;44;25;16;171;175;113;56;31;78;145;179;196;81;90;40;165;185;106;178;138;14;144;62;9;148;102;49;52;55;92;57;129;82;120;2;101;1;97;152;124;94;63;79;80;176;137;51;118;59;115;139;46;68;0;89;183;143;117;93;140;108;69;18,7811242319754407631,0.000000
steepest_intra:nodes_start:greedy,21,71988,23819,48169,1,0,21;14;138;165;40;185;90;81;196;179;145;78;31;56;113;175;171;16;25;44;120;75;86;26;189;94;63;79;80;176;133;151;51;118;59;115;46;0;137;23;186;89;183;143;117;93;140;68;139;193;41;5;42;181;159;69;108;18;22;146;34;160;48;54;177;10;190;184;43;116;65;131;149;162;123;127;70;135;154;180;53;100;101;1;97;152;2;129;92;57;55;52;106;178;49;102;148;9;62;144,3436365235039325536,0.000000
steepest_intra:nodes_start:greedy,22,71385,23490,47895,1,0,22;146;181;34;160;48;54;177;10;190;4;112;84;184;42;43;116;65;149;123;127;162;151;133;135;70;154;180;53;121;100;26;86;75;44;25;16;171;175;113;56;31;78;145;179;196;81;90;40;165;185;106;178;138;14;144;62;9;148;102;49;52;55;92;57;129;82;120;2;101;1;97;152;124;94;63;79;80;176;137;23;186;89;183;143;117;0;51;118;59;115;46;68;139;41;193;159;69;108;18,1106092657454510474,0.000000
steepest_intra:nodes_start:greedy,23,71108,22981,48127,1,0,23;137;176;80;79;63;94;124;152;97;1;101;2;120;82;129;57;92;55;52;49;102;148;9;62;144;14;138;178;106;185;165;40;90;81;196;179;145;78;31;56;113;175;171;16;25;44;75;86;26;100;121;53;180;154;135;70;127;123;162;133;151;51;118;59;65;116;43;184;84;112;4;190;10;177;54;48;160;34;146;22;18;108;69;159;181;42;5;115;41;193;139;68;46;0;117;143;183;89;186,2051389807080426210,0.000000
steepest_intra:nodes_start:greedy,24,72431,23484,48947,1,0,24;149;65;116;43;184;84;190;10;177;54;48;160;34;146;22;18;108;69;159;181;42;5;41;193;139;68;46;115;59;118;51;0;117;143;183;89;186;23;137;176;80;79;63;94;124;152;97;1;101;2;120;82;129;57;92;55;52;49;102;148;9;62;144;14;138;178;106;185;165;40;90;81;196;179;145;78;31;56;113;175;171;16;25;44;75;86;26;100;121;53;180;154;70;135;133;151;162;127;123,4046082739393253974,0.000000
steepest_intra:nodes_start:greedy,25,71905,23579,48326,1,0,25;44;120;75;86;26;189;94;63;79;80;176;133;151;51;118;59;115;46;0;137;23;186;89;183;143;117;93;140;68;139;193;41;5;42;181;159;69;108;18;22;146;34;160;48;54;177;10;190;84;184;43;116;65;131;149;162;123;127;70;135;154;180;53;100;101;1;97;152;2;129;57;92;55;52;49;102;148;9;62;144;14;138;178;106;185;165;40;90;81;196;179;145;78;31;56;113;175;171;16,7414570148039697006,0.000000
steepest_intra:nodes_start:greedy,26,71591,23565,48026,1,0,26;97;1;101;75;86;53;154;70;135;180;63;79;133;51;118;59;115;46;0;143;117;93;140;68;139;193;41;5;42;181;159;69;108;18;22;146;34;160;48;54;177;10;190;184;43;116;65;149;123;127;162;151;80;176;137;23;183;89;186;114;15;9;62;144;14;138;165;40;185;90;81;196;179;145;78;31;56;113;175;171;16;25;44;120;2;129;92;57;55;52;106;178;49;102;148;124;94;152;100,4172260981297658951,0.000000
steepest_intra:nodes_start:greedy,27,72164,23636,48528,1,0,27;71;164;7;95;39;165;138;14;144;62;9;148;102;49;178;106;52;55;57;92;129;2;152;97;1;101;100;53;180;154;135;70;127;123;162;149;65;116;43;184;177;54;48;160;34;146;22;18;108;69;159;181;42;5;41;193;139;68;140;93;117;143;183;89;23;137;0;46;115;59;118;51;151;133;176;80;79;63;94;26;86;75;120;44;25;16;171;175;113;56;31;78;145;179;196;81;185;40;90,7746166022796938728,0.000000
steepest_intra:nodes_start:greedy,28,72501,23471,49030,1,0,28;43;65;116;131;149;123;127;162;151;133;135;70;154;180;53;121;100;26;86;75;44;25;16;171;175;113;56;31;78;145;179;196;81;90;40;165;185;106;178;138;14;144;62;9;148;102;49;52;55;92;57;129;82;120;2;101;1;97;152;124;94;63;79;80;176;137;23;186;89;183;143;117;0;51;59;118;115;46;68;139;193;41;5;42;181;159;69;108;18;22;146;34;160;48;54;177;10;190;184,7764357713782940599,0.000000
steepest_intra:nodes_start:greedy,29,72298,23401,48897,1,0,29;112;4;84;35;184;177;54;48;160;34;181;146;22;18;108;69;159;193;41;5;42;43;116;65;46;68;139;115;59;118;51;0;117;143;183;89;186;23;137;176;80;79;63;94;124;152;97;1;101;2;120;82;129;57;92;55;52;49;102;148;9;62;144;14;138;178;106;185;165;40;90;81;196;179;145;78;31;56;113;175;171;16;25;44;75;86;26;100;121;53;180;154;70;135;133;151;162;123;127,4627552965816651064,0.000000
steepest_intra:nodes_start:greedy,30,72324,23799,48525,1,0,30;54;177;10;190;84;184;43;65;116;59;118;115;46;0;51;151;133;162;123;127;70;135;154;180;53;121;100;26;86;75;44;25;16;171;175;113;56;31;78;145;179;196;81;90;40;165;185;106;178;138;14;144;62;9;148;102;49;52;55;92;57;129;82;120;2;101;1;97;152;124;94;63;79;80;176;137;23;186;89;183;143;117;93;140;68;139;193;41;159;69;108;18;22;146;195;42;181;160;34,9069792918114747568,0.000000
steepest_intra:nodes_start:greedy,31,72017,23691,48326,1,0,31;145;78;92;179;196;81;90;40;165;185;106;178;138;14;144;62;9;148;102;49;52;55;57;129;2;152;97;1;101;100;53;180;154;135;70;127;123;162;149;131;65;116;43;184;84;190;10;177;54;48;160;34;146;22;18;108;69;159;181;42;5;41;193;139;68;140;93;117;143;183;89;186;23;137;0;46;115;59;118;51;151;133;176;80;79;63;94;189;26;86;75;120;44;25;16;171;175;113;56,4987698617755590335,0.000000
steepest_intra:nodes_start:greedy,32,72151,23295,48856,1,0,32;14;144;62;9;148;102;49;178;106;52;55;57;92;129;2;152;97;1;101;100;53;180;154;135;70;127;123;162;149;131;65;116;43;184;84;190;10;177;54;48;160;34;146;22;18;108;69;159;181;42;5;41;193;139;68;140;93;117;143;183;89;186;23;137;0;46;115;59;118;51;151;133;176;80;79;63;94;189;26;86;75;120;44;25;16;171;175;113;56;31;78;145;179;196;81;90;185;40;165,455564430013991932,0.000000
steepest_intra:nodes_start:greedy,33,72265,23015,49250,1,0,33;102;49;178;106;52;55;57;92;129;2;152;97;1;101;100;53;180;154;135;70;127;123;162;149;131;65;116;43;184;190;10;177;54;48;160;34;146;22;18;108;69;159;181;42;5;41;193;139;68;140;93;117;143;183;89;186;23;137;0;46;115;59;118;51;151;133;176;80;79;63;94;189;26;86;75;120;44;25;16;171;175;113;56;31;78;145;179;196;81;90;185;40;165;138;14;144;62;9;148,4488950767593811310,0.000000
steepest_intra:nodes_start:greedy,34,71385,23490,47895,1,0,34;181;146;22;18;108;69;159;193;41;139;68;46;115;59;118;51;0;117;143;183;89;186;23;137;176;80;79;63;94;124;152;97;1;101;2;120;82;129;57;92;55;52;49;102;148;9;62;144;14;138;178;106;185;165;40;90;81;196;179;145;78;31;56;113;175;171;16;25;44;75;86;26;100;121;53;180;154;70;135;133;151;162;127;123;149;65;116;43;42;184;84;112;4;190;10;177;54;48;160,7536999983604150444,0.000000
steepest_intra:nodes_start:greedy,35,71935,23606,48329,1,0,35;84;4;112;127;123;162;151;133;135;70;154;180;53;121;100;26;86;75;44;25;16;171;175;113;56;31;78;145;179;196;81;90;40;165;185;106;178;138;14;144;62;9;148;102;49;52;55;92;57;129;82;120;2;101;1;97;152;124;94;63;79;80;176;137;23;186;89;183;143;117;0;51;118;59;115;139;68;46;65;116;43;42;5;41;193;159;69;108;18;22;146;181;34;160;48;54;177;190;184,279022818156952682,0.000000
steepest_intra:nodes_start:greedy,36,72462,23372,49090,1,0,36;108;69;18;22;146;159;193;41;5;42;181;34;160;48;54;177;10;190;84;184;43;116;65;149;123;127;162;151;133;135;70;154;180;53;121;100;26;86;75;44;25;16;171;175;113;56;31;78;145;179;196;81;90;40;165;185;106;178;138;14;144;62;9;148;102;49;52;55;92;57;129;82;120;2;101;1;97;152;124;94;63;79;80;176;137;51;118;59;115;139;46;68;0;89;183;143;117;93;140,6600520194577507555,0.000000
steepest_intra:nodes_start:greedy,37,71679,23015,48664,1,0,37;102;49;178;106;52;55;57;92;129;2;152;97;1;101;100;53;180;154;135;70;127;123;162;149;131;65;116;43;184;190;10;177;54;48;160;34;146;22;18;108;69;159;181;42;5;41;193;139;68;140;93;117;143;183;89;186;23;137;0;46;115;59;118;51;151;133;176;80;79;63;94;189;26;86;75;120;44;25;16;171;175;113;56;31;78;145;179;196;81;90;185;40;165;138;14;144;62;9;148,2186271153373418815,0.000000
steepest_intra:nodes_start:greedy,38,72529,23535,48994,1,0,38;145;78;92;179;196;81;90;40;165;185;106;178;138;14;144;62;9;148;102;49;52;55;57;129;2;152;97;1;101;100;53;180;154;135;70;127;123;162;149;131;65;116;43;184;190;10;177;54;48;160;34;146;22;18;108;69;159;181;42;5;41;193;139;68;140;93;117;143;183;89;186;23;137;0;46;115;59;118;51;151;133;176;80;79;63;94;189;26;86;75;120;44;25;16;171;175;113;56;31,1332465031530019512,0.000000
steepest_intra:nodes_start:greedy,39,72098,23628,48470,1,0,39;95;7;164;27;90;40;185;81;196;179;145;78;31;56;113;175;171;16;25;44;120;75;86;26;189;94;63;79;80;176;133;151;51;118;59;115;46;0;137;23;89;183;143;117;93;140;68;139;193;41;5;42;181;159;69;108;18;22;146;34;160;48;54;177;184;43;116;65;149;162;123;127;70;135;154;180;53;100;101;1;97;152;2;129;92;57;55;52;106;178;49;102;148;9;62;144;14;138;165,3963254006911044476,0.000000
steepest_intra:nodes_start:greedy,40,71523,23197,48326,1,0,40;165;138;14;144;62;9;148;102;49;178;106;52;55;57;92;129;2;152;97;1;101;100;53;180;154;135;70;127;123;162;149;131;65;116;43;184;84;190;10;177;54;48;160;34;146;22;18;108;69;159;181;42;5;41;193;139;68;140;93;117;143;183;89;186;23;137;0;46;115;59;118;51;151;133;176;80;79;63;94;189;26;86;75;120;44;25;16;171;175;113;56;31;78;145;179;196;81;90;185,6713096551219148801,0.000000
steepest_intra:nodes_start:greedy,41,71947,23578,48369,1,0,41;5;42;181;159;69;108;18;22;146;34;160;48;54;177;10;190;4;84;184;43;116;65;149;123;127;162;151;133;135;70;154;180;53;121;100;26;86;75;44;25;16;171;175;113;56;31;78;145;179;196;81;90;40;165;185;106;178;138;14;144;62;9;148;102;49;52;55;92;57;129;82;120;2;101;1;97;152;124;94;63;79;80;176;137;23;186;89;183;143;117;0;51;118;59;115;46;68;139;193,77713564332273361,0.000000
steepest_intra:nodes_start:greedy,42,71947,23578,48369,1,0,42;5;41;193;139;68;46;115;59;118;51;0;117;143;183;89;186;23;137;176;80;79;63;94;124;152;97;1;101;2;120;82;129;57;92;55;52;49;102;148;9;62;144;14;138;178;106;185;165;40;90;81;196;179;145;78;31;56;113;175;171;16;25;44;75;86;26;100;121;53;180;154;70;135;133;151;162;127;123;149;65;116;43;184;84;4;190;10;177;54;48;160;34;146;22;18;108;69;159;181,1160684402952882641,0.000000
steepest_intra:nodes_start:greedy,43,72083,23661,48422,1,0,43;65;116;59;118;115;46;0;51;151;133;162;123;127;70;135;154;180;53;121;100;26;86;75;44;25;16;171;175;113;56;31;78;145;179;196;81;90;40;165;185;106;178;138;14;144;62;9;148;102;49;52;55;92;57;129;82;120;2;101;1;97;152;124;94;63;79;80;176;137;23;186;89;183;143;117;93;140;68;139;193;41;5;42;181;159;69;108;18;22;146;34;160;48;54;177;10;190;84;184,8145559826457577045,0.000000
steepest_intra:nodes_start:greedy,44,71905,23579,48326,1,0,44;25;16;171;175;113;56;31;78;145;179;196;81;90;40;165;185;106;178;138;14;144;62;9;148;102;49;52;55;92;57;129;2;152;97;1;101;100;53;180;154;135;70;127;123;162;149;131;65;116;43;184;84;190;10;177;54;48;160;34;146;22;18;108;69;159;181;42;5;41;193;139;68;140;93;117;143;183;89;186;23;137;0;46;115;59;118;51;151;133;176;80;79;63;94;189;26;86;75;120,2747676488690551703,0.000000
steepest_intra:nodes_start:greedy,45,73081,23748,49333,1,0,45;162;133;135;70;154;180;53;121;100;26;86;75;44;25;16;171;175;113;56;31;78;145;179;196;81;90;40;165;185;106;178;138;14;144;62;9;148;102;49;52;55;92;57;129;82;120;2;101;1;97;152;124;94;63;79;80;176;137;23;186;89;183;143;117;0;51;118;59;115;46;68;139;193;41;5;42;181;159;69;108;18;22;146;34;160;48;54;177;10;190;84;184;43;116;65;149;123;127;151,3300937069928792198,0.000000
steepest_intra:nodes_start:greedy,46,71947,23578,48369,1,0,46;115;59;118;51;0;117;143;183;89;186;23;137;176;80;79;63;94;124;152;97;1;101;2;120;82;129;57;92;55;52;49;102;148;9;62;144;14;138;178;106;185;165;40;90;81;196;179;145;78;31;56;113;175;171;16;25;44;75;86;26;100;121;53;180;154;70;135;133;151;162;127;123;149;65;116;43;184;84;4;190;10;177;54;48;160;34;146;22;18;108;69;159;181;42;5;41;193;139;68,8630422154514879408,0.000000
steepest_intra:nodes_start:greedy,47,72248,23594,48654,1,0,47;116;43;184;84;190;10;177;54;48;160;34;146;22;18;108;69;159;181;42;5;41;193;139;68;46;115;118;59;51;0;117;143;183;89;186;23;137;176;80;79;63;94;124;152;97;1;101;2;120;82;129;57;92;55;52;49;102;148;9;62;144;14;138;178;106;185;165;40;90;81;196;179;145;78;31;56;113;175;171;16;25;44;75;86;26;100;121;53;180;154;70;135;133;151;162;127;123;149;65,3828600648894420642,0.000000
steepest_intra:nodes_start:greedy,48,72287,23801,48486,1,0,48;34;160;181;42;195;146;22;18;108;69;159;41;193;139;68;140;93;117;143;183;89;186;23;137;176;80;79;63;94;124;152;97;1;101;2;120;82;129;57;92;55;52;49;102;148;9;62;144;14;138;178;106;185;165;40;90;81;196;179;145;78;31;56;113;175;171;16;25;44;75;86;26;100;121;53;180;154;135;70;127;123;162;133;151;51;0;46;115;118;59;116;65;43;184;84;190;10;177;54,2717835386758297831,0.000000
steepest_intra:nodes_start:greedy,49,71523,23197,48326,1,0,49;178;106;52;55;57;92;129;2;152;97;1;101;100;53;180;154;135;70;127;123;162;149;131;65;116;43;184;84;190;10;177;54;48;160;34;146;22;18;108;69;159;181;42;5;41;193;139;68;140;93;117;143;183;89;186;23;137;0;46;115;59;118;51;151;133;176;80;79;63;94;189;26;86;75;120;44;25;16;171;175;113;56;31;78;145;179;196;81;90;185;40;165;138;14;144;62;9;148;102,5028756045020824740,0.000000
steepest_intra:nodes_start:greedy,50,72985,23643,49342,1,0,50;175;171;16;25;44;120;75;86;26;189;94;63;79;80;176;133;151;51;118;59;115;46;0;137;23;186;89;183;143;117;93;140;68;139;193;41;5;42;181;159;69;108;18;22;146;34;160;48;54;177;10;190;184;43;116;65;131;149;162;123;127;70;135;154;180;53;100;101;1;97;152;2;129;57;55;52;49;102;148;9;62;144;14;138;178;106;185;165;40;90;81;196;179;92;78;145;31;56;113,1716394821077055219,0.000000
steepest_intra:nodes_start:greedy,51,71947,23578,48369,1,0,51;118;59;115;46;68;139;193;41;5;42;181;159;69;108;18;22;146;34;160;48;54;177;10;190;4;84;184;43;116;65;149;123;127;162;151;133;135;70;154;180;53;121;100;26;86;75;44;25;16;171;175;113;56;31;78;145;179;196;81;90;40;165;185;106;178;138;14;144;62;9;148;102;49;52;55;92;57;129;82;120;2;101;1;97;152;124;94;63;79;80;176;137;23;186;89;183;143;117;0,5917531696812761630,0.000000
steepest_intra:nodes_start:greedy,52,71590,23264,48326,1,0,52;178;106;49;102;148;9;62;144;14;138;165;40;185;90;81;196;179;145;78;31;56;113;175;171;16;25;44;120;75;86;26;189;94;63;79;80;176;133;151;51;118;59;115;46;0;137;23;186;89;183;143;117;93;140;68;139;193;41;5;42;181;159;69;108;18;22;146;34;160;48;54;177;10;190;84;184;43;116;65;131;149;162;123;127;70;135;154;180;53;100;101;1;97;152;2;129;92;57;55,5607734685690753226,0.000000
steepest_intra:nodes_start:greedy,53,71750,23180,48570,1,0,53;158;154;70;135;180;63;79;133;51;118;59;115;46;0;143;117;93;140;68;139;193;41;5;42;181;159;69;108;18;22;146;34;160;48;54;177;184;43;116;65;149;123;127;162;151;80;176;137;23;183;89;186;114;15;9;62;144;14;138;165;40;185;90;81;196;179;145;78;31;56;113;175;171;16;25;44;120;2;129;92;57;55;52;106;178;49;102;148;124;94;152;97;1;101;75;86;26;100;121,8232177578397489507,0.000000
steepest_intra:nodes_start:greedy,54,72287,23801,48486,1,0,54;48;34;160;181;42;195;146;22;18;108;69;159;41;193;139;68;140;93;117;143;183;89;186;23;137;176;80;79;63;94;124;152;97;1;101;2;120;82;129;57;92;55;52;49;102;148;9;62;144;14;138;178;106;185;165;40;90;81;196;179;145;78;31;56;113;175;171;16;25;44;75;86;26;100;121;53;180;154;135;70;127;123;162;133;151;51;0;46;115;118;59;116;65;43;184;84;190;10;177,9107925316720870622,0.000000
steepest_intra:nodes_start:greedy,55,71590,23264,48326,1,0,55;52;178;106;49;102;148;9;62;144;14;138;165;40;185;90;81;196;179;145;78;31;56;113;175;171;16;25;44;120;75;86;26;189;94;63;79;80;176;133;151;51;118;59;115;46;0;137;23;186;89;183;143;117;93;140;68;139;193;41;5;42;181;159;69;108;18;22;146;34;160;48;54;177;10;190;84;184;43;116;65;131;149;162;123;127;70;135;154;180;53;100;101;1;97;152;2;129;92;57,1895763725044904589,0.000000
steepest_intra:nodes_start:greedy,56,72017,23691,48326,1,0,56;31;145;78;92;179;196;81;90;40;165;185;106;178;138;14;144;62;9;148;102;49;52;55;57;129;2;152;97;1;101;100;53;180;154;135;70;127;123;162;149;131;65;116;43;184;84;190;10;177;54;48;160;34;146;22;18;108;69;159;181;42;5;41;193;139;68;140;93;117;143;183;89;186;23;137;0;46;115;59;118;51;151;133;176;80;79;63;94;189;26;86;75;120;44;25;16;171;175;113,606867129220067047,0.000000
steepest_intra:nodes_start:greedy,57,71704,23378,48326,1,0,57;55;52;49;102;148;9;62;144;14;138;178;106;185;165;40;90;81;196;179;145;78;31;56;113;175;171;16;25;44;120;75;86;26;189;94;63;79;80;176;133;151;51;118;59;115;46;0;137;23;186;89;183;143;117;93;140;68;139;193;41;5;42;181;159;69;108;18;22;146;34;160;48;54;177;10;190;84;184;43;116;65;131;149;162;123;127;70;135;154;180;53;100;101;1;97;152;2;129;92,2407516227562597616,0.000000
steepest_intra:nodes_start:greedy,58,72703,24207,48496,1,0,58;71;27;90;81;196;157;31;56;113;175;171;16;25;44;120;75;86;26;94;63;79;80;176;133;151;51;118;59;115;46;0;137;23;89;183;143;117;93;140;68;139;193;41;5;42;181;159;69;108;18;22;146;34;160;48;54;177;184;43;116;65;149;162;123;127;70;135;154;180;53;100;101;1;97;152;2;129;57;92;78;145;179;40;185;165;55;52;106;178;49;14;102;148;9;62;144;21;7;164,6817748461831680204,0.000000
steepest_intra:nodes_start:greedy,59,71947,23578,48369,1,0,59;115;46;68;139;193;41;5;42;181;159;69;108;18;22;146;34;160;48;54;177;10;190;4;84;184;43;116;65;149;123;127;162;151;133;135;70;154;180;53;121;100;26;86;75;44;25;16;171;175;113;56;31;78;145;179;196;81;90;40;165;185;106;178;138;14;144;62;9;148;102;49;52;55;92;57;129;82;120;2;101;1;97;152;124;94;63;79;80;176;137;23;186;89;183;143;117;0;51;118,4576588203846195352,0.000000
steepest_intra:nodes_start:greedy,60,72791,23521,49270,1,0,60;46;115;139;193;41;5;42;181;159;69;108;18;22;146;34;160;48;54;177;10;190;4;84;184;43;116;65;149;123;127;162;151;133;135;70;154;180;53;121;100;26;86;75;44;25;16;171;175;113;56;31;78;145;179;196;81;90;40;165;185;106;178;138;14;144;62;9;148;102;49;52;55;92;57;129;82;120;2;101;1;97;152;124;94;63;79;80;176;137;23;186;89;183;143;117;0;51;59;118,6265730473471225949,0.000000
steepest_intra:nodes_start:greedy,61,72475,23085,49390,1,0,61;144;14;138;165;40;185;90;81;196;179;145;78;31;56;113;175;171;16;25;44;120;75;86;26;189;94;63;79;80;176;133;151;51;118;59;115;46;0;137;23;186;89;183;143;117;93;140;68;139;193;41;5;42;181;159;69;108;18;22;146;34;160;48;54;177;10;190;184;43;116;65;131;149;162;123;127;70;135;154;180;53;100;101;1;97;152;2;129;92;57;55;52;106;178;49;102;62;9;148,3202691792511557253,0.000000
steepest_intra:nodes_start:greedy,62,71523,23197,48326,1,0,62;144;14;138;165;40;185;90;81;196;179;145;78;31;56;113;175;171;16;25;44;120;75;86;26;189;94;63;79;80;176;133;151;51;118;59;115;46;0;137;23;186;89;183;143;117;93;140;68;139;193;41;5;42;181;159;69;108;18;22;146;34;160;48;54;177;10;190;84;184;43;116;65;131;149;162;123;127;70;135;154;180;53;100;101;1;97;152;2;129;92;57;55;52;106;178;49;102;148;9,4154230019888610832,0.000000
steepest_intra:nodes_start:greedy,63,71750,23180,48570,1,0,63;180;135;70;154;158;53;121;100;26;86;75;101;1;97;152;94;124;148;102;49;178;106;52;55;57;92;129;2;120;44;25;16;171;175;113;56;31;78;145;179;196;81;90;185;40;165;138;14;144;62;9;15;114;186;89;183;23;137;176;80;151;162;127;123;149;65;116;43;184;177;54;48;160;34;146;22;18;108;69;159;181;42;5;41;193;139;68;140;93;117;143;0;46;115;59;118;51;133;79,7584142929541763854,0.000000
steepest_intra:nodes_start:greedy,64,72373,22854,49519,1,0,64;114;186;89;183;23;137;176;80;151;162;123;149;65;116;43;184;177;54;48;160;34;146;22;18;108;69;159;181;42;5;41;193;139;68;140;93;117;143;0;46;115;59;118;51;133;79;63;180;135;70;154;158;53;121;100;26;86;75;101;1;97;152;94;124;148;9;62;102;49;178;106;52;55;57;92;129;2;120;44;25;16;171;175;113;56;31;78;145;179;196;81;90;185;40;165;138;14;144;15,5701317402486162859,0.000000
steepest_intra:nodes_start:greedy,65,71947,23578,48369,1,0,65;149;123;127;162;151;133;135;70;154;180;53;121;100;26;86;75;44;25;16;171;175;113;56;31;78;145;179;196;81;90;40;165;185;106;178;138;14;144;62;9;148;102;49;52;55;92;57;129;82;120;2;101;1;97;152;124;94;63;79;80;176;137;23;186;89;183;143;117;0;51;118;59;115;46;68;139;193;41;5;42;181;159;69;108;18;22;146;34;160;48;54;177;10;190;4;84;184;43;116,9116062684629410820,0.000000
steepest_intra:nodes_start:greedy,66,72976,23779,49197,1,0,66;51;118;59;115;46;0;89;183;143;117;93;140;68;139;193;41;5;42;181;159;69;108;18;22;146;34;160;48;54;177;10;190;84;184;43;116;65;149;123;127;162;151;133;135;70;154;180;53;121;100;26;86;75;44;25;16;171;175;113;56;31;78;145;179;196;81;90;40;165;185;106;178;138;14;144;62;9;148;102;49;52;55;92;57;129;82;120;2;101;1;97;152;124;94;63;79;80;176;137,9209632211238338118,0.000000
steepest_intra:nodes_start:greedy,67,72645,23364,49281,1,0,67;108;69;18;22;146;159;193;41;5;42;181;34;160;48;54;177;10;190;84;184;43;116;65;149;123;127;162;151;133;135;70;154;180;53;121;100;26;86;75;44;25;16;171;175;113;56;31;78;145;179;196;81;90;40;165;185;106;178;138;14;144;62;9;148;102;49;52;55;92;57;129;82;120;2;101;1;97;152;124;94;63;79;80;176;137;51;118;59;115;139;46;68;0;89;183;143;117;93;140,7693932187064589005,0.000000
steepest_intra:nodes_start:greedy,68,71947,23578,48369,1,0,68;46;115;59;118;51;0;117;143;183;89;186;23;137;176;80;79;63;94;124;152;97;1;101;2;120;82;129;57;92;55;52;49;102;148;9;62;144;14;138;178;106;185;165;40;90;81;196;179;145;78;31;56;113;175;171;16;25;44;75;86;26;100;121;53;180;154;70;135;133;151;162;127;123;149;65;116;43;184;84;4;190;10;177;54;48;160;34;146;22;18;108;69;159;181;42;5;41;193;139,4954554570388117254,0.000000
steepest_intra:nodes_start:greedy,69,72218,23381,48837,1,0,69;108;18;20;22;146;159;193;41;5;42;181;34;160;48;54;177;10;190;84;184;43;116;65;149;123;127;162;151;133;135;70;154;180;53;121;100;26;86;75;44;25;16;171;175;113;56;31;78;145;179;196;81;90;40;165;185;106;178;138;14;144;62;9;148;102;49;52;55;92;57;129;82;120;2;101;1;97;152;124;94;63;79;80;176;137;23;186;89;183;143;117;0;51;118;59;115;46;68;139,1813075226716605512,0.000000
steepest_intra:nodes_start:greedy,70,71750,23180,48570,1,0,70;154;158;53;121;100;26;86;75;101;1;97;152;94;124;148;102;49;178;106;52;55;57;92;129;2;120;44;25;16;171;175;113;56;31;78;145;179;196;81;90;185;40;165;138;14;144;62;9;15;114;186;89;183;23;137;176;80;151;162;127;123;149;65;116;43;184;177;54;48;160;34;146;22;18;108;69;159;181;42;5;41;193;139;68;140;93;117;143;0;46;115;59;118;51;133;79;63;180;135,1919576202982093093,0.000000
steepest_intra:nodes_start:greedy,71,72164,23636,48528,1,0,71;164;7;95;39;165;138;14;144;62;9;148;102;49;178;106;52;55;57;92;129;2;152;97;1;101;100;53;180;154;135;70;127;123;162;149;65;116;43;184;177;54;48;160;34;146;22;18;108;69;159;181;42;5;41;193;139;68;140;93;117;143;183;89;23;137;0;46;115;59;118;51;151;133;176;80;79;63;94;26;86;75;120;44;25;16;171;175;113;56;31;78;145;179;196;81;185;40;90;27,9196536455924559813,0.000000
steepest_intra:nodes_start:greedy,72,72377,23627,48750,1,0,72;51;0;117;143;183;89;186;23;137;176;80;79;63;94;124;152;97;1;101;2;120;82;129;57;92;55;52;49;102;148;9;62;144;14;138;178;106;185;165;40;90;81;196;179;145;78;31;56;113;175;171;16;25;44;75;86;26;100;121;53;180;154;70;135;133;151;162;127;123;149;65;116;43;184;84;190;10;177;54;48;160;34;146;22;18;108;69;159;181;42;5;41;193;139;68;46;115;118;59,2591008858747704569,0.000000
steepest_intra:nodes_start:greedy,73,72456,23554,48902,1,0,73;15;148;9;62;102;49;178;106;52;55;57;92;129;2;152;97;1;101;100;53;180;154;135;70;127;123;162;149;131;65;116;43;184;190;177;54;48;160;34;146;22;18;108;69;159;181;42;5;41;193;139;68;140;93;117;143;183;89;186;23;137;0;46;115;59;118;51;151;133;176;80;79;63;94;189;26;86;75;120;44;25;16;171;175;113;56;31;78;145;179;196;81;90;185;40;165;138;14;144,5562210615675300871,0.000000
steepest_intra:nodes_start:greedy,74,72489,23273,49216,1,0,74;1;101;75;86;53;154;70;135;180;63;79;133;51;118;59;115;46;0;143;117;93;140;68;139;193;41;5;42;181;159;69;108;18;22;146;34;160;48;54;177;184;43;116;65;149;123;127;162;151;80;176;137;23;183;89;186;114;15;9;62;144;14;138;165;40;185;90;81;196;179;145;78;31;56;113;175;171;16;25;44;120;2;129;92;57;55;52;106;178;49;102;148;124;94;189;100;26;97;152,4347962049237640284,0.000000
steepest_intra:nodes_start:greedy,75,72208,23680,48528,1,0,75;44;25;16;171;175;113;56;31;78;145;179;196;81;90;40;165;185;106;178;138;14;144;62;9;148;102;49;52;55;92;57;129;82;120;2;152;97;1;101;100;53;180;154;135;70;127;123;162;149;131;65;116;43;184;190;10;177;54;48;160;34;146;22;18;108;69;159;181;42;5;41;193;139;68;140;93;117;143;183;89;186;23;137;0;46;115;59;118;51;151;133;176;80;79;63;94;189;26;86,2412278128700055582,0.000000
steepest_intra:nodes_start:greedy,76,73321,23737,49584,1,0,76;176;80;151;162;127;123;149;65;116;43;184;190;177;54;48;160;34;146;22;18;108;69;159;181;42;5;41;193;139;68;46;115;59;118;51;133;79;63;180;135;70;154;158;53;121;100;26;86;75;101;1;97;152;94;124;148;102;49;178;106;52;55;57;92;129;2;120;44;25;16;171;175;113;56;31;78;145;179;196;81;90;185;40;165;138;14;144;62;9;15;114;186;137;23;89;183;143;117;0,8613101042980449666,0.000000
steepest_intra:nodes_start:greedy,77,72370,23528,48842,1,0,77;43;184;190;10;177;54;48;160;34;146;22;18;108;69;159;181;42;5;41;193;139;68;140;93;117;143;183;89;186;23;137;176;80;79;63;94;124;152;97;1;101;2;120;82;129;57;92;55;52;49;102;148;9;62;144;14;138;178;106;185;165;40;90;81;196;179;145;78;31;56;113;175;171;16;25;44;75;86;26;100;121;53;180;154;135;70;127;123;162;133;151;51;0;46;115;118;59;116;65,3850121264524196719,0.000000
steepest_intra:nodes_start:greedy,78,71905,23579,48326,1,0,78;31;56;113;175;171;16;25;44;120;75;86;26;189;94;63;79;80;176;133;151;51;118;59;115;46;0;137;23;186;89;183;143;117;93;140;68;139;193;41;5;42;181;159;69;108;18;22;146;34;160;48;54;177;10;190;84;184;43;116;65;131;149;162;123;127;70;135;154;180;53;100;101;1;97;152;2;129;57;92;55;52;49;102;148;9;62;144;14;138;178;106;185;165;40;90;81;196;179;145,4056827645110783421,0.000000
steepest_intra:nodes_start:greedy,79,72330,23522,48808,1,0,79;80;176;133;151;51;118;59;115;46;0;137;23;186;89;183;143;117;93;140;68;139;193;41;5;42;181;159;69;108;18;22;146;34;160;48;54;177;184;43;116;65;131;149;162;123;127;70;135;180;154;158;53;121;100;26;86;75;44;25;16;171;175;113;56;31;78;145;179;196;81;90;40;165;185;106;178;138;14;144;62;9;148;102;49;52;55;92;57;129;82;120;2;101;1;97;152;124;94;63,4486784730876490726,0.000000
steepest_intra:nodes_start:greedy,80,71940,23456,48484,1,0,80;79;63;94;124;152;97;1;101;2;120;82;129;57;92;55;52;49;102;148;9;62;144;14;138;178;106;185;165;40;90;81;196;179;145;78;31;56;113;175;171;16;25;44;75;86;26;100;121;53;180;154;135;70;127;123;162;133;151;149;131;65;116;43;184;84;190;10;177;54;48;160;34;146;22;18;108;69;159;181;42;5;41;193;139;68;46;115;59;118;51;0;117;143;183;89;186;23;137;176,6140663805023073342,0.000000
steepest_intra:nodes_start:greedy,81,71630,23304,48326,1,0,81;196;40;185;179;145;78;31;56;113;175;171;16;25;44;120;75;86;26;189;94;63;79;80;176;133;151;51;118;59;115;46;0;137;23;186;89;183;143;117;93;140;68;139;193;41;5;42;181;159;69;108;18;22;146;34;160;48;54;177;10;190;84;184;43;116;65;131;149;162;123;127;70;135;154;180;53;100;101;1;97;152;2;129;92;57;55;52;106;178;49;102;148;9;62;144;14;138;165;90,1585669582224034715,0.000000
steepest_intra:nodes_start:greedy,82,72236,23708,48528,1,0,82;2;75;86;26;189;94;63;79;80;176;133;151;51;118;59;115;46;0;137;23;186;89;183;143;117;93;140;68;139;193;41;5;42;181;159;69;108;18;22;146;34;160;48;54;177;10;190;184;43;116;65;131;149;162;123;127;70;135;154;180;53;100;101;1;97;152;129;57;92;55;52;49;102;148;9;62;144;14;138;178;106;185;165;40;90;81;196;179;145;78;31;56;113;175;171;16;25;44;120,3064957491514232938,0.000000
steepest_intra:nodes_start:greedy,83,72261,22842,49419,1,0,83;89;183;143;117;0;46;68;139;193;41;115;5;42;181;159;69;108;18;22;146;34;160;48;54;177;10;190;4;84;184;43;116;65;59;118;51;151;133;162;123;127;70;135;154;180;53;121;100;26;86;75;44;25;16;171;175;113;56;31;78;145;179;196;81;90;40;165;185;106;178;138;14;144;62;9;148;102;49;52;55;92;57;129;82;120;2;101;1;97;152;124;94;63;79;80;176;137;23;186,736156122743092934,0.000000
steepest_intra:nodes_start:greedy,84,71935,23606,48329,1,0,84;4;112;127;123;162;151;133;135;70;154;180;53;121;100;26;86;75;44;25;16;171;175;113;56;31;78;145;179;196;81;90;40;165;185;106;178;138;14;144;62;9;148;102;49;52;55;92;57;129;82;120;2;101;1;97;152;124;94;63;79;80;176;137;23;186;89;183;143;117;0;51;118;59;115;139;68;46;65;116;43;42;5;41;193;159;69;108;18;22;146;181;34;160;48;54;177;190;184;35,7466225871829833651,0.000000
steepest_intra:nodes_start:greedy,85,72861,23848,49013,1,0,85;145;179;196;81;90;40;165;185;106;178;138;14;144;62;9;148;102;49;52;55;92;57;129;2;152;97;1;101;100;53;180;154;135;70;127;123;162;149;131;65;116;43;184;190;10;177;54;48;160;34;146;22;18;108;69;159;181;42;5;41;193;139;68;140;93;117;143;183;89;186;23;137;0;46;115;59;118;51;151;133;176;80;79;63;94;189;26;86;75;120;44;25;78;31;16;171;175;113;56,7748395948149112909,0.000000
steepest_intra:nodes_start:greedy,86,71750,23180,48570,1,0,86;75;101;1;97;152;94;124;148;102;49;178;106;52;55;57;92;129;2;120;44;25;16;171;175;113;56;31;78;145;179;196;81;90;185;40;165;138;14;144;62;9;15;114;186;89;183;23;137;176;80;151;162;127;123;149;65;116;43;184;177;54;48;160;34;146;22;18;108;69;159;181;42;5;41;193;139;68;140;93;117;143;0;46;115;59;118;51;133;79;63;180;135;70;154;158;53;121;100;26,174597571015871218,0.000000
steepest_intra:nodes_start:greedy,87,73165,23569,49596,1,0,87;2;120;82;129;57;92;55;52;49;102;148;9;62;144;14;138;178;106;185;165;40;90;81;196;179;145;78;31;56;113;175;171;16;25;44;75;86;26;189;94;63;79;80;176;133;151;51;118;59;115;46;0;137;23;186;89;183;143;117;93;140;68;139;193;41;5;42;181;159;69;108;18;22;146;34;160;48;54;177;190;184;43;116;65;131;149;162;123;127;70;135;154;180;53;100;101;1;97;152,9087573596991195142,0.000000
steepest_intra:nodes_start:greedy,88,72887,23626,49261,1,0,88;25;44;120;75;86;26;189;94;63;79;80;176;133;151;51;118;59;115;46;0;137;23;186;89;183;143;117;93;140;68;139;193;41;5;42;181;159;69;108;18;22;146;34;160;48;54;177;10;190;184;43;116;65;131;149;162;123;127;70;135;154;180;53;100;101;1;97;152;2;129;57;55;52;49;102;148;9;62;144;14;138;178;106;185;165;40;90;81;196;179;92;78;145;31;56;113;175;171;16,3652614462842364547,0.000000
steepest_intra:nodes_start:greedy,89,71226,22804,48422,1,0,89;186;23;137;176;80;79;63;94;124;152;97;1;101;2;120;82;129;57;92;55;52;49;102;148;9;62;144;14;138;178;106;185;165;40;90;81;196;179;145;78;31;56;113;175;171;16;25;44;75;86;26;100;121;53;180;154;135;70;127;123;162;133;151;51;118;59;65;116;43;184;84;190;10;177;54;48;160;34;146;22;18;108;69;159;181;42;5;115;41;193;139;46;68;140;93;117;0;143;183,6308001918949169611,0.000000
steepest_intra:nodes_start:greedy,90,71673,23347,48326,1,0,90;40;185;81;196;179;145;78;31;56;113;175;171;16;25;44;120;75;86;26;189;94;63;79;80;176;133;151;51;118;59;115;46;0;137;23;186;89;183;143;117;93;140;68;139;193;41;5;42;181;159;69;108;18;22;146;34;160;48;54;177;10;190;84;184;43;116;65;131;149;162;123;127;70;135;154;180;53;100;101;1;97;152;2;129;92;57;55;52;106;178;49;102;148;9;62;144;14;138;165,9222718067592138870,0.000000
steepest_intra:nodes_start:greedy,91,72110,23205,48905,1,0,91;179;145;78;31;56;113;175;171;16;25;44;120;75;86;26;189;94;63;79;80;176;133;151;51;118;59;115;46;0;137;23;186;89;183;143;117;93;140;68;139;193;41;5;42;181;159;69;108;18;22;146;34;160;48;54;177;10;190;184;43;116;65;131;149;162;123;127;70;135;154;180;53;100;101;1;97;152;2;129;92;57;55;52;49;102;148;9;62;144;14;138;178;106;185;165;40;90;81;196,3787981646784373890,0.000000
steepest_intra:nodes_start:greedy,92,71905,23579,48326,1,0,92;55;52;49;102;148;9;62;144;14;138;178;106;185;165;40;90;81;196;179;145;78;31;56;113;175;171;16;25;44;120;75;86;26;189;94;63;79;80;176;133;151;51;118;59;115;46;0;137;23;186;89;183;143;117;93;140;68;139;193;41;5;42;181;159;69;108;18;22;146;34;160;48;54;177;10;190;84;184;43;116;65;131;149;162;123;127;70;135;154;180;53;100;101;1;97;152;2;129;57,7314582754207138088,0.000000
steepest_intra:nodes_start:greedy,93,71968,23472,48496,1,0,93;140;108;69;18;22;146;159;193;41;5;42;181;34;160;48;54;177;10;190;4;84;184;43;116;65;149;123;127;162;151;133;135;70;154;180;53;121;100;26;86;75;44;25;16;171;175;113;56;31;78;145;179;196;81;90;40;165;185;106;178;138;14;144;62;9;148;102;49;52;55;92;57;129;82;120;2;101;1;97;152;124;94;63;79;80;176;137;51;118;59;115;139;46;68;0;89;183;143;117,2268075184895893711,0.000000
steepest_intra:nodes_start:greedy,94,71750,23180,48570,1,0,94;152;97;1;101;75;86;26;100;121;53;158;154;70;135;180;63;79;133;51;118;59;115;46;0;143;117;93;140;68;139;193;41;5;42;181;159;69;108;18;22;146;34;160;48;54;177;184;43;116;65;149;123;127;162;151;80;176;137;23;183;89;186;114;15;9;62;144;14;138;165;40;185;90;81;196;179;145;78;31;56;113;175;171;16;25;44;120;2;129;92;57;55;52;106;178;49;102;148;124,1917234734493718579,0.000000
steepest_intra:nodes_start:greedy,95,72164,23636,48528,1,0,95;7;164;71;27;90;40;185;81;196;179;145;78;31;56;113;175;171;16;25;44;120;75;86;26;94;63;79;80;176;133;151;51;118;59;115;46;0;137;23;89;183;143;117;93;140;68;139;193;41;5;42;181;159;69;108;18;22;146;34;160;48;54;177;184;43;116;65;149;162;123;127;70;135;154;180;53;100;101;1;97;152;2;129;92;57;55;52;106;178;49;102;148;9;62;144;14;138;165;39,986001455634741189,0.000000
steepest_intra:nodes_start:greedy,96,72114,23548,48566,1,0,96;43;116;65;149;123;127;162;151;133;135;70;154;180;53;121;100;26;86;75;44;25;16;171;175;113;56;31;78;145;179;196;81;90;40;165;185;106;178;138;14;144;62;9;148;102;49;52;55;92;57;129;82;120;2;101;1;97;152;124;94;63;79;80;176;137;23;186;89;183;143;117;0;51;118;59;115;46;68;139;41;193;159;69;108;18;22;146;181;34;160;48;54;177;10;190;4;84;184;42,7735305414317298969,0.000000
steepest_intra:nodes_start:greedy,97,71933,23455,48478,1,0,97;152;1;101;75;86;53;154;70;135;180;63;79;133;51;118;59;115;46;0;143;117;93;140;68;139;193;41;5;42;181;159;69;108;18;22;146;34;160;48;54;177;190;184;43;116;65;149;123;127;162;151;80;176;137;23;183;89;186;114;15;9;62;144;14;138;165;40;185;90;81;196;179;145;78;31;56;113;175;171;16;25;44;120;2;129;92;57;55;52;106;178;49;102;148;124;94;189;100;26,6082462742328523402,0.000000
steepest_intra:nodes_start:greedy,98,73217,24027,49190,1,0,98;81;90;27;164;39;165;40;185;106;178;138;14;144;62;9;148;102;49;52;55;57;129;92;179;145;78;82;2;152;97;1;101;100;53;180;154;135;70;127;123;162;149;65;116;43;184;177;54;48;160;34;146;22;18;108;69;159;181;42;5;41;193;139;68;140;93;117;143;183;89;23;137;0;46;115;59;118;51;151;133;176;80;79;63;94;26;86;75;120;44;25;16;171;175;113;56;31;157;196,3347151336724243667,0.000000
steepest_intra:nodes_start:greedy,99,72749,23378,49371,1,0,99;97;26;100;86;75;101;1;152;94;124;148;102;49;178;106;52;55;57;92;129;2;120;44;25;16;171;175;113;56;31;78;145;179;196;81;90;185;40;165;138;14;144;62;9;15;114;186;89;183;23;137;176;80;151;162;127;123;149;65;116;43;184;177;54;48;160;34;146;22;18;108;69;159;181;42;5;41;193;139;68;140;93;117;143;0;46;115;59;118;51;133;79;63;180;135;70;154;158;53,5749895575655158278,0.000000
steepest_intra:nodes_start:greedy,100,71750,23180,48570,1,0,100;26;86;75;101;1;97;152;94;124;148;102;49;178;106;52;55;57;92;129;2;120;44;25;16;171;175;113;56;31;78;145;179;196;81;90;185;40;165;138;14;144;62;9;15;114;186;89;183;23;137;176;80;151;162;127;123;149;65;116;43;184;177;54;48;160;34;146;22;18;108;69;159;181;42;5;41;193;139;68;140;93;117;143;0;46;115;59;118;51;133;79;63;180;135;70;154;158;53;121,1123402658768162803,0.000000
steepest_intra:nodes_start:greedy,101,71933,23455,48478,1,0,101;1;152;97;26;100;189;94;124;148;102;49;178;106;52;55;57;92;129;2;120;44;25;16;171;175;113;56;31;78;145;179;196;81;90;185;40;165;138;14;144;62;9;15;114;186;89;183;23;137;176;80;151;162;127;123;149;65;116;43;184;190;177;54;48;160;34;146;22;18;108;69;159;181;42;5;41;193;139;68;140;93;117;143;0;46;115;59;118;51;133;79;63;180;135;70;154;53;86;75,1326309248499277327,0.000000
steepest_intra:nodes_start:greedy,102,71523,23197,48326,1,0,102;148;9;62;144;14;138;165;40;185;90;81;196;179;145;78;31;56;113;175;171;16;25;44;120;75;86;26;189;94;63;79;80;176;133;151;51;118;59;115;46;0;137;23;186;89;183;143;117;93;140;68;139;193;41;5;42;181;159;69;108;18;22;146;34;160;48;54;177;10;190;84;184;43;116;65;131;149;162;123;127;70;135;154;180;53;100;101;1;97;152;2;129;92;57;55;52;106;178;49,3634418812847618033,0.000000
steepest_intra:nodes_start:greedy,103,71597,23235,48362,1,0,103;34;160;48;54;177;10;190;4;112;84;184;42;43;116;65;149;123;127;162;151;133;135;70;154;180;53;121;100;26;86;75;44;25;16;171;175;113;56;31;78;145;179;196;81;90;40;165;185;106;178;138;14;144;62;9;148;102;49;52;55;92;57;129;82;120;2;101;1;97;152;124;94;63;79;80;176;137;23;186;89;183;143;117;0;51;118;59;115;46;68;139;41;193;159;69;108;18;22;146,3098114168956355765,0.000000
steepest_intra:nodes_start:greedy,104,73110,23928,49182,1,0,104;54;48;34;160;181;42;195;146;22;18;108;69;159;41;193;139;68;140;93;117;143;183;89;186;23;137;176;80;79;63;94;124;152;97;1;101;2;120;82;129;57;92;55;52;49;102;148;9;62;144;14;138;178;106;185;165;40;90;81;196;179;145;78;31;56;113;175;171;16;25;44;75;86;26;100;121;53;180;154;135;70;127;123;162;133;151;51;0;46;115;118;59;116;65;43;184;4;10;177,496943065887943353,0.000000
steepest_intra:nodes_start:greedy,105,72393,23544,48849,2,1,116;105;43;184;84;190;10;177;54;48;160;34;146;22;18;108;69;159;181;42;5;41;193;139;68;46;115;118;59;51;0;117;143;183;89;186;23;137;176;80;79;63;94;124;152;97;1;101;2;120;82;129;57;92;55;52;49;102;148;9;62;144;14;138;178;106;185;165;40;90;81;196;179;145;78;31;56;113;175;171;16;25;44;75;86;26;100;121;53;180;154;70;135;133;151;162;127;123;149;65,4678047515409644657,0.000000
steepest_intra:nodes_start:greedy,106,71523,23197,48326,1,0,106;178;49;102;148;9;62;144;14;138;165;40;185;90;81;196;179;145;78;31;56;113;175;171;16;25;44;120;75;86;26;189;94;63;79;80;176;133;151;51;118;59;115;46;0;137;23;186;89;183;143;117;93;140;68;139;193;41;5;42;181;159;69;108;18;22;146;34;160;48;54;177;10;190;84;184;43;116;65;131;149;162;123;127;70;135;154;180;53;100;101;1;97;152;2;129;92;57;55;52,637267794296406360,0.000000
steepest_intra:nodes_start:greedy,107,72830,23628,49202,1,0,107;27;164;7;95;39;165;138;14;144;62;9;148;102;49;178;106;52;55;57;92;129;2;152;97;1;101;100;53;180;154;135;70;127;123;162;149;65;116;43;184;177;54;48;160;34;146;22;18;108;69;159;181;42;5;41;193;139;68;140;93;117;143;183;89;23;137;0;46;115;59;118;51;151;133;176;80;79;63;94;26;86;75;120;44;25;16;171;175;113;56;31;78;145;179;196;81;185;40;90,9057291073378394826,0.000000
steepest_intra:nodes_start:greedy,108,72218,23381,48837,1,0,108;69;139;68;46;115;59;118;51;0;117;143;183;89;186;23;137;176;80;79;63;94;124;152;97;1;101;2;120;82;129;57;92;55;52;49;102;148;9;62;144;14;138;178;106;185;165;40;90;81;196;179;145;78;31;56;113;175;171;16;25;44;75;86;26;100;121;53;180;154;70;135;133;151;162;127;123;149;65;116;43;184;84;190;10;177;54;48;160;34;181;42;5;41;193;159;146;22;20;18,3213958398819357387,0.000000
steepest_intra:nodes_start:greedy,109,72236,23390,48846,1,0,109;118;115;46;68;139;193;41;5;42;181;159;69;108;18;22;146;34;160;48;54;177;10;190;4;84;184;43;65;116;59;151;133;162;123;127;70;135;154;180;53;121;100;26;86;75;44;25;16;171;175;113;56;31;78;145;179;196;81;90;40;165;185;106;178;138;14;144;62;9;148;102;49;52;55;92;57;129;82;120;2;101;1;97;152;124;94;63;79;80;176;137;23;186;89;183;143;117;0;51,1473220751098756056,0.000000
steepest_intra:nodes_start:greedy,110,72558,23584,48974,1,0,110;193;41;5;42;181;159;69;108;18;22;146;34;160;48;54;177;10;190;84;184;43;116;65;149;123;127;162;151;133;135;70;154;180;53;121;100;26;86;75;44;25;16;171;175;113;56;31;78;145;179;196;81;90;40;165;185;106;178;138;14;144;62;9;148;102;49;52;55;92;57;129;82;120;2;101;1;97;152;124;94;63;79;80;176;137;23;186;89;183;143;117;0;51;118;59;115;46;68;139,2641988619265797554,0.000000
steepest_intra:nodes_start:greedy,111,72861,23747,49114,1,0,111;148;9;62;102;144;14;49;178;106;165;39;95;164;27;90;81;196;40;185;52;55;57;129;92;179;145;78;31;56;113;175;171;16;25;44;120;2;152;97;1;101;75;86;26;100;121;53;158;154;70;135;180;63;79;133;51;118;59;115;46;0;89;183;143;117;93;140;68;139;193;41;5;42;181;159;69;108;18;22;146;34;160;48;54;177;184;43;116;65;149;123;127;162;151;80;176;137;94;124,8611924287246479173,0.000000
steepest_intra:nodes_start:greedy,112,71935,23606,48329,1,0,112;4;84;35;184;190;177;54;48;160;34;181;146;22;18;108;69;159;193;41;5;42;43;116;65;46;68;139;115;59;118;51;0;117;143;183;89;186;23;137;176;80;79;63;94;124;152;97;1;101;2;120;82;129;57;92;55;52;49;102;148;9;62;144;14;138;178;106;185;165;40;90;81;196;179;145;78;31;56;113;175;171;16;25;44;75;86;26;100;121;53;180;154;70;135;133;151;162;123;127,7988559433921719998,0.000000
steepest_intra:nodes_start:greedy,113,72017,23691,48326,1,0,113;56;31;145;78;92;179;196;81;90;40;165;185;106;178;138;14;144;62;9;148;102;49;52;55;57;129;2;152;97;1;101;100;53;180;154;135;70;127;123;162;149;131;65;116;43;184;84;190;10;177;54;48;160;34;146;22;18;108;69;159;181;42;5;41;193;139;68;140;93;117;143;183;89;186;23;137;0;46;115;59;118;51;151;133;176;80;79;63;94;189;26;86;75;120;44;25;16;171;175,8989028408987619420,0.000000
steepest_intra:nodes_start:greedy,114,71682,23112,48570,1,0,114;186;89;183;23;137;176;80;151;162;127;123;149;65;116;43;184;177;54;48;160;34;146;22;18;108;69;159;181;42;5;41;193;139;68;140;93;117;143;0;46;115;59;118;51;133;79;63;180;135;70;154;158;53;121;100;26;86;75;101;1;97;152;94;124;148;9;62;102;49;178;106;52;55;57;92;129;2;120;44;25;16;171;175;113;56;31;78;145;179;196;81;90;185;40;165;138;14;144;15,1783016277711784589,0.000000
steepest_intra:nodes_start:greedy,115,71947,23578,48369,1,0,115;59;118;51;0;117;143;183;89;186;23;137;176;80;79;63;94;124;152;97;1;101;2;120;82;129;57;92;55;52;49;102;148;9;62;144;14;138;178;106;185;165;40;90;81;196;179;145;78;31;56;113;175;171;16;25;44;75;86;26;100;121;53;180;154;70;135;133;151;162;127;123;149;65;116;43;184;84;4;190;10;177;54;48;160;34;146;22;18;108;69;159;181;42;5;41;193;139;68;46,4238732848290107099,0.000000
steepest_intra:nodes_start:greedy,116,71947,23578,48369,1,0,116;43;184;84;4;190;10;177;54;48;160;34;146;22;18;108;69;159;181;42;5;41;193;139;68;46;115;59;118;51;0;117;143;183;89;186;23;137;176;80;79;63;94;124;152;97;1;101;2;120;82;129;57;92;55;52;49;102;148;9;62;144;14;138;178;106;185;165;40;90;81;196;179;145;78;31;56;113;175;171;16;25;44;75;86;26;100;121;53;180;154;70;135;133;151;162;127;123;149;65,1328711573631925904,0.000000
steepest_intra:nodes_start:greedy,117,71108,22981,48127,1,0,117;0;46;68;139;193;41;115;5;42;181;159;69;108;18;22;146;34;160;48;54;177;10;190;4;112;84;184;43;116;65;59;118;51;151;133;162;123;127;70;135;154;180;53;121;100;26;86;75;44;25;16;171;175;113;56;31;78;145;179;196;81;90;40;165;185;106;178;138;14;144;62;9;148;102;49;52;55;92;57;129;82;120;2;101;1;97;152;124;94;63;79;80;176;137;23;186;89;183;143,667002370361845191,0.000000
steepest_intra:nodes_start:greedy,118,72006,23637,48369,1,0,118;115;46;68;139;193;41;5;42;181;159;69;108;18;22;146;34;160;48;54;177;10;190;4;84;184;43;116;65;149;123;127;162;151;133;135;70;154;180;53;121;100;26;86;75;44;25;16;171;175;113;56;31;78;145;179;196;81;90;40;165;185;106;178;138;14;144;62;9;148;102;49;52;55;92;57;129;82;120;2;101;1;97;152;124;94;63;79;80;176;137;23;186;89;183;143;117;0;51;59,4512933002738749818,0.000000
steepest_intra:nodes_start:greedy,119,71472,23013,48459,1,0,119;40;185;90;81;196;179;145;78;31;56;113;175;171;16;25;44;120;75;86;26;189;94;63;79;80;176;133;151;51;118;59;115;46;0;137;23;186;89;183;143;117;93;140;68;139;193;41;5;42;181;159;69;108;18;22;146;34;160;48;54;177;10;190;184;43;116;65;131;149;162;123;127;70;135;154;180;53;100;101;1;97;152;2;129;92;57;55;52;106;178;49;102;148;9;62;144;14;138;165,7999754663076948831,0.000000
steepest_intra:nodes_start:greedy,120,71905,23579,48326,1,0,120;75;86;26;189;94;63;79;80;176;133;151;51;118;59;115;46;0;137;23;186;89;183;143;117;93;140;68;139;193;41;5;42;181;159;69;108;18;22;146;34;160;48;54;177;10;190;84;184;43;116;65;131;149;162;123;127;70;135;154;180;53;100;101;1;97;152;2;129;57;92;55;52;49;102;148;9;62;144;14;138;178;106;185;165;40;90;81;196;179;145;78;31;56;113;175;171;16;25;44,1381440545310351560,0.000000
steepest_intra:nodes_start:greedy,121,71867,23297,48570,1,0,121;100;26;97;86;75;101;1;152;94;124;148;102;49;178;106;52;55;57;92;129;2;120;44;25;16;171;175;113;56;31;78;145;179;196;81;90;185;40;165;138;14;144;62;9;15;114;186;89;183;23;137;176;80;151;162;127;123;149;65;116;43;184;177;54;48;160;34;146;22;18;108;69;159;181;42;5;41;193;139;68;140;93;117;143;0;46;115;59;118;51;133;79;63;180;135;70;154;158;53,6786467762816060282,0.000000
steepest_intra:nodes_start:greedy,122,72576,23444,49132,1,0,122;176;80;79;133;151;51;118;59;115;46;0;137;23;89;183;143;117;93;140;68;139;193;41;5;42;181;159;69;108;18;22;146;34;160;48;54;177;184;43;116;65;131;149;162;123;127;70;135;180;154;158;53;121;100;26;86;75;44;25;16;171;175;113;56;31;78;145;179;196;81;90;40;165;185;106;178;138;14;144;62;9;148;102;49;52;55;92;57;129;82;120;2;101;1;97;152;124;94;63,1986694929815546998,0.000000
steepest_intra:nodes_start:greedy,123,71940,23456,48484,1,0,123;162;133;151;149;131;65;116;43;184;84;190;10;177;54;48;160;34;146;22;18;108;69;159;181;42;5;41;193;139;68;46;115;59;118;51;0;117;143;183;89;186;23;137;176;80;79;63;94;124;152;97;1;101;2;120;82;129;57;92;55;52;49;102;148;9;62;144;14;138;178;106;185;165;40;90;81;196;179;145;78;31;56;113;175;171;16;25;44;75;86;26;100;121;53;180;154;135;70;127,4583788699605446637,0.000000
steepest_intra:nodes_start:greedy,124,71861,23291,48570,1,0,124;152;97;1;101;75;86;26;100;121;53;158;154;70;135;180;63;79;133;51;118;59;115;46;0;143;117;93;140;68;139;193;41;5;42;181;159;69;108;18;22;146;34;160;48;54;177;184;43;116;65;149;123;127;162;151;80;176;137;23;183;89;186;114;15;9;62;144;14;138;165;40;185;90;81;196;179;145;78;31;56;113;175;171;16;25;44;120;2;129;92;57;55;52;106;178;49;102;148;94,3388915229007830189,0.000000
steepest_intra:nodes_start:greedy,125,73395,23511,49884,1,0,125;2;120;82;129;57;92;179;145;78;31;56;113;175;171;16;25;44;75;86;53;154;70;135;180;63;79;133;51;118;59;115;46;0;143;117;93;140;68;139;193;41;5;42;181;159;69;108;18;22;146;34;160;48;54;177;184;43;116;65;149;123;162;151;80;176;137;23;183;89;186;114;15;9;62;144;14;138;165;90;81;196;40;185;55;52;106;178;49;102;148;124;94;189;100;26;1;101;97;152,3315332400019163977,0.000000
steepest_intra:nodes_start:greedy,126,72420,23391,49029,1,0,126;112;4;84;35;184;177;54;48;160;34;181;146;22;18;108;69;159;193;41;5;42;43;116;65;46;68;139;115;59;118;51;0;117;143;183;89;186;23;137;176;80;79;63;94;124;152;97;1;101;2;120;82;129;57;92;55;52;49;102;148;9;62;144;14;138;178;106;185;165;40;90;81;196;179;145;78;31;56;113;175;171;16;25;44;75;86;26;100;121;53;180;154;70;135;133;151;162;123;127,1528720535627200341,0.000000
steepest_intra:nodes_start:greedy,127,72193,23609,48584,1,0,127;70;135;154;180;53;121;100;26;86;75;44;25;16;171;175;113;56;31;78;145;179;196;81;90;40;165;185;106;178;138;14;144;62;9;148;102;49;52;55;92;57;129;82;120;2;101;1;97;152;124;94;63;79;80;176;133;151;51;118;59;115;46;0;137;23;186;89;183;143;117;93;140;68;139;193;41;5;42;181;159;69;108;18;22;146;34;160;48;54;177;190;184;43;116;65;131;149;162;123,1363074552844860012,0.000000
steepest_intra:nodes_start:greedy,128,72267,23379,48888,1,0,128;167;148;9;62;102;144;14;49;178;106;165;40;185;90;81;196;179;145;78;31;56;113;175;171;16;25;44;120;75;86;26;189;94;63;79;80;176;133;151;51;118;59;115;46;0;137;23;186;89;183;143;117;93;140;68;139;193;41;5;42;181;159;69;108;18;22;146;34;160;48;54;177;10;190;184;43;116;65;131;149;162;123;127;70;135;154;180;53;100;101;1;97;152;2;129;92;57;52;55,6100945259069875948,0.000000
steepest_intra:nodes_start:greedy,129,71905,23579,48326,1,0,129;57;92;55;52;49;102;148;9;62;144;14;138;178;106;185;165;40;90;81;196;179;145;78;31;56;113;175;171;16;25;44;120;75;86;26;189;94;63;79;80;176;133;151;51;118;59;115;46;0;137;23;186;89;183;143;117;93;140;68;139;193;41;5;42;181;159;69;108;18;22;146;34;160;48;54;177;10;190;84;184;43;116;65;131;149;162;123;127;70;135;154;180;53;100;101;1;97;152;2,7989213528427932681,0.000000
steepest_intra:nodes_start:greedy,130,72516,23221,49295,1,0,130;148;102;49;178;106;52;55;57;92;129;2;120;44;25;16;171;175;113;56;31;78;145;179;196;81;90;185;40;165;138;14;144;62;9;15;114;186;89;183;23;137;176;80;151;162;127;123;149;65;116;43;184;177;54;48;160;34;146;22;18;108;69;159;181;42;5;41;193;139;68;140;93;117;143;0;46;115;59;118;51;133;79;63;180;135;70;154;158;53;121;100;26;86;75;101;1;97;152;94,2275814788847704591,0.000000
steepest_intra:nodes_start:greedy,131,71993,23509,48484,1,0,131;149;123;127;162;151;133;135;70;154;180;53;121;100;26;86;75;44;25;16;171;175;113;56;31;78;145;179;196;81;90;40;165;185;106;178;138;14;144;62;9;148;102;49;52;55;92;57;129;82;120;2;101;1;97;152;124;94;63;79;80;176;137;23;186;89;183;143;117;0;51;118;59;115;46;68;139;193;41;5;42;181;159;69;108;18;22;146;34;160;48;54;177;10;190;84;184;43;116;65,4763603693777904176,0.000000
steepest_intra:nodes_start:greedy,132,72621,23434,49187,1,0,132;14;138;165;40;185;90;81;196;179;145;78;31;56;113;175;171;16;25;44;120;75;86;26;189;94;63;79;80;176;133;151;51;118;59;115;46;0;137;23;186;89;183;143;117;93;140;68;139;193;41;5;42;181;159;69;108;18;22;146;34;160;48;54;177;10;190;184;43;116;65;131;149;162;123;127;70;135;154;180;53;100;101;1;97;152;2;129;92;57;55;52;106;178;49;102;148;9;62;144,5245717068767889812,0.000000
steepest_intra:nodes_start:greedy,133,72193,23609,48584,1,0,133;151;51;118;59;115;46;0;137;23;186;89;183;143;117;93;140;68;139;193;41;5;42;181;159;69;108;18;22;146;34;160;48;54;177;190;184;43;116;65;131;149;162;123;127;70;135;154;180;53;121;100;26;86;75;44;25;16;171;175;113;56;31;78;145;179;196;81;90;40;165;185;106;178;138;14;144;62;9;148;102;49;52;55;92;57;129;82;120;2;101;1;97;152;124;94;63;79;80;176,2935794038646019663,0.000000
steepest_intra:nodes_start:greedy,134,73278,23531,49747,1,0,134;108;18;69;139;68;46;115;59;118;51;0;117;143;183;89;186;23;137;176;80;79;63;94;124;152;97;1;101;2;120;82;129;57;92;55;52;49;102;148;9;62;144;14;138;178;106;185;165;40;90;81;196;179;145;78;31;56;113;175;171;16;25;44;75;86;26;100;121;53;180;154;70;135;133;151;162;127;123;149;65;116;43;184;190;10;177;54;48;160;34;181;42;5;41;193;159;146;22;20,2620737676831673066,0.000000
steepest_intra:nodes_start:greedy,135,71750,23180,48570,1,0,135;70;154;158;53;121;100;26;86;75;101;1;97;152;94;124;148;102;49;178;106;52;55;57;92;129;2;120;44;25;16;171;175;113;56;31;78;145;179;196;81;90;185;40;165;138;14;144;62;9;15;114;186;89;183;23;137;176;80;151;162;127;123;149;65;116;43;184;177;54;48;160;34;146;22;18;108;69;159;181;42;5;41;193;139;68;140;93;117;143;0;46;115;59;118;51;133;79;63;180,397861573621658936,0.000000
steepest_intra:nodes_start:greedy,136,72536,23768,48768,1,0,136;121;100;26;86;75;44;25;16;171;175;113;56;31;78;145;179;196;81;90;40;165;185;106;178;138;14;144;62;9;148;102;49;52;55;92;57;129;82;120;2;101;1;97;152;124;94;63;79;80;176;137;23;186;89;183;143;117;0;51;118;59;115;46;68;139;193;41;5;42;181;159;69;108;18;22;146;34;160;48;54;177;10;190;84;184;43;116;65;149;123;127;162;151;133;180;135;70;154;53,2342578585075391415,0.000000
steepest_intra:nodes_start:greedy,137,71750,23180,48570,1,0,137;23;183;89;186;114;15;9;62;144;14;138;165;40;185;90;81;196;179;145;78;31;56;113;175;171;16;25;44;120;2;129;92;57;55;52;106;178;49;102;148;124;94;152;97;1;101;75;86;26;100;121;53;158;154;70;135;180;63;79;133;51;118;59;115;46;0;143;117;93;140;68;139;193;41;5;42;181;159;69;108;18;22;146;34;160;48;54;177;184;43;116;65;149;123;127;162;151;80;176,2836082748232614780,0.000000
steepest_intra:nodes_start:greedy,138,71523,23197,48326,1,0,138;14;144;62;9;148;102;49;178;106;52;55;57;92;129;2;152;97;1;101;100;53;180;154;135;70;127;123;162;149;131;65;116;43;184;84;190;10;177;54;48;160;34;146;22;18;108;69;159;181;42;5;41;193;139;68;140;93;117;143;183;89;186;23;137;0;46;115;59;118;51;151;133;176;80;79;63;94;189;26;86;75;120;44;25;16;171;175;113;56;31;78;145;179;196;81;90;185;40;165,2047115208009688480,0.000000
steepest_intra:nodes_start:greedy,139,71947,23578,48369,1,0,139;68;46;115;59;118;51;0;117;143;183;89;186;23;137;176;80;79;63;94;124;152;97;1;101;2;120;82;129;57;92;55;52;49;102;148;9;62;144;14;138;178;106;185;165;40;90;81;196;179;145;78;31;56;113;175;171;16;25;44;75;86;26;100;121;53;180;154;70;135;133;151;162;127;123;149;65;116;43;184;84;4;190;10;177;54;48;160;34;146;22;18;108;69;159;181;42;5;41;193,8800652149650050232,0.000000
steepest_intra:nodes_start:greedy,140,71968,23472,48496,1,0,140;108;69;18;22;146;159;193;41;5;42;181;34;160;48;54;177;10;190;4;84;184;43;116;65;149;123;127;162;151;133;135;70;154;180;53;121;100;26;86;75;44;25;16;171;175;113;56;31;78;145;179;196;81;90;40;165;185;106;178;138;14;144;62;9;148;102;49;52;55;92;57;129;82;120;2;101;1;97;152;124;94;63;79;80;176;137;51;118;59;115;139;46;68;0;89;183;143;117;93,7442003084919095979,0.000000
steepest_intra:nodes_start:greedy,141,72824,23488,49336,1,0,141;23;186;89;183;143;117;0;93;140;68;46;115;139;193;41;5;42;181;159;69;108;18;22;146;34;160;48;54;177;10;190;184;43;116;65;59;118;51;151;133;162;123;127;70;135;154;180;53;121;100;26;86;75;44;25;16;171;175;113;56;31;78;145;179;196;81;90;40;165;185;106;178;138;14;144;62;9;148;102;49;52;55;92;57;129;82;120;2;101;1;97;152;124;94;63;79;80;176;137,1700114193189747063,0.000000
steepest_intra:nodes_start:greedy,142,72909,23572,49337,1,0,142;139;68;46;115;59;118;51;0;117;143;183;89;186;23;137;176;80;79;63;94;124;152;97;1;101;2;120;82;129;57;92;55;52;49;102;148;9;62;144;14;138;178;106;185;165;40;90;81;196;179;145;78;31;56;113;175;171;16;25;44;75;86;26;100;121;53;180;154;70;135;133;151;162;127;123;149;65;116;43;184;84;190;10;177;54;48;160;34;146;22;18;108;69;159;181;42;5;41;193,5188237479156551187,0.000000
steepest_intra:nodes_start:greedy,143,71108,22981,48127,1,0,143;117;0;46;68;139;193;41;115;5;42;181;159;69;108;18;22;146;34;160;48;54;177;10;190;4;112;84;184;43;116;65;59;118;51;151;133;162;123;127;70;135;154;180;53;121;100;26;86;75;44;25;16;171;175;113;56;31;78;145;179;196;81;90;40;165;185;106;178;138;14;144;62;9;148;102;49;52;55;92;57;129;82;120;2;101;1;97;152;124;94;63;79;80;176;137;23;186;89;183,2853414028746058257,0.000000
steepest_intra:nodes_start:greedy,144,71523,23197,48326,1,0,144;14;138;165;40;185;90;81;196;179;145;78;31;56;113;175;171;16;25;44;120;75;86;26;189;94;63;79;80;176;133;151;51;118;59;115;46;0;137;23;186;89;183;143;117;93;140;68;139;193;41;5;42;181;159;69;108;18;22;146;34;160;48;54;177;10;190;84;184;43;116;65;131;149;162;123;127;70;135;154;180;53;100;101;1;97;152;2;129;92;57;55;52;106;178;49;102;148;9;62,3707749773111949436,0.000000
steepest_intra:nodes_start:greedy,145,71905,23579,48326,1,0,145;179;196;81;90;40;165;185;106;178;138;14;144;62;9;148;102;49;52;55;92;57;129;2;152;97;1;101;100;53;180;154;135;70;127;123;162;149;131;65;116;43;184;84;190;10;177;54;48;160;34;146;22;18;108;69;159;181;42;5;41;193;139;68;140;93;117;143;183;89;186;23;137;0;46;115;59;118;51;151;133;176;80;79;63;94;189;26;86;75;120;44;25;16;171;175;113;56;31;78,3308680710710937528,0.000000
steepest_intra:nodes_start:greedy,146,71385,23490,47895,1,0,146;181;34;160;48;54;177;10;190;4;112;84;184;42;43;116;65;149;123;127;162;151;133;135;70;154;180;53;121;100;26;86;75;44;25;16;171;175;113;56;31;78;145;179;196;81;90;40;165;185;106;178;138;14;144;62;9;148;102;49;52;55;92;57;129;82;120;2;101;1;97;152;124;94;63;79;80;176;137;23;186;89;183;143;117;0;51;118;59;115;46;68;139;41;193;159;69;108;18;22,4018733446915379941,0.000000
steepest_intra:nodes_start:greedy,147,73391,23933,49458,1,0,147;177;10;4;184;43;65;116;59;118;115;46;0;51;151;133;162;123;127;70;135;154;180;53;121;100;26;86;75;44;25;16;171;175;113;56;31;78;145;179;196;81;90;40;165;185;106;178;138;14;144;62;9;148;102;49;52;55;92;57;129;82;120;2;101;1;97;152;124;94;63;79;80;176;137;23;186;89;183;143;117;93;140;68;139;193;41;159;69;108;18;22;146;195;42;181;160;34;48;54,2325209411540628682,0.000000
steepest_intra:nodes_start:greedy,148,71523,23197,48326,1,0,148;102;49;178;106;52;55;57;92;129;2;152;97;1;101;100;53;180;154;135;70;127;123;162;149;131;65;116;43;184;84;190;10;177;54;48;160;34;146;22;18;108;69;159;181;42;5;41;193;139;68;140;93;117;143;183;89;186;23;137;0;46;115;59;118;51;151;133;176;80;79;63;94;189;26;86;75;120;44;25;16;171;175;113;56;31;78;145;179;196;81;90;185;40;165;138;14;144;62;9,9174821185381232505,0.000000
steepest_intra:nodes_start:greedy,149,71947,23578,48369,1,0,149;123;127;162;151;133;135;70;154;180;53;121;100;26;86;75;44;25;16;171;175;113;56;31;78;145;179;196;81;90;40;165;185;106;178;138;14;144;62;9;148;102;49;52;55;92;57;129;82;120;2;101;1;97;152;124;94;63;79;80;176;137;23;186;89;183;143;117;0;51;118;59;115;46;68;139;193;41;5;42;181;159;69;108;18;22;146;34;160;48;54;177;10;190;4;84;184;43;116;65,6529483113843421134,0.000000
steepest_intra:nodes_start:greedy,150,73393,23514,49879,1,0,150;75;44;25;16;171;175;113;56;31;78;145;179;92;57;129;82;120;2;1;152;97;26;100;189;94;124;148;102;49;178;106;52;55;185;40;196;81;90;165;138;14;144;62;9;15;114;186;89;183;23;137;176;80;151;162;123;149;65;116;43;184;177;54;48;160;34;146;22;18;108;69;159;181;42;5;41;193;139;68;140;93;117;143;0;46;115;59;118;51;133;79;63;180;135;70;154;53;86;101,9213463393695048362,0.000000
steepest_intra:nodes_start:greedy,151,71940,23456,48484,1,0,151;133;162;123;127;70;135;154;180;53;121;100;26;86;75;44;25;16;171;175;113;56;31;78;145;179;196;81;90;40;165;185;106;178;138;14;144;62;9;148;102;49;52;55;92;57;129;82;120;2;101;1;97;152;124;94;63;79;80;176;137;23;186;89;183;143;117;0;51;118;59;115;46;68;139;193;41;5;42;181;159;69;108;18;22;146;34;160;48;54;177;10;190;84;184;43;116;65;131;149,2233460067036250034,0.000000
steepest_intra:nodes_start:greedy,152,71933,23455,48478,1,0,152;1;101;75;86;53;154;70;135;180;63;79;133;51;118;59;115;46;0;143;117;93;140;68;139;193;41;5;42;181;159;69;108;18;22;146;34;160;48;54;177;190;184;43;116;65;149;123;127;162;151;80;176;137;23;183;89;186;114;15;9;62;144;14;138;165;40;185;90;81;196;179;145;78;31;56;113;175;171;16;25;44;120;2;129;92;57;55;52;106;178;49;102;148;124;94;189;100;26;97,7860420184703724760,0.000000
steepest_intra:nodes_start:greedy,153,71829,23022,48807,2,1,0;153;117;143;183;89;186;23;137;176;80;79;63;94;124;152;97;1;101;2;120;82;129;57;92;55;52;49;102;148;9;62;144;14;138;178;106;185;165;40;90;81;196;179;145;78;31;56;113;175;171;16;25;44;75;86;26;100;121;53;180;154;135;70;127;123;162;133;151;51;118;59;65;116;43;184;84;4;190;10;177;54;48;160;34;146;22;18;108;69;159;181;42;5;115;41;193;139;68;46,5080170288318044563,0.000000
steepest_intra:nodes_start:greedy,154,71750,23180,48570,1,0,154;158;53;121;100;26;86;75;101;1;97;152;94;124;148;102;49;178;106;52;55;57;92;129;2;120;44;25;16;171;175;113;56;31;78;145;179;196;81;90;185;40;165;138;14;144;62;9;15;114;186;89;183;23;137;176;80;151;162;127;123;149;65;116;43;184;177;54;48;160;34;146;22;18;108;69;159;181;42;5;41;193;139;68;140;93;117;143;0;46;115;59;118;51;133;79;63;180;135;70,663078900488064996,0.000000
steepest_intra:nodes_start:greedy,155,72039,23020,49019,1,0,155;14;138;165;40;185;90;81;196;179;145;78;31;56;113;175;171;16;25;44;120;75;86;26;189;94;63;79;80;176;133;151;51;118;59;115;46;0;137;23;186;89;183;143;117;93;140;68;139;193;41;5;42;181;159;69;108;18;22;146;34;160;48;54;177;10;190;184;43;116;65;131;149;162;123;127;70;135;154;180;53;100;101;1;97;152;2;129;92;57;55;52;106;178;49;102;148;9;62;144,2984748993743747401,0.000000
steepest_intra:nodes_start:greedy,156,72431,23408,49023,1,0,156;112;4;84;35;184;177;54;48;160;34;181;146;22;18;108;69;159;193;41;5;42;43;116;65;46;68;139;115;59;118;51;0;117;143;183;89;186;23;137;176;80;79;63;94;124;152;97;1;101;2;120;82;129;57;92;55;52;49;102;148;9;62;144;14;138;178;106;185;165;40;90;81;196;179;145;78;31;56;113;175;171;16;25;44;75;86;26;100;121;53;180;154;70;135;133;151;162;123;127,1496631759637516154,0.000000
steepest_intra:nodes_start:greedy,157,72008,23507,48501,1,0,157;196;81;90;40;165;185;106;178;138;14;144;62;9;148;102;49;52;55;179;145;78;92;57;129;2;152;97;1;101;100;53;180;154;135;70;127;123;162;149;131;65;116;43;184;190;10;177;54;48;160;34;146;22;18;108;69;159;181;42;5;41;193;139;68;140;93;117;143;183;89;186;23;137;0;46;115;59;118;51;151;133;176;80;79;63;94;189;26;86;75;120;44;25;16;171;175;113;56;31,1434855793478328203,0.000000
steepest_intra:nodes_start:greedy,158,71750,23180,48570,1,0,158;154;70;135;180;63;79;133;51;118;59;115;46;0;143;117;93;140;68;139;193;41;5;42;181;159;69;108;18;22;146;34;160;48;54;177;184;43;116;65;149;123;127;162;151;80;176;137;23;183;89;186;114;15;9;62;144;14;138;165;40;185;90;81;196;179;145;78;31;56;113;175;171;16;25;44;120;2;129;92;57;55;52;106;178;49;102;148;124;94;152;97;1;101;75;86;26;100;121;53,3521598144777219146,0.000000
steepest_intra:nodes_start:greedy,159,71968,23472,48496,1,0,159;146;22;18;69;108;140;93;117;143;183;89;0;68;46;139;115;59;118;51;137;176;80;79;63;94;124;152;97;1;101;2;120;82;129;57;92;55;52;49;102;148;9;62;144;14;138;178;106;185;165;40;90;81;196;179;145;78;31;56;113;175;171;16;25;44;75;86;26;100;121;53;180;154;70;135;133;151;162;127;123;149;65;116;43;184;84;4;190;10;177;54;48;160;34;181;42;5;41;193,2718026000104066304,0.000000
steepest_intra:nodes_start:greedy,160,71385,23490,47895,1,0,160;48;54;177;10;190;4;112;84;184;42;43;116;65;149;123;127;162;151;133;135;70;154;180;53;121;100;26;86;75;44;25;16;171;175;113;56;31;78;145;179;196;81;90;40;165;185;106;178;138;14;144;62;9;148;102;49;52;55;92;57;129;82;120;2;101;1;97;152;124;94;63;79;80;176;137;23;186;89;183;143;117;0;51;118;59;115;46;68;139;41;193;159;69;108;18;22;146;181;34,2198642193924462941,0.000000
steepest_intra:nodes_start:greedy,161,73384,23693,49691,1,0,161;133;135;70;180;154;158;53;121;100;26;86;75;44;25;16;171;175;113;56;31;78;145;179;196;81;90;40;165;185;106;178;138;14;144;62;9;148;102;49;52;55;92;57;129;82;120;2;101;1;97;152;124;94;63;79;80;176;137;23;186;89;183;143;117;0;51;118;59;115;46;68;139;193;41;5;42;181;159;69;108;18;22;146;34;160;48;54;177;10;190;184;43;116;65;131;149;151;162;123,3179887485133972996,0.000000
steepest_intra:nodes_start:greedy,162,71947,23578,48369,1,0,162;151;133;135;70;154;180;53;121;100;26;86;75;44;25;16;171;175;113;56;31;78;145;179;196;81;90;40;165;185;106;178;138;14;144;62;9;148;102;49;52;55;92;57;129;82;120;2;101;1;97;152;124;94;63;79;80;176;137;23;186;89;183;143;117;0;51;118;59;115;46;68;139;193;41;5;42;181;159;69;108;18;22;146;34;160;48;54;177;10;190;4;84;184;43;116;65;149;123;127,5110733384289613005,0.000000
steepest_intra:nodes_start:greedy,163,72555,23328,49227,1,0,163;139;68;46;115;59;118;51;0;117;143;183;89;186;23;137;176;80;79;63;94;124;152;97;1;101;2;120;82;129;57;92;55;52;49;102;148;9;62;144;14;138;178;106;185;165;40;90;81;196;179;145;78;31;56;113;175;171;16;25;44;75;86;26;100;121;53;180;154;70;135;133;151;162;127;123;149;65;116;43;184;84;190;10;177;54;48;160;34;181;42;5;41;193;159;146;22;20;18;108,6649416444105519546,0.000000
steepest_intra:nodes_start:greedy,164,72164,23636,48528,1,0,164;7;95;39;165;138;14;144;62;9;148;102;49;178;106;52;55;57;92;129;2;152;97;1;101;100;53;180;154;135;70;127;123;162;149;65;116;43;184;177;54;48;160;34;146;22;18;108;69;159;181;42;5;41;193;139;68;140;93;117;143;183;89;23;137;0;46;115;59;118;51;151;133;176;80;79;63;94;26;86;75;120;44;25;16;171;175;113;56;31;78;145;179;196;81;185;40;90;27;71,5712422280468649856,0.000000
steepest_intra:nodes_start:greedy,165,71523,23197,48326,1,0,165;40;185;90;81;196;179;145;78;31;56;113;175;171;16;25;44;120;75;86;26;189;94;63;79;80;176;133;151;51;118;59;115;46;0;137;23;186;89;183;143;117;93;140;68;139;193;41;5;42;181;159;69;108;18;22;146;34;160;48;54;177;10;190;84;184;43;116;65;131;149;162;123;127;70;135;154;180;53;100;101;1;97;152;2;129;92;57;55;52;106;178;49;102;148;9;62;144;14;138,3618490145219412866,0.000000
steepest_intra:nodes_start:greedy,166,72595,23537,49058,1,0,166;184;190;10;177;54;48;160;34;146;22;18;108;69;159;181;42;5;41;193;139;68;140;93;117;143;183;89;186;23;137;176;80;79;63;94;124;152;97;1;101;2;120;82;129;57;92;55;52;49;102;148;9;62;144;14;138;178;106;185;165;40;90;81;196;179;145;78;31;56;113;175;171;16;25;44;75;86;26;100;121;53;180;154;135;70;127;123;162;133;151;51;0;46;115;118;59;116;65;43,4337033548384858257,0.000000
steepest_intra:nodes_start:greedy,167,72713,24137,48576,1,0,167;148;9;62;102;144;14;49;178;106;165;39;95;7;164;71;27;90;81;196;40;185;52;55;57;129;92;179;145;78;31;56;113;175;171;16;25;44;120;2;75;101;1;97;152;26;100;86;53;154;70;135;180;63;79;133;51;118;59;115;46;0;89;183;143;117;93;140;68;139;193;41;5;42;181;159;69;108;18;22;146;34;160;48;54;177;184;43;116;65;149;123;127;162;151;80;176;137;94;124,5938836212017856939,0.000000
steepest_intra:nodes_start:greedy,168,72772,23521,49251,1,0,168;145;179;196;81;90;40;165;185;106;178;138;14;144;62;9;148;102;49;52;55;92;57;129;2;152;97;1;101;100;53;180;154;135;70;127;123;162;149;131;65;116;43;184;190;10;177;54;48;160;34;146;22;18;108;69;159;181;42;5;41;193;139;68;140;93;117;143;183;89;186;23;137;0;46;115;59;118;51;151;133;176;80;79;63;94;189;26;86;75;120;44;25;16;171;175;113;56;31;78,4660593918835033160,0.000000
steepest_intra:nodes_start:greedy,169,72402,23479,48923,1,0,169;40;90;165;138;14;144;62;9;148;102;49;178;106;52;55;57;92;129;2;152;97;1;101;100;53;180;154;135;70;127;123;162;149;131;65;116;43;184;190;10;177;54;48;160;34;146;22;18;108;69;159;181;42;5;41;193;139;68;140;93;117;143;183;89;186;23;137;0;46;115;59;118;51;151;133;176;80;79;63;94;189;26;86;75;120;44;25;16;171;175;113;56;31;78;145;179;185;81;196,5363978911063126142,0.000000
steepest_intra:nodes_start:greedy,170,71641,22771,48870,1,0,170;117;0;46;68;139;193;41;115;5;42;181;159;69;108;18;22;146;34;160;48;54;177;10;190;4;84;184;43;116;65;59;118;51;151;133;162;123;127;70;135;154;180;53;121;100;26;86;75;44;25;16;171;175;113;56;31;78;145;179;196;81;90;40;165;185;106;178;138;14;144;62;9;148;102;49;52;55;92;57;129;82;120;2;101;1;97;152;124;94;63;79;80;176;137;23;186;89;183;143,1404852557831135434,0.000000
steepest_intra:nodes_start:greedy,171,72017,23691,48326,1,0,171;175;113;56;31;145;78;92;179;196;81;90;40;165;185;106;178;138;14;144;62;9;148;102;49;52;55;57;129;2;152;97;1;101;100;53;180;154;135;70;127;123;162;149;131;65;116;43;184;84;190;10;177;54;48;160;34;146;22;18;108;69;159;181;42;5;41;193;139;68;140;93;117;143;183;89;186;23;137;0;46;115;59;118;51;151;133;176;80;79;63;94;189;26;86;75;120;44;25;16,7102112992224982374,0.000000
steepest_intra:nodes_start:greedy,172,72794,23350,49444,1,0,172;167;148;9;62;102;144;14;49;178;106;165;39;27;90;81;196;40;185;52;55;57;129;92;179;145;78;31;56;113;175;171;16;25;44;120;2;75;86;26;189;94;63;79;80;176;133;151;51;118;59;115;46;0;137;23;186;89;183;143;117;93;140;68;139;193;41;5;42;181;159;69;108;18;22;146;34;160;48;54;177;184;43;116;65;131;149;162;123;127;70;135;154;180;53;100;101;1;97;152,6480922647524824846,0.000000
steepest_intra:nodes_start:greedy,173,72487,22851,49636,1,0,173;135;70;154;158;53;121;100;26;86;75;101;1;97;152;94;124;148;102;49;178;106;52;55;57;92;129;2;120;44;25;16;171;175;113;56;31;78;145;179;196;81;90;185;40;165;138;14;144;62;9;15;114;186;89;183;23;137;176;80;151;162;123;149;65;116;43;184;177;54;48;160;34;146;22;18;108;69;159;181;42;5;41;193;139;68;140;93;117;143;0;46;115;59;118;51;133;79;63;180,4734935168359835194,0.000000
steepest_intra:nodes_start:greedy,174,72441,23126,49315,1,0,174;40;185;179;145;78;31;56;113;175;171;16;25;44;120;75;86;26;189;94;63;79;80;176;133;151;51;118;59;115;46;0;137;23;186;89;183;143;117;93;140;68;139;193;41;5;42;181;159;69;108;18;22;146;34;160;48;54;177;10;190;84;184;43;116;65;131;149;162;123;127;70;135;154;180;53;100;101;1;97;152;2;129;92;57;55;52;106;178;49;102;148;9;62;144;14;138;165;90;81,546698162713924445,0.000000
steepest_intra:nodes_start:greedy,175,72017,23691,48326,1,0,175;113;56;31;145;78;92;179;196;81;90;40;165;185;106;178;138;14;144;62;9;148;102;49;52;55;57;129;2;152;97;1;101;100;53;180;154;135;70;127;123;162;149;131;65;116;43;184;84;190;10;177;54;48;160;34;146;22;18;108;69;159;181;42;5;41;193;139;68;140;93;117;143;183;89;186;23;137;0;46;115;59;118;51;151;133;176;80;79;63;94;189;26;86;75;120;44;25;16;171,2099497546530674954,0.000000
steepest_intra:nodes_start:greedy,176,71940,23456,48484,1,0,176;80;79;63;94;124;152;97;1;101;2;120;82;129;57;92;55;52;49;102;148;9;62;144;14;138;178;106;185;165;40;90;81;196;179;145;78;31;56;113;175;171;16;25;44;75;86;26;100;121;53;180;154;135;70;127;123;162;133;151;149;131;65;116;43;184;84;190;10;177;54;48;160;34;146;22;18;108;69;159;181;42;5;41;193;139;68;46;115;59;118;51;0;117;143;183;89;186;23;137,84936931049209387,0.000000
steepest_intra:nodes_start:greedy,177,72287,23801,48486,1,0,177;54;48;34;160;181;42;195;146;22;18;108;69;159;41;193;139;68;140;93;117;143;183;89;186;23;137;176;80;79;63;94;124;152;97;1;101;2;120;82;129;57;92;55;52;49;102;148;9;62;144;14;138;178;106;185;165;40;90;81;196;179;145;78;31;56;113;175;171;16;25;44;75;86;26;100;121;53;180;154;135;70;127;123;162;133;151;51;0;46;115;118;59;116;65;43;184;84;190;10,1395384409675407909,0.000000
steepest_intra:nodes_start:greedy,178,71523,23197,48326,1,0,178;49;102;148;9;62;144;14;138;165;40;185;90;81;196;179;145;78;31;56;113;175;171;16;25;44;120;75;86;26;189;94;63;79;80;176;133;151;51;118;59;115;46;0;137;23;186;89;183;143;117;93;140;68;139;193;41;5;42;181;159;69;108;18;22;146;34;160;48;54;177;10;190;84;184;43;116;65;131;149;162;123;127;70;135;154;180;53;100;101;1;97;152;2;129;92;57;55;52;106,5060043202937185911,0.000000
steepest_intra:nodes_start:greedy,179,71704,23378,48326,1,0,179;145;78;31;56;113;175;171;16;25;44;120;75;86;26;189;94;63;79;80;176;133;151;51;118;59;115;46;0;137;23;186;89;183;143;117;93;140;68;139;193;41;5;42;181;159;69;108;18;22;146;34;160;48;54;177;10;190;84;184;43;116;65;131;149;162;123;127;70;135;154;180;53;100;101;1;97;152;2;129;92;57;55;52;49;102;148;9;62;144;14;138;178;106;185;165;40;90;81;196,5298271215594272155,0.000000
steepest_intra:nodes_start:greedy,180,71750,23180,48570,1,0,180;135;70;154;158;53;121;100;26;86;75;101;1;97;152;94;124;148;102;49;178;106;52;55;57;92;129;2;120;44;25;16;171;175;113;56;31;78;145;179;196;81;90;185;40;165;138;14;144;62;9;15;114;186;89;183;23;137;176;80;151;162;127;123;149;65;116;43;184;177;54;48;160;34;146;22;18;108;69;159;181;42;5;41;193;139;68;140;93;117;143;0;46;115;59;118;51;133;79;63,9069796867778996935,0.000000
steepest_intra:nodes_start:greedy,181,71385,23490,47895,1,0,181;34;160;48;54;177;10;190;4;112;84;184;42;43;116;65;149;123;127;162;151;133;135;70;154;180;53;121;100;26;86;75;44;25;16;171;175;113;56;31;78;145;179;196;81;90;40;165;185;106;178;138;14;144;62;9;148;102;49;52;55;92;57;129;82;120;2;101;1;97;152;124;94;63;79;80;176;137;23;186;89;183;143;117;0;51;118;59;115;46;68;139;41;193;159;69;108;18;22;146,1000502857712463670,0.000000
steepest_intra:nodes_start:greedy,182,72008,23266,48742,1,0,182;121;100;26;86;75;101;1;97;152;94;124;148;102;49;178;106;52;55;57;92;129;2;120;44;25;16;171;175;113;56;31;78;145;179;196;81;90;185;40;165;138;14;144;62;9;15;114;186;89;183;23;137;176;80;151;162;127;123;149;65;116;43;184;177;54;48;160;34;146;22;18;108;69;159;181;42;5;41;193;139;68;140;93;117;143;0;46;115;59;118;51;133;79;63;180;135;70;154;53,7388203330142180245,0.000000
steepest_intra:nodes_start:greedy,183,71108,22981,48127,1,0,183;89;186;23;137;176;80;79;63;94;124;152;97;1;101;2;120;82;129;57;92;55;52;49;102;148;9;62;144;14;138;178;106;185;165;40;90;81;196;179;145;78;31;56;113;175;171;16;25;44;75;86;26;100;121;53;180;154;135;70;127;123;162;133;151;51;118;59;65;116;43;184;84;112;4;190;10;177;54;48;160;34;146;22;18;108;69;159;181;42;5;115;41;193;139;68;46;0;117;143,8595160964941373517,0.000000
steepest_intra:nodes_start:greedy,184,72083,23661,48422,1,0,184;43;65;116;59;118;115;46;0;51;151;133;162;123;127;70;135;154;180;53;121;100;26;86;75;44;25;16;171;175;113;56;31;78;145;179;196;81;90;40;165;185;106;178;138;14;144;62;9;148;102;49;52;55;92;57;129;82;120;2;101;1;97;152;124;94;63;79;80;176;137;23;186;89;183;143;117;93;140;68;139;193;41;5;42;181;159;69;108;18;22;146;34;160;48;54;177;10;190;84,680212272516914761,0.000000
steepest_intra:nodes_start:greedy,185,71523,23197,48326,1,0,185;90;81;196;179;145;78;31;56;113;175;171;16;25;44;120;75;86;26;189;94;63;79;80;176;133;151;51;118;59;115;46;0;137;23;186;89;183;143;117;93;140;68;139;193;41;5;42;181;159;69;108;18;22;146;34;160;48;54;177;10;190;84;184;43;116;65;131;149;162;123;127;70;135;154;180;53;100;101;1;97;152;2;129;92;57;55;52;106;178;49;102;148;9;62;144;14;138;165;40,8085006984973739143,0.000000
steepest_intra:nodes_start:greedy,186,71108,22981,48127,1,0,186;89;183;143;117;0;46;68;139;193;41;115;5;42;181;159;69;108;18;22;146;34;160;48;54;177;10;190;4;112;84;184;43;116;65;59;118;51;151;133;162;123;127;70;135;154;180;53;121;100;26;86;75;44;25;16;171;175;113;56;31;78;145;179;196;81;90;40;165;185;106;178;138;14;144;62;9;148;102;49;52;55;92;57;129;82;120;2;101;1;97;152;124;94;63;79;80;176;137;23,4638892990656930402,0.000000
steepest_intra:nodes_start:greedy,187,72151,23121,49030,1,0,187;81;196;40;185;179;145;78;31;56;113;175;171;16;25;44;120;75;86;26;189;94;63;79;80;176;133;151;51;118;59;115;46;0;137;23;186;89;183;143;117;93;140;68;139;193;41;5;42;181;159;69;108;18;22;146;34;160;48;54;177;10;190;184;43;116;65;131;149;162;123;127;70;135;154;180;53;100;101;1;97;152;2;129;92;57;55;52;106;178;49;102;148;9;62;144;14;138;165;90,4724501969472676268,0.000000
steepest_intra:nodes_start:greedy,188,73045,23657,49388,1,0,188;31;145;78;92;179;196;81;90;40;165;185;106;178;138;14;144;62;9;148;102;49;52;55;57;129;2;152;97;1;101;100;53;180;154;135;70;127;123;162;149;131;65;116;43;184;190;10;177;54;48;160;34;146;22;18;108;69;159;181;42;5;41;193;139;68;140;93;117;143;183;89;186;23;137;0;46;115;59;118;51;151;133;176;80;79;63;94;189;26;86;75;120;44;25;16;171;175;113;56,2284718329338643742,0.000000
steepest_intra:nodes_start:greedy,189,71945,22885,49060,1,0,189;94;124;148;102;49;178;106;52;55;57;92;129;2;120;44;25;16;171;175;113;56;31;78;145;179;196;81;90;185;40;165;138;14;144;62;9;15;114;186;89;183;23;137;176;80;151;162;123;149;65;116;43;184;177;54;48;160;34;146;22;18;108;69;159;181;42;5;41;193;139;68;140;93;117;143;0;46;115;59;118;51;133;79;63;180;135;70;154;158;53;121;100;26;86;75;101;1;97;152,3600588887374749304,0.000000
steepest_intra:nodes_start:greedy,190,72214,24115,48099,1,0,190;10;177;54;48;34;160;181;42;146;22;18;108;69;159;41;193;139;68;46;115;118;59;116;65;43;184;35;131;149;123;162;151;133;51;0;117;143;183;89;23;137;176;80;79;63;94;124;152;97;1;101;2;120;82;129;57;92;55;52;49;102;148;9;62;144;14;138;178;106;185;165;40;90;81;196;179;145;78;31;56;113;175;171;16;25;44;75;86;26;100;121;53;180;154;135;70;127;112;4,3419951744023774486,0.000000
steepest_intra:nodes_start:greedy,191,72529,23490,49039,1,0,191;193;41;5;42;181;159;69;108;18;22;146;34;160;48;54;177;10;190;84;184;43;116;65;149;123;127;162;151;133;135;70;154;180;53;121;100;26;86;75;44;25;16;171;175;113;56;31;78;145;179;196;81;90;40;165;185;106;178;138;14;144;62;9;148;102;49;52;55;92;57;129;82;120;2;101;1;97;152;124;94;63;79;80;176;137;23;186;89;183;143;117;0;51;118;59;115;46;68;139,6137994155006839023,0.000000
steepest_intra:nodes_start:greedy,192,72789,23609,49180,1,0,192;42;5;41;193;139;68;140;93;117;143;183;89;186;23;137;176;80;79;63;94;124;152;97;1;101;2;120;82;129;57;92;55;52;49;102;148;9;62;144;14;138;178;106;185;165;40;90;81;196;179;145;78;31;56;113;175;171;16;25;44;75;86;26;100;121;53;180;154;135;70;127;123;162;133;151;51;0;46;115;118;59;116;65;43;184;190;10;177;54;48;160;34;146;22;18;108;69;159;181,5416422839365551015,0.000000
steepest_intra:nodes_start:greedy,193,71947,23578,48369,1,0,193;139;68;46;115;59;118;51;0;117;143;183;89;186;23;137;176;80;79;63;94;124;152;97;1;101;2;120;82;129;57;92;55;52;49;102;148;9;62;144;14;138;178;106;185;165;40;90;81;196;179;145;78;31;56;113;175;171;16;25;44;75;86;26;100;121;53;180;154;70;135;133;151;162;127;123;149;65;116;43;184;84;4;190;10;177;54;48;160;34;146;22;18;108;69;159;181;42;5;41,1719501734471777592,0.000000
steepest_intra:nodes_start:greedy,194,72641,23748,48893,1,0,194;127;123;162;133;151;149;131;65;116;43;184;190;10;177;54;48;160;34;146;22;18;108;69;159;181;42;5;41;193;139;68;46;115;59;118;51;0;117;143;183;89;186;23;137;176;80;79;63;94;124;152;97;1;101;2;120;82;129;57;92;55;52;49;102;148;9;62;144;14;138;178;106;185;165;40;90;81;196;179;145;78;31;56;113;175;171;16;25;44;75;86;26;100;121;180;53;154;70;135,1959480591578683882,0.000000
steepest_intra:nodes_start:greedy,195,71734,23301,48433,1,0,195;181;34;160;48;54;177;10;190;4;84;184;42;43;116;65;149;123;127;162;151;133;135;70;154;180;53;121;100;26;86;75;44;25;16;171;175;113;56;31;78;145;179;196;81;90;40;165;185;106;178;138;14;144;62;9;148;102;49;52;55;92;57;129;82;120;2;101;1;97;152;124;94;63;79;80;176;137;23;186;89;183;143;117;0;51;118;59;115;46;68;139;41;193;159;69;108;18;22;146,3430741754094472440,0.000000
steepest_intra:nodes_start:greedy,196,72377,23517,48860,1,0,196;81;90;40;165;185;106;178;138;14;144;62;9;148;102;49;52;55;57;129;92;179;145;78;82;2;152;97;1;101;100;53;180;154;135;70;127;123;162;149;131;65;116;43;184;190;177;54;48;160;34;146;22;18;108;69;159;181;42;5;41;193;139;68;140;93;117;143;183;89;186;23;137;0;46;115;59;118;51;151;133;176;80;79;63;94;189;26;86;75;120;44;25;16;171;175;113;56;31;157,2586273626118808806,0.000000
steepest_intra:nodes_start:greedy,197,72970,23867,49103,1,0,197;46;68;139;193;41;5;42;181;159;69;108;18;22;146;34;160;48;54;177;10;190;84;184;43;116;65;149;123;127;162;151;133;135;70;154;180;53;121;100;26;86;75;44;25;16;171;175;113;56;31;78;145;179;196;81;90;40;165;185;106;178;138;14;144;62;9;148;102;49;52;55;92;57;129;82;120;2;101;1;97;152;124;94;63;79;80;176;137;23;186;89;183;143;117;0;51;118;59;115,2822945899637172057,0.000000
steepest_intra:nodes_start:greedy,198,72216,23377,48839,1,0,198;46;115;59;118;51;0;117;143;183;89;186;23;137;176;80;79;63;94;124;152;97;1;101;2;120;82;129;57;92;55;52;49;102;148;9;62;144;14;138;178;106;185;165;40;90;81;196;179;145;78;31;56;113;175;171;16;25;44;75;86;26;100;121;53;180;154;70;135;133;151;162;127;123;149;65;116;43;184;84;4;190;10;177;54;48;160;34;146;22;18;108;69;159;181;42;5;41;193;139,8850823889007656199,0.000000
steepest_intra:nodes_start:greedy,199,72263,23490,48773,1,0,199;139;68;46;115;59;118;51;0;117;143;183;89;186;23;137;176;80;79;63;94;124;152;97;1;101;2;120;82;129;57;92;55;52;49;102;148;9;62;144;14;138;178;106;185;165;40;90;81;196;179;145;78;31;56;113;175;171;16;25;44;75;86;26;100;121;53;180;154;70;135;133;151;162;127;123;149;65;116;43;184;84;190;10;177;54;48;160;34;181;42;5;41;193;159;146;22;18;108;69,3279844254412053664,0.000000
steepest_intra:edges_start:random,0,279553,179623,99930,1,0,132;24;167;177;138;81;172;32;119;75;116;113;108;149;103;97;62;121;69;26;199;115;31;95;152;50;99;191;70;137;20;10;0;37;169;64;13;11;161;76;196;133;176;15;3;195;192;175;57;52;68;27;51;56;158;174;42;80;114;17;12;181;86;79;23;188;102;159;148;6;59;153;179;100;156;1;139;22;34;171;104;58;28;107;49;45;105;88;189;110;35;78;47;36;173;124;18;157;82;130,8365032267956095805,0.000000
steepest_intra:edges_start:random,1,264969,166535,98434,1,0,182;105;184;166;152;112;24;137;57;82;177;181;56;155;144;87;120;25;55;195;163;68;185;189;173;160;153;183;168;114;67;41;26;98;84;178;19;13;131;167;75;20;2;17;111;117;97;10;88;33;161;72;30;90;44;138;18;49;76;83;196;74;176;113;8;121;73;193;96;81;66;43;39;28;22;126;134;65;132;191;92;123;172;149;108;171;7;79;60;104;139;6;122;115;125;164;180;157;170;29,684892224185598406,0.000000
steepest_intra:edges_start:random,2,267604,168355,99249,1,0,122;10;153;63;173;136;196;154;47;160;39;108;66;169;171;15;25;164;56;3;64;130;7;21;38;149;116;143;20;144;87;107;96;78;176;166;23;22;18;104;57;177;89;113;198;16;102;187;36;53;124;106;141;40;33;121;132;165;5;83;188;61;161;58;76;180;123;34;54;41;98;172;60;155;195;111;197;86;152;17;109;137;163;103;186;1;159;26;81;27;151;120;8;190;167;19;105;28;68;95,8589720973572036190,0.000000
steepest_intra:edges_start:random,3,276243,185100,91143,1,0,55;41;63;130;169;180;42;183;137;92;199;70;32;45;58;107;154;174;153;19;109;106;125;26;139;108;173;171;176;2;80;172;175;112;74;170;24;127;113;149;18;38;140;110;82;65;122;83;144;90;192;157;43;168;21;11;91;84;120;54;163;145;177;20;160;16;47;4;121;86;17;193;148;178;100;28;12;30;124;115;0;23;104;189;69;13;141;49;81;101;50;182;152;87;159;7;1;79;14;48,7051139234606242122,0.000000
steepest_intra:edges_start:random,4,256691,159789,96902,1,0,82;15;157;35;132;199;135;102;60;111;192;117;189;195;62;129;95;66;69;159;24;98;137;6;112;158;122;175;4;96;17;73;54;21;183;101;145;125;46;170;156;114;53;180;130;40;187;83;184;79;147;23;178;116;77;131;149;176;162;153;164;143;166;7;41;123;50;25;121;103;109;197;43;61;161;127;74;67;49;163;174;2;14;86;1;173;148;160;52;42;191;92;44;45;11;0;26;59;105;186,240629777134577143,0.000000
steepest_intra:edges_start:random,5,287051,185490,101561,1,0,128;72;157;19;66;195;155;27;84;92;198;138;90;51;126;188;64;179;139;6;46;100;31;136;5;44;63;89;97;91;71;99;172;48;117;166;160;127;70;189;109;113;130;9;116;123;7;187;112;153;78;4;35;137;197;13;162;133;96;121;151;105;47;134;10;87;95;93;17;180;193;82;103;23;120;30;50;156;108;74;14;142;132;29;196;65;37;177;114;56;131;106;34;60;194;140;79;3;24;36,3362311169766634744,0.000000
steepest_intra:edges_start:random,6,265730,161347,104383,1,0,97;136;181;187;31;8;45;92;193;35;38;1;78;44;36;199;7;163;41;143;149;183;196;84;0;15;121;195;178;122;53;63;33;166;123;194;23;131;126;197;128;125;64;105;54;55;155;161;19;85;91;189;93;165;114;146;74;77;87;50;113;106;107;139;130;9;103;47;168;46;96;34;176;160;98;29;81;3;170;89;61;144;192;17;134;172;82;157;120;162;67;174;62;150;42;108;72;117;182;142,962723636435635209,0.000000
steepest_intra:edges_start:random,7,264932,170386,94546,1,0,113;36;145;130;194;15;190;46;65;95;56;154;11;51;27;35;54;117;83;75;184;140;98;59;72;153;115;64;44;78;50;139;42;77;30;58;2;146;186;22;82;70;164;17;173;93;178;86;188;39;53;179;116;193;23;137;181;55;168;37;52;126;159;149;174;18;63;163;123;110;185;20;8;102;71;180;176;76;32;84;80;155;1;85;61;105;150;13;128;133;67;191;19;106;124;132;157;112;41;169,6695345447818576260,0.000000
steepest_intra:edges_start:random,8,238795,147028,91767,1,0,28;184;165;48;62;105;2;79;156;96;94;124;103;130;106;40;7;166;82;120;75;175;104;0;140;22;191;178;143;195;146;5;131;86;180;15;173;65;147;118;121;54;137;151;149;168;69;112;99;53;115;57;192;141;72;163;134;122;56;159;92;188;110;84;11;181;119;114;90;83;93;73;78;176;59;167;42;183;12;23;25;8;158;61;45;43;13;55;194;129;9;189;63;161;154;108;37;32;52;101,6429451995722105553,0.000000
steepest_intra:edges_start:random,9,256075,158047,98028,1,0,10;169;199;126;130;88;118;134;38;178;91;64;132;3;72;39;119;106;31;183;173;36;115;17;73;171;59;43;34;4;99;138;30;150;121;25;192;69;179;14;94;79;13;78;131;65;90;97;139;198;96;114;170;41;172;113;145;75;32;89;108;11;61;23;135;100;105;146;20;35;142;148;83;22;40;165;120;133;42;2;195;71;29;7;158;45;101;181;143;24;184;55;53;166;191;155;76;156;116;67,1481255177806822614,0.000000
steepest_intra:edges_start:random,10,279180,177933,101247,1,0,97;190;16;107;14;170;122;185;144;163;70;60;98;86;187;41;154;5;147;157;67;49;77;85;148;142;180;92;18;59;178;194;161;39;160;53;69;95;128;24;6;162;7;188;159;110;168;17;4;176;12;101;131;118;186;76;48;153;139;65;109;181;29;129;64;112;50;3;134;58;66;87;104;120;173;113;23;8;150;43;2;193;45;80;189;169;140;191;22;46;184;26;91;166;30;79;156;119;195;52,7285938921399949925,0.000000
steepest_intra:edges_start:random,11,251618,160982,90636,1,0,165;58;87;101;0;77;26;176;196;6;169;19;191;140;128;59;152;100;167;93;28;109;174;121;123;43;156;112;133;146;63;144;70;122;141;193;64;68;190;9;51;160;185;184;118;39;187;27;61;85;31;180;32;79;67;95;181;38;3;2;195;104;164;92;65;171;86;13;62;42;54;48;30;89;157;119;197;57;29;135;110;117;159;78;97;7;4;147;14;199;151;81;173;18;125;124;98;154;155;113,8229432663890849444,0.000000
steepest_intra:edges_start:random,12,251638,159800,91838,1,0,15;108;147;143;93;65;152;113;79;82;148;119;10;19;172;91;95;120;17;191;140;96;4;23;77;176;125;52;150;189;182;101;0;164;160;49;25;55;40;67;90;60;159;63;112;188;43;106;190;26;44;1;173;41;193;157;136;170;166;51;20;59;103;199;145;78;22;175;158;87;85;104;37;86;155;115;162;98;31;185;56;121;139;9;110;137;187;168;53;195;48;198;179;29;124;21;130;72;30;132,7738343516030711417,0.000000
steepest_intra:edges_start:random,13,252071,155335,96736,1,0,179;150;98;166;180;9;194;37;175;135;139;117;80;62;75;168;172;190;108;54;189;128;5;159;94;7;131;1;51;64;138;161;193;16;112;53;119;104;192;46;61;132;140;70;149;181;126;57;125;185;183;26;97;31;45;113;144;15;29;10;187;198;81;3;106;147;84;122;40;167;174;107;105;82;11;28;48;19;79;25;66;52;170;42;146;77;137;127;141;171;73;87;86;169;196;123;49;85;195;110,7814564768029275640,0.000000
steepest_intra:edges_start:random,14,254654,156694,97960,1,0,170;38;144;50;2;71;188;155;127;45;129;80;191;60;75;39;148;91;64;138;199;69;62;190;87;15;161;23;186;115;106;73;44;74;55;124;176;164;100;5;26;116;30;4;111;151;89;165;27;152;53;173;13;51;34;117;167;77;150;193;160;169;9;145;168;29;113;194;174;82;14;97;195;67;179;96;159;110;49;171;123;20;28;17;192;125;133;18;76;72;25;86;8;90;102;131;132;35;120;128,5350526456004737949,0.000000
steepest_intra:edges_start:random,15,282115,176195,105920,1,0,182;151;191;185;118;146;164;143;157;50;58;104;124;162;44;121;95;33;85;72;193;141;114;100;48;70;16;122;28;27;94;197;144;188;3;167;43;137;23;46;126;1;30;41;38;108;92;154;178;138;153;84;29;132;69;161;36;80;127;22;106;37;61;79;71;64;68;183;20;107;88;128;199;56;0;99;105;131;66;168;150;98;130;139;52;163;186;76;65;17;147;87;155;109;196;112;174;135;10;177,1633872099175187444,0.000000
steepest_intra:edges_start:random,16,263909,168799,95110,1,0,129;51;80;40;49;125;105;34;89;70;59;148;79;192;142;176;144;36;68;50;22;41;86;23;158;151;38;75;64;171;137;150;140;188;116;172;134;99;72;100;60;98;66;152;154;25;56;132;146;33;163;32;96;71;183;31;14;103;65;29;83;20;104;16;160;161;77;55;133;153;90;181;18;122;180;110;184;81;95;21;131;19;67;47;44;120;91;30;194;11;186;128;187;119;136;92;102;62;63;112,5975668682895280434,0.000000
steepest_intra:edges_start:random,17,286689,182948,103741,1,0,97;27;4;80;165;32;36;195;144;168;175;68;38;154;44;163;194;49;181;87;117;136;60;64;85;45;126;90;157;37;186;2;103;53;88;13;43;161;92;138;113;17;3;86;148;35;66;101;108;112;104;191;28;67;188;166;109;133;114;128;30;57;59;134;164;132;34;79;48;169;58;15;22;89;10;179;170;11;184;174;115;91;172;147;142;23;162;187;24;95;190;94;183;33;156;167;41;93;71;185,7437542951841260198,0.000000
steepest_intra:edges_start:random,18,267923,166422,101501,1,0,149;33;86;21;160;64;137;104;67;25;177;186;180;121;191;126;123;182;73;60;1;61;158;77;150;197;45;40;190;79;34;39;48;75;159;181;72;128;103;102;122;105;92;112;194;162;198;161;14;57;31;2;168;109;59;129;9;76;101;44;132;81;13;93;18;106;187;140;90;163;166;133;7;20;82;52;8;184;29;37;144;155;164;50;146;108;87;135;110;63;143;189;156;125;138;142;134;111;100;193,4554815058525589234,0.000000
steepest_intra:edges_start:random,19,255549,158469,97080,1,0,97;91;111;88;132;25;151;65;80;161;67;117;163;114;27;14;64;75;170;29;167;61;164;120;136;69;143;182;92;119;154;58;43;73;121;198;11;104;86;48;115;159;12;140;95;44;122;171;185;57;13;131;76;96;113;194;63;28;94;26;123;177;24;19;38;32;110;6;175;23;46;135;165;193;191;33;187;195;146;16;100;0;105;2;81;147;30;168;174;150;149;184;40;34;125;70;116;71;31;39,3013787689545403726,0.000000
steepest_intra:edges_start:random,20,275524,175755,99769,1,0,134;188;69;182;105;109;143;193;47;34;25;166;170;138;146;184;124;123;16;198;31;167;96;113;68;185;191;97;114;121;61;157;62;13;24;159;60;190;150;86;197;37;151;164;59;194;98;141;40;154;77;102;39;49;76;104;56;103;93;129;153;45;6;89;199;29;21;72;48;108;168;95;189;8;54;101;53;26;130;158;176;73;7;119;58;79;82;5;177;178;172;115;165;38;91;125;14;22;136;51,721520472679907528,0.000000
steepest_intra:edges_start:random,21,270889,171993,98896,1,0,97;189;94;105;184;33;32;53;66;41;85;145;124;17;103;14;77;5;153;62;58;64;159;73;40;109;12;36;75;54;31;134;21;187;95;133;164;182;142;157;51;144;108;49;181;82;167;147;130;86;43;9;67;34;57;141;137;156;193;89;45;76;18;87;71;79;72;50;80;19;162;83;56;42;3;116;11;6;22;172;175;27;23;26;179;186;69;127;173;101;102;91;113;194;135;92;110;140;169;39,3118772266634395504,0.000000
steepest_intra:edges_start:random,22,267718,169224,98494,1,0,130;195;113;0;73;76;109;71;89;194;161;43;144;96;46;51;156;49;85;170;24;159;197;82;18;28;23;98;125;190;10;153;3;192;106;143;117;41;16;7;168;112;166;100;188;34;175;87;60;110;4;193;169;72;145;135;164;38;66;12;119;173;177;104;134;122;178;103;141;182;142;29;107;2;154;6;179;30;140;48;123;124;27;59;64;70;101;139;69;120;65;137;185;44;13;1;97;80;58;165,6245929218869776548,0.000000
steepest_intra:edges_start:random,23,260785,167252,93533,1,0,53;21;118;30;197;11;17;54;181;6;18;36;140;145;87;155;117;67;132;16;154;63;73;188;105;91;116;64;160;183;108;152;75;176;51;146;59;102;4;127;47;187;195;128;113;180;172;166;179;189;198;184;40;25;106;144;147;185;120;186;159;119;190;199;84;138;162;65;43;126;90;86;182;5;94;100;107;57;114;34;9;31;150;77;83;191;49;129;131;69;130;156;15;1;96;48;80;194;142;161,3903070405365176188,0.000000
steepest_intra:edges_start:random,24,253799,159667,94132,1,0,6;11;102;182;162;184;195;17;179;92;73;95;166;157;192;164;113;194;105;187;154;86;83;54;34;47;143;197;144;130;75;111;90;41;145;13;10;60;79;46;101;94;89;131;62;140;26;40;99;169;81;4;82;78;8;98;107;25;110;149;117;96;161;33;1;39;84;185;68;71;23;19;91;7;148;22;181;103;133;165;108;173;59;125;186;116;18;121;29;80;147;171;31;122;123;167;63;151;128;142,2143408106863053352,0.000000
steepest_intra:edges_start:random,25,266984,169208,97776,1,0,166;63;106;176;159;89;112;123;167;94;50;162;61;113;70;97;190;34;165;156;117;138;5;79;47;172;109;139;158;6;66;153;42;179;33;102;22;87;20;51;131;100;81;18;121;77;191;114;4;187;108;154;105;163;118;12;25;76;192;195;160;48;127;177;146;148;68;130;67;31;128;134;170;95;143;62;98;13;110;58;41;78;73;86;16;38;57;82;103;178;151;157;104;147;83;145;26;37;132;35,296609699040493824,0.000000
steepest_intra:edges_start:random,26,275388,180615,94773,1,0,40;155;75;152;19;156;30;190;181;175;183;110;169;180;98;61;112;85;174;64;165;122;195;162;56;154;121;51;103;65;199;9;144;46;42;97;6;124;28;37;59;115;76;93;55;53;149;50;192;71;186;187;117;16;48;140;39;22;196;177;26;126;197;88;164;68;194;84;49;113;127;67;101;89;123;57;34;168;137;96;32;3;78;38;188;52;8;160;20;173;129;23;36;147;185;114;69;95;172;146,6991342860935436906,0.000000
steepest_intra:edges_start:random,27,268749,175212,93537,1,0,81;83;126;10;165;46;170;164;139;156;47;167;54;133;102;76;196;11;74;96;152;136;43;79;175;104;52;0;120;132;177;122;108;154;195;95;87;169;118;50;23;140;16;158;190;184;38;135;182;85;161;115;78;172;166;101;37;89;18;69;9;153;194;114;148;137;71;159;98;150;198;145;42;3;60;1;124;119;35;176;55;14;61;168;2;171;67;63;53;105;123;8;31;179;92;7;68;64;66;25,9200695007896314481,0.000000
steepest_intra:edges_start:random,28,264196,175801,88395,1,0,80;184;39;77;91;25;186;139;146;149;167;133;49;155;169;127;174;19;115;73;60;119;88;105;130;159;85;156;93;55;31;68;62;162;150;120;193;136;166;36;118;50;12;23;0;59;2;182;102;70;158;98;22;46;40;58;145;190;7;196;29;82;125;135;143;180;124;83;97;163;78;38;109;113;101;172;10;185;65;57;42;147;53;71;142;129;165;99;123;176;112;183;54;26;52;96;121;153;160;154,478545927199041543,0.000000
steepest_intra:edges_start:random,29,253450,153533,99917,1,0,104;97;34;145;13;79;169;44;168;165;130;57;140;64;92;185;39;77;180;25;26;23;22;85;138;47;115;33;152;56;123;137;144;41;147;172;173;29;149;179;120;21;14;119;66;112;87;125;42;78;74;171;182;19;156;142;48;175;88;163;151;18;27;134;54;46;197;141;40;187;183;3;121;51;38;35;7;45;150;106;24;96;131;127;86;50;63;60;122;170;6;158;20;198;95;58;70;114;94;136,7211757515539695056,0.000000
steepest_intra:edges_start:random,30,254864,156208,98656,1,0,113;130;46;78;84;119;70;2;106;21;175;81;121;185;188;35;59;147;97;73;14;44;60;45;53;190;105;134;126;9;0;117;12;139;77;192;76;25;182;56;3;146;98;102;169;125;92;47;72;148;163;141;197;158;66;26;155;63;109;39;65;199;89;129;120;180;193;50;159;154;42;178;51;132;111;64;107;168;123;22;6;24;75;112;104;103;27;127;136;20;83;74;177;135;194;176;43;15;61;4,4258163948895801309,0.000000
steepest_intra:edges_start:random,31,276769,175580,101189,1,0,72;114;148;133;130;28;79;94;43;190;17;173;138;132;18;117;7;76;70;184;113;166;124;82;152;140;89;35;2;39;198;162;105;64;187;108;44;158;149;59;131;88;97;52;159;6;9;61;12;66;153;85;4;155;75;50;103;77;151;150;81;197;128;139;178;199;67;134;13;143;92;30;95;191;156;56;176;51;49;23;84;175;47;186;38;21;107;22;147;182;121;87;142;179;62;71;193;53;31;101,8643692559051202940,0.000000
steepest_intra:edges_start:random,32,288503,188104,100399,1,0,6;146;64;119;99;87;18;193;61;84;177;37;101;179;182;181;2;104;148;112;165;190;180;188;178;59;88;105;7;158;28;114;174;185;196;123;25;159;12;175;51;82;19;79;140;56;30;145;14;122;74;39;5;136;198;142;151;162;27;46;21;33;69;71;23;38;66;72;50;139;98;167;9;163;67;3;141;113;155;57;147;70;31;194;83;107;197;137;97;144;133;195;93;44;166;60;49;54;47;164,8884126723313752691,0.000000
steepest_intra:edges_start:random,33,279104,182813,96291,1,0,46;137;150;62;4;74;197;56;123;107;136;71;50;141;164;157;18;45;140;27;109;66;82;34;171;181;3;84;47;173;5;178;174;156;1;78;115;41;8;9;145;35;87;64;39;88;147;186;17;151;25;112;194;110;22;98;58;196;10;90;7;183;179;101;20;180;80;24;160;129;121;77;148;36;185;76;170;189;23;116;191;83;14;51;96;2;52;31;188;104;195;79;97;40;108;85;73;133;154;16,7730454245564266173,0.000000
steepest_intra:edges_start:random,34,272688,176805,95883,1,0,130;53;168;26;187;131;84;162;123;129;70;109;38;176;95;11;69;179;22;25;43;132;52;54;15;40;136;189;169;13;6;47;98;51;148;39;44;194;78;42;172;30;104;32;9;76;181;105;117;2;46;138;134;184;141;185;166;55;198;133;80;64;146;19;102;118;82;48;188;174;128;137;192;155;142;126;31;73;143;116;183;107;101;190;21;145;106;111;63;8;193;120;81;41;127;149;113;3;7;186,6796578106547016006,0.000000
steepest_intra:edges_start:random,35,269119,172639,96480,1,0,186;59;79;82;183;63;171;46;3;75;87;13;57;56;140;50;29;106;180;108;6;193;165;32;31;25;120;121;94;33;85;134;9;69;27;139;199;177;91;89;105;28;110;55;70;5;111;123;175;64;10;53;194;12;58;40;127;44;104;47;30;100;131;93;73;22;128;149;117;178;39;197;109;43;155;17;116;153;7;147;135;80;166;167;158;90;151;192;164;15;136;77;67;11;99;84;68;76;54;189,4713495566737015626,0.000000
steepest_intra:edges_start:random,36,281419,176173,105246,1,0,88;47;29;138;5;139;46;145;36;28;182;155;143;66;11;126;135;148;79;157;22;30;20;86;166;170;83;45;104;140;82;21;39;188;41;118;84;13;92;110;180;101;74;173;165;100;60;103;187;97;151;179;164;44;72;90;174;70;142;144;192;61;37;156;117;17;146;48;168;116;31;26;111;42;119;62;122;197;169;196;19;184;161;93;34;33;181;136;199;171;38;189;78;193;81;163;132;6;89;24,925438173514913844,0.000000
steepest_intra:edges_start:random,37,259139,163189,95950,1,0,159;167;150;125;128;105;130;12;53;171;60;92;73;154;25;185;49;88;101;113;23;191;102;106;34;162;174;161;140;64;177;192;148;32;189;26;68;139;164;74;143;19;43;9;35;184;39;116;90;3;138;104;13;149;114;7;187;18;179;22;103;48;131;84;14;118;91;142;95;29;42;2;86;24;87;188;112;45;196;4;152;33;117;46;111;81;11;176;123;108;5;136;173;121;52;158;100;70;181;80,3695702866662224161,0.000000
steepest_intra:edges_start:random,38,246036,152824,93212,1,0,25;198;52;34;91;190;192;157;85;67;47;154;116;69;59;163;50;98;170;161;159;109;58;10;123;21;103;0;133;49;32;126;63;175;138;64;68;145;57;84;38;86;178;37;9;92;88;152;172;144;51;189;78;173;107;83;122;8;187;114;158;12;117;132;176;155;62;89;164;27;179;196;6;39;75;11;141;93;101;118;149;66;94;1;171;108;115;183;97;112;14;55;81;87;56;121;70;23;180;119,7625898661760316047,0.000000
steepest_intra:edges_start:random,39,279246,179057,100189,1,0,121;153;181;195;13;77;162;87;22;112;188;101;88;70;156;165;96;140;67;94;7;139;113;111;103;75;27;102;178;35;33;46;193;145;41;11;2;9;36;86;144;126;185;143;169;175;8;6;50;74;192;53;142;182;198;80;125;158;199;28;37;148;170;151;191;14;59;171;39;110;26;21;131;82;84;85;136;154;20;23;128;115;32;1;79;137;62;24;190;93;45;38;197;3;135;163;30;107;91;95,3747798406778673189,0.000000
steepest_intra:edges_start:random,40,275973,175937,100036,1,0,120;38;77;6;104;89;84;91;112;97;92;118;107;192;49;131;54;162;79;169;117;128;13;25;51;96;62;75;65;3;76;72;115;22;94;50;156;109;139;148;124;56;130;58;155;108;63;98;150;64;42;52;4;40;136;140;198;60;141;29;171;19;73;34;125;143;102;44;116;10;43;168;142;16;119;32;70;121;31;173;195;83;55;69;17;188;85;81;0;178;127;134;14;154;15;153;164;191;90;167,1016197158098688703,0.000000
steepest_intra:edges_start:random,41,258979,163373,95606,1,0,29;10;75;100;157;164;166;174;109;2;6;36;1;15;97;129;23;121;67;18;183;151;61;87;78;95;104;53;199;57;116;127;77;194;162;117;8;25;41;96;21;185;34;14;141;184;32;114;188;49;177;107;137;176;191;89;0;93;118;123;138;56;195;125;130;145;193;59;135;136;122;63;198;72;171;30;140;98;139;169;12;43;156;182;50;197;38;7;71;165;131;192;148;132;170;146;154;45;64;4,7012976292728793681,0.000000
steepest_intra:edges_start:random,42,257021,166332,90689,1,0,179;26;164;143;85;156;81;181;95;72;117;5;97;94;106;32;123;165;102;196;24;182;149;135;46;142;180;50;56;52;150;93;155;172;146;194;189;116;89;198;60;48;15;169;154;185;54;163;75;136;77;78;195;10;41;98;62;114;79;144;152;4;113;80;63;16;99;86;112;70;9;66;161;160;148;87;121;0;83;40;110;157;57;104;20;58;127;96;44;27;130;53;115;128;191;139;19;21;88;183,7840452049860110131,0.000000
steepest_intra:edges_start:random,43,275008,177968,97040,1,0,0;99;127;194;71;53;174;134;93;5;91;26;8;35;165;15;143;49;59;1;188;147;103;54;65;172;186;88;83;27;62;45;2;61;124;108;109;177;58;78;52;163;24;84;63;126;37;87;176;106;112;135;179;81;121;70;69;180;183;118;74;104;67;66;22;193;158;150;50;190;120;14;170;155;159;173;64;148;144;47;189;68;56;73;184;136;25;139;107;166;175;39;141;30;117;152;160;17;10;145,5833573469159843057,0.000000
steepest_intra:edges_start:random,44,250255,157921,92334,1,0,120;152;66;85;136;60;30;41;149;5;79;44;78;127;97;89;148;15;4;9;58;182;101;23;93;27;12;70;106;184;186;163;169;40;39;171;197;164;33;167;1;111;94;180;71;82;61;88;29;196;199;108;115;95;2;132;47;48;51;80;83;121;92;128;100;72;107;181;84;45;174;139;68;112;118;103;178;170;194;102;16;11;18;7;36;59;8;154;90;50;124;183;52;190;189;134;193;43;14;155,4047999173491271372,0.000000
steepest_intra:edges_start:random,45,245335,153184,92151,1,0,35;18;22;2;55;90;165;144;77;142;131;15;33;6;140;38;27;91;174;1;171;94;43;117;127;119;150;16;25;54;135;129;36;199;26;148;125;10;172;60;100;49;104;107;0;149;136;20;32;155;154;78;98;86;62;80;4;64;97;175;145;186;194;56;53;42;65;14;59;17;39;188;173;23;3;197;73;122;83;156;99;176;79;184;177;162;81;164;70;96;29;11;40;113;183;9;61;84;166;44,4559512190392501765,0.000000
steepest_intra:edges_start:random,46,250822,157111,93711,1,0,123;51;35;196;90;28;105;191;41;103;159;67;78;8;10;112;158;98;45;151;137;92;139;25;167;49;36;72;165;97;192;63;199;55;157;127;195;117;118;79;136;82;75;24;77;171;179;188;99;80;13;26;42;93;182;18;83;87;38;124;175;2;120;101;11;113;194;107;48;126;108;22;153;29;102;58;160;170;76;111;138;62;185;60;53;64;96;39;5;40;30;172;86;189;21;81;177;193;37;155,8756267136133814298,0.000000
steepest_intra:edges_start:random,47,286520,186176,100344,1,0,104;62;81;5;2;98;31;121;14;187;4;8;154;164;171;102;175;128;75;91;57;80;37;9;196;115;188;96;58;144;35;170;168;141;20;138;22;179;120;32;52;157;172;134;61;195;34;17;148;158;199;101;163;50;56;197;21;156;78;73;0;29;111;76;182;86;54;107;72;162;3;112;67;136;49;27;149;38;183;13;126;7;184;6;100;83;94;84;194;117;173;42;53;46;12;153;59;165;130;135,278530218112923310,0.000000
steepest_intra:edges_start:random,48,248747,147432,101315,1,0,136;159;58;171;71;88;153;190;50;196;169;117;139;19;127;191;74;57;38;107;124;115;123;66;80;60;114;97;3;116;30;193;144;41;94;148;174;163;199;165;102;128;188;125;197;96;53;198;10;76;64;189;42;181;118;162;75;47;20;187;18;15;77;22;194;150;92;104;151;137;43;26;129;17;192;134;9;132;111;166;170;32;72;4;131;135;95;154;16;172;85;120;112;28;158;184;160;36;108;37,1827750462541198107,0.000000
steepest_intra:edges_start:random,49,277412,171339,106073,1,0,92;176;9;38;171;43;136;102;141;13;78;77;97;18;81;83;1;0;45;189;192;172;47;179;159;118;25;71;66;75;11;181;15;37;70;121;88;57;148;187;61;19;151;100;105;117;32;188;86;94;67;109;137;132;126;85;110;138;155;119;113;103;54;7;133;72;12;104;144;30;73;5;164;162;23;185;62;52;4;80;98;147;139;143;173;56;150;134;166;142;145;169;79;28;125;198;186;64;26;96,784407747093092311,0.000000
steepest_intra:edges_start:random,50,268783,170670,98113,1,0,113;4;69;141;23;157;156;52;80;122;56;3;90;83;194;120;177;176;60;153;195;186;168;91;137;118;192;6;129;190;73;68;42;183;172;102;57;93;145;103;124;138;25;97;61;179;123;104;84;50;39;7;89;0;171;63;166;116;188;142;146;51;178;173;58;158;134;184;46;22;98;88;152;117;99;54;45;27;35;95;196;53;198;151;78;128;110;47;105;187;38;77;193;169;28;85;115;18;44;26,3639243515131621803,0.000000
steepest_intra:edges_start:random,51,263503,173842,89661,1,0,137;26;177;15;152;146;11;193;195;192;57;167;105;39;20;128;199;143;34;149;189;124;172;104;88;68;65;198;179;112;185;120;121;91;145;84;76;173;154;5;90;0;158;126;27;148;138;102;98;157;25;93;184;144;4;37;111;180;188;78;31;140;101;109;18;8;153;183;116;155;3;53;164;194;54;79;42;50;115;170;32;89;64;73;48;168;139;45;196;110;162;49;70;16;23;92;58;19;22;14,9116635648080315238,0.000000
steepest_intra:edges_start:random,52,262662,170466,92196,1,0,26;4;28;183;127;186;43;140;106;37;80;102;44;82;162;25;103;49;181;74;24;109;131;32;188;143;31;92;118;54;52;40;89;66;48;113;170;149;130;163;93;189;159;110;56;34;117;116;145;29;123;120;50;174;132;128;17;150;125;171;15;0;30;99;146;166;84;152;62;51;193;169;196;191;97;64;73;179;39;83;137;65;155;112;96;105;53;164;68;198;175;22;35;57;190;9;165;69;58;20,276875879070134888,0.000000
steepest_intra:edges_start:random,53,270007,168985,101022,1,0,54;19;107;46;50;87;117;104;114;173;195;16;176;33;152;45;137;58;8;12;183;161;199;66;90;131;105;23;101;32;100;4;64;145;34;130;7;63;26;171;102;174;134;182;185;79;194;55;78;80;157;3;38;165;158;113;53;20;111;140;72;35;115;179;88;85;127;136;59;188;1;132;13;24;98;41;110;181;27;25;52;62;73;142;170;177;18;81;17;0;121;175;29;65;172;36;69;75;141;93,8806241830268340162,0.000000
steepest_intra:edges_start:random,54,250572,150907,99665,1,0,20;77;189;151;123;162;47;49;29;130;96;109;32;12;8;37;60;197;116;91;45;159;103;1;63;176;43;9;97;95;18;41;156;167;52;106;171;150;31;39;122;64;13;80;121;16;27;112;124;48;40;36;136;28;157;175;160;79;15;178;191;72;188;113;55;34;161;35;76;66;107;92;148;125;25;133;2;67;70;87;139;186;59;120;141;173;11;165;168;4;88;83;102;65;166;23;42;199;111;134,6633172901137096851,0.000000
steepest_intra:edges_start:random,55,268582,170752,97830,1,0,110;167;23;18;19;64;39;85;41;8;77;99;127;62;131;88;157;177;144;169;124;12;82;60;117;109;98;148;52;6;194;93;141;87;145;198;185;7;63;183;181;10;113;29;133;57;73;189;126;21;84;68;0;53;160;139;4;32;119;196;172;186;27;118;164;146;96;94;38;171;116;121;78;147;175;153;114;50;43;33;182;143;174;97;179;66;130;55;40;120;58;74;90;184;173;95;69;11;67;51,2420632495147993418,0.000000
steepest_intra:edges_start:random,56,268457,158554,109903,1,0,75;33;108;94;76;123;111;194;168;87;79;189;107;164;3;70;134;152;195;190;166;98;12;72;149;126;109;25;64;57;132;174;26;138;121;125;110;184;9;92;56;139;81;183;37;10;30;101;74;119;28;84;22;128;89;170;20;67;141;187;176;6;158;113;163;90;147;159;133;61;100;88;60;156;35;4;27;48;171;198;153;117;77;186;8;120;82;175;160;45;135;38;173;44;24;66;150;122;178;142,9153858549632157991,0.000000
steepest_intra:edges_start:random,57,252325,159412,92913,1,0,183;35;93;193;135;34;47;173;91;145;50;80;194;143;196;79;170;63;113;159;33;182;72;190;137;156;142;178;10;124;126;116;75;197;94;31;181;198;43;151;81;51;99;154;6;7;157;25;121;26;103;176;61;97;128;167;177;109;17;45;153;65;179;40;19;37;162;115;160;83;122;12;101;73;96;44;102;158;163;70;11;164;148;184;69;74;48;55;20;29;85;21;110;49;78;129;175;127;168;130,4567121386335039749,0.000000
steepest_intra:edges_start:random,58,273827,175823,98004,1,0,39;60;153;84;45;75;73;131;25;78;120;168;110;46;102;43;105;132;17;72;62;57;4;152;1;170;130;94;126;18;56;148;106;161;129;23;171;195;65;133;71;61;26;32;79;13;93;185;119;198;35;89;125;29;191;128;135;14;180;113;172;142;91;53;146;8;103;98;11;181;34;187;54;134;48;121;40;151;177;144;107;169;164;178;104;143;95;12;197;137;51;5;189;199;31;92;9;166;157;186,7884816063315823879,0.000000
steepest_intra:edges_start:random,59,265311,168987,96324,1,0,18;60;0;123;9;194;25;149;104;181;89;143;62;68;165;48;82;175;38;160;184;167;170;131;86;153;189;120;161;127;132;110;112;2;125;16;7;105;23;185;135;141;115;40;10;50;177;129;124;87;113;191;88;14;77;37;43;142;121;49;5;109;156;150;155;197;168;78;173;148;172;169;1;179;166;80;116;164;182;4;188;76;71;178;24;66;6;26;190;90;139;11;75;117;95;52;186;106;152;72,2977102171938214874,0.000000
steepest_intra:edges_start:random,60,272330,176576,95754,1,0,58;42;31;64;126;183;46;185;181;38;104;111;76;86;1;83;108;121;66;55;4;72;190;195;82;40;96;160;172;130;169;33;18;48;159;139;152;22;20;123;145;60;15;43;134;92;79;164;97;89;95;29;30;191;28;116;186;132;146;45;35;167;98;143;75;67;153;81;179;61;36;49;52;118;3;77;163;71;59;99;131;7;41;0;149;90;84;196;91;14;25;176;70;138;173;198;102;44;56;8,6901081705781033373,0.000000
steepest_intra:edges_start:random,61,250661,153681,96980,1,0,41;124;77;145;155;142;185;94;9;199;170;80;62;162;69;172;116;15;40;78;102;0;24;156;100;6;143;54;67;149;58;13;113;147;182;173;8;119;18;157;83;33;153;82;132;23;104;1;164;91;14;86;108;121;152;125;46;45;168;171;187;63;167;165;144;192;193;110;3;189;88;178;107;112;76;122;57;98;129;25;65;48;36;126;35;31;180;66;32;117;120;195;103;176;34;148;101;39;95;92,1909412210404299302,0.000000
steepest_intra:edges_start:random,62,277118,176808,100310,1,0,29;32;11;153;126;24;25;154;74;141;163;161;116;45;107;174;48;10;188;90;140;36;16;62;89;80;69;9;149;61;105;40;63;49;159;177;1;95;127;70;137;193;181;142;185;6;72;94;81;58;51;128;96;91;79;195;152;184;12;60;42;123;7;104;88;85;97;190;44;175;5;199;158;197;100;8;179;4;84;148;87;22;28;13;124;68;165;112;150;3;164;162;166;77;145;198;20;120;147;98,7322082433495219909,0.000000
steepest_intra:edges_start:random,63,247908,155421,92487,1,0,136;143;132;138;82;135;18;83;62;73;193;68;174;49;124;116;179;104;187;137;27;147;86;64;39;196;100;109;48;96;29;108;99;87;67;123;41;74;175;198;72;139;19;118;56;17;191;160;183;57;199;111;76;182;35;20;90;52;31;66;51;88;22;9;159;177;105;154;180;80;0;63;176;152;94;169;167;38;50;42;93;186;98;165;14;133;30;184;181;43;7;195;46;44;168;65;103;189;131;173,1620919132443310836,0.000000
steepest_intra:edges_start:random,64,262565,162625,99940,1,0,102;97;167;59;166;173;110;34;103;77;130;80;87;8;88;153;57;35;149;114;17;154;98;177;1;51;62;74;160;41;55;161;197;113;39;99;3;139;78;118;14;61;191;199;46;124;188;194;132;4;133;175;82;198;95;65;93;20;75;44;117;170;38;43;151;159;162;156;52;168;36;187;122;172;131;144;0;183;56;111;109;49;107;101;25;121;112;28;91;119;83;100;143;142;152;169;68;73;70;140,8168184375374520071,0.000000
steepest_intra:edges_start:random,65,261052,161642,99410,1,0,134;120;184;99;83;188;33;161;51;123;142;35;193;36;163;80;98;187;86;37;74;72;166;195;173;167;70;138;103;183;92;114;121;61;16;190;153;8;71;178;110;156;48;145;128;67;154;43;73;137;77;171;65;91;157;2;93;79;186;78;135;112;97;40;32;185;45;141;26;130;152;46;11;53;60;170;52;115;14;113;104;24;75;124;18;140;144;55;174;147;125;107;194;192;56;175;20;10;180;164,5684387169726520475,0.000000
steepest_intra:edges_start:random,66,257194,159011,98183,1,0,128;12;70;184;180;5;59;103;75;163;20;169;14;11;80;139;13;9;63;56;49;136;190;24;61;68;129;118;132;189;112;57;198;196;101;182;140;108;123;116;177;95;27;192;126;165;195;147;67;77;0;172;162;122;96;186;28;91;31;100;125;107;121;135;145;143;181;34;44;29;191;33;185;171;157;73;40;84;151;50;174;82;72;111;148;55;39;87;36;16;119;179;102;8;197;199;90;60;69;92,6294737640500164682,0.000000
steepest_intra:edges_start:random,67,252943,151238,101705,1,0,76;79;153;125;16;131;12;155;160;74;159;118;165;83;49;31;181;114;55;40;145;163;96;164;58;123;149;10;199;41;188;52;4;30;197;60;146;2;152;98;9;137;116;139;178;142;147;107;158;77;44;66;46;92;38;85;140;148;132;73;80;11;176;8;173;161;51;169;196;75;111;167;150;182;128;143;94;81;172;154;108;7;95;99;67;174;70;18;64;104;183;37;17;113;119;109;6;193;5;100,3326552111206721447,0.000000
steepest_intra:edges_start:random,68,263448,163914,99534,1,0,20;77;18;52;62;11;180;169;191;32;104;46;23;110;66;156;154;21;171;194;55;28;41;67;107;117;49;129;116;197;4;103;30;151;17;87;118;13;45;29;173;54;112;75;199;144;150;138;53;63;16;6;99;42;136;176;76;108;64;74;170;131;89;190;2;35;111;158;113;58;40;88;196;90;59;127;153;115;7;106;198;60;125;68;174;51;1;167;50;184;79;143;145;93;102;141;3;163;24;97,3285946888287731242,0.000000
steepest_intra:edges_start:random,69,272165,179594,92571,1,0,160;72;180;162;193;122;196;116;190;55;24;28;70;103;113;117;84;179;8;34;159;57;86;85;92;13;11;194;126;73;22;14;152;93;25;51;161;153;58;164;188;59;134;120;124;27;199;49;0;192;150;170;112;144;99;147;16;67;101;48;97;184;3;133;168;17;130;50;69;185;4;18;33;47;149;64;114;54;89;29;96;154;123;151;60;43;30;31;94;119;165;1;95;23;182;176;71;155;74;21,2292669781906779827,0.000000
steepest_intra:edges_start:random,70,254173,156993,97180,1,0,40;104;122;144;15;117;54;157;0;97;18;198;164;196;162;197;112;69;30;29;5;118;130;33;57;145;44;167;177;24;38;168;103;10;146;25;143;17;140;110;91;64;60;150;87;81;183;141;93;63;155;176;109;80;48;36;156;195;42;148;172;121;158;50;174;108;189;11;13;46;53;127;175;31;194;20;173;56;163;193;43;65;3;128;27;39;107;160;84;124;9;184;85;185;4;180;41;92;170;52,3474209224609331914,0.000000
steepest_intra:edges_start:random,71,267064,165597,101467,1,0,133;180;107;76;14;25;36;124;42;141;149;17;94;1;159;51;87;110;112;175;130;62;54;59;57;7;67;186;34;45;113;167;73;121;97;44;182;65;55;146;191;169;19;10;47;91;15;128;24;198;144;190;150;64;35;196;32;158;29;189;197;119;79;83;80;183;122;111;160;86;52;60;30;147;41;134;84;4;93;37;129;193;27;194;99;178;185;98;131;188;199;28;170;125;177;140;164;153;117;100,6966016452264428266,0.000000
steepest_intra:edges_start:random,72,258013,161700,96313,1,0,38;136;110;17;58;0;130;117;35;169;18;192;102;7;122;175;40;174;195;79;72;48;198;11;189;180;10;54;185;118;103;183;194;26;170;154;92;46;181;76;184;167;111;119;191;150;165;14;98;55;1;188;15;8;161;13;139;22;6;163;69;187;73;96;152;173;65;85;135;149;63;47;3;109;86;37;124;25;68;134;113;23;100;197;29;123;190;107;101;137;193;44;147;94;178;62;132;95;78;90,8094213803167291072,0.000000
steepest_intra:edges_start:random,73,262596,164180,98416,1,0,42;66;183;45;152;53;90;122;31;184;43;141;172;78;29;32;173;105;139;154;147;140;55;166;177;27;80;49;56;160;9;148;117;199;130;89;181;3;167;137;0;190;68;124;71;133;149;162;104;187;85;161;22;132;64;120;60;13;50;95;4;103;174;39;121;58;63;125;81;75;41;189;62;76;175;159;108;136;38;191;109;5;102;82;87;186;129;135;158;67;110;112;54;168;20;70;165;1;74;153,590070990754952936,0.000000
steepest_intra:edges_start:random,74,275507,174371,101136,1,0,70;125;51;169;55;30;10;174;92;108;64;46;13;128;54;56;152;4;191;88;1;199;163;3;126;19;85;53;67;134;151;183;167;96;139;28;103;38;15;157;101;37;63;105;75;131;161;66;49;160;72;68;16;82;180;45;188;166;32;127;81;156;197;14;185;177;145;8;111;132;99;173;93;113;94;165;106;181;195;178;104;196;12;143;74;57;147;95;40;133;60;168;90;115;142;170;20;154;52;71,3810696190981754826,0.000000
steepest_intra:edges_start:random,75,252033,159151,92882,1,0,104;26;63;187;2;78;97;91;156;20;197;6;50;126;81;177;49;68;4;60;133;89;21;136;158;52;70;109;48;69;189;165;115;114;28;34;11;0;16;125;62;154;141;96;159;143;121;74;130;153;51;8;19;160;128;185;25;139;106;44;150;119;39;199;37;162;193;92;164;191;31;90;190;103;112;198;124;79;33;169;173;40;129;181;66;42;186;58;59;5;99;55;175;137;24;148;65;182;105;138,5794486673844457830,0.000000
steepest_intra:edges_start:random,76,277987,178292,99695,1,0,169;182;7;41;100;185;115;20;99;127;101;190;176;186;95;156;36;23;171;77;150;27;198;24;91;93;73;163;134;31;110;153;133;103;56;180;68;32;175;125;147;159;79;124;194;58;197;92;43;48;149;97;64;45;4;44;188;173;30;177;86;39;112;183;94;59;54;42;88;26;29;146;61;65;166;193;6;75;81;140;40;195;119;144;96;35;50;139;63;152;70;167;87;192;3;141;142;83;2;179,7506596786747492035,0.000000
steepest_intra:edges_start:random,77,261243,164563,96680,1,0,89;115;161;86;116;196;188;128;140;102;103;10;119;31;152;167;43;50;181;153;39;21;173;61;123;183;30;187;19;36;184;63;17;177;133;144;67;156;114;25;150;38;88;174;70;118;29;154;85;92;198;129;194;62;68;64;190;44;72;82;125;26;59;160;65;42;157;171;130;40;5;9;53;191;13;2;158;54;69;98;95;49;122;15;37;73;182;159;126;164;52;1;143;34;137;79;83;99;48;20,6283491588979008947,0.000000
steepest_intra:edges_start:random,78,249513,150900,98613,1,0,79;95;93;159;145;27;94;110;158;77;138;17;5;122;121;116;36;107;66;115;111;8;113;83;161;196;100;16;38;176;140;26;49;9;14;146;186;35;192;177;15;188;139;68;155;73;154;45;126;39;89;32;183;101;74;144;187;40;152;71;61;106;10;131;30;109;153;31;55;125;25;172;163;57;46;12;60;198;149;117;108;41;191;34;65;199;168;58;24;171;156;98;194;162;102;179;175;90;1;76,5047819188487914385,0.000000
steepest_intra:edges_start:random,79,254961,152441,102520,1,0,122;133;178;137;47;46;68;64;195;33;120;143;38;174;58;104;93;109;12;116;118;56;99;197;110;194;184;139;97;187;102;153;121;67;140;106;190;36;126;151;45;163;131;95;179;171;168;34;135;191;83;43;114;66;117;177;65;152;157;60;20;13;49;125;119;158;136;165;160;166;141;23;142;53;193;69;169;42;156;63;98;90;57;10;1;159;130;85;32;182;11;24;18;37;88;81;145;107;129;21,8977265608477241657,0.000000
steepest_intra:edges_start:random,80,264758,168785,95973,1,0,61;122;142;173;171;107;143;93;149;162;75;23;97;182;138;117;28;15;48;102;119;146;178;91;106;184;199;1;83;9;98;108;170;160;109;134;88;135;168;72;27;55;129;190;47;82;35;2;65;66;103;79;38;187;51;24;44;85;132;17;139;31;77;126;147;29;53;121;148;99;180;185;120;45;179;13;137;145;30;6;183;123;89;81;19;62;165;115;163;92;155;116;25;192;96;175;54;49;95;189,4240560362535823120,0.000000
steepest_intra:edges_start:random,81,249451,156209,93242,1,0,193;117;116;66;184;65;131;198;162;110;26;60;49;37;148;180;177;185;128;102;187;50;189;145;90;21;135;88;125;191;23;121;93;48;44;68;100;112;31;144;186;15;63;151;16;87;14;0;192;113;64;153;19;47;76;165;141;105;10;35;56;197;194;169;108;176;124;11;72;149;43;146;109;168;188;58;175;173;179;67;70;7;84;75;28;190;29;181;82;42;129;18;120;27;174;25;182;89;69;40,7993481753598699865,0.000000
steepest_intra:edges_start:random,82,265089,166941,98148,1,0,16;76;136;19;147;180;30;88;105;116;74;160;29;109;196;184;8;21;36;125;90;192;7;106;23;5;127;117;27;47;66;12;174;172;198;139;32;70;142;104;26;99;44;164;6;34;144;92;165;151;138;194;40;130;132;159;42;107;49;60;2;115;101;55;182;33;11;158;103;24;162;98;163;96;141;113;67;68;120;129;153;35;53;171;83;65;72;102;170;14;156;112;193;137;69;173;145;57;31;78,5214025644786452843,0.000000
steepest_intra:edges_start:random,83,274587,175519,99068,1,0,148;78;146;61;185;18;51;101;11;152;147;90;20;32;111;144;199;99;177;198;25;89;42;140;178;141;83;117;86;137;63;143;134;10;121;150;100;182;155;79;168;24;125;48;188;118;41;119;73;110;166;21;76;184;17;106;29;40;88;80;193;98;9;81;195;115;45;164;105;167;56;160;192;49;107;165;136;170;183;87;70;189;44;156;96;169;4;68;122;37;102;120;60;127;62;145;151;38;129;174,8634978794125488813,0.000000
steepest_intra:edges_start:random,84,278442,174358,104084,1,0,149;179;93;101;60;169;89;164;15;161;100;13;151;152;86;53;49;177;137;30;172;66;150;131;28;197;143;6;14;59;46;136;174;102;7;48;2;105;1;3;163;127;182;91;193;168;87;113;112;71;125;173;129;188;156;195;55;171;20;134;128;33;72;192;23;24;99;189;92;64;32;117;135;11;70;37;108;114;63;27;36;17;43;81;181;144;110;35;166;198;31;165;45;170;139;88;94;175;39;56,5519408706142268712,0.000000
steepest_intra:edges_start:random,85,262945,160462,102483,1,0,80;187;86;13;186;58;30;159;141;6;52;150;164;42;72;121;83;134;166;151;39;69;73;145;8;117;148;95;31;140;27;48;74;22;189;61;163;111;65;127;26;36;165;62;25;157;182;12;124;168;66;29;181;153;9;167;84;192;32;199;112;47;172;169;125;136;110;119;55;35;94;105;197;77;188;171;1;104;63;7;183;138;97;133;154;131;5;71;102;120;34;19;155;46;93;137;149;70;162;20,1994972512885788715,0.000000
steepest_intra:edges_start:random,86,285360,186462,98898,1,0,27;93;4;3;130;156;193;11;39;144;128;111;21;68;132;119;112;13;192;191;7;155;159;167;62;20;165;102;8;6;34;56;24;114;120;94;163;86;57;140;199;90;151;52;81;162;95;26;170;69;66;175;181;190;107;126;75;142;2;59;125;36;161;43;85;63;198;172;47;40;97;70;186;173;17;67;65;31;96;53;158;188;101;46;131;60;19;164;14;73;139;89;15;150;105;187;177;179;49;44,1773943968201573109,0.000000
steepest_intra:edges_start:random,87,270523,173061,97462,1,0,5;187;160;60;180;198;134;9;95;161;93;143;31;55;59;57;146;48;119;183;135;154;49;85;69;102;32;43;114;181;62;35;167;73;12;141;24;7;8;96;142;111;67;108;177;79;21;103;140;41;174;18;33;39;131;155;44;193;172;197;14;186;91;122;173;171;132;115;162;17;75;82;136;133;46;28;109;72;188;65;37;22;190;78;15;107;117;50;88;149;176;74;38;100;34;152;130;106;94;121,5284038852545351943,0.000000
steepest_intra:edges_start:random,88,282289,178419,103870,1,0,137;152;190;67;167;150;22;194;29;138;74;163;13;147;111;45;177;31;110;71;198;189;108;63;33;34;36;57;195;93;196;179;98;9;107;117;73;37;95;42;119;132;148;46;44;169;84;68;126;18;149;65;145;123;100;85;159;99;155;60;26;75;53;114;6;106;157;89;15;183;188;91;197;186;35;102;7;124;127;59;0;125;43;143;21;19;173;88;12;161;38;51;17;113;96;86;39;191;32;175,8115942025225525763,0.000000
steepest_intra:edges_start:random,89,266088,171433,94655,1,0,116;56;20;55;134;37;71;86;109;83;188;77;21;107;2;78;185;13;147;193;144;73;36;89;105;101;52;24;53;163;108;96;136;192;35;120;57;68;100;76;70;29;40;58;197;140;145;180;117;143;80;137;175;167;5;31;121;125;65;158;157;93;127;12;54;69;39;17;43;59;184;49;162;11;61;15;130;174;152;135;103;98;159;10;91;84;191;139;26;142;119;113;47;1;114;122;23;97;138;186,6477357349787921403,0.000000
steepest_intra:edges_start:random,90,278664,174811,103853,1,0,70;197;119;11;69;74;186;16;60;139;79;43;144;17;80;191;194;152;62;121;103;153;157;18;83;59;57;87;168;162;142;63;81;65;98;127;84;12;140;54;67;118;0;172;110;86;56;50;72;129;123;3;195;114;173;125;198;160;154;137;91;105;85;51;174;44;199;61;133;126;190;92;82;6;196;178;26;108;42;111;45;158;34;187;122;104;20;135;27;55;136;66;5;161;166;13;163;14;28;94,6841773691074056729,0.000000
steepest_intra:edges_start:random,91,265573,163882,101691,1,0,6;38;29;193;31;103;108;142;18;130;136;197;180;112;173;106;46;97;122;76;67;69;151;66;48;19;104;65;16;198;169;63;156;93;174;123;13;148;98;191;77;17;167;11;35;121;71;111;143;26;149;61;54;88;10;45;139;126;32;138;186;94;44;40;101;79;128;3;60;135;21;160;175;102;14;91;52;64;39;1;178;152;140;56;188;99;165;68;124;118;113;181;141;109;28;132;72;25;179;144,7659694875633454424,0.000000
steepest_intra:edges_start:random,92,273828,183149,90679,1,0,104;177;26;37;63;38;139;6;21;132;52;184;25;91;36;185;64;56;67;86;157;110;167;41;100;116;14;134;143;16;90;89;186;29;122;69;58;35;107;71;65;155;10;172;126;76;140;97;105;60;145;42;114;39;73;88;49;119;154;171;83;7;163;45;124;5;164;44;117;54;68;20;192;190;2;96;148;18;62;193;12;159;4;120;59;9;79;72;31;92;40;128;183;160;24;43;50;80;47;176,5377514531588124711,0.000000
steepest_intra:edges_start:random,93,258786,155295,103491,1,0,86;12;176;173;1;158;145;44;54;99;136;142;117;90;105;42;29;50;91;115;180;182;172;114;23;119;132;2;102;88;83;111;185;171;128;74;55;69;143;32;20;66;56;100;167;71;154;11;67;68;192;7;120;63;26;33;19;87;196;129;61;80;4;98;160;107;199;170;84;3;131;81;193;40;191;36;79;39;127;18;125;57;45;146;150;163;76;189;157;179;24;53;25;51;94;62;65;72;122;166,4683246060570772790,0.000000
steepest_intra:edges_start:random,94,276826,182417,94409,1,0,66;71;11;75;165;18;39;74;4;198;87;194;129;151;169;130;34;190;56;106;37;96;177;100;68;29;91;143;187;0;128;97;7;42;21;46;185;58;108;17;152;195;171;51;123;65;192;112;149;95;178;113;12;88;76;188;105;167;78;38;134;183;184;148;26;61;23;5;163;64;70;159;180;16;63;69;43;115;197;127;146;83;98;168;133;89;80;93;189;103;196;191;164;50;138;25;139;102;14;28,5468786539315082583,0.000000
steepest_intra:edges_start:random,95,268478,172438,96040,1,0,82;187;24;173;14;104;175;97;54;115;94;85;112;101;68;138;99;17;90;123;83;58;139;84;185;119;62;41;176;110;98;161;45;167;52;143;134;77;166;144;151;87;165;5;88;50;107;164;149;29;124;65;11;27;1;172;125;72;91;28;132;81;127;120;148;89;171;178;47;117;21;43;78;31;73;100;113;108;105;35;147;6;18;135;74;193;133;116;142;130;46;4;195;136;162;16;146;169;23;67,3970076391267828668,0.000000
steepest_intra:edges_start:random,96,261168,168616,92552,1,0,153;14;128;54;80;82;145;150;4;165;31;2;9;97;177;104;42;125;169;137;168;108;33;167;194;61;175;83;103;173;124;19;100;51;16;117;131;55;109;122;191;32;144;180;196;146;50;68;17;148;56;28;81;129;59;154;89;5;91;116;3;185;1;78;22;62;73;65;176;183;30;92;35;49;21;166;6;15;172;40;130;156;70;149;66;193;64;90;48;85;189;182;47;58;8;151;11;199;72;18,6756882903321713449,0.000000
steepest_intra:edges_start:random,97,254040,162157,91883,1,0,5;12;172;7;146;179;69;147;120;75;105;77;65;108;18;113;112;122;180;128;92;170;127;81;3;182;6;123;4;24;21;176;194;160;163;25;44;28;169;39;64;106;48;79;192;186;197;37;9;159;94;141;51;136;195;181;156;26;30;53;16;0;132;131;66;41;52;11;91;14;49;121;139;161;45;31;95;59;78;80;10;119;102;138;42;32;85;17;101;144;84;111;103;22;157;174;177;145;162;19,1573045428739223463,0.000000
steepest_intra:edges_start:random,98,265639,167523,98116,1,0,60;127;42;120;172;106;111;95;162;75;57;29;27;11;195;44;175;85;114;125;40;14;99;100;134;64;164;196;22;115;119;132;55;72;131;185;20;123;21;142;124;155;69;70;78;48;0;1;192;152;158;109;156;117;126;169;9;107;53;68;161;91;45;18;188;33;183;80;141;26;84;76;23;49;34;137;30;170;191;113;189;153;66;71;133;166;110;96;140;105;92;15;179;151;194;35;178;39;139;82,8779545351627586690,0.000000
steepest_intra:edges_start:random,99,249198,158994,90204,1,0,70;43;150;176;145;105;31;173;21;73;113;86;135;52;92;25;42;1;28;132;64;182;171;198;34;146;5;27;136;180;48;93;172;142;4;187;76;120;26;118;184;164;140;95;69;119;138;104;159;80;24;126;110;22;121;94;9;38;115;123;44;40;196;81;188;130;46;124;98;8;186;87;128;10;117;51;166;163;133;175;16;20;65;183;84;189;197;47;103;78;19;137;7;185;23;167;79;12;18;91,524198759068280854,0.000000
steepest_intra:edges_start:random,100,267202,163250,103952,1,0,1;166;175;68;153;183;187;113;185;86;89;199;69;131;45;60;177;23;93;76;14;10;138;142;53;156;24;4;174;5;11;149;190;82;140;181;85;137;29;49;26;134;150;90;154;81;84;43;110;13;152;64;66;108;61;161;122;197;59;20;133;129;114;0;144;155;124;55;48;106;98;71;102;173;74;35;12;39;139;100;116;92;9;83;2;194;146;30;148;88;87;67;132;32;198;46;107;25;105;31,4877297413199495384,0.000000
steepest_intra:edges_start:random,101,262710,160847,101863,1,0,1;141;193;88;189;118;38;119;169;117;133;44;136;160;111;83;125;82;103;147;173;128;31;182;142;110;47;165;170;156;89;129;185;187;74;41;22;102;197;46;3;54;48;164;72;4;90;19;114;151;32;40;76;198;132;140;35;159;63;126;69;57;116;60;9;65;80;29;199;30;52;12;33;98;109;135;79;150;153;86;68;134;37;108;196;145;11;171;26;27;78;191;14;56;152;8;144;155;188;180,7199802326128129002,0.000000
steepest_intra:edges_start:random,102,267847,174247,93600,1,0,124;161;58;164;146;125;103;71;128;112;123;16;51;82;5;39;156;36;199;8;108;14;21;139;133;106;13;136;0;46;115;107;37;134;10;59;149;179;177;184;77;169;66;195;63;193;38;132;127;34;90;89;189;64;102;198;40;144;188;163;140;25;45;93;165;97;95;15;50;167;43;181;172;69;168;120;2;119;135;70;84;118;54;155;182;72;94;22;61;29;122;52;171;129;152;145;6;83;183;1,7337856723306625045,0.000000
steepest_intra:edges_start:random,103,275167,177195,97972,1,0,120;191;182;189;102;6;188;105;175;184;117;179;140;149;75;64;103;96;178;50;80;155;190;61;147;131;167;130;37;51;132;150;29;153;23;91;199;122;169;173;39;78;79;135;19;143;116;90;123;197;43;152;35;7;22;193;66;142;161;21;95;85;38;113;100;136;185;5;177;172;156;16;115;92;98;183;139;59;133;57;93;2;145;8;28;76;71;44;54;27;25;77;18;69;88;10;68;86;30;111,2468669032147494459,0.000000
steepest_intra:edges_start:random,104,268363,166919,101444,1,0,5;167;163;112;23;124;121;122;145;159;156;192;79;110;162;28;131;170;85;63;174;2;161;27;115;84;196;108;130;50;43;24;188;61;20;30;16;179;182;143;105;17;129;0;104;194;116;14;125;169;178;89;144;198;38;146;166;40;94;199;123;120;107;69;128;140;8;97;80;148;25;149;70;82;11;74;142;42;44;78;187;158;60;152;118;35;126;83;135;134;102;138;139;193;10;197;37;186;99;117,4678858877002438768,0.000000
steepest_intra:edges_start:random,105,260082,161643,98439,1,0,112;9;154;183;33;193;138;136;143;146;83;198;116;186;44;187;105;76;152;25;55;129;87;177;68;0;141;2;174;13;147;20;125;119;70;194;195;14;107;144;171;179;109;148;84;101;114;52;47;172;21;75;79;34;110;168;153;124;113;65;69;1;36;155;91;40;94;50;182;8;97;150;98;184;3;197;18;32;176;90;132;99;180;80;185;82;64;88;72;38;163;89;4;164;178;158;92;77;160;161,9183029771886525224,0.000000
steepest_intra:edges_start:random,106,247380,150797,96583,1,0,141;91;138;139;103;161;62;89;125;155;82;26;23;175;60;104;65;61;189;191;116;112;110;92;179;10;24;180;4;46;102;75;199;37;111;178;142;176;163;157;47;40;44;19;169;144;74;13;68;20;31;39;121;1;168;129;152;41;58;114;126;153;195;51;160;97;86;55;16;122;172;6;50;105;123;133;135;143;145;184;193;115;3;28;181;186;57;154;132;148;170;71;188;35;197;100;113;124;12;33,6044661235585526435,0.000000
steepest_intra:edges_start:random,107,261816,165650,96166,1,0,23;174;53;173;78;6;155;51;95;40;52;30;179;27;50;154;7;178;135;158;175;127;183;152;134;55;11;82;120;138;32;186;96;66;37;59;153;185;125;172;130;103;171;137;107;147;191;48;112;56;67;146;169;5;54;71;128;60;72;181;76;184;84;90;26;97;131;31;91;39;141;75;118;182;101;57;126;29;165;19;145;80;43;61;123;104;144;197;28;2;34;33;106;0;190;108;139;47;89;25,6459540283094301237,0.000000
steepest_intra:edges_start:random,108,263231,171164,92067,1,0,30;151;73;0;42;172;83;3;63;33;14;192;124;44;19;149;141;101;38;54;186;168;117;79;126;20;177;196;58;188;82;55;93;91;185;184;9;31;108;43;11;105;21;81;148;157;123;143;48;164;115;50;62;6;67;137;150;106;128;171;45;136;57;158;195;49;113;15;114;122;59;120;77;103;144;41;17;176;146;68;35;178;25;70;165;181;36;16;89;61;71;29;161;2;24;131;72;175;28;46,4155734940685039124,0.000000
steepest_intra:edges_start:random,109,258064,159735,98329,1,0,137;199;159;37;180;11;152;75;59;104;124;0;98;156;170;122;99;130;105;74;103;153;188;113;135;66;26;162;80;194;18;197;126;101;118;62;139;87;78;8;141;143;1;69;196;106;191;67;47;145;20;102;155;23;54;92;100;82;142;183;71;149;9;95;160;68;64;24;84;52;121;110;90;133;127;181;123;136;186;61;29;131;72;44;163;91;172;19;177;39;89;195;42;38;13;97;14;158;70;140,3120475425666010847,0.000000
steepest_intra:edges_start:random,110,262188,160784,101404,1,0,1;20;22;95;79;51;170;125;50;126;124;131;76;123;3;196;143;58;176;173;86;111;28;115;197;31;166;42;29;154;155;121;138;18;199;198;93;26;61;127;165;33;19;122;162;10;107;7;23;21;133;130;69;75;168;85;161;169;137;182;151;17;96;32;152;82;102;39;193;144;37;40;8;117;88;185;181;0;35;120;142;119;175;62;55;48;114;110;77;149;113;38;134;164;83;45;27;56;188;101,9192253172830703336,0.000000
steepest_intra:edges_start:random,111,276548,173072,103476,1,0,130;146;111;55;157;50;150;33;136;199;107;28;187;99;116;49;70;69;174;8;67;51;177;36;12;57;118;3;54;169;62;23;88;183;161;79;182;112;180;95;122;175;40;37;181;61;190;194;13;192;26;52;65;31;131;124;35;189;17;186;10;127;24;109;114;73;193;46;119;100;110;42;87;20;133;91;148;44;92;176;74;66;93;43;198;56;30;0;47;16;123;102;103;34;142;83;5;15;105;191,4251192902586318600,0.000000
steepest_intra:edges_start:random,112,274315,170534,103781,1,0,55;193;85;83;153;24;158;192;185;44;126;97;36;186;171;13;163;172;125;95;67;26;155;150;122;38;70;74;76;25;86;92;148;3;94;176;194;102;106;59;75;121;9;88;135;96;93;164;16;183;170;190;15;45;132;177;89;22;58;119;110;123;107;82;21;17;196;47;159;35;30;174;137;149;141;27;184;64;189;4;130;181;152;191;127;131;128;62;51;187;129;20;188;84;142;161;109;48;54;68,5126830344938960622,0.000000
steepest_intra:edges_start:random,113,262680,164308,98372,1,0,166;94;149;174;23;21;172;124;167;143;70;164;118;138;39;120;127;29;178;106;8;160;190;116;16;11;81;15;77;161;125;151;131;177;165;26;92;105;117;10;185;51;73;128;30;69;184;84;67;100;42;68;199;156;79;93;7;24;99;19;139;64;123;187;32;198;75;158;192;142;83;147;18;20;191;103;145;110;175;104;132;27;47;152;56;168;35;159;90;129;141;31;44;13;122;33;43;5;133;0,8583891418597152034,0.000000
steepest_intra:edges_start:random,114,262478,163569,98909,1,0,134;127;95;85;59;141;21;47;155;115;178;10;34;174;45;62;77;8;181;190;83;73;152;184;96;60;35;188;26;58;170;49;124;136;42;33;52;122;76;156;183;74;172;187;38;99;86;48;143;109;159;132;16;167;131;161;173;106;40;18;148;89;37;81;154;102;125;2;123;151;105;44;199;28;94;119;0;70;165;57;25;30;97;79;108;194;111;4;162;179;1;189;153;191;157;19;144;192;9;91,2365955698405969605,0.000000
steepest_intra:edges_start:random,115,263254,171534,91720,1,0,181;179;15;2;138;147;27;136;30;191;97;86;185;192;157;177;53;84;100;26;76;176;60;114;59;195;175;46;72;79;22;172;130;16;132;24;184;93;63;98;64;152;54;124;160;41;178;142;3;9;12;158;94;101;13;119;43;183;90;107;55;159;36;18;137;71;169;40;31;153;127;143;0;122;4;39;120;6;95;66;112;151;196;42;17;89;129;173;85;91;74;14;48;81;45;146;131;125;105;171,572724548910567567,0.000000
steepest_intra:edges_start:random,116,269745,172176,97569,1,0,84;145;4;126;90;100;187;82;42;107;184;103;62;32;113;93;78;169;177;21;133;80;193;46;17;165;136;188;39;195;3;76;123;5;166;102;75;91;13;19;191;130;114;6;73;142;192;146;124;154;179;150;64;99;183;116;129;128;155;131;98;197;1;51;190;152;109;71;65;170;125;164;173;2;171;48;30;111;120;34;25;86;28;104;162;63;115;74;139;151;9;199;22;167;161;15;138;194;143;106,6841149174982511357,0.000000
steepest_intra:edges_start:random,117,268213,173396,94817,1,0,13;198;193;104;155;165;130;30;78;76;25;141;146;173;71;177;77;63;68;112;199;100;0;65;188;61;127;20;94;126;42;181;14;86;175;46;43;179;119;133;124;89;57;187;93;134;51;34;117;39;170;97;180;18;73;194;47;56;36;143;6;128;35;192;149;178;72;135;79;172;123;64;48;196;184;142;171;189;27;50;103;176;52;151;148;156;15;154;158;88;144;26;161;29;163;69;160;183;4;11,2533907936221318702,0.000000
steepest_intra:edges_start:random,118,257274,160946,96328,1,0,53;195;130;85;87;161;136;94;143;38;107;89;184;117;132;145;185;134;191;188;176;197;55;144;74;65;139;70;93;54;73;104;166;154;1;39;42;80;179;121;69;28;198;88;173;131;102;10;141;63;59;116;24;150;155;76;122;164;142;20;36;86;75;187;152;172;148;92;6;110;183;127;72;193;22;196;23;79;124;160;51;106;48;99;18;17;108;84;126;30;153;171;192;16;2;129;46;52;189;35,3207053749112569890,0.000000
steepest_intra:edges_start:random,119,280063,178514,101549,1,0,152;196;25;23;198;63;100;141;157;166;168;56;109;80;106;69;83;135;32;81;45;177;134;159;19;105;20;112;40;170;10;164;74;121;139;136;48;120;37;189;46;39;118;34;149;101;147;178;6;1;5;0;137;169;24;111;114;4;73;150;43;89;191;52;79;158;29;175;140;60;126;138;127;28;197;11;97;44;179;107;146;90;30;87;76;57;35;188;94;163;15;49;110;3;7;58;31;104;26;18,1857744220229531266,0.000000
steepest_intra:edges_start:random,120,255662,155435,100227,1,0,179;189;83;3;73;99;60;198;166;170;196;168;128;12;66;190;140;145;125;17;48;55;8;26;182;109;117;4;184;88;59;94;54;77;65;13;64;31;58;161;67;185;9;76;96;75;46;197;90;14;146;116;20;152;147;61;158;174;18;148;89;144;0;176;183;70;124;136;178;5;192;137;133;33;122;56;164;121;40;130;47;39;112;155;29;118;162;119;27;120;186;78;41;191;172;1;7;154;173;25,14543234375985913,0.000000
steepest_intra:edges_start:random,121,240106,153261,86845,1,0,191;87;32;189;159;104;60;122;80;179;176;70;75;49;98;161;151;157;158;153;193;172;30;56;29;149;52;69;0;10;74;65;192;116;102;23;135;9;41;146;152;62;154;61;178;167;194;88;112;18;20;22;197;118;73;130;186;123;99;134;24;162;140;148;120;58;97;46;113;180;53;106;163;115;1;79;133;67;196;183;165;190;31;125;94;82;137;78;100;35;15;139;28;131;155;3;47;181;8;185,1338846405333640862,0.000000
steepest_intra:edges_start:random,122,255600,157452,98148,1,0,4;144;113;195;61;73;185;125;155;20;60;89;68;1;171;159;66;62;24;2;197;33;154;63;151;69;45;139;130;42;44;47;179;117;173;14;163;180;19;76;9;160;177;161;95;83;148;166;55;71;82;86;31;106;132;129;194;115;136;108;116;54;153;25;29;156;119;174;65;28;74;127;181;142;5;198;8;133;41;192;70;124;36;165;53;110;190;109;10;77;22;88;38;169;30;168;15;79;52;75,3389886902867082433,0.000000
steepest_intra:edges_start:random,123,259368,161771,97597,1,0,121;139;133;89;164;36;142;0;148;96;144;128;98;17;184;54;118;7;163;13;40;162;3;135;80;32;186;172;124;187;16;31;24;150;47;76;110;189;113;14;152;169;18;134;93;165;85;38;178;149;33;173;56;199;175;15;157;73;131;57;102;180;196;65;105;77;83;129;160;122;21;72;106;10;23;132;151;53;119;155;195;91;82;197;146;145;153;60;35;159;194;127;44;192;22;117;156;130;143;101,8415432508188226185,0.000000
steepest_intra:edges_start:random,124,249193,157065,92128,1,0,184;116;143;106;136;95;155;157;138;34;152;194;159;190;50;44;63;81;84;147;172;117;29;5;27;115;175;35;168;26;131;22;161;179;96;49;118;10;108;93;196;148;94;119;51;38;165;99;19;166;97;65;18;195;53;130;154;128;0;88;113;6;80;199;47;169;163;78;122;92;170;123;151;100;46;11;30;182;124;1;16;62;125;158;133;82;153;17;7;129;149;60;176;150;74;146;134;140;139;189,2520253652829179661,0.000000
steepest_intra:edges_start:random,125,267448,169227,98221,1,0,174;0;52;38;135;3;146;124;195;61;108;105;198;152;72;8;42;114;91;27;12;86;159;66;54;153;1;59;98;170;110;179;109;113;17;156;133;184;142;101;53;89;20;143;81;164;176;139;88;189;169;35;64;76;56;51;43;48;167;180;111;125;154;181;106;32;115;131;34;55;82;93;41;15;2;178;129;71;119;155;29;132;4;33;107;158;10;26;95;36;160;67;30;99;137;57;126;14;128;31,1655908925471119722,0.000000
steepest_intra:edges_start:random,126,264980,167233,97747,1,0,21;14;139;4;97;13;196;69;67;138;173;16;153;24;181;175;6;161;189;56;105;178;113;40;133;183;95;129;26;124;193;162;53;130;20;73;68;111;0;94;118;27;48;159;9;71;51;88;160;166;79;65;149;121;125;106;169;62;50;34;128;150;132;114;147;187;100;198;140;86;39;45;28;135;137;120;11;58;60;199;61;107;109;75;41;15;117;188;122;182;33;42;23;170;96;180;84;131;144;115,1904360067781338750,0.000000
steepest_intra:edges_start:random,127,264193,163225,100968,1,0,55;186;41;89;191;124;176;13;8;164;126;161;121;12;66;152;52;195;29;101;107;51;0;172;74;192;146;182;2;168;110;21;65;187;14;125;82;57;119;76;22;165;114;6;102;174;199;136;137;77;24;99;9;103;178;155;53;179;91;20;188;183;111;156;190;90;16;78;92;61;170;32;122;7;194;94;138;87;104;86;159;196;97;72;10;163;133;115;95;189;129;167;177;88;118;18;120;70;54;112,1191326039239156728,0.000000
steepest_intra:edges_start:random,128,276354,170598,105756,1,0,162;157;56;47;54;4;125;83;119;184;8;87;107;151;116;27;170;88;14;3;103;85;90;16;93;52;121;60;58;48;99;133;106;38;139;100;23;180;150;156;147;42;113;78;141;72;12;149;173;80;191;172;165;24;118;76;86;15;71;57;36;122;74;70;43;46;179;127;64;101;28;148;111;32;104;187;6;5;185;79;155;195;96;109;146;69;112;84;25;33;51;130;108;171;13;18;197;164;134;190,313317684878306764,0.000000
steepest_intra:edges_start:random,129,264504,165615,98889,1,0,188;134;71;176;126;36;190;18;130;148;79;8;109;89;151;73;183;139;168;26;164;61;115;10;2;185;192;169;131;152;40;70;49;53;184;98;45;137;181;167;14;75;84;194;24;64;195;170;22;51;177;198;108;7;100;60;103;32;122;29;136;4;88;186;150;11;46;59;62;110;104;37;19;81;120;125;80;0;114;191;111;146;58;112;106;39;124;153;15;142;69;129;90;13;55;3;78;174;189;172,391098775173194518,0.000000
steepest_intra:edges_start:random,130,266308,172227,94081,1,0,55;175;126;124;110;76;164;116;105;7;21;49;161;107;151;73;174;3;171;8;150;6;184;52;162;139;22;74;149;30;85;37;120;86;65;95;140;132;33;41;27;100;193;70;10;190;137;81;63;131;136;1;159;50;35;138;148;181;48;198;123;106;45;134;68;4;129;113;153;54;14;191;173;26;188;71;160;102;80;187;57;189;186;72;176;112;104;197;179;20;119;66;96;78;118;34;18;39;99;25,1253861610286833571,0.000000
steepest_intra:edges_start:random,131,275461,171132,104329,1,0,176;178;54;172;192;179;125;1;89;173;35;138;182;168;80;197;185;110;165;56;112;158;187;92;69;177;18;131;174;129;114;75;95;46;79;4;124;47;162;64;127;146;121;105;42;55;60;143;195;157;141;17;30;108;167;126;191;133;140;87;155;102;128;132;109;50;23;2;11;21;193;151;170;45;136;94;53;119;20;74;130;147;59;76;29;116;12;62;81;7;156;196;13;88;161;113;65;70;41;99,506997766058084681,0.000000
steepest_intra:edges_start:random,132,268674,171928,96746,1,0,163;53;168;162;48;75;9;136;109;45;167;185;122;24;39;106;130;152;72;142;86;177;137;100;198;76;44;143;134;37;34;70;33;127;5;193;95;36;115;91;175;59;119;60;166;108;64;94;92;7;107;126;153;140;116;96;25;173;68;73;4;29;121;104;157;18;139;10;62;51;171;13;63;84;151;183;192;101;159;50;81;58;176;40;87;132;66;179;103;178;99;98;146;89;71;57;31;181;194;8,6706835067736046446,0.000000
steepest_intra:edges_start:random,133,271678,170369,101309,1,0,1;87;34;80;90;48;32;43;65;66;169;131;63;119;83;145;175;39;28;123;136;142;10;19;155;149;96;117;72;134;97;8;22;188;115;160;56;71;114;49;98;18;17;177;89;187;77;128;6;100;162;141;70;78;199;197;67;105;171;76;54;152;13;88;140;60;35;104;47;189;150;94;16;102;15;147;61;170;144;55;148;99;30;101;167;45;81;53;11;143;91;12;137;176;37;108;133;69;186;95,8592022579361246114,0.000000
steepest_intra:edges_start:random,134,258535,164397,94138,1,0,170;136;39;1;141;190;51;188;171;79;65;195;156;131;83;139;59;41;163;99;26;76;84;43;182;149;54;112;179;28;7;152;166;61;18;106;80;66;199;30;157;75;148;197;108;62;42;102;165;35;0;56;9;68;192;117;4;52;21;159;184;25;49;128;138;120;105;133;34;191;63;181;71;37;20;36;10;126;103;176;93;40;58;193;185;16;50;144;169;142;122;174;140;13;155;145;172;29;125;69,6830533938213264533,0.000000
steepest_intra:edges_start:random,135,249643,154801,94842,1,0,154;187;84;80;186;99;51;165;54;155;145;143;128;11;104;33;60;85;62;122;167;0;94;140;132;170;190;97;47;49;193;179;138;91;183;148;151;5;198;121;101;172;95;74;9;120;113;16;2;144;181;112;108;3;82;27;25;185;76;174;152;48;177;157;83;52;146;68;69;24;22;194;98;78;141;100;90;110;133;116;10;149;125;46;92;168;115;70;32;56;87;162;102;114;45;124;36;147;103;29,6990634087063171497,0.000000
steepest_intra:edges_start:random,136,267612,165786,101826,1,0,80;6;182;180;12;96;100;187;81;95;38;25;93;122;110;102;34;70;49;74;99;163;61;48;53;7;44;156;177;172;42;123;185;161;141;175;146;164;148;129;149;3;139;33;54;196;160;76;108;192;91;98;83;57;135;117;199;125;128;152;73;130;5;121;167;101;190;79;68;127;173;11;134;18;50;24;27;21;26;82;114;86;137;193;104;197;136;92;113;36;189;32;120;88;143;23;106;77;150;67,446057347162874604,0.000000
steepest_intra:edges_start:random,137,259537,167032,92505,1,0,98;172;56;177;99;19;187;8;24;46;51;198;61;49;94;41;11;60;128;84;30;77;57;85;199;103;122;165;174;189;135;25;76;18;42;150;140;193;62;28;115;164;26;149;178;184;23;142;100;70;147;37;176;163;182;145;43;5;133;108;71;154;185;110;139;92;166;180;134;97;3;127;7;181;55;183;95;35;159;93;65;167;86;38;104;69;162;117;48;130;121;27;123;16;119;125;131;15;40;175,272418057660097618,0.000000
steepest_intra:edges_start:random,138,269060,174382,94678,1,0,71;50;73;70;24;139;97;11;82;36;161;131;168;123;129;136;110;116;101;13;9;169;178;1;7;75;163;132;26;54;0;30;184;15;140;175;133;143;14;186;102;109;113;64;45;141;198;196;190;157;79;39;137;103;72;106;29;40;55;89;3;145;120;179;167;78;156;34;91;47;160;188;180;165;153;144;18;134;37;166;95;19;59;187;10;63;61;176;99;93;154;57;152;104;195;28;17;98;41;130,601762119054229306,0.000000
steepest_intra:edges_start:random,139,267230,166581,100649,1,0,92;167;102;11;38;139;198;50;44;26;145;195;109;150;15;130;66;166;57;2;93;61;31;160;76;126;142;161;154;158;3;72;13;42;190;19;147;94;79;180;108;32;122;176;141;39;111;91;36;7;104;14;71;192;100;133;98;164;10;87;49;132;107;52;159;60;0;55;136;119;105;43;53;82;97;58;140;77;187;28;85;144;46;51;193;20;56;99;117;62;95;114;112;152;137;63;29;18;165;40,2718565872685864066,0.000000
steepest_intra:edges_start:random,140,281349,186990,94359,1,0,31;76;145;122;34;101;109;184;10;117;113;149;158;104;193;75;38;89;60;4;168;92;107;123;30;39;62;22;82;69;47;143;163;15;42;140;161;51;103;90;11;94;97;119;9;37;173;142;21;13;95;115;53;1;65;127;177;44;20;85;36;106;16;191;199;195;190;183;174;70;5;128;86;187;175;18;87;118;84;74;49;58;56;108;2;6;198;179;73;78;7;135;66;100;147;8;48;61;134;126,8799618155586454673,0.000000
steepest_intra:edges_start:random,141,273856,167305,106551,1,0,188;28;141;57;71;112;35;145;1;166;136;135;158;10;184;76;146;90;119;108;109;74;27;58;20;69;173;156;117;125;163;197;82;64;190;99;143;65;39;130;155;50;70;162;129;21;62;40;115;56;106;157;138;161;195;182;25;26;147;128;172;68;13;105;193;124;66;24;91;53;186;9;116;103;83;98;30;43;194;149;170;110;31;165;168;148;152;178;88;5;81;154;8;38;192;2;139;104;118;67,1214360379569877741,0.000000
steepest_intra:edges_start:random,142,253686,150348,103338,1,0,53;10;30;94;126;0;24;23;196;56;50;76;124;75;183;159;82;156;186;100;123;68;48;181;27;104;3;58;109;101;51;5;42;38;170;158;168;117;161;190;189;98;65;63;99;140;74;152;62;138;118;178;119;120;111;79;33;191;174;173;32;193;184;105;77;95;21;139;47;97;37;132;167;80;121;19;142;153;96;87;91;60;192;129;185;197;145;141;84;29;135;55;133;198;72;61;28;34;35;13,4228272608425597442,0.000000
steepest_intra:edges_start:random,143,259838,166810,93028,1,0,133;43;180;144;94;140;102;143;173;170;0;4;97;100;111;74;46;45;194;91;2;158;191;88;185;198;184;37;72;164;129;138;197;146;19;20;159;161;128;116;35;7;145;83;26;114;90;39;15;120;192;61;42;125;25;53;188;117;137;127;167;17;190;55;49;36;27;118;139;95;52;141;21;135;177;5;86;108;79;84;131;71;119;130;8;179;126;54;113;107;59;134;9;22;82;132;18;160;154;178,7545978320123599180,0.000000
steepest_intra:edges_start:random,144,274056,172729,101327,1,0,15;142;52;77;8;83;57;175;50;81;58;137;121;174;20;107;66;188;193;21;89;149;23;104;6;197;153;5;144;152;163;126;98;179;114;65;109;73;2;84;136;86;156;105;110;79;154;117;125;167;170;40;131;3;168;146;177;61;70;35;13;145;37;95;159;186;184;94;135;0;12;60;43;1;128;36;111;191;74;22;161;130;10;102;93;91;54;17;151;162;55;182;49;180;106;64;123;116;160;164,8820352935926972554,0.000000
steepest_intra:edges_start:random,145,265337,167352,97985,1,0,106;62;56;96;33;50;153;136;198;160;168;188;28;44;109;150;26;84;115;190;64;61;82;166;98;163;49;38;14;8;41;174;144;118;116;162;128;31;180;52;67;10;32;59;16;4;20;140;161;101;37;158;25;178;149;131;78;107;7;156;120;88;159;79;146;90;0;75;85;86;48;187;127;108;199;164;114;169;182;133;105;15;176;143;181;191;29;77;151;173;139;141;97;171;132;66;102;112;65;72,1037147848787594247,0.000000
steepest_intra:edges_start:random,146,269693,169453,100240,1,0,31;113;80;72;96;198;55;199;5;78;76;35;7;144;93;156;73;136;17;0;127;53;56;139;186;170;114;29;20;54;28;107;150;41;121;71;14;122;15;126;132;180;154;69;38;25;130;19;135;153;91;134;98;109;118;133;8;129;70;143;188;16;86;85;23;27;65;48;10;37;46;75;32;79;140;183;95;81;117;30;148;175;24;141;45;158;94;146;157;110;105;51;47;164;166;6;100;43;147;131,5963554972292325544,0.000000
steepest_intra:edges_start:random,147,267647,168252,99395,1,0,123;147;21;124;43;96;143;67;9;73;129;12;38;163;57;0;88;53;59;10;22;160;6;161;75;110;69;95;74;106;50;61;156;182;8;171;3;115;125;174;41;180;32;153;112;20;40;89;192;93;166;56;27;142;34;85;16;62;72;65;138;84;68;117;42;149;152;144;23;162;15;52;55;158;134;178;17;60;111;31;151;132;141;126;78;159;24;121;148;177;118;146;155;172;116;99;108;83;28;7,4679248497862926092,0.000000
steepest_intra:edges_start:random,148,281571,183462,98109,1,0,126;78;79;45;140;195;29;102;164;72;31;108;71;11;91;20;162;157;199;104;90;98;105;106;41;48;107;155;54;159;99;34;177;131;122;9;147;36;10;23;125;94;116;188;5;68;100;175;198;37;154;16;158;145;25;178;193;55;32;179;139;141;180;12;26;13;77;189;142;73;7;24;124;96;172;185;83;18;133;169;129;143;40;14;74;88;62;103;127;146;52;165;112;152;58;109;67;70;183;61,550308920272805417,0.000000
steepest_intra:edges_start:random,149,250566,151887,98679,1,0,75;46;116;137;161;22;74;189;40;87;61;106;165;105;131;146;3;12;14;56;37;11;164;55;104;59;2;77;48;150;95;195;190;144;166;58;145;192;160;24;45;63;33;88;101;90;134;51;186;188;151;143;69;199;47;181;163;193;135;27;127;123;66;64;115;100;171;114;17;57;30;62;23;172;119;138;25;79;141;168;18;120;32;70;72;8;68;153;6;15;9;147;159;43;102;132;5;112;126;136,5758899343805279950,0.000000
steepest_intra:edges_start:random,150,249907,159207,90700,1,0,131;5;180;108;143;23;121;144;37;69;3;185;88;40;42;2;84;47;171;78;70;187;102;89;80;113;194;43;53;7;152;125;19;4;30;8;122;20;9;6;72;160;34;38;197;190;36;173;79;140;159;14;55;132;139;52;62;82;184;155;115;65;195;172;106;111;123;181;10;183;136;193;162;179;192;169;99;199;174;101;110;127;138;58;27;128;33;133;61;100;77;175;109;11;44;137;165;15;85;75,4528449863386370400,0.000000
steepest_intra:edges_start:random,151,269229,171850,97379,1,0,169;143;142;66;154;113;55;111;145;5;170;72;23;128;52;103;37;93;85;184;177;156;120;104;171;45;130;165;62;150;146;153;149;40;64;121;82;6;43;189;122;161;115;39;164;44;182;159;88;101;73;27;91;41;38;160;179;123;36;106;127;13;83;141;4;47;2;24;54;34;15;21;32;137;131;75;58;144;118;81;42;3;7;50;99;1;112;20;181;148;155;186;63;108;71;134;16;22;96;33,831357924376707251,0.000000
steepest_intra:edges_start:random,152,255973,161546,94427,1,0,53;177;157;7;183;191;113;39;4;21;104;86;185;103;72;43;184;65;68;196;150;97;127;106;1;156;171;57;10;15;173;12;44;3;52;176;122;195;67;0;6;197;119;24;16;75;145;190;71;138;131;110;23;19;101;178;193;45;146;136;133;189;181;70;77;59;38;55;142;159;152;180;167;33;47;50;170;137;34;151;134;128;61;172;60;164;58;30;147;117;90;100;11;188;144;99;25;37;32;78,5443850677491040938,0.000000
steepest_intra:edges_start:random,153,265417,166266,99151,1,0,93;157;199;106;69;197;47;175;161;142;113;76;70;27;92;87;136;112;133;137;16;54;48;176;26;140;116;119;51;52;64;100;192;72;85;21;141;156;159;4;63;182;29;150;130;97;35;127;172;37;60;38;145;178;184;22;169;25;81;109;24;62;66;139;171;95;134;18;135;158;148;131;198;31;9;10;19;164;41;91;56;174;11;83;3;104;146;183;121;13;33;193;82;186;79;103;30;195;147;162,6831602671827776845,0.000000
steepest_intra:edges_start:random,154,263416,171333,92083,1,0,91;29;12;68;92;110;88;8;177;139;144;191;129;124;104;95;179;54;159;165;25;73;149;93;134;90;36;21;125;136;187;147;13;57;137;145;138;100;135;101;170;85;103;146;106;175;61;52;46;118;65;42;119;131;161;18;94;123;26;2;49;97;111;140;11;39;99;50;15;70;84;22;194;117;183;24;6;151;78;122;3;28;143;108;45;173;40;121;76;59;31;86;176;102;17;197;63;75;193;199,6278069112804020763,0.000000
steepest_intra:edges_start:random,155,255403,158872,96531,1,0,44;14;105;129;119;68;63;75;83;162;95;54;174;90;111;52;172;12;151;132;154;87;164;85;42;20;59;141;0;53;130;45;179;41;88;81;67;32;73;195;18;33;4;104;178;101;124;138;43;183;185;192;80;16;98;150;166;5;159;116;102;169;145;34;120;156;103;157;126;3;146;191;89;149;35;51;93;136;135;199;182;11;112;181;6;40;107;7;55;160;143;117;82;84;161;190;122;60;97;158,4485837785747142382,0.000000
steepest_intra:edges_start:random,156,279406,179071,100335,1,0,37;68;54;44;181;108;176;80;35;58;174;48;72;143;126;139;79;104;90;7;192;157;26;1;198;158;102;119;20;190;165;60;34;130;187;74;133;86;92;38;70;128;16;177;36;45;142;28;168;82;115;164;138;141;9;96;56;6;64;116;62;171;114;131;43;196;42;166;150;11;179;194;97;173;18;17;106;147;85;132;199;46;105;110;135;149;93;88;98;50;83;123;52;40;193;8;151;111;160;183,8405647387226196930,0.000000
steepest_intra:edges_start:random,157,271363,170557,100806,1,0,134;20;113;58;47;154;121;195;86;138;18;26;32;13;122;186;147;67;110;78;164;4;132;39;82;179;97;85;71;180;140;177;116;64;21;61;81;187;73;79;74;199;88;12;129;54;189;103;30;17;84;190;182;160;63;101;198;60;137;197;178;94;188;157;150;196;42;155;142;193;14;89;115;2;31;133;56;46;66;171;107;68;69;149;34;55;27;53;105;127;62;158;83;130;159;8;192;168;15;194,3171298918457588180,0.000000
steepest_intra:edges_start:random,158,271621,179616,92005,1,0,164;59;50;28;119;180;39;77;165;64;137;192;112;61;178;103;195;190;20;90;146;168;188;158;172;163;82;199;8;44;120;193;174;29;51;83;72;177;3;86;144;62;114;99;196;121;16;176;159;17;63;70;92;194;107;97;14;136;45;40;31;9;105;117;58;76;139;32;30;129;54;173;12;43;108;118;35;140;55;138;124;116;181;41;145;85;175;15;166;87;153;113;27;38;81;22;18;94;152;34,338172680680158103,0.000000
steepest_intra:edges_start:random,159,282714,182871,99843,1,0,146;71;14;181;27;115;49;158;155;134;162;114;178;5;132;151;95;29;55;13;37;30;170;124;138;173;31;35;93;6;85;117;87;188;176;89;92;10;67;33;72;56;101;23;47;189;160;60;39;122;104;51;15;11;142;172;123;42;161;145;128;21;109;136;193;94;83;40;0;16;195;135;153;127;152;9;150;70;8;119;22;100;61;63;38;20;99;199;19;175;53;165;36;168;120;52;186;59;48;147,6277576488171595094,0.000000
steepest_intra:edges_start:random,160,270584,174966,95618,1,0,187;112;185;118;179;37;89;136;193;171;28;175;90;31;110;157;150;46;166;24;184;152;177;130;63;85;121;104;22;58;5;16;134;14;107;0;52;18;86;1;165;74;126;2;27;17;78;30;87;139;125;197;13;75;188;111;116;6;147;142;169;25;57;160;8;135;4;181;69;42;123;167;128;195;127;11;189;140;146;138;120;79;190;105;66;149;48;84;172;156;122;40;176;183;141;191;196;164;39;143,6742453503162059339,0.000000
steepest_intra:edges_start:random,161,266589,169444,97145,1,0,105;71;119;70;162;140;34;47;94;143;24;92;77;176;177;107;112;110;37;101;78;97;15;132;84;3;28;133;131;1;72;150;104;88;125;42;187;9;175;144;113;49;89;25;193;36;53;167;32;59;127;68;83;29;0;65;43;76;161;48;2;147;154;129;55;194;114;159;170;54;61;86;40;138;169;146;173;74;172;137;75;95;60;186;31;156;134;39;99;82;141;80;179;108;118;188;52;163;56;178,4096890151908837968,0.000000
steepest_intra:edges_start:random,162,264366,168196,96170,1,0,141;10;48;112;82;165;149;23;171;59;184;64;73;67;89;84;131;40;166;189;122;46;51;61;57;22;70;45;55;172;3;111;186;194;195;134;15;104;116;117;49;146;137;71;37;173;138;108;142;9;79;198;74;5;38;113;78;109;60;190;18;162;157;105;21;185;47;39;95;182;36;72;69;41;174;145;43;30;8;191;63;97;177;153;75;183;150;85;20;154;147;155;26;80;143;13;140;86;34;160,4410306970872233627,0.000000
steepest_intra:edges_start:random,163,253430,157841,95589,1,0,66;54;194;42;94;162;37;38;97;88;39;43;170;182;153;145;17;143;118;141;36;52;144;87;25;139;108;79;132;116;102;62;197;164;9;161;40;184;83;149;103;77;126;163;169;154;152;179;183;67;18;7;2;53;188;74;31;95;110;84;171;155;115;70;176;177;92;14;76;58;138;91;198;63;16;174;45;187;72;172;186;27;55;68;104;158;189;11;85;49;15;140;159;71;90;57;73;30;193;131,8820429533440362488,0.000000
steepest_intra:edges_start:random,164,246213,155652,90561,1,0,72;16;7;163;89;63;118;67;164;147;61;43;166;190;18;1;48;80;129;17;107;56;47;2;53;9;127;181;40;157;106;156;65;185;132;169;120;85;58;167;60;13;150;128;68;109;111;151;22;133;138;84;192;158;98;59;108;191;152;76;12;117;176;115;197;70;21;141;123;94;11;183;145;24;51;162;75;170;137;100;4;165;135;139;57;79;119;26;178;92;96;184;41;104;122;46;124;29;121;38,7589472215351505858,0.000000
steepest_intra:edges_start:random,165,264055,166567,97488,1,0,125;21;106;116;199;49;62;175;11;142;53;113;135;179;155;25;170;114;185;94;67;71;65;147;12;105;76;150;119;144;188;109;46;136;27;42;73;129;88;32;17;5;86;22;173;160;101;169;31;196;83;115;171;138;128;1;166;111;13;197;57;121;9;178;117;127;84;132;30;161;2;131;58;80;43;146;108;37;66;87;102;137;195;103;59;174;90;152;181;14;29;124;40;140;89;68;38;93;110;96,3638042625425786757,0.000000
steepest_intra:edges_start:random,166,282890,183103,99787,1,0,138;82;172;176;30;126;185;9;125;171;72;157;87;64;118;3;65;191;40;149;161;152;10;16;107;153;55;48;88;129;37;56;166;144;195;5;119;178;131;61;186;167;182;165;156;128;181;127;44;28;70;47;12;113;42;168;141;2;51;25;159;174;54;189;196;63;20;67;114;158;13;0;148;69;133;115;175;41;99;35;97;76;194;68;110;173;146;100;198;21;123;81;79;31;170;4;59;6;38;188,2093491391021708777,0.000000
steepest_intra:edges_start:random,167,274442,175573,98869,1,0,96;164;161;23;172;183;29;120;95;5;7;51;180;158;174;50;156;107;141;104;86;176;133;71;163;154;46;20;117;68;105;87;185;111;66;79;0;122;102;119;32;118;151;36;13;90;127;166;33;10;103;73;1;59;123;198;129;131;76;53;42;165;24;175;146;108;16;184;47;142;18;57;125;89;138;28;186;56;8;58;160;52;84;25;177;69;70;167;153;134;17;98;115;155;60;100;130;62;14;110,6623640306502508719,0.000000
steepest_intra:edges_start:random,168,265215,166986,98229,1,0,167;25;196;59;108;113;102;123;198;69;136;121;129;141;62;75;190;88;84;143;110;148;85;47;4;1;83;140;61;119;150;166;134;0;156;112;104;7;135;149;34;154;128;70;146;79;132;127;192;42;60;98;178;64;18;165;188;101;20;177;199;3;111;137;29;159;147;78;82;53;92;10;71;139;63;30;114;144;41;126;31;67;155;51;195;50;109;94;186;72;91;124;142;191;133;12;21;36;176;32,6651643144243841983,0.000000
steepest_intra:edges_start:random,169,272671,178177,94494,1,0,127;75;40;96;28;90;43;154;121;29;170;164;158;2;162;1;99;53;166;84;129;65;88;151;87;188;178;194;123;24;140;102;195;77;191;109;76;152;48;106;185;80;198;100;26;157;115;16;104;50;34;135;167;79;60;17;54;108;130;179;12;25;93;32;22;113;83;153;174;197;78;5;116;97;91;20;189;49;45;176;47;18;131;59;11;70;103;56;62;124;141;57;69;64;159;73;156;55;42;98,3434207594823439779,0.000000
steepest_intra:edges_start:random,170,266606,173210,93396,1,0,67;153;165;65;166;86;154;177;167;69;38;56;16;162;103;2;189;116;94;31;100;96;113;60;147;97;198;194;158;106;181;47;74;87;7;126;191;18;149;128;140;45;25;160;129;127;132;77;41;136;36;125;10;51;122;17;134;80;5;142;34;39;40;1;180;9;59;171;91;190;157;54;109;70;151;35;188;46;172;123;75;73;29;53;92;118;64;108;164;50;57;88;49;89;182;44;101;21;114;81,1519033303339184499,0.000000
steepest_intra:edges_start:random,171,260290,159612,100678,1,0,136;102;31;148;118;112;182;70;93;177;81;17;150;109;103;97;82;197;48;122;129;33;96;174;154;52;44;1;18;95;194;11;141;140;87;3;170;155;72;59;8;77;91;185;190;104;22;76;198;173;64;156;149;142;86;146;4;178;162;159;114;74;49;6;89;193;167;131;179;152;133;42;23;83;16;66;35;184;60;88;108;186;71;98;24;45;65;132;94;27;191;20;127;115;90;56;106;80;38;180,883875044024141662,0.000000
steepest_intra:edges_start:random,172,251286,158223,93063,1,0,56;63;70;181;75;10;157;176;1;61;158;86;66;192;34;74;93;15;132;9;3;65;179;169;117;197;113;124;190;33;44;149;99;6;29;4;188;0;171;161;199;137;155;116;14;24;194;170;107;27;95;125;118;163;100;151;175;73;164;111;36;46;162;49;37;173;85;91;153;160;165;39;150;144;78;102;154;23;35;126;115;54;25;186;112;145;89;19;41;59;62;97;77;129;32;178;193;148;195;105,8525939054539895053,0.000000
steepest_intra:edges_start:random,173,252140,156932,95208,1,0,138;8;39;145;61;146;60;127;80;117;131;136;115;133;16;120;101;123;31;114;27;108;197;19;51;49;79;46;143;59;33;64;175;50;139;45;75;189;63;28;4;155;35;178;83;174;137;191;47;193;57;181;130;172;15;162;163;95;69;36;135;144;0;20;161;166;151;90;2;70;126;110;128;122;37;17;87;109;7;26;25;99;10;1;196;71;77;52;198;129;199;165;93;104;141;56;42;121;119;94,924271300925452129,0.000000
steepest_intra:edges_start:random,174,267815,166392,101423,1,0,129;37;158;76;86;173;191;28;114;178;121;82;52;5;15;192;116;179;27;153;146;118;117;17;29;163;128;134;100;169;48;6;197;183;69;195;199;97;70;172;44;63;125;40;12;3;62;180;10;71;119;61;103;143;20;102;159;133;91;148;110;46;78;149;66;81;167;120;156;55;47;38;160;68;109;101;54;22;122;188;194;92;11;33;93;166;157;90;162;198;111;141;174;164;77;35;94;0;21;151,2904597864667170045,0.000000
steepest_intra:edges_start:random,175,257187,157131,100056,1,0,47;150;42;7;169;37;130;171;126;41;68;101;85;87;134;191;76;46;187;155;153;103;60;32;122;197;145;27;33;12;57;131;137;65;173;19;38;183;21;64;156;129;163;192;188;119;14;56;95;23;125;174;186;29;49;79;104;148;63;89;112;70;117;81;138;90;54;48;167;15;176;144;11;123;132;22;55;114;110;152;107;44;25;59;199;180;93;128;6;10;34;189;111;45;62;80;151;108;3;193,744739742367268132,0.000000
steepest_intra:edges_start:random,176,255310,160998,94312,1,0,126;98;161;55;106;40;76;112;122;133;177;196;39;47;18;145;150;93;94;152;2;70;71;14;69;188;16;129;74;165;88;100;59;73;140;186;102;166;66;28;50;52;108;15;198;176;9;136;180;44;184;183;123;58;178;197;193;103;173;30;128;105;85;24;148;1;49;36;149;114;68;117;116;132;60;12;110;3;22;179;75;82;169;125;21;155;43;181;163;53;95;42;101;79;153;62;64;17;27;142,2559333112247969874,0.000000
steepest_intra:edges_start:random,177,256809,159866,96943,1,0,96;107;23;70;146;7;187;193;89;190;173;50;157;97;85;145;21;65;35;105;136;20;109;78;56;133;134;144;24;26;5;182;184;140;41;61;95;48;164;31;72;98;19;123;74;195;90;63;150;177;118;158;169;198;178;170;80;73;16;152;17;71;3;191;32;6;45;1;122;124;12;99;47;29;176;116;162;27;39;117;66;131;11;82;175;44;102;148;185;64;52;92;112;183;142;34;54;49;51;38,6907720010698621398,0.000000
steepest_intra:edges_start:random,178,273367,171089,102278,1,0,66;101;114;91;193;36;6;92;111;119;16;9;175;12;134;49;53;157;30;61;27;143;190;59;73;85;171;177;19;142;21;42;11;166;39;135;35;71;82;22;62;99;144;195;147;125;43;167;68;116;156;18;25;150;72;152;105;83;174;180;158;88;173;159;95;126;98;165;122;2;131;189;155;78;67;128;14;115;102;109;178;57;124;81;168;63;33;154;60;110;172;198;100;141;183;5;10;32;75;87,276867593962576151,0.000000
steepest_intra:edges_start:random,179,256162,157533,98629,1,0,167;64;177;61;150;183;88;46;157;148;132;91;74;156;24;40;65;75;34;26;117;126;142;102;79;131;180;181;100;106;113;53;149;193;182;69;8;196;188;21;0;71;119;176;62;66;136;67;195;155;36;87;178;97;174;28;89;54;5;146;77;94;68;83;96;23;103;105;138;63;49;121;186;172;82;3;32;198;6;37;111;189;16;124;70;59;166;31;35;108;109;12;164;45;27;159;184;152;2;114,3727248077061996237,0.000000
steepest_intra:edges_start:random,180,250655,159308,91347,1,0,124;49;30;130;184;106;17;9;114;126;157;81;186;189;63;77;197;107;180;168;53;35;80;188;133;162;68;55;142;171;2;190;45;52;109;42;50;86;15;175;22;153;18;97;144;41;62;193;78;167;44;155;46;34;60;191;117;24;31;33;70;48;115;158;4;1;36;82;139;79;183;136;151;159;170;95;27;75;165;137;163;69;25;179;11;198;161;128;90;37;66;3;19;156;99;14;72;111;8;172,8076288032130921737,0.000000
steepest_intra:edges_start:random,181,288036,183136,104900,1,0,80;118;46;124;157;19;169;172;160;140;87;79;170;194;43;27;148;49;180;34;158;188;166;167;18;138;173;137;53;120;33;190;7;186;69;90;168;104;54;32;16;149;74;161;182;50;163;24;28;145;132;35;89;14;179;198;39;45;56;193;165;37;116;153;65;6;134;121;17;57;60;84;107;133;67;3;192;111;117;83;31;101;197;144;174;61;131;189;64;181;159;72;85;96;1;71;136;15;48;185,952710892032851803,0.000000
steepest_intra:edges_start:random,182,272602,170935,101667,1,0,114;138;20;179;7;160;173;19;149;118;101;199;148;44;73;33;133;34;140;38;79;164;159;188;98;45;120;150;59;16;166;163;189;64;1;197;151;90;31;190;168;60;130;6;52;162;128;81;108;46;75;80;131;104;192;161;69;27;25;143;116;152;177;47;194;17;83;111;78;100;170;57;158;3;198;106;24;12;0;67;9;147;70;96;195;132;40;172;126;68;82;13;181;15;93;142;145;171;185;196,7972883406642326036,0.000000
steepest_intra:edges_start:random,183,259120,164471,94649,1,0,45;198;10;164;182;44;52;50;103;111;159;179;25;144;55;47;4;81;194;100;187;174;189;156;157;152;93;170;105;33;61;22;149;113;106;121;178;107;126;148;139;86;158;102;186;51;54;20;122;165;110;199;143;12;30;131;132;71;135;98;7;168;171;173;101;127;78;115;31;177;38;66;116;92;69;24;35;153;65;96;23;172;68;147;53;9;128;167;97;190;63;197;176;154;80;14;160;90;134;191,5872061073976324954,0.000000
steepest_intra:edges_start:random,184,280667,177848,102819,1,0,198;39;54;85;67;120;188;81;83;35;107;112;75;118;82;173;117;19;69;164;178;114;119;20;104;46;60;152;45;194;134;102;4;88;155;96;195;168;94;130;189;12;51;61;106;115;133;150;183;73;132;103;172;100;38;165;68;21;122;113;121;42;2;196;140;108;186;29;181;24;84;53;199;184;17;163;44;58;66;138;8;78;149;99;55;36;6;62;116;169;128;139;157;49;65;142;86;0;22;89,3357314708175361584,0.000000
steepest_intra:edges_start:random,185,273570,179570,94000,1,0,54;68;162;7;34;165;131;150;132;158;44;136;47;49;58;170;86;66;167;166;189;51;3;52;125;197;187;127;164;176;180;79;67;102;153;96;120;174;171;5;50;179;172;148;138;31;60;185;11;63;0;42;151;128;13;160;168;152;18;75;101;195;35;53;77;21;199;73;123;65;98;91;41;26;113;134;84;39;36;97;126;59;110;37;72;109;88;76;55;133;22;157;15;159;24;143;83;94;40;118,8108974690962984637,0.000000
steepest_intra:edges_start:random,186,269570,173549,96021,1,0,9;164;77;192;67;69;26;48;73;122;177;7;62;126;104;85;39;112;125;111;120;180;195;81;148;140;42;198;70;86;173;132;102;30;118;100;174;136;6;98;14;191;143;12;60;135;75;4;176;101;91;157;95;155;162;189;175;57;115;40;170;63;185;47;146;172;149;160;44;61;28;138;158;131;129;184;110;2;68;87;59;96;31;108;128;151;52;72;3;142;78;94;56;83;168;92;5;58;84;0,1340875118935917939,0.000000
steepest_intra:edges_start:random,187,251710,150931,100779,1,0,90;171;91;43;60;122;23;111;58;81;121;194;87;93;94;39;129;47;79;45;73;96;13;8;130;80;113;173;62;180;50;51;69;63;184;76;31;95;10;67;191;127;52;158;149;176;156;11;24;3;70;133;181;136;5;14;174;143;85;179;2;154;82;104;192;125;37;0;105;144;75;177;155;15;138;114;166;146;41;159;98;169;55;38;9;195;16;78;53;108;106;57;99;83;164;126;157;182;119;107,4795012161090127417,0.000000
steepest_intra:edges_start:random,188,269223,166514,102709,1,0,87;72;56;157;45;123;0;117;186;16;146;126;155;53;61;109;79;110;80;25;175;59;57;134;179;90;26;147;154;32;107;49;48;39;47;189;71;164;183;88;150;198;67;7;68;101;76;143;167;188;9;43;41;130;166;11;89;187;161;42;38;152;14;127;159;62;106;30;160;28;122;104;153;50;98;149;82;176;65;12;131;29;103;118;95;191;22;10;171;197;36;163;156;115;24;54;132;69;138;125,9087347764473338729,0.000000
steepest_intra:edges_start:random,189,281026,180143,100883,1,0,126;84;41;63;114;115;39;117;198;6;62;71;188;170;160;156;151;31;46;163;119;106;104;171;79;110;7;161;45;60;125;141;135;15;192;51;92;122;30;33;36;120;155;190;91;147;185;121;112;32;186;14;165;1;164;195;101;134;27;76;138;124;199;10;139;66;83;146;102;22;58;123;148;145;72;65;38;50;180;68;107;48;67;150;175;174;90;24;187;23;128;97;95;55;118;82;99;111;75;86,121862138502212014,0.000000
steepest_intra:edges_start:random,190,264162,165975,98187,1,0,94;9;141;23;115;59;161;183;78;187;157;4;124;31;177;32;49;72;76;15;165;100;195;79;121;18;50;91;167;112;33;46;29;179;45;25;56;54;10;156;55;159;162;110;38;8;37;127;117;1;144;173;152;132;171;125;60;111;135;0;57;140;12;13;136;108;169;104;182;105;74;107;80;73;134;40;119;90;51;42;199;155;158;114;30;27;95;109;164;34;65;116;181;93;189;190;6;149;63;198,5200514841718380301,0.000000
steepest_intra:edges_start:random,191,253831,150333,103498,1,0,187;111;79;138;64;7;60;133;169;195;31;0;134;100;21;185;121;131;20;47;189;97;44;40;72;153;69;110;109;99;173;48;73;56;87;140;91;29;125;84;175;80;54;34;37;124;155;139;161;89;132;17;122;156;127;154;50;61;158;170;144;130;164;180;152;168;188;123;119;86;177;102;184;25;13;145;55;1;4;112;93;3;92;12;194;74;159;151;65;52;26;8;166;5;197;191;105;135;126;181,3304122138188638996,0.000000
steepest_intra:edges_start:random,192,279484,176846,102638,1,0,132;187;77;105;56;179;3;65;88;35;113;86;41;16;102;173;1;82;34;109;66;191;80;46;42;76;15;154;162;190;31;182;91;165;156;196;135;11;155;67;90;169;133;159;14;70;144;121;99;147;7;25;36;170;123;107;49;62;145;93;61;103;78;54;20;141;142;85;192;6;50;126;158;43;74;64;172;92;185;40;136;118;44;33;151;194;27;29;63;98;168;112;12;119;116;188;184;13;97;73,1677424990552023085,0.000000
steepest_intra:edges_start:random,193,252699,161249,91450,1,0,42;182;138;72;31;55;137;98;156;5;123;82;104;116;68;128;81;133;88;89;90;45;10;60;143;49;177;144;61;15;181;26;75;70;35;109;56;168;158;28;189;101;186;7;39;85;148;111;161;62;107;180;152;37;83;3;12;11;172;140;64;120;84;77;78;190;184;76;122;153;20;193;100;115;165;197;154;113;106;179;121;134;92;14;175;1;25;192;178;54;65;135;46;93;16;58;125;112;199;196,3269095103478826324,0.000000
steepest_intra:edges_start:random,194,257175,160560,96615,1,0,147;61;124;140;132;156;184;70;6;82;50;154;48;176;97;137;67;153;16;65;17;52;135;131;20;68;183;166;148;75;93;151;150;96;199;11;103;91;5;8;175;193;127;126;111;15;18;66;121;157;197;45;78;53;63;141;14;58;195;54;174;100;112;55;31;191;189;99;44;59;56;95;41;128;85;182;87;51;86;28;118;136;110;165;185;143;114;190;149;102;177;181;2;171;64;89;37;3;10;198,4126891016091301708,0.000000
steepest_intra:edges_start:random,195,256475,160219,96256,1,0,122;45;195;80;63;84;24;88;23;40;0;183;82;123;59;157;69;17;158;187;107;188;37;65;180;86;140;114;19;67;148;6;25;73;44;79;145;170;31;96;172;101;52;131;89;111;36;5;50;102;194;126;35;10;130;20;70;117;115;106;16;97;154;8;139;110;162;165;120;116;149;147;177;14;171;18;81;173;64;144;105;150;155;168;142;74;87;163;62;138;99;176;75;55;132;34;47;12;2;167,8007111891949148817,0.000000
steepest_intra:edges_start:random,196,261602,161801,99801,1,0,180;40;157;149;82;97;196;178;13;155;134;137;11;10;15;76;99;158;120;113;63;128;35;8;33;18;167;59;129;110;197;161;84;3;143;185;115;194;2;168;46;131;56;138;174;198;62;179;182;103;118;119;184;36;173;14;37;146;195;147;165;66;151;104;148;30;189;67;109;140;181;29;169;130;107;199;69;65;68;79;16;5;163;70;34;51;100;126;191;121;106;145;77;156;93;81;154;86;188;187,1017505975953531933,0.000000
steepest_intra:edges_start:random,197,262431,167710,94721,1,0,148;134;172;22;68;72;165;176;20;121;90;154;52;160;115;30;47;1;159;193;59;16;120;167;147;26;181;161;97;188;132;6;183;164;126;117;46;136;170;84;112;198;187;107;55;140;138;45;10;33;63;185;11;184;66;103;92;137;142;102;15;111;191;57;182;61;40;143;190;8;177;35;67;128;119;17;37;94;197;21;178;127;171;135;199;50;104;65;180;19;79;163;51;77;81;99;49;130;100;41,6984146570681903166,0.000000
steepest_intra:edges_start:random,198,273376,168812,104564,1,0,158;149;102;42;162;180;109;60;54;6;111;196;58;164;11;92;10;86;140;74;99;98;8;182;122;51;108;94;25;75;195;169;155;173;172;87;101;20;137;185;43;66;110;124;187;56;72;144;147;113;26;146;50;193;132;157;97;145;7;28;191;153;24;100;93;121;139;178;170;84;64;27;123;36;199;165;114;69;119;96;181;197;4;44;41;166;151;138;184;48;76;77;133;125;174;13;189;30;192;95,82030804887040908,0.000000
steepest_intra:edges_start:random,199,263561,167689,95872,1,0,50;80;142;32;33;181;62;57;37;162;159;5;98;121;188;90;123;21;102;82;70;93;7;34;22;39;154;173;180;116;41;88;17;53;129;78;101;135;111;120;125;149;43;168;126;157;59;179;28;97;156;187;89;140;167;91;106;49;83;124;144;20;138;147;66;166;85;71;137;186;19;172;81;67;143;45;30;183;171;9;104;27;14;16;164;131;2;73;54;6;190;178;174;128;117;109;64;0;127;94,5790033870006882349,0.000000
steepest_intra:edges_start:greedy,0,71108,22981,48127,1,0,0;117;143;183;89;186;23;137;176;80;79;63;94;124;152;97;1;101;2;120;82;129;57;92;55;52;49;102;148;9;62;144;14;138;178;106;185;165;40;90;81;196;179;145;78;31;56;113;175;171;16;25;44;75;86;26;100;121;53;180;154;135;70;127;123;162;133;151;51;118;59;65;116;43;184;84;112;4;190;10;177;54;48;160;34;146;22;18;108;69;159;181;42;5;115;41;193;139;68;46,5911812189553155292,0.000000
steepest_intra:edges_start:greedy,1,71933,23455,48478,1,0,1;101;75;86;53;154;70;135;180;63;79;133;51;118;59;115;46;0;143;117;93;140;68;139;193;41;5;42;181;159;69;108;18;22;146;34;160;48;54;177;190;184;43;116;65;149;123;127;162;151;80;176;137;23;183;89;186;114;15;9;62;144;14;138;165;40;185;90;81;196;179;145;78;31;56;113;175;171;16;25;44;120;2;129;92;57;55;52;106;178;49;102;148;124;94;189;100;26;97;152,667815170375672396,0.000000
steepest_intra:edges_start:greedy,2,71905,23579,48326,1,0,2;129;57;92;55;52;49;102;148;9;62;144;14;138;178;106;185;165;40;90;81;196;179;145;78;31;56;113;175;171;16;25;44;120;75;86;26;189;94;63;79;80;176;133;151;51;118;59;115;46;0;137;23;186;89;183;143;117;93;140;68;139;193;41;5;42;181;159;69;108;18;22;146;34;160;48;54;177;10;190;84;184;43;116;65;131;149;162;123;127;70;135;154;180;53;100;101;1;97;152,3385511409767462095,0.000000
steepest_intra:edges_start:greedy,3,71813,23409,48404,1,0,3;14;144;62;9;148;102;49;178;106;52;55;57;92;129;2;152;97;1;101;100;53;180;154;135;70;127;123;162;149;131;65;116;43;184;84;190;10;177;54;48;160;34;146;22;18;108;69;159;181;42;5;41;193;139;68;140;93;117;143;183;89;186;23;137;0;46;115;59;118;51;151;133;176;80;79;63;94;189;26;86;75;120;44;25;16;171;175;113;56;31;78;145;179;196;81;90;185;40;165,4790610926336737107,0.000000
steepest_intra:edges_start:greedy,4,72214,24115,48099,1,0,4;190;10;177;54;48;34;160;181;42;146;22;18;108;69;159;41;193;139;68;46;115;118;59;116;65;43;184;35;131;149;123;162;151;133;51;0;117;143;183;89;23;137;176;80;79;63;94;124;152;97;1;101;2;120;82;129;57;92;55;52;49;102;148;9;62;144;14;138;178;106;185;165;40;90;81;196;179;145;78;31;56;113;175;171;16;25;44;75;86;26;100;121;53;180;154;135;70;127;112,2723835481487348551,0.000000
steepest_intra:edges_start:greedy,5,71757,23388,48369,1,0,5;43;116;65;149;123;127;162;151;133;135;70;154;180;53;121;100;26;86;75;44;25;16;171;175;113;56;31;78;145;179;196;81;90;40;165;185;106;178;138;14;144;62;9;148;102;49;52;55;92;57;129;82;120;2;101;1;97;152;124;94;63;79;80;176;137;23;186;89;183;143;117;0;51;118;59;115;46;68;139;41;193;159;69;108;18;22;146;181;34;160;48;54;177;10;190;4;84;184;42,5321001672029533819,0.000000
steepest_intra:edges_start:greedy,6,72451,23177,49274,1,0,6;154;53;121;100;26;86;75;101;1;97;152;94;124;148;102;49;178;106;52;55;57;92;129;2;120;44;25;16;171;175;113;56;31;78;145;179;196;81;90;185;40;165;138;14;144;62;9;15;114;186;89;183;23;137;176;80;151;162;127;123;149;65;116;43;184;177;54;48;160;34;146;22;18;108;69;159;181;42;5;41;193;139;68;140;93;117;143;0;46;115;59;118;51;133;79;63;180;70;135,6396386434810360366,0.000000
steepest_intra:edges_start:greedy,7,72637,24199,48438,1,0,7;21;144;62;9;148;102;14;49;178;106;52;55;165;185;40;179;145;78;92;57;129;2;152;97;1;101;100;53;180;154;135;70;127;123;162;149;65;116;43;184;177;54;48;160;34;146;22;18;108;69;159;181;42;5;41;193;139;68;140;93;117;143;183;89;23;137;0;46;115;59;118;51;151;133;176;80;79;63;94;189;26;86;75;120;44;25;16;171;175;113;56;31;157;196;81;90;27;71;164,2390480320912231919,0.000000
steepest_intra:edges_start:greedy,8,71847,23063,48784,1,0,8;165;40;185;90;81;196;179;145;78;31;56;113;175;171;16;25;44;120;75;86;26;189;94;63;79;80;176;133;151;51;118;59;115;46;0;137;23;186;89;183;143;117;93;140;68;139;193;41;5;42;181;159;69;108;18;22;146;34;160;48;54;177;10;190;184;43;116;65;131;149;162;123;127;70;135;154;180;53;100;101;1;97;152;2;129;92;57;55;52;106;178;49;102;148;9;62;144;14;138,6113921068484385599,0.000000
steepest_intra:edges_start:greedy,9,71523,23197,48326,1,0,9;148;102;49;178;106;52;55;57;92;129;2;152;97;1;101;100;53;180;154;135;70;127;123;162;149;131;65;116;43;184;84;190;10;177;54;48;160;34;146;22;18;108;69;159;181;42;5;41;193;139;68;140;93;117;143;183;89;186;23;137;0;46;115;59;118;51;151;133;176;80;79;63;94;189;26;86;75;120;44;25;16;171;175;113;56;31;78;145;179;196;81;90;185;40;165;138;14;144;62,611017881450375199,0.000000
steepest_intra:edges_start:greedy,10,72214,24115,48099,1,0,10;190;4;112;127;70;135;154;180;53;121;100;26;86;75;44;25;16;171;175;113;56;31;78;145;179;196;81;90;40;165;185;106;178;138;14;144;62;9;148;102;49;52;55;92;57;129;82;120;2;101;1;97;152;124;94;63;79;80;176;137;23;89;183;143;117;0;51;133;151;162;123;149;131;35;184;43;65;116;59;118;115;46;68;139;193;41;159;69;108;18;22;146;42;181;160;34;48;54;177,4061096458509072394,0.000000
steepest_intra:edges_start:greedy,11,72516,23391,49125,1,0,11;35;84;4;112;127;123;162;151;133;135;70;154;180;53;121;100;26;86;75;44;25;16;171;175;113;56;31;78;145;179;196;81;90;40;165;185;106;178;138;14;144;62;9;148;102;49;52;55;92;57;129;82;120;2;101;1;97;152;124;94;63;79;80;176;137;23;186;89;183;143;117;0;51;118;59;115;139;68;46;65;116;43;42;5;41;193;159;69;108;18;22;146;181;34;160;48;54;177;184,3156451612831796588,0.000000
steepest_intra:edges_start:greedy,12,72899,23524,49375,1,0,12;94;152;97;1;101;2;120;82;129;57;92;179;145;78;31;56;113;175;171;16;25;44;75;86;26;100;121;53;158;154;70;135;180;63;79;133;51;118;59;115;46;0;143;117;93;140;68;139;193;41;5;42;181;159;69;108;18;22;146;34;160;48;54;177;184;43;116;65;149;123;162;151;80;176;137;23;183;89;186;114;15;9;62;144;14;138;165;90;81;196;40;185;55;52;106;178;49;102;148,4137438373853854676,0.000000
steepest_intra:edges_start:greedy,13,72754,23520,49234,1,0,13;31;145;78;92;179;196;81;90;40;165;185;106;178;138;14;144;62;9;148;102;49;52;55;57;129;2;152;97;1;101;100;53;180;154;135;70;127;123;162;149;131;65;116;43;184;190;10;177;54;48;160;34;146;22;18;108;69;159;181;42;5;41;193;139;68;140;93;117;143;183;89;186;23;137;0;46;115;59;118;51;151;133;176;80;79;63;94;189;26;86;75;120;44;25;16;171;175;113;56,4568476524068667854,0.000000
steepest_intra:edges_start:greedy,14,71523,23197,48326,1,0,14;144;62;9;148;102;49;178;106;52;55;57;92;129;2;152;97;1;101;100;53;180;154;135;70;127;123;162;149;131;65;116;43;184;84;190;10;177;54;48;160;34;146;22;18;108;69;159;181;42;5;41;193;139;68;140;93;117;143;183;89;186;23;137;0;46;115;59;118;51;151;133;176;80;79;63;94;189;26;86;75;120;44;25;16;171;175;113;56;31;78;145;179;196;81;90;185;40;165;138,2919061766278657796,0.000000
steepest_intra:edges_start:greedy,15,71602,23316,48286,1,0,15;144;14;138;165;40;185;90;81;196;179;145;78;31;56;113;175;171;16;25;44;120;75;86;26;189;94;63;79;80;176;133;151;51;118;59;115;46;0;137;23;186;89;183;143;117;93;140;68;139;193;41;5;42;181;159;69;108;18;22;146;34;160;48;54;177;10;190;184;43;116;65;131;149;162;123;127;70;135;154;180;53;100;101;1;97;152;2;129;92;57;55;52;106;178;49;102;62;9;148,7910616063288263737,0.000000
steepest_intra:edges_start:greedy,16,72017,23691,48326,1,0,16;25;44;120;75;86;26;189;94;63;79;80;176;133;151;51;118;59;115;46;0;137;23;186;89;183;143;117;93;140;68;139;193;41;5;42;181;159;69;108;18;22;146;34;160;48;54;177;10;190;84;184;43;116;65;131;149;162;123;127;70;135;154;180;53;100;101;1;97;152;2;129;57;55;52;49;102;148;9;62;144;14;138;178;106;185;165;40;90;81;196;179;92;78;145;31;56;113;175;171,2901989316274172804,0.000000
steepest_intra:edges_start:greedy,17,73438,23931,49507,1,0,17;196;81;90;27;71;164;7;95;39;165;40;185;106;178;138;14;144;62;9;148;102;49;52;55;57;129;92;179;145;78;82;2;152;97;1;101;53;180;154;135;70;127;123;162;149;65;116;43;184;177;54;48;160;34;146;22;18;108;159;181;42;41;193;139;68;140;93;117;143;183;89;23;137;0;46;115;59;118;51;151;133;176;80;79;63;94;26;86;75;120;44;25;16;171;175;113;56;31;157,7309871173772576356,0.000000
steepest_intra:edges_start:greedy,18,71968,23472,48496,1,0,18;22;146;159;193;41;5;42;181;34;160;48;54;177;10;190;4;84;184;43;116;65;149;123;127;162;151;133;135;70;154;180;53;121;100;26;86;75;44;25;16;171;175;113;56;31;78;145;179;196;81;90;40;165;185;106;178;138;14;144;62;9;148;102;49;52;55;92;57;129;82;120;2;101;1;97;152;124;94;63;79;80;176;137;51;118;59;115;139;46;68;0;89;183;143;117;93;140;108;69,8324871402498234870,0.000000
steepest_intra:edges_start:greedy,19,72190,22856,49334,1,0,19;94;124;148;102;49;178;106;52;55;57;92;129;2;120;44;25;16;171;175;113;56;31;78;145;179;196;81;90;185;40;165;138;14;144;62;9;15;114;186;89;183;23;137;176;80;151;162;123;149;65;116;43;184;177;54;48;160;34;146;22;18;108;69;159;181;42;5;41;193;139;68;140;93;117;143;0;46;115;59;118;51;133;79;63;180;135;70;154;158;53;121;100;26;86;75;101;1;97;152,3496704878202105461,0.000000
steepest_intra:edges_start:greedy,20,72394,23430,48964,1,0,20;22;146;159;193;41;5;42;181;34;160;48;54;177;10;190;84;184;43;116;65;149;123;127;162;151;133;135;70;154;180;53;121;100;26;86;75;44;25;16;171;175;113;56;31;78;145;179;196;81;90;40;165;185;106;178;138;14;144;62;9;148;102;49;52;55;92;57;129;82;120;2;101;1;97;152;124;94;63;79;80;176;137;51;118;59;115;139;46;68;0;89;183;143;117;93;140;108;69;18,7295745512188870814,0.000000
steepest_intra:edges_start:greedy,21,71988,23819,48169,1,0,21;14;138;165;40;185;90;81;196;179;145;78;31;56;113;175;171;16;25;44;120;75;86;26;189;94;63;79;80;176;133;151;51;118;59;115;46;0;137;23;186;89;183;143;117;93;140;68;139;193;41;5;42;181;159;69;108;18;22;146;34;160;48;54;177;10;190;184;43;116;65;131;149;162;123;127;70;135;154;180;53;100;101;1;97;152;2;129;92;57;55;52;106;178;49;102;148;9;62;144,7180304330681538037,0.000000
steepest_intra:edges_start:greedy,22,71385,23490,47895,1,0,22;146;181;34;160;48;54;177;10;190;4;112;84;184;42;43;116;65;149;123;127;162;151;133;135;70;154;180;53;121;100;26;86;75;44;25;16;171;175;113;56;31;78;145;179;196;81;90;40;165;185;106;178;138;14;144;62;9;148;102;49;52;55;92;57;129;82;120;2;101;1;97;152;124;94;63;79;80;176;137;23;186;89;183;143;117;0;51;118;59;115;46;68;139;41;193;159;69;108;18,7971589091626894586,0.000000
steepest_intra:edges_start:greedy,23,71108,22981,48127,1,0,23;137;176;80;79;63;94;124;152;97;1;101;2;120;82;129;57;92;55;52;49;102;148;9;62;144;14;138;178;106;185;165;40;90;81;196;179;145;78;31;56;113;175;171;16;25;44;75;86;26;100;121;53;180;154;135;70;127;123;162;133;151;51;118;59;65;116;43;184;84;112;4;190;10;177;54;48;160;34;146;22;18;108;69;159;181;42;5;115;41;193;139;68;46;0;117;143;183;89;186,5971655096530826278,0.000000
steepest_intra:edges_start:greedy,24,72431,23484,48947,1,0,24;149;65;116;43;184;84;190;10;177;54;48;160;34;146;22;18;108;69;159;181;42;5;41;193;139;68;46;115;59;118;51;0;117;143;183;89;186;23;137;176;80;79;63;94;124;152;97;1;101;2;120;82;129;57;92;55;52;49;102;148;9;62;144;14;138;178;106;185;165;40;90;81;196;179;145;78;31;56;113;175;171;16;25;44;75;86;26;100;121;53;180;154;70;135;133;151;162;127;123,7466296657878715852,0.000000
steepest_intra:edges_start:greedy,25,71905,23579,48326,1,0,25;44;120;75;86;26;189;94;63;79;80;176;133;151;51;118;59;115;46;0;137;23;186;89;183;143;117;93;140;68;139;193;41;5;42;181;159;69;108;18;22;146;34;160;48;54;177;10;190;84;184;43;116;65;131;149;162;123;127;70;135;154;180;53;100;101;1;97;152;2;129;57;92;55;52;49;102;148;9;62;144;14;138;178;106;185;165;40;90;81;196;179;145;78;31;56;113;175;171;16,625165010635440803,0.000000
steepest_intra:edges_start:greedy,26,71591,23565,48026,1,0,26;97;1;101;75;86;53;154;70;135;180;63;79;133;51;118;59;115;46;0;143;117;93;140;68;139;193;41;5;42;181;159;69;108;18;22;146;34;160;48;54;177;10;190;184;43;116;65;149;123;127;162;151;80;176;137;23;183;89;186;114;15;9;62;144;14;138;165;40;185;90;81;196;179;145;78;31;56;113;175;171;16;25;44;120;2;129;92;57;55;52;106;178;49;102;148;124;94;152;100,566379487009258001,0.000000
steepest_intra:edges_start:greedy,27,72164,23636,48528,1,0,27;71;164;7;95;39;165;138;14;144;62;9;148;102;49;178;106;52;55;57;92;129;2;152;97;1;101;100;53;180;154;135;70;127;123;162;149;65;116;43;184;177;54;48;160;34;146;22;18;108;69;159;181;42;5;41;193;139;68;140;93;117;143;183;89;23;137;0;46;115;59;118;51;151;133;176;80;79;63;94;26;86;75;120;44;25;16;171;175;113;56;31;78;145;179;196;81;185;40;90,8499432644021402412,0.000000
steepest_intra:edges_start:greedy,28,72501,23471,49030,1,0,28;43;65;116;131;149;123;127;162;151;133;135;70;154;180;53;121;100;26;86;75;44;25;16;171;175;113;56;31;78;145;179;196;81;90;40;165;185;106;178;138;14;144;62;9;148;102;49;52;55;92;57;129;82;120;2;101;1;97;152;124;94;63;79;80;176;137;23;186;89;183;143;117;0;51;59;118;115;46;68;139;193;41;5;42;181;159;69;108;18;22;146;34;160;48;54;177;10;190;184,8946616730821530458,0.000000
steepest_intra:edges_start:greedy,29,72298,23401,48897,1,0,29;112;4;84;35;184;177;54;48;160;34;181;146;22;18;108;69;159;193;41;5;42;43;116;65;46;68;139;115;59;118;51;0;117;143;183;89;186;23;137;176;80;79;63;94;124;152;97;1;101;2;120;82;129;57;92;55;52;49;102;148;9;62;144;14;138;178;106;185;165;40;90;81;196;179;145;78;31;56;113;175;171;16;25;44;75;86;26;100;121;53;180;154;70;135;133;151;162;123;127,2618875056891684759,0.000000
steepest_intra:edges_start:greedy,30,72324,23799,48525,1,0,30;54;177;10;190;84;184;43;65;116;59;118;115;46;0;51;151;133;162;123;127;70;135;154;180;53;121;100;26;86;75;44;25;16;171;175;113;56;31;78;145;179;196;81;90;40;165;185;106;178;138;14;144;62;9;148;102;49;52;55;92;57;129;82;120;2;101;1;97;152;124;94;63;79;80;176;137;23;186;89;183;143;117;93;140;68;139;193;41;159;69;108;18;22;146;195;42;181;160;34,3262720364394453783,0.000000
steepest_intra:edges_start:greedy,31,72017,23691,48326,1,0,31;145;78;92;179;196;81;90;40;165;185;106;178;138;14;144;62;9;148;102;49;52;55;57;129;2;152;97;1;101;100;53;180;154;135;70;127;123;162;149;131;65;116;43;184;84;190;10;177;54;48;160;34;146;22;18;108;69;159;181;42;5;41;193;139;68;140;93;117;143;183;89;186;23;137;0;46;115;59;118;51;151;133;176;80;79;63;94;189;26;86;75;120;44;25;16;171;175;113;56,561316070311717755,0.000000
steepest_intra:edges_start:greedy,32,72151,23295,48856,1,0,32;14;144;62;9;148;102;49;178;106;52;55;57;92;129;2;152;97;1;101;100;53;180;154;135;70;127;123;162;149;131;65;116;43;184;84;190;10;177;54;48;160;34;146;22;18;108;69;159;181;42;5;41;193;139;68;140;93;117;143;183;89;186;23;137;0;46;115;59;118;51;151;133;176;80;79;63;94;189;26;86;75;120;44;25;16;171;175;113;56;31;78;145;179;196;81;90;185;40;165,953465071402975936,0.000000
steepest_intra:edges_start:greedy,33,72265,23015,49250,1,0,33;102;49;178;106;52;55;57;92;129;2;152;97;1;101;100;53;180;154;135;70;127;123;162;149;131;65;116;43;184;190;10;177;54;48;160;34;146;22;18;108;69;159;181;42;5;41;193;139;68;140;93;117;143;183;89;186;23;137;0;46;115;59;118;51;151;133;176;80;79;63;94;189;26;86;75;120;44;25;16;171;175;113;56;31;78;145;179;196;81;90;185;40;165;138;14;144;62;9;148,4846275401535237493,0.000000
steepest_intra:edges_start:greedy,34,71385,23490,47895,1,0,34;181;146;22;18;108;69;159;193;41;139;68;46;115;59;118;51;0;117;143;183;89;186;23;137;176;80;79;63;94;124;152;97;1;101;2;120;82;129;57;92;55;52;49;102;148;9;62;144;14;138;178;106;185;165;40;90;81;196;179;145;78;31;56;113;175;171;16;25;44;75;86;26;100;121;53;180;154;70;135;133;151;162;127;123;149;65;116;43;42;184;84;112;4;190;10;177;54;48;160,6562155353939852956,0.000000
steepest_intra:edges_start:greedy,35,71935,23606,48329,1,0,35;84;4;112;127;123;162;151;133;135;70;154;180;53;121;100;26;86;75;44;25;16;171;175;113;56;31;78;145;179;196;81;90;40;165;185;106;178;138;14;144;62;9;148;102;49;52;55;92;57;129;82;120;2;101;1;97;152;124;94;63;79;80;176;137;23;186;89;183;143;117;0;51;118;59;115;139;68;46;65;116;43;42;5;41;193;159;69;108;18;22;146;181;34;160;48;54;177;190;184,3544341888746561123,0.000000
steepest_intra:edges_start:greedy,36,72462,23372,49090,1,0,36;108;69;18;22;146;159;193;41;5;42;181;34;160;48;54;177;10;190;84;184;43;116;65;149;123;127;162;151;133;135;70;154;180;53;121;100;26;86;75;44;25;16;171;175;113;56;31;78;145;179;196;81;90;40;165;185;106;178;138;14;144;62;9;148;102;49;52;55;92;57;129;82;120;2;101;1;97;152;124;94;63;79;80;176;137;51;118;59;115;139;46;68;0;89;183;143;117;93;140,7530084744755374335,0.000000
steepest_intra:edges_start:greedy,37,71679,23015,48664,1,0,37;102;49;178;106;52;55;57;92;129;2;152;97;1;101;100;53;180;154;135;70;127;123;162;149;131;65;116;43;184;190;10;177;54;48;160;34;146;22;18;108;69;159;181;42;5;41;193;139;68;140;93;117;143;183;89;186;23;137;0;46;115;59;118;51;151;133;176;80;79;63;94;189;26;86;75;120;44;25;16;171;175;113;56;31;78;145;179;196;81;90;185;40;165;138;14;144;62;9;148,7845570325236856220,0.000000
steepest_intra:edges_start:greedy,38,72529,23535,48994,1,0,38;145;78;92;179;196;81;90;40;165;185;106;178;138;14;144;62;9;148;102;49;52;55;57;129;2;152;97;1;101;100;53;180;154;135;70;127;123;162;149;131;65;116;43;184;190;10;177;54;48;160;34;146;22;18;108;69;159;181;42;5;41;193;139;68;140;93;117;143;183;89;186;23;137;0;46;115;59;118;51;151;133;176;80;79;63;94;189;26;86;75;120;44;25;16;171;175;113;56;31,2029149827901530274,0.000000
steepest_intra:edges_start:greedy,39,72098,23628,48470,1,0,39;95;7;164;27;90;40;185;81;196;179;145;78;31;56;113;175;171;16;25;44;120;75;86;26;189;94;63;79;80;176;133;151;51;118;59;115;46;0;137;23;89;183;143;117;93;140;68;139;193;41;5;42;181;159;69;108;18;22;146;34;160;48;54;177;184;43;116;65;149;162;123;127;70;135;154;180;53;100;101;1;97;152;2;129;92;57;55;52;106;178;49;102;148;9;62;144;14;138;165,2697931895186153156,0.000000
steepest_intra:edges_start:greedy,40,71523,23197,48326,1,0,40;165;138;14;144;62;9;148;102;49;178;106;52;55;57;92;129;2;152;97;1;101;100;53;180;154;135;70;127;123;162;149;131;65;116;43;184;84;190;10;177;54;48;160;34;146;22;18;108;69;159;181;42;5;41;193;139;68;140;93;117;143;183;89;186;23;137;0;46;115;59;118;51;151;133;176;80;79;63;94;189;26;86;75;120;44;25;16;171;175;113;56;31;78;145;179;196;81;90;185,7884756624616011316,0.000000
steepest_intra:edges_start:greedy,41,71947,23578,48369,1,0,41;5;42;181;159;69;108;18;22;146;34;160;48;54;177;10;190;4;84;184;43;116;65;149;123;127;162;151;133;135;70;154;180;53;121;100;26;86;75;44;25;16;171;175;113;56;31;78;145;179;196;81;90;40;165;185;106;178;138;14;144;62;9;148;102;49;52;55;92;57;129;82;120;2;101;1;97;152;124;94;63;79;80;176;137;23;186;89;183;143;117;0;51;118;59;115;46;68;139;193,2394750011256618144,0.000000
steepest_intra:edges_start:greedy,42,71947,23578,48369,1,0,42;5;41;193;139;68;46;115;59;118;51;0;117;143;183;89;186;23;137;176;80;79;63;94;124;152;97;1;101;2;120;82;129;57;92;55;52;49;102;148;9;62;144;14;138;178;106;185;165;40;90;81;196;179;145;78;31;56;113;175;171;16;25;44;75;86;26;100;121;53;180;154;70;135;133;151;162;127;123;149;65;116;43;184;84;4;190;10;177;54;48;160;34;146;22;18;108;69;159;181,7210668265839579867,0.000000
steepest_intra:edges_start:greedy,43,72083,23661,48422,1,0,43;65;116;59;118;115;46;0;51;151;133;162;123;127;70;135;154;180;53;121;100;26;86;75;44;25;16;171;175;113;56;31;78;145;179;196;81;90;40;165;185;106;178;138;14;144;62;9;148;102;49;52;55;92;57;129;82;120;2;101;1;97;152;124;94;63;79;80;176;137;23;186;89;183;143;117;93;140;68;139;193;41;5;42;181;159;69;108;18;22;146;34;160;48;54;177;10;190;84;184,362119462133013396,0.000000
steepest_intra:edges_start:greedy,44,71905,23579,48326,1,0,44;25;16;171;175;113;56;31;78;145;179;196;81;90;40;165;185;106;178;138;14;144;62;9;148;102;49;52;55;92;57;129;2;152;97;1;101;100;53;180;154;135;70;127;123;162;149;131;65;116;43;184;84;190;10;177;54;48;160;34;146;22;18;108;69;159;181;42;5;41;193;139;68;140;93;117;143;183;89;186;23;137;0;46;115;59;118;51;151;133;176;80;79;63;94;189;26;86;75;120,7173976871973646782,0.000000
steepest_intra:edges_start:greedy,45,73081,23748,49333,1,0,45;162;133;135;70;154;180;53;121;100;26;86;75;44;25;16;171;175;113;56;31;78;145;179;196;81;90;40;165;185;106;178;138;14;144;62;9;148;102;49;52;55;92;57;129;82;120;2;101;1;97;152;124;94;63;79;80;176;137;23;186;89;183;143;117;0;51;118;59;115;46;68;139;193;41;5;42;181;159;69;108;18;22;146;34;160;48;54;177;10;190;84;184;43;116;65;149;123;127;151,2290416591608628494,0.000000
steepest_intra:edges_start:greedy,46,71947,23578,48369,1,0,46;115;59;118;51;0;117;143;183;89;186;23;137;176;80;79;63;94;124;152;97;1;101;2;120;82;129;57;92;55;52;49;102;148;9;62;144;14;138;178;106;185;165;40;90;81;196;179;145;78;31;56;113;175;171;16;25;44;75;86;26;100;121;53;180;154;70;135;133;151;162;127;123;149;65;116;43;184;84;4;190;10;177;54;48;160;34;146;22;18;108;69;159;181;42;5;41;193;139;68,1414639891773339637,0.000000
steepest_intra:edges_start:greedy,47,72248,23594,48654,1,0,47;116;43;184;84;190;10;177;54;48;160;34;146;22;18;108;69;159;181;42;5;41;193;139;68;46;115;118;59;51;0;117;143;183;89;186;23;137;176;80;79;63;94;124;152;97;1;101;2;120;82;129;57;92;55;52;49;102;148;9;62;144;14;138;178;106;185;165;40;90;81;196;179;145;78;31;56;113;175;171;16;25;44;75;86;26;100;121;53;180;154;70;135;133;151;162;127;123;149;65,5180239887903686172,0.000000
steepest_intra:edges_start:greedy,48,72287,23801,48486,1,0,48;34;160;181;42;195;146;22;18;108;69;159;41;193;139;68;140;93;117;143;183;89;186;23;137;176;80;79;63;94;124;152;97;1;101;2;120;82;129;57;92;55;52;49;102;148;9;62;144;14;138;178;106;185;165;40;90;81;196;179;145;78;31;56;113;175;171;16;25;44;75;86;26;100;121;53;180;154;135;70;127;123;162;133;151;51;0;46;115;118;59;116;65;43;184;84;190;10;177;54,4382270110788745459,0.000000
steepest_intra:edges_start:greedy,49,71523,23197,48326,1,0,49;178;106;52;55;57;92;129;2;152;97;1;101;100;53;180;154;135;70;127;123;162;149;131;65;116;43;184;84;190;10;177;54;48;160;34;146;22;18;108;69;159;181;42;5;41;193;139;68;140;93;117;143;183;89;186;23;137;0;46;115;59;118;51;151;133;176;80;79;63;94;189;26;86;75;120;44;25;16;171;175;113;56;31;78;145;179;196;81;90;185;40;165;138;14;144;62;9;148;102,3173369176966253942,0.000000
steepest_intra:edges_start:greedy,50,72985,23643,49342,1,0,50;175;171;16;25;44;120;75;86;26;189;94;63;79;80;176;133;151;51;118;59;115;46;0;137;23;186;89;183;143;117;93;140;68;139;193;41;5;42;181;159;69;108;18;22;146;34;160;48;54;177;10;190;184;43;116;65;131;149;162;123;127;70;135;154;180;53;100;101;1;97;152;2;129;57;55;52;49;102;148;9;62;144;14;138;178;106;185;165;40;90;81;196;179;92;78;145;31;56;113,7460249511526214280,0.000000
steepest_intra:edges_start:greedy,51,71947,23578,48369,1,0,51;118;59;115;46;68;139;193;41;5;42;181;159;69;108;18;22;146;34;160;48;54;177;10;190;4;84;184;43;116;65;149;123;127;162;151;133;135;70;154;180;53;121;100;26;86;75;44;25;16;171;175;113;56;31;78;145;179;196;81;90;40;165;185;106;178;138;14;144;62;9;148;102;49;52;55;92;57;129;82;120;2;101;1;97;152;124;94;63;79;80;176;137;23;186;89;183;143;117;0,8312893077877705395,0.000000
steepest_intra:edges_start:greedy,52,71590,23264,48326,1,0,52;178;106;49;102;148;9;62;144;14;138;165;40;185;90;81;196;179;145;78;31;56;113;175;171;16;25;44;120;75;86;26;189;94;63;79;80;176;133;151;51;118;59;115;46;0;137;23;186;89;183;143;117;93;140;68;139;193;41;5;42;181;159;69;108;18;22;146;34;160;48;54;177;10;190;84;184;43;116;65;131;149;162;123;127;70;135;154;180;53;100;101;1;97;152;2;129;92;57;55,9015823880463397898,0.000000
steepest_intra:edges_start:greedy,53,71750,23180,48570,1,0,53;158;154;70;135;180;63;79;133;51;118;59;115;46;0;143;117;93;140;68;139;193;41;5;42;181;159;69;108;18;22;146;34;160;48;54;177;184;43;116;65;149;123;127;162;151;80;176;137;23;183;89;186;114;15;9;62;144;14;138;165;40;185;90;81;196;179;145;78;31;56;113;175;171;16;25;44;120;2;129;92;57;55;52;106;178;49;102;148;124;94;152;97;1;101;75;86;26;100;121,9111366187719395073,0.000000
steepest_intra:edges_start:greedy,54,72287,23801,48486,1,0,54;48;34;160;181;42;195;146;22;18;108;69;159;41;193;139;68;140;93;117;143;183;89;186;23;137;176;80;79;63;94;124;152;97;1;101;2;120;82;129;57;92;55;52;49;102;148;9;62;144;14;138;178;106;185;165;40;90;81;196;179;145;78;31;56;113;175;171;16;25;44;75;86;26;100;121;53;180;154;135;70;127;123;162;133;151;51;0;46;115;118;59;116;65;43;184;84;190;10;177,3626176444099136583,0.000000
steepest_intra:edges_start:greedy,55,71590,23264,48326,1,0,55;52;178;106;49;102;148;9;62;144;14;138;165;40;185;90;81;196;179;145;78;31;56;113;175;171;16;25;44;120;75;86;26;189;94;63;79;80;176;133;151;51;118;59;115;46;0;137;23;186;89;183;143;117;93;140;68;139;193;41;5;42;181;159;69;108;18;22;146;34;160;48;54;177;10;190;84;184;43;116;65;131;149;162;123;127;70;135;154;180;53;100;101;1;97;152;2;129;92;57,9048348446548939537,0.000000
steepest_intra:edges_start:greedy,56,72017,23691,48326,1,0,56;31;145;78;92;179;196;81;90;40;165;185;106;178;138;14;144;62;9;148;102;49;52;55;57;129;2;152;97;1;101;100;53;180;154;135;70;127;123;162;149;131;65;116;43;184;84;190;10;177;54;48;160;34;146;22;18;108;69;159;181;42;5;41;193;139;68;140;93;117;143;183;89;186;23;137;0;46;115;59;118;51;151;133;176;80;79;63;94;189;26;86;75;120;44;25;16;171;175;113,6021516909367988533,0.000000
steepest_intra:edges_start:greedy,57,71704,23378,48326,1,0,57;55;52;49;102;148;9;62;144;14;138;178;106;185;165;40;90;81;196;179;145;78;31;56;113;175;171;16;25;44;120;75;86;26;189;94;63;79;80;176;133;151;51;118;59;115;46;0;137;23;186;89;183;143;117;93;140;68;139;193;41;5;42;181;159;69;108;18;22;146;34;160;48;54;177;10;190;84;184;43;116;65;131;149;162;123;127;70;135;154;180;53;100;101;1;97;152;2;129;92,4996521535936095784,0.000000
steepest_intra:edges_start:greedy,58,72703,24207,48496,1,0,58;71;27;90;81;196;157;31;56;113;175;171;16;25;44;120;75;86;26;94;63;79;80;176;133;151;51;118;59;115;46;0;137;23;89;183;143;117;93;140;68;139;193;41;5;42;181;159;69;108;18;22;146;34;160;48;54;177;184;43;116;65;149;162;123;127;70;135;154;180;53;100;101;1;97;152;2;129;57;92;78;145;179;40;185;165;55;52;106;178;49;14;102;148;9;62;144;21;7;164,5868524572869758078,0.000000
steepest_intra:edges_start:greedy,59,71947,23578,48369,1,0,59;115;46;68;139;193;41;5;42;181;159;69;108;18;22;146;34;160;48;54;177;10;190;4;84;184;43;116;65;149;123;127;162;151;133;135;70;154;180;53;121;100;26;86;75;44;25;16;171;175;113;56;31;78;145;179;196;81;90;40;165;185;106;178;138;14;144;62;9;148;102;49;52;55;92;57;129;82;120;2;101;1;97;152;124;94;63;79;80;176;137;23;186;89;183;143;117;0;51;118,5561568442329123798,0.000000
steepest_intra:edges_start:greedy,60,72791,23521,49270,1,0,60;46;115;139;193;41;5;42;181;159;69;108;18;22;146;34;160;48;54;177;10;190;4;84;184;43;116;65;149;123;127;162;151;133;135;70;154;180;53;121;100;26;86;75;44;25;16;171;175;113;56;31;78;145;179;196;81;90;40;165;185;106;178;138;14;144;62;9;148;102;49;52;55;92;57;129;82;120;2;101;1;97;152;124;94;63;79;80;176;137;23;186;89;183;143;117;0;51;59;118,4399585819791123459,0.000000
steepest_intra:edges_start:greedy,61,72475,23085,49390,1,0,61;144;14;138;165;40;185;90;81;196;179;145;78;31;56;113;175;171;16;25;44;120;75;86;26;189;94;63;79;80;176;133;151;51;118;59;115;46;0;137;23;186;89;183;143;117;93;140;68;139;193;41;5;42;181;159;69;108;18;22;146;34;160;48;54;177;10;190;184;43;116;65;131;149;162;123;127;70;135;154;180;53;100;101;1;97;152;2;129;92;57;55;52;106;178;49;102;62;9;148,409354212865124322,0.000000
steepest_intra:edges_start:greedy,62,71523,23197,48326,1,0,62;144;14;138;165;40;185;90;81;196;179;145;78;31;56;113;175;171;16;25;44;120;75;86;26;189;94;63;79;80;176;133;151;51;118;59;115;46;0;137;23;186;89;183;143;117;93;140;68;139;193;41;5;42;181;159;69;108;18;22;146;34;160;48;54;177;10;190;84;184;43;116;65;131;149;162;123;127;70;135;154;180;53;100;101;1;97;152;2;129;92;57;55;52;106;178;49;102;148;9,2148307432871472362,0.000000
steepest_intra:edges_start:greedy,63,71750,23180,48570,1,0,63;180;135;70;154;158;53;121;100;26;86;75;101;1;97;152;94;124;148;102;49;178;106;52;55;57;92;129;2;120;44;25;16;171;175;113;56;31;78;145;179;196;81;90;185;40;165;138;14;144;62;9;15;114;186;89;183;23;137;176;80;151;162;127;123;149;65;116;43;184;177;54;48;160;34;146;22;18;108;69;159;181;42;5;41;193;139;68;140;93;117;143;0;46;115;59;118;51;133;79,210485231383583566,0.000000
steepest_intra:edges_start:greedy,64,72373,22854,49519,1,0,64;114;186;89;183;23;137;176;80;151;162;123;149;65;116;43;184;177;54;48;160;34;146;22;18;108;69;159;181;42;5;41;193;139;68;140;93;117;143;0;46;115;59;118;51;133;79;63;180;135;70;154;158;53;121;100;26;86;75;101;1;97;152;94;124;148;9;62;102;49;178;106;52;55;57;92;129;2;120;44;25;16;171;175;113;56;31;78;145;179;196;81;90;185;40;165;138;14;144;15,7329934095951462242,0.000000
steepest_intra:edges_start:greedy,65,71947,23578,48369,1,0,65;149;123;127;162;151;133;135;70;154;180;53;121;100;26;86;75;44;25;16;171;175;113;56;31;78;145;179;196;81;90;40;165;185;106;178;138;14;144;62;9;148;102;49;52;55;92;57;129;82;120;2;101;1;97;152;124;94;63;79;80;176;137;23;186;89;183;143;117;0;51;118;59;115;46;68;139;193;41;5;42;181;159;69;108;18;22;146;34;160;48;54;177;10;190;4;84;184;43;116,2312315849628946152,0.000000
steepest_intra:edges_start:greedy,66,72976,23779,49197,1,0,66;51;118;59;115;46;0;89;183;143;117;93;140;68;139;193;41;5;42;181;159;69;108;18;22;146;34;160;48;54;177;10;190;84;184;43;116;65;149;123;127;162;151;133;135;70;154;180;53;121;100;26;86;75;44;25;16;171;175;113;56;31;78;145;179;196;81;90;40;165;185;106;178;138;14;144;62;9;148;102;49;52;55;92;57;129;82;120;2;101;1;97;152;124;94;63;79;80;176;137,7352491863679327699,0.000000
steepest_intra:edges_start:greedy,67,72645,23364,49281,1,0,67;108;69;18;22;146;159;193;41;5;42;181;34;160;48;54;177;10;190;84;184;43;116;65;149;123;127;162;151;133;135;70;154;180;53;121;100;26;86;75;44;25;16;171;175;113;56;31;78;145;179;196;81;90;40;165;185;106;178;138;14;144;62;9;148;102;49;52;55;92;57;129;82;120;2;101;1;97;152;124;94;63;79;80;176;137;51;118;59;115;139;46;68;0;89;183;143;117;93;140,5598651872045384269,0.000000
steepest_intra:edges_start:greedy,68,71947,23578,48369,1,0,68;46;115;59;118;51;0;117;143;183;89;186;23;137;176;80;79;63;94;124;152;97;1;101;2;120;82;129;57;92;55;52;49;102;148;9;62;144;14;138;178;106;185;165;40;90;81;196;179;145;78;31;56;113;175;171;16;25;44;75;86;26;100;121;53;180;154;70;135;133;151;162;127;123;149;65;116;43;184;84;4;190;10;177;54;48;160;34;146;22;18;108;69;159;181;42;5;41;193;139,1738908405543115796,0.000000
steepest_intra:edges_start:greedy,69,72218,23381,48837,1,0,69;108;18;20;22;146;159;193;41;5;42;181;34;160;48;54;177;10;190;84;184;43;116;65;149;123;127;162;151;133;135;70;154;180;53;121;100;26;86;75;44;25;16;171;175;113;56;31;78;145;179;196;81;90;40;165;185;106;178;138;14;144;62;9;148;102;49;52;55;92;57;129;82;120;2;101;1;97;152;124;94;63;79;80;176;137;23;186;89;183;143;117;0;51;118;59;115;46;68;139,6447714781539790770,0.000000
steepest_intra:edges_start:greedy,70,71750,23180,48570,1,0,70;154;158;53;121;100;26;86;75;101;1;97;152;94;124;148;102;49;178;106;52;55;57;92;129;2;120;44;25;16;171;175;113;56;31;78;145;179;196;81;90;185;40;165;138;14;144;62;9;15;114;186;89;183;23;137;176;80;151;162;127;123;149;65;116;43;184;177;54;48;160;34;146;22;18;108;69;159;181;42;5;41;193;139;68;140;93;117;143;0;46;115;59;118;51;133;79;63;180;135,2581911045975166243,0.000000
steepest_intra:edges_start:greedy,71,72164,23636,48528,1,0,71;164;7;95;39;165;138;14;144;62;9;148;102;49;178;106;52;55;57;92;129;2;152;97;1;101;100;53;180;154;135;70;127;123;162;149;65;116;43;184;177;54;48;160;34;146;22;18;108;69;159;181;42;5;41;193;139;68;140;93;117;143;183;89;23;137;0;46;115;59;118;51;151;133;176;80;79;63;94;26;86;75;120;44;25;16;171;175;113;56;31;78;145;179;196;81;185;40;90;27,8461426277233734921,0.000000
steepest_intra:edges_start:greedy,72,72377,23627,48750,1,0,72;51;0;117;143;183;89;186;23;137;176;80;79;63;94;124;152;97;1;101;2;120;82;129;57;92;55;52;49;102;148;9;62;144;14;138;178;106;185;165;40;90;81;196;179;145;78;31;56;113;175;171;16;25;44;75;86;26;100;121;53;180;154;70;135;133;151;162;127;123;149;65;116;43;184;84;190;10;177;54;48;160;34;146;22;18;108;69;159;181;42;5;41;193;139;68;46;115;118;59,3877629823527683274,0.000000
steepest_intra:edges_start:greedy,73,72456,23554,48902,1,0,73;15;148;9;62;102;49;178;106;52;55;57;92;129;2;152;97;1;101;100;53;180;154;135;70;127;123;162;149;131;65;116;43;184;190;177;54;48;160;34;146;22;18;108;69;159;181;42;5;41;193;139;68;140;93;117;143;183;89;186;23;137;0;46;115;59;118;51;151;133;176;80;79;63;94;189;26;86;75;120;44;25;16;171;175;113;56;31;78;145;179;196;81;90;185;40;165;138;14;144,2005637677460638030,0.000000
steepest_intra:edges_start:greedy,74,72489,23273,49216,1,0,74;1;101;75;86;53;154;70;135;180;63;79;133;51;118;59;115;46;0;143;117;93;140;68;139;193;41;5;42;181;159;69;108;18;22;146;34;160;48;54;177;184;43;116;65;149;123;127;162;151;80;176;137;23;183;89;186;114;15;9;62;144;14;138;165;40;185;90;81;196;179;145;78;31;56;113;175;171;16;25;44;120;2;129;92;57;55;52;106;178;49;102;148;124;94;189;100;26;97;152,4439587749389206608,0.000000
steepest_intra:edges_start:greedy,75,72208,23680,48528,1,0,75;44;25;16;171;175;113;56;31;78;145;179;196;81;90;40;165;185;106;178;138;14;144;62;9;148;102;49;52;55;92;57;129;82;120;2;152;97;1;101;100;53;180;154;135;70;127;123;162;149;131;65;116;43;184;190;10;177;54;48;160;34;146;22;18;108;69;159;181;42;5;41;193;139;68;140;93;117;143;183;89;186;23;137;0;46;115;59;118;51;151;133;176;80;79;63;94;189;26;86,7531785239630445316,0.000000
steepest_intra:edges_start:greedy,76,73321,23737,49584,1,0,76;176;80;151;162;127;123;149;65;116;43;184;190;177;54;48;160;34;146;22;18;108;69;159;181;42;5;41;193;139;68;46;115;59;118;51;133;79;63;180;135;70;154;158;53;121;100;26;86;75;101;1;97;152;94;124;148;102;49;178;106;52;55;57;92;129;2;120;44;25;16;171;175;113;56;31;78;145;179;196;81;90;185;40;165;138;14;144;62;9;15;114;186;137;23;89;183;143;117;0,3033520186748303489,0.000000
steepest_intra:edges_start:greedy,77,72370,23528,48842,1,0,77;43;184;190;10;177;54;48;160;34;146;22;18;108;69;159;181;42;5;41;193;139;68;140;93;117;143;183;89;186;23;137;176;80;79;63;94;124;152;97;1;101;2;120;82;129;57;92;55;52;49;102;148;9;62;144;14;138;178;106;185;165;40;90;81;196;179;145;78;31;56;113;175;171;16;25;44;75;86;26;100;121;53;180;154;135;70;127;123;162;133;151;51;0;46;115;118;59;116;65,4972063021229988900,0.000000
steepest_intra:edges_start:greedy,78,71905,23579,48326,1,0,78;31;56;113;175;171;16;25;44;120;75;86;26;189;94;63;79;80;176;133;151;51;118;59;115;46;0;137;23;186;89;183;143;117;93;140;68;139;193;41;5;42;181;159;69;108;18;22;146;34;160;48;54;177;10;190;84;184;43;116;65;131;149;162;123;127;70;135;154;180;53;100;101;1;97;152;2;129;57;92;55;52;49;102;148;9;62;144;14;138;178;106;185;165;40;90;81;196;179;145,7015993157578704725,0.000000
steepest_intra:edges_start:greedy,79,72330,23522,48808,1,0,79;80;176;133;151;51;118;59;115;46;0;137;23;186;89;183;143;117;93;140;68;139;193;41;5;42;181;159;69;108;18;22;146;34;160;48;54;177;184;43;116;65;131;149;162;123;127;70;135;180;154;158;53;121;100;26;86;75;44;25;16;171;175;113;56;31;78;145;179;196;81;90;40;165;185;106;178;138;14;144;62;9;148;102;49;52;55;92;57;129;82;120;2;101;1;97;152;124;94;63,4622101104541480744,0.000000
steepest_intra:edges_start:greedy,80,71940,23456,48484,1,0,80;79;63;94;124;152;97;1;101;2;120;82;129;57;92;55;52;49;102;148;9;62;144;14;138;178;106;185;165;40;90;81;196;179;145;78;31;56;113;175;171;16;25;44;75;86;26;100;121;53;180;154;135;70;127;123;162;133;151;149;131;65;116;43;184;84;190;10;177;54;48;160;34;146;22;18;108;69;159;181;42;5;41;193;139;68;46;115;59;118;51;0;117;143;183;89;186;23;137;176,8663906224464111879,0.000000
steepest_intra:edges_start:greedy,81,71630,23304,48326,1,0,81;196;40;185;179;145;78;31;56;113;175;171;16;25;44;120;75;86;26;189;94;63;79;80;176;133;151;51;118;59;115;46;0;137;23;186;89;183;143;117;93;140;68;139;193;41;5;42;181;159;69;108;18;22;146;34;160;48;54;177;10;190;84;184;43;116;65;131;149;162;123;127;70;135;154;180;53;100;101;1;97;152;2;129;92;57;55;52;106;178;49;102;148;9;62;144;14;138;165;90,7457981794482536988,0.000000
steepest_intra:edges_start:greedy,82,72236,23708,48528,1,0,82;2;75;86;26;189;94;63;79;80;176;133;151;51;118;59;115;46;0;137;23;186;89;183;143;117;93;140;68;139;193;41;5;42;181;159;69;108;18;22;146;34;160;48;54;177;10;190;184;43;116;65;131;149;162;123;127;70;135;154;180;53;100;101;1;97;152;129;57;92;55;52;49;102;148;9;62;144;14;138;178;106;185;165;40;90;81;196;179;145;78;31;56;113;175;171;16;25;44;120,8087834057445133142,0.000000
steepest_intra:edges_start:greedy,83,72261,22842,49419,1,0,83;89;183;143;117;0;46;68;139;193;41;115;5;42;181;159;69;108;18;22;146;34;160;48;54;177;10;190;4;84;184;43;116;65;59;118;51;151;133;162;123;127;70;135;154;180;53;121;100;26;86;75;44;25;16;171;175;113;56;31;78;145;179;196;81;90;40;165;185;106;178;138;14;144;62;9;148;102;49;52;55;92;57;129;82;120;2;101;1;97;152;124;94;63;79;80;176;137;23;186,4180230248648889573,0.000000
steepest_intra:edges_start:greedy,84,71935,23606,48329,1,0,84;4;112;127;123;162;151;133;135;70;154;180;53;121;100;26;86;75;44;25;16;171;175;113;56;31;78;145;179;196;81;90;40;165;185;106;178;138;14;144;62;9;148;102;49;52;55;92;57;129;82;120;2;101;1;97;152;124;94;63;79;80;176;137;23;186;89;183;143;117;0;51;118;59;115;139;68;46;65;116;43;42;5;41;193;159;69;108;18;22;146;181;34;160;48;54;177;190;184;35,2524001907581937402,0.000000
steepest_intra:edges_start:greedy,85,72861,23848,49013,1,0,85;145;179;196;81;90;40;165;185;106;178;138;14;144;62;9;148;102;49;52;55;92;57;129;2;152;97;1;101;100;53;180;154;135;70;127;123;162;149;131;65;116;43;184;190;10;177;54;48;160;34;146;22;18;108;69;159;181;42;5;41;193;139;68;140;93;117;143;183;89;186;23;137;0;46;115;59;118;51;151;133;176;80;79;63;94;189;26;86;75;120;44;25;78;31;16;171;175;113;56,6152261356420877997,0.000000
steepest_intra:edges_start:greedy,86,71750,23180,48570,1,0,86;75;101;1;97;152;94;124;148;102;49;178;106;52;55;57;92;129;2;120;44;25;16;171;175;113;56;31;78;145;179;196;81;90;185;40;165;138;14;144;62;9;15;114;186;89;183;23;137;176;80;151;162;127;123;149;65;116;43;184;177;54;48;160;34;146;22;18;108;69;159;181;42;5;41;193;139;68;140;93;117;143;0;46;115;59;118;51;133;79;63;180;135;70;154;158;53;121;100;26,1122225397953878543,0.000000
steepest_intra:edges_start:greedy,87,73165,23569,49596,1,0,87;2;120;82;129;57;92;55;52;49;102;148;9;62;144;14;138;178;106;185;165;40;90;81;196;179;145;78;31;56;113;175;171;16;25;44;75;86;26;189;94;63;79;80;176;133;151;51;118;59;115;46;0;137;23;186;89;183;143;117;93;140;68;139;193;41;5;42;181;159;69;108;18;22;146;34;160;48;54;177;190;184;43;116;65;131;149;162;123;127;70;135;154;180;53;100;101;1;97;152,3368640670333781362,0.000000
steepest_intra:edges_start:greedy,88,72887,23626,49261,1,0,88;25;44;120;75;86;26;189;94;63;79;80;176;133;151;51;118;59;115;46;0;137;23;186;89;183;143;117;93;140;68;139;193;41;5;42;181;159;69;108;18;22;146;34;160;48;54;177;10;190;184;43;116;65;131;149;162;123;127;70;135;154;180;53;100;101;1;97;152;2;129;57;55;52;49;102;148;9;62;144;14;138;178;106;185;165;40;90;81;196;179;92;78;145;31;56;113;175;171;16,2194605004638995676,0.000000
steepest_intra:edges_start:greedy,89,71226,22804,48422,1,0,89;186;23;137;176;80;79;63;94;124;152;97;1;101;2;120;82;129;57;92;55;52;49;102;148;9;62;144;14;138;178;106;185;165;40;90;81;196;179;145;78;31;56;113;175;171;16;25;44;75;86;26;100;121;53;180;154;135;70;127;123;162;133;151;51;118;59;65;116;43;184;84;190;10;177;54;48;160;34;146;22;18;108;69;159;181;42;5;115;41;193;139;46;68;140;93;117;0;143;183,2244470979684818654,0.000000
steepest_intra:edges_start:greedy,90,71673,23347,48326,1,0,90;40;185;81;196;179;145;78;31;56;113;175;171;16;25;44;120;75;86;26;189;94;63;79;80;176;133;151;51;118;59;115;46;0;137;23;186;89;183;143;117;93;140;68;139;193;41;5;42;181;159;69;108;18;22;146;34;160;48;54;177;10;190;84;184;43;116;65;131;149;162;123;127;70;135;154;180;53;100;101;1;97;152;2;129;92;57;55;52;106;178;49;102;148;9;62;144;14;138;165,574267697287986607,0.000000
steepest_intra:edges_start:greedy,91,72110,23205,48905,1,0,91;179;145;78;31;56;113;175;171;16;25;44;120;75;86;26;189;94;63;79;80;176;133;151;51;118;59;115;46;0;137;23;186;89;183;143;117;93;140;68;139;193;41;5;42;181;159;69;108;18;22;146;34;160;48;54;177;10;190;184;43;116;65;131;149;162;123;127;70;135;154;180;53;100;101;1;97;152;2;129;92;57;55;52;49;102;148;9;62;144;14;138;178;106;185;165;40;90;81;196,8739869969581950602,0.000000
steepest_intra:edges_start:greedy,92,71905,23579,48326,1,0,92;55;52;49;102;148;9;62;144;14;138;178;106;185;165;40;90;81;196;179;145;78;31;56;113;175;171;16;25;44;120;75;86;26;189;94;63;79;80;176;133;151;51;118;59;115;46;0;137;23;186;89;183;143;117;93;140;68;139;193;41;5;42;181;159;69;108;18;22;146;34;160;48;54;177;10;190;84;184;43;116;65;131;149;162;123;127;70;135;154;180;53;100;101;1;97;152;2;129;57,2972901292872760893,0.000000
steepest_intra:edges_start:greedy,93,71968,23472,48496,1,0,93;140;108;69;18;22;146;159;193;41;5;42;181;34;160;48;54;177;10;190;4;84;184;43;116;65;149;123;127;162;151;133;135;70;154;180;53;121;100;26;86;75;44;25;16;171;175;113;56;31;78;145;179;196;81;90;40;165;185;106;178;138;14;144;62;9;148;102;49;52;55;92;57;129;82;120;2;101;1;97;152;124;94;63;79;80;176;137;51;118;59;115;139;46;68;0;89;183;143;117,70267831037329642,0.000000
steepest_intra:edges_start:greedy,94,71750,23180,48570,1,0,94;152;97;1;101;75;86;26;100;121;53;158;154;70;135;180;63;79;133;51;118;59;115;46;0;143;117;93;140;68;139;193;41;5;42;181;159;69;108;18;22;146;34;160;48;54;177;184;43;116;65;149;123;127;162;151;80;176;137;23;183;89;186;114;15;9;62;144;14;138;165;40;185;90;81;196;179;145;78;31;56;113;175;171;16;25;44;120;2;129;92;57;55;52;106;178;49;102;148;124,3717134755688683134,0.000000
steepest_intra:edges_start:greedy,95,72164,23636,48528,1,0,95;7;164;71;27;90;40;185;81;196;179;145;78;31;56;113;175;171;16;25;44;120;75;86;26;94;63;79;80;176;133;151;51;118;59;115;46;0;137;23;89;183;143;117;93;140;68;139;193;41;5;42;181;159;69;108;18;22;146;34;160;48;54;177;184;43;116;65;149;162;123;127;70;135;154;180;53;100;101;1;97;152;2;129;92;57;55;52;106;178;49;102;148;9;62;144;14;138;165;39,4672528517472573811,0.000000
steepest_intra:edges_start:greedy,96,72114,23548,48566,1,0,96;43;116;65;149;123;127;162;151;133;135;70;154;180;53;121;100;26;86;75;44;25;16;171;175;113;56;31;78;145;179;196;81;90;40;165;185;106;178;138;14;144;62;9;148;102;49;52;55;92;57;129;82;120;2;101;1;97;152;124;94;63;79;80;176;137;23;186;89;183;143;117;0;51;118;59;115;46;68;139;41;193;159;69;108;18;22;146;181;34;160;48;54;177;10;190;4;84;184;42,6974631567429131367,0.000000
steepest_intra:edges_start:greedy,97,71933,23455,48478,1,0,97;152;1;101;75;86;53;154;70;135;180;63;79;133;51;118;59;115;46;0;143;117;93;140;68;139;193;41;5;42;181;159;69;108;18;22;146;34;160;48;54;177;190;184;43;116;65;149;123;127;162;151;80;176;137;23;183;89;186;114;15;9;62;144;14;138;165;40;185;90;81;196;179;145;78;31;56;113;175;171;16;25;44;120;2;129;92;57;55;52;106;178;49;102;148;124;94;189;100;26,2879545401084652901,0.000000
steepest_intra:edges_start:greedy,98,73217,24027,49190,1,0,98;81;90;27;164;39;165;40;185;106;178;138;14;144;62;9;148;102;49;52;55;57;129;92;179;145;78;82;2;152;97;1;101;100;53;180;154;135;70;127;123;162;149;65;116;43;184;177;54;48;160;34;146;22;18;108;69;159;181;42;5;41;193;139;68;140;93;117;143;183;89;23;137;0;46;115;59;118;51;151;133;176;80;79;63;94;26;86;75;120;44;25;16;171;175;113;56;31;157;196,4558116871151740459,0.000000
steepest_intra:edges_start:greedy,99,72749,23378,49371,1,0,99;97;26;100;86;75;101;1;152;94;124;148;102;49;178;106;52;55;57;92;129;2;120;44;25;16;171;175;113;56;31;78;145;179;196;81;90;185;40;165;138;14;144;62;9;15;114;186;89;183;23;137;176;80;151;162;127;123;149;65;116;43;184;177;54;48;160;34;146;22;18;108;69;159;181;42;5;41;193;139;68;140;93;117;143;0;46;115;59;118;51;133;79;63;180;135;70;154;158;53,8820282080469282015,0.000000
steepest_intra:edges_start:greedy,100,71750,23180,48570,1,0,100;26;86;75;101;1;97;152;94;124;148;102;49;178;106;52;55;57;92;129;2;120;44;25;16;171;175;113;56;31;78;145;179;196;81;90;185;40;165;138;14;144;62;9;15;114;186;89;183;23;137;176;80;151;162;127;123;149;65;116;43;184;177;54;48;160;34;146;22;18;108;69;159;181;42;5;41;193;139;68;140;93;117;143;0;46;115;59;118;51;133;79;63;180;135;70;154;158;53;121,7796512421240368458,0.000000
steepest_intra:edges_start:greedy,101,71933,23455,48478,1,0,101;1;152;97;26;100;189;94;124;148;102;49;178;106;52;55;57;92;129;2;120;44;25;16;171;175;113;56;31;78;145;179;196;81;90;185;40;165;138;14;144;62;9;15;114;186;89;183;23;137;176;80;151;162;127;123;149;65;116;43;184;190;177;54;48;160;34;146;22;18;108;69;159;181;42;5;41;193;139;68;140;93;117;143;0;46;115;59;118;51;133;79;63;180;135;70;154;53;86;75,1384987163345293279,0.000000
steepest_intra:edges_start:greedy,102,71523,23197,48326,1,0,102;148;9;62;144;14;138;165;40;185;90;81;196;179;145;78;31;56;113;175;171;16;25;44;120;75;86;26;189;94;63;79;80;176;133;151;51;118;59;115;46;0;137;23;186;89;183;143;117;93;140;68;139;193;41;5;42;181;159;69;108;18;22;146;34;160;48;54;177;10;190;84;184;43;116;65;131;149;162;123;127;70;135;154;180;53;100;101;1;97;152;2;129;92;57;55;52;106;178;49,2373938662182085421,0.000000
steepest_intra:edges_start:greedy,103,71597,23235,48362,1,0,103;34;160;48;54;177;10;190;4;112;84;184;42;43;116;65;149;123;127;162;151;133;135;70;154;180;53;121;100;26;86;75;44;25;16;171;175;113;56;31;78;145;179;196;81;90;40;165;185;106;178;138;14;144;62;9;148;102;49;52;55;92;57;129;82;120;2;101;1;97;152;124;94;63;79;80;176;137;23;186;89;183;143;117;0;51;118;59;115;46;68;139;41;193;159;69;108;18;22;146,160095917741063904,0.000000
steepest_intra:edges_start:greedy,104,73110,23928,49182,1,0,104;54;48;34;160;181;42;195;146;22;18;108;69;159;41;193;139;68;140;93;117;143;183;89;186;23;137;176;80;79;63;94;124;152;97;1;101;2;120;82;129;57;92;55;52;49;102;148;9;62;144;14;138;178;106;185;165;40;90;81;196;179;145;78;31;56;113;175;171;16;25;44;75;86;26;100;121;53;180;154;135;70;127;123;162;133;151;51;0;46;115;118;59;116;65;43;184;4;10;177,9117846406035034700,0.000000
steepest_intra:edges_start:greedy,105,72453,23604,48849,1,0,105;116;43;184;84;190;10;177;54;48;160;34;146;22;18;108;69;159;181;42;5;41;193;139;68;46;115;118;59;51;0;117;143;183;89;186;23;137;176;80;79;63;94;124;152;97;1;101;2;120;82;129;57;92;55;52;49;102;148;9;62;144;14;138;178;106;185;165;40;90;81;196;179;145;78;31;56;113;175;171;16;25;44;75;86;26;100;121;53;180;154;70;135;133;151;162;127;123;149;65,7304984519600919046,0.000000
steepest_intra:edges_start:greedy,106,71523,23197,48326,1,0,106;178;49;102;148;9;62;144;14;138;165;40;185;90;81;196;179;145;78;31;56;113;175;171;16;25;44;120;75;86;26;189;94;63;79;80;176;133;151;51;118;59;115;46;0;137;23;186;89;183;143;117;93;140;68;139;193;41;5;42;181;159;69;108;18;22;146;34;160;48;54;177;10;190;84;184;43;116;65;131;149;162;123;127;70;135;154;180;53;100;101;1;97;152;2;129;92;57;55;52,959009559078229261,0.000000
steepest_intra:edges_start:greedy,107,72830,23628,49202,1,0,107;27;164;7;95;39;165;138;14;144;62;9;148;102;49;178;106;52;55;57;92;129;2;152;97;1;101;100;53;180;154;135;70;127;123;162;149;65;116;43;184;177;54;48;160;34;146;22;18;108;69;159;181;42;5;41;193;139;68;140;93;117;143;183;89;23;137;0;46;115;59;118;51;151;133;176;80;79;63;94;26;86;75;120;44;25;16;171;175;113;56;31;78;145;179;196;81;185;40;90,3715371110596587455,0.000000
steepest_intra:edges_start:greedy,108,72218,23381,48837,1,0,108;69;139;68;46;115;59;118;51;0;117;143;183;89;186;23;137;176;80;79;63;94;124;152;97;1;101;2;120;82;129;57;92;55;52;49;102;148;9;62;144;14;138;178;106;185;165;40;90;81;196;179;145;78;31;56;113;175;171;16;25;44;75;86;26;100;121;53;180;154;70;135;133;151;162;127;123;149;65;116;43;184;84;190;10;177;54;48;160;34;181;42;5;41;193;159;146;22;20;18,6935146092864160480,0.000000
steepest_intra:edges_start:greedy,109,72236,23390,48846,1,0,109;118;115;46;68;139;193;41;5;42;181;159;69;108;18;22;146;34;160;48;54;177;10;190;4;84;184;43;65;116;59;151;133;162;123;127;70;135;154;180;53;121;100;26;86;75;44;25;16;171;175;113;56;31;78;145;179;196;81;90;40;165;185;106;178;138;14;144;62;9;148;102;49;52;55;92;57;129;82;120;2;101;1;97;152;124;94;63;79;80;176;137;23;186;89;183;143;117;0;51,6994788870875282107,0.000000
steepest_intra:edges_start:greedy,110,72558,23584,48974,1,0,110;193;41;5;42;181;159;69;108;18;22;146;34;160;48;54;177;10;190;84;184;43;116;65;149;123;127;162;151;133;135;70;154;180;53;121;100;26;86;75;44;25;16;171;175;113;56;31;78;145;179;196;81;90;40;165;185;106;178;138;14;144;62;9;148;102;49;52;55;92;57;129;82;120;2;101;1;97;152;124;94;63;79;80;176;137;23;186;89;183;143;117;0;51;118;59;115;46;68;139,217348459928008393,0.000000
steepest_intra:edges_start:greedy,111,72861,23747,49114,1,0,111;148;9;62;102;144;14;49;178;106;165;39;95;164;27;90;81;196;40;185;52;55;57;129;92;179;145;78;31;56;113;175;171;16;25;44;120;2;152;97;1;101;75;86;26;100;121;53;158;154;70;135;180;63;79;133;51;118;59;115;46;0;89;183;143;117;93;140;68;139;193;41;5;42;181;159;69;108;18;22;146;34;160;48;54;177;184;43;116;65;149;123;127;162;151;80;176;137;94;124,2805819017307626831,0.000000
steepest_intra:edges_start:greedy,112,71935,23606,48329,1,0,112;4;84;35;184;190;177;54;48;160;34;181;146;22;18;108;69;159;193;41;5;42;43;116;65;46;68;139;115;59;118;51;0;117;143;183;89;186;23;137;176;80;79;63;94;124;152;97;1;101;2;120;82;129;57;92;55;52;49;102;148;9;62;144;14;138;178;106;185;165;40;90;81;196;179;145;78;31;56;113;175;171;16;25;44;75;86;26;100;121;53;180;154;70;135;133;151;162;123;127,3200228534020428183,0.000000
steepest_intra:edges_start:greedy,113,72017,23691,48326,1,0,113;56;31;145;78;92;179;196;81;90;40;165;185;106;178;138;14;144;62;9;148;102;49;52;55;57;129;2;152;97;1;101;100;53;180;154;135;70;127;123;162;149;131;65;116;43;184;84;190;10;177;54;48;160;34;146;22;18;108;69;159;181;42;5;41;193;139;68;140;93;117;143;183;89;186;23;137;0;46;115;59;118;51;151;133;176;80;79;63;94;189;26;86;75;120;44;25;16;171;175,491371508131925202,0.000000
steepest_intra:edges_start:greedy,114,71682,23112,48570,1,0,114;186;89;183;23;137;176;80;151;162;127;123;149;65;116;43;184;177;54;48;160;34;146;22;18;108;69;159;181;42;5;41;193;139;68;140;93;117;143;0;46;115;59;118;51;133;79;63;180;135;70;154;158;53;121;100;26;86;75;101;1;97;152;94;124;148;9;62;102;49;178;106;52;55;57;92;129;2;120;44;25;16;171;175;113;56;31;78;145;179;196;81;90;185;40;165;138;14;144;15,9083696840410127119,0.000000
steepest_intra:edges_start:greedy,115,71947,23578,48369,1,0,115;59;118;51;0;117;143;183;89;186;23;137;176;80;79;63;94;124;152;97;1;101;2;120;82;129;57;92;55;52;49;102;148;9;62;144;14;138;178;106;185;165;40;90;81;196;179;145;78;31;56;113;175;171;16;25;44;75;86;26;100;121;53;180;154;70;135;133;151;162;127;123;149;65;116;43;184;84;4;190;10;177;54;48;160;34;146;22;18;108;69;159;181;42;5;41;193;139;68;46,4254697979079746110,0.000000
steepest_intra:edges_start:greedy,116,71947,23578,48369,1,0,116;43;184;84;4;190;10;177;54;48;160;34;146;22;18;108;69;159;181;42;5;41;193;139;68;46;115;59;118;51;0;117;143;183;89;186;23;137;176;80;79;63;94;124;152;97;1;101;2;120;82;129;57;92;55;52;49;102;148;9;62;144;14;138;178;106;185;165;40;90;81;196;179;145;78;31;56;113;175;171;16;25;44;75;86;26;100;121;53;180;154;70;135;133;151;162;127;123;149;65,8720237266402137780,0.000000
steepest_intra:edges_start:greedy,117,71108,22981,48127,1,0,117;0;46;68;139;193;41;115;5;42;181;159;69;108;18;22;146;34;160;48;54;177;10;190;4;112;84;184;43;116;65;59;118;51;151;133;162;123;127;70;135;154;180;53;121;100;26;86;75;44;25;16;171;175;113;56;31;78;145;179;196;81;90;40;165;185;106;178;138;14;144;62;9;148;102;49;52;55;92;57;129;82;120;2;101;1;97;152;124;94;63;79;80;176;137;23;186;89;183;143,891220797047762018,0.000000
steepest_intra:edges_start:greedy,118,72006,23637,48369,1,0,118;115;46;68;139;193;41;5;42;181;159;69;108;18;22;146;34;160;48;54;177;10;190;4;84;184;43;116;65;149;123;127;162;151;133;135;70;154;180;53;121;100;26;86;75;44;25;16;171;175;113;56;31;78;145;179;196;81;90;40;165;185;106;178;138;14;144;62;9;148;102;49;52;55;92;57;129;82;120;2;101;1;97;152;124;94;63;79;80;176;137;23;186;89;183;143;117;0;51;59,3723052246393711406,0.000000
steepest_intra:edges_start:greedy,119,71472,23013,48459,1,0,119;40;185;90;81;196;179;145;78;31;56;113;175;171;16;25;44;120;75;86;26;189;94;63;79;80;176;133;151;51;118;59;115;46;0;137;23;186;89;183;143;117;93;140;68;139;193;41;5;42;181;159;69;108;18;22;146;34;160;48;54;177;10;190;184;43;116;65;131;149;162;123;127;70;135;154;180;53;100;101;1;97;152;2;129;92;57;55;52;106;178;49;102;148;9;62;144;14;138;165,593790832874361594,0.000000
steepest_intra:edges_start:greedy,120,71905,23579,48326,1,0,120;75;86;26;189;94;63;79;80;176;133;151;51;118;59;115;46;0;137;23;186;89;183;143;117;93;140;68;139;193;41;5;42;181;159;69;108;18;22;146;34;160;48;54;177;10;190;84;184;43;116;65;131;149;162;123;127;70;135;154;180;53;100;101;1;97;152;2;129;57;92;55;52;49;102;148;9;62;144;14;138;178;106;185;165;40;90;81;196;179;145;78;31;56;113;175;171;16;25;44,365461159964338235,0.000000
steepest_intra:edges_start:greedy,121,71867,23297,48570,1,0,121;100;26;97;86;75;101;1;152;94;124;148;102;49;178;106;52;55;57;92;129;2;120;44;25;16;171;175;113;56;31;78;145;179;196;81;90;185;40;165;138;14;144;62;9;15;114;186;89;183;23;137;176;80;151;162;127;123;149;65;116;43;184;177;54;48;160;34;146;22;18;108;69;159;181;42;5;41;193;139;68;140;93;117;143;0;46;115;59;118;51;133;79;63;180;135;70;154;158;53,5057507945617779192,0.000000
steepest_intra:edges_start:greedy,122,72576,23444,49132,1,0,122;176;80;79;133;151;51;118;59;115;46;0;137;23;89;183;143;117;93;140;68;139;193;41;5;42;181;159;69;108;18;22;146;34;160;48;54;177;184;43;116;65;131;149;162;123;127;70;135;180;154;158;53;121;100;26;86;75;44;25;16;171;175;113;56;31;78;145;179;196;81;90;40;165;185;106;178;138;14;144;62;9;148;102;49;52;55;92;57;129;82;120;2;101;1;97;152;124;94;63,3974121876618277758,0.000000
steepest_intra:edges_start:greedy,123,71940,23456,48484,1,0,123;162;133;151;149;131;65;116;43;184;84;190;10;177;54;48;160;34;146;22;18;108;69;159;181;42;5;41;193;139;68;46;115;59;118;51;0;117;143;183;89;186;23;137;176;80;79;63;94;124;152;97;1;101;2;120;82;129;57;92;55;52;49;102;148;9;62;144;14;138;178;106;185;165;40;90;81;196;179;145;78;31;56;113;175;171;16;25;44;75;86;26;100;121;53;180;154;135;70;127,485505255665112079,0.000000
steepest_intra:edges_start:greedy,124,71861,23291,48570,1,0,124;152;97;1;101;75;86;26;100;121;53;158;154;70;135;180;63;79;133;51;118;59;115;46;0;143;117;93;140;68;139;193;41;5;42;181;159;69;108;18;22;146;34;160;48;54;177;184;43;116;65;149;123;127;162;151;80;176;137;23;183;89;186;114;15;9;62;144;14;138;165;40;185;90;81;196;179;145;78;31;56;113;175;171;16;25;44;120;2;129;92;57;55;52;106;178;49;102;148;94,6353942995542550604,0.000000
steepest_intra:edges_start:greedy,125,73395,23511,49884,1,0,125;2;120;82;129;57;92;179;145;78;31;56;113;175;171;16;25;44;75;86;53;154;70;135;180;63;79;133;51;118;59;115;46;0;143;117;93;140;68;139;193;41;5;42;181;159;69;108;18;22;146;34;160;48;54;177;184;43;116;65;149;123;162;151;80;176;137;23;183;89;186;114;15;9;62;144;14;138;165;90;81;196;40;185;55;52;106;178;49;102;148;124;94;189;100;26;1;101;97;152,4478112644210299389,0.000000
steepest_intra:edges_start:greedy,126,72420,23391,49029,1,0,126;112;4;84;35;184;177;54;48;160;34;181;146;22;18;108;69;159;193;41;5;42;43;116;65;46;68;139;115;59;118;51;0;117;143;183;89;186;23;137;176;80;79;63;94;124;152;97;1;101;2;120;82;129;57;92;55;52;49;102;148;9;62;144;14;138;178;106;185;165;40;90;81;196;179;145;78;31;56;113;175;171;16;25;44;75;86;26;100;121;53;180;154;70;135;133;151;162;123;127,2884859684427591092,0.000000
steepest_intra:edges_start:greedy,127,72193,23609,48584,1,0,127;70;135;154;180;53;121;100;26;86;75;44;25;16;171;175;113;56;31;78;145;179;196;81;90;40;165;185;106;178;138;14;144;62;9;148;102;49;52;55;92;57;129;82;120;2;101;1;97;152;124;94;63;79;80;176;133;151;51;118;59;115;46;0;137;23;186;89;183;143;117;93;140;68;139;193;41;5;42;181;159;69;108;18;22;146;34;160;48;54;177;190;184;43;116;65;131;149;162;123,879615183268075123,0.000000
steepest_intra:edges_start:greedy,128,72267,23379,48888,1,0,128;167;148;9;62;102;144;14;49;178;106;165;40;185;90;81;196;179;145;78;31;56;113;175;171;16;25;44;120;75;86;26;189;94;63;79;80;176;133;151;51;118;59;115;46;0;137;23;186;89;183;143;117;93;140;68;139;193;41;5;42;181;159;69;108;18;22;146;34;160;48;54;177;10;190;184;43;116;65;131;149;162;123;127;70;135;154;180;53;100;101;1;97;152;2;129;92;57;52;55,1740723882675908440,0.000000
steepest_intra:edges_start:greedy,129,71905,23579,48326,1,0,129;57;92;55;52;49;102;148;9;62;144;14;138;178;106;185;165;40;90;81;196;179;145;78;31;56;113;175;171;16;25;44;120;75;86;26;189;94;63;79;80;176;133;151;51;118;59;115;46;0;137;23;186;89;183;143;117;93;140;68;139;193;41;5;42;181;159;69;108;18;22;146;34;160;48;54;177;10;190;84;184;43;116;65;131;149;162;123;127;70;135;154;180;53;100;101;1;97;152;2,4039356810002847356,0.000000
steepest_intra:edges_start:greedy,130,72516,23221,49295,1,0,130;148;102;49;178;106;52;55;57;92;129;2;120;44;25;16;171;175;113;56;31;78;145;179;196;81;90;185;40;165;138;14;144;62;9;15;114;186;89;183;23;137;176;80;151;162;127;123;149;65;116;43;184;177;54;48;160;34;146;22;18;108;69;159;181;42;5;41;193;139;68;140;93;117;143;0;46;115;59;118;51;133;79;63;180;135;70;154;158;53;121;100;26;86;75;101;1;97;152;94,1221870736799237320,0.000000
steepest_intra:edges_start:greedy,131,71993,23509,48484,1,0,131;149;123;127;162;151;133;135;70;154;180;53;121;100;26;86;75;44;25;16;171;175;113;56;31;78;145;179;196;81;90;40;165;185;106;178;138;14;144;62;9;148;102;49;52;55;92;57;129;82;120;2;101;1;97;152;124;94;63;79;80;176;137;23;186;89;183;143;117;0;51;118;59;115;46;68;139;193;41;5;42;181;159;69;108;18;22;146;34;160;48;54;177;10;190;84;184;43;116;65,861404193012879177,0.000000
steepest_intra:edges_start:greedy,132,72621,23434,49187,1,0,132;14;138;165;40;185;90;81;196;179;145;78;31;56;113;175;171;16;25;44;120;75;86;26;189;94;63;79;80;176;133;151;51;118;59;115;46;0;137;23;186;89;183;143;117;93;140;68;139;193;41;5;42;181;159;69;108;18;22;146;34;160;48;54;177;10;190;184;43;116;65;131;149;162;123;127;70;135;154;180;53;100;101;1;97;152;2;129;92;57;55;52;106;178;49;102;148;9;62;144,6091729223730738970,0.000000
steepest_intra:edges_start:greedy,133,72193,23609,48584,1,0,133;151;51;118;59;115;46;0;137;23;186;89;183;143;117;93;140;68;139;193;41;5;42;181;159;69;108;18;22;146;34;160;48;54;177;190;184;43;116;65;131;149;162;123;127;70;135;154;180;53;121;100;26;86;75;44;25;16;171;175;113;56;31;78;145;179;196;81;90;40;165;185;106;178;138;14;144;62;9;148;102;49;52;55;92;57;129;82;120;2;101;1;97;152;124;94;63;79;80;176,8310879384611392545,0.000000
steepest_intra:edges_start:greedy,134,73278,23531,49747,1,0,134;108;18;69;139;68;46;115;59;118;51;0;117;143;183;89;186;23;137;176;80;79;63;94;124;152;97;1;101;2;120;82;129;57;92;55;52;49;102;148;9;62;144;14;138;178;106;185;165;40;90;81;196;179;145;78;31;56;113;175;171;16;25;44;75;86;26;100;121;53;180;154;70;135;133;151;162;127;123;149;65;116;43;184;190;10;177;54;48;160;34;181;42;5;41;193;159;146;22;20,2350342563947151013,0.000000
steepest_intra:edges_start:greedy,135,71750,23180,48570,1,0,135;70;154;158;53;121;100;26;86;75;101;1;97;152;94;124;148;102;49;178;106;52;55;57;92;129;2;120;44;25;16;171;175;113;56;31;78;145;179;196;81;90;185;40;165;138;14;144;62;9;15;114;186;89;183;23;137;176;80;151;162;127;123;149;65;116;43;184;177;54;48;160;34;146;22;18;108;69;159;181;42;5;41;193;139;68;140;93;117;143;0;46;115;59;118;51;133;79;63;180,8424231976188163350,0.000000
steepest_intra:edges_start:greedy,136,72536,23768,48768,1,0,136;121;100;26;86;75;44;25;16;171;175;113;56;31;78;145;179;196;81;90;40;165;185;106;178;138;14;144;62;9;148;102;49;52;55;92;57;129;82;120;2;101;1;97;152;124;94;63;79;80;176;137;23;186;89;183;143;117;0;51;118;59;115;46;68;139;193;41;5;42;181;159;69;108;18;22;146;34;160;48;54;177;10;190;84;184;43;116;65;149;123;127;162;151;133;180;135;70;154;53,5004823974660103328,0.000000
steepest_intra:edges_start:greedy,137,71750,23180,48570,1,0,137;23;183;89;186;114;15;9;62;144;14;138;165;40;185;90;81;196;179;145;78;31;56;113;175;171;16;25;44;120;2;129;92;57;55;52;106;178;49;102;148;124;94;152;97;1;101;75;86;26;100;121;53;158;154;70;135;180;63;79;133;51;118;59;115;46;0;143;117;93;140;68;139;193;41;5;42;181;159;69;108;18;22;146;34;160;48;54;177;184;43;116;65;149;123;127;162;151;80;176,8679987959379576134,0.000000
steepest_intra:edges_start:greedy,138,71523,23197,48326,1,0,138;14;144;62;9;148;102;49;178;106;52;55;57;92;129;2;152;97;1;101;100;53;180;154;135;70;127;123;162;149;131;65;116;43;184;84;190;10;177;54;48;160;34;146;22;18;108;69;159;181;42;5;41;193;139;68;140;93;117;143;183;89;186;23;137;0;46;115;59;118;51;151;133;176;80;79;63;94;189;26;86;75;120;44;25;16;171;175;113;56;31;78;145;179;196;81;90;185;40;165,6392601535491630986,0.000000
steepest_intra:edges_start:greedy,139,71947,23578,48369,1,0,139;68;46;115;59;118;51;0;117;143;183;89;186;23;137;176;80;79;63;94;124;152;97;1;101;2;120;82;129;57;92;55;52;49;102;148;9;62;144;14;138;178;106;185;165;40;90;81;196;179;145;78;31;56;113;175;171;16;25;44;75;86;26;100;121;53;180;154;70;135;133;151;162;127;123;149;65;116;43;184;84;4;190;10;177;54;48;160;34;146;22;18;108;69;159;181;42;5;41;193,8193136330116814371,0.000000
steepest_intra:edges_start:greedy,140,71968,23472,48496,1,0,140;108;69;18;22;146;159;193;41;5;42;181;34;160;48;54;177;10;190;4;84;184;43;116;65;149;123;127;162;151;133;135;70;154;180;53;121;100;26;86;75;44;25;16;171;175;113;56;31;78;145;179;196;81;90;40;165;185;106;178;138;14;144;62;9;148;102;49;52;55;92;57;129;82;120;2;101;1;97;152;124;94;63;79;80;176;137;51;118;59;115;139;46;68;0;89;183;143;117;93,1763774118143172067,0.000000
steepest_intra:edges_start:greedy,141,72824,23488,49336,1,0,141;23;186;89;183;143;117;0;93;140;68;46;115;139;193;41;5;42;181;159;69;108;18;22;146;34;160;48;54;177;10;190;184;43;116;65;59;118;51;151;133;162;123;127;70;135;154;180;53;121;100;26;86;75;44;25;16;171;175;113;56;31;78;145;179;196;81;90;40;165;185;106;178;138;14;144;62;9;148;102;49;52;55;92;57;129;82;120;2;101;1;97;152;124;94;63;79;80;176;137,7904260256975667218,0.000000
steepest_intra:edges_start:greedy,142,72909,23572,49337,1,0,142;139;68;46;115;59;118;51;0;117;143;183;89;186;23;137;176;80;79;63;94;124;152;97;1;101;2;120;82;129;57;92;55;52;49;102;148;9;62;144;14;138;178;106;185;165;40;90;81;196;179;145;78;31;56;113;175;171;16;25;44;75;86;26;100;121;53;180;154;70;135;133;151;162;127;123;149;65;116;43;184;84;190;10;177;54;48;160;34;146;22;18;108;69;159;181;42;5;41;193,2507958334653729477,0.000000
steepest_intra:edges_start:greedy,143,71108,22981,48127,1,0,143;117;0;46;68;139;193;41;115;5;42;181;159;69;108;18;22;146;34;160;48;54;177;10;190;4;112;84;184;43;116;65;59;118;51;151;133;162;123;127;70;135;154;180;53;121;100;26;86;75;44;25;16;171;175;113;56;31;78;145;179;196;81;90;40;165;185;106;178;138;14;144;62;9;148;102;49;52;55;92;57;129;82;120;2;101;1;97;152;124;94;63;79;80;176;137;23;186;89;183,9063044787280775025,0.000000
steepest_intra:edges_start:greedy,144,71523,23197,48326,1,0,144;14;138;165;40;185;90;81;196;179;145;78;31;56;113;175;171;16;25;44;120;75;86;26;189;94;63;79;80;176;133;151;51;118;59;115;46;0;137;23;186;89;183;143;117;93;140;68;139;193;41;5;42;181;159;69;108;18;22;146;34;160;48;54;177;10;190;84;184;43;116;65;131;149;162;123;127;70;135;154;180;53;100;101;1;97;152;2;129;92;57;55;52;106;178;49;102;148;9;62,6786331351398502678,0.000000
steepest_intra:edges_start:greedy,145,71905,23579,48326,1,0,145;179;196;81;90;40;165;185;106;178;138;14;144;62;9;148;102;49;52;55;92;57;129;2;152;97;1;101;100;53;180;154;135;70;127;123;162;149;131;65;116;43;184;84;190;10;177;54;48;160;34;146;22;18;108;69;159;181;42;5;41;193;139;68;140;93;117;143;183;89;186;23;137;0;46;115;59;118;51;151;133;176;80;79;63;94;189;26;86;75;120;44;25;16;171;175;113;56;31;78,2219060110202465860,0.000000
steepest_intra:edges_start:greedy,146,71385,23490,47895,1,0,146;181;34;160;48;54;177;10;190;4;112;84;184;42;43;116;65;149;123;127;162;151;133;135;70;154;180;53;121;100;26;86;75;44;25;16;171;175;113;56;31;78;145;179;196;81;90;40;165;185;106;178;138;14;144;62;9;148;102;49;52;55;92;57;129;82;120;2;101;1;97;152;124;94;63;79;80;176;137;23;186;89;183;143;117;0;51;118;59;115;46;68;139;41;193;159;69;108;18;22,2494930808403843223,0.000000
steepest_intra:edges_start:greedy,147,73391,23933,49458,1,0,147;177;10;4;184;43;65;116;59;118;115;46;0;51;151;133;162;123;127;70;135;154;180;53;121;100;26;86;75;44;25;16;171;175;113;56;31;78;145;179;196;81;90;40;165;185;106;178;138;14;144;62;9;148;102;49;52;55;92;57;129;82;120;2;101;1;97;152;124;94;63;79;80;176;137;23;186;89;183;143;117;93;140;68;139;193;41;159;69;108;18;22;146;195;42;181;160;34;48;54,2900856346997738344,0.000000
steepest_intra:edges_start:greedy,148,71523,23197,48326,1,0,148;102;49;178;106;52;55;57;92;129;2;152;97;1;101;100;53;180;154;135;70;127;123;162;149;131;65;116;43;184;84;190;10;177;54;48;160;34;146;22;18;108;69;159;181;42;5;41;193;139;68;140;93;117;143;183;89;186;23;137;0;46;115;59;118;51;151;133;176;80;79;63;94;189;26;86;75;120;44;25;16;171;175;113;56;31;78;145;179;196;81;90;185;40;165;138;14;144;62;9,7016038973940288133,0.000000
steepest_intra:edges_start:greedy,149,71947,23578,48369,1,0,149;123;127;162;151;133;135;70;154;180;53;121;100;26;86;75;44;25;16;171;175;113;56;31;78;145;179;196;81;90;40;165;185;106;178;138;14;144;62;9;148;102;49;52;55;92;57;129;82;120;2;101;1;97;152;124;94;63;79;80;176;137;23;186;89;183;143;117;0;51;118;59;115;46;68;139;193;41;5;42;181;159;69;108;18;22;146;34;160;48;54;177;10;190;4;84;184;43;116;65,8718002907495505729,0.000000
steepest_intra:edges_start:greedy,150,73393,23514,49879,1,0,150;75;44;25;16;171;175;113;56;31;78;145;179;92;57;129;82;120;2;1;152;97;26;100;189;94;124;148;102;49;178;106;52;55;185;40;196;81;90;165;138;14;144;62;9;15;114;186;89;183;23;137;176;80;151;162;123;149;65;116;43;184;177;54;48;160;34;146;22;18;108;69;159;181;42;5;41;193;139;68;140;93;117;143;0;46;115;59;118;51;133;79;63;180;135;70;154;53;86;101,6624573401813018016,0.000000
steepest_intra:edges_start:greedy,151,71940,23456,48484,1,0,151;133;162;123;127;70;135;154;180;53;121;100;26;86;75;44;25;16;171;175;113;56;31;78;145;179;196;81;90;40;165;185;106;178;138;14;144;62;9;148;102;49;52;55;92;57;129;82;120;2;101;1;97;152;124;94;63;79;80;176;137;23;186;89;183;143;117;0;51;118;59;115;46;68;139;193;41;5;42;181;159;69;108;18;22;146;34;160;48;54;177;10;190;84;184;43;116;65;131;149,2246680546607574740,0.000000
steepest_intra:edges_start:greedy,152,71933,23455,48478,1,0,152;1;101;75;86;53;154;70;135;180;63;79;133;51;118;59;115;46;0;143;117;93;140;68;139;193;41;5;42;181;159;69;108;18;22;146;34;160;48;54;177;190;184;43;116;65;149;123;127;162;151;80;176;137;23;183;89;186;114;15;9;62;144;14;138;165;40;185;90;81;196;179;145;78;31;56;113;175;171;16;25;44;120;2;129;92;57;55;52;106;178;49;102;148;124;94;189;100;26;97,2685506458088267995,0.000000
steepest_intra:edges_start:greedy,153,71836,23029,48807,1,0,153;0;117;143;183;89;186;23;137;176;80;79;63;94;124;152;97;1;101;2;120;82;129;57;92;55;52;49;102;148;9;62;144;14;138;178;106;185;165;40;90;81;196;179;145;78;31;56;113;175;171;16;25;44;75;86;26;100;121;53;180;154;135;70;127;123;162;133;151;51;118;59;65;116;43;184;84;4;190;10;177;54;48;160;34;146;22;18;108;69;159;181;42;5;115;41;193;139;68;46,7103845337275478710,0.000000
steepest_intra:edges_start:greedy,154,71750,23180,48570,1,0,154;158;53;121;100;26;86;75;101;1;97;152;94;124;148;102;49;178;106;52;55;57;92;129;2;120;44;25;16;171;175;113;56;31;78;145;179;196;81;90;185;40;165;138;14;144;62;9;15;114;186;89;183;23;137;176;80;151;162;127;123;149;65;116;43;184;177;54;48;160;34;146;22;18;108;69;159;181;42;5;41;193;139;68;140;93;117;143;0;46;115;59;118;51;133;79;63;180;135;70,3478418354725500517,0.000000
steepest_intra:edges_start:greedy,155,72039,23020,49019,1,0,155;14;138;165;40;185;90;81;196;179;145;78;31;56;113;175;171;16;25;44;120;75;86;26;189;94;63;79;80;176;133;151;51;118;59;115;46;0;137;23;186;89;183;143;117;93;140;68;139;193;41;5;42;181;159;69;108;18;22;146;34;160;48;54;177;10;190;184;43;116;65;131;149;162;123;127;70;135;154;180;53;100;101;1;97;152;2;129;92;57;55;52;106;178;49;102;148;9;62;144,6651979942678210935,0.000000
steepest_intra:edges_start:greedy,156,72431,23408,49023,1,0,156;112;4;84;35;184;177;54;48;160;34;181;146;22;18;108;69;159;193;41;5;42;43;116;65;46;68;139;115;59;118;51;0;117;143;183;89;186;23;137;176;80;79;63;94;124;152;97;1;101;2;120;82;129;57;92;55;52;49;102;148;9;62;144;14;138;178;106;185;165;40;90;81;196;179;145;78;31;56;113;175;171;16;25;44;75;86;26;100;121;53;180;154;70;135;133;151;162;123;127,4914251144350750573,0.000000
steepest_intra:edges_start:greedy,157,72008,23507,48501,1,0,157;196;81;90;40;165;185;106;178;138;14;144;62;9;148;102;49;52;55;179;145;78;92;57;129;2;152;97;1;101;100;53;180;154;135;70;127;123;162;149;131;65;116;43;184;190;10;177;54;48;160;34;146;22;18;108;69;159;181;42;5;41;193;139;68;140;93;117;143;183;89;186;23;137;0;46;115;59;118;51;151;133;176;80;79;63;94;189;26;86;75;120;44;25;16;171;175;113;56;31,7081035770806643393,0.000000
steepest_intra:edges_start:greedy,158,71750,23180,48570,1,0,158;154;70;135;180;63;79;133;51;118;59;115;46;0;143;117;93;140;68;139;193;41;5;42;181;159;69;108;18;22;146;34;160;48;54;177;184;43;116;65;149;123;127;162;151;80;176;137;23;183;89;186;114;15;9;62;144;14;138;165;40;185;90;81;196;179;145;78;31;56;113;175;171;16;25;44;120;2;129;92;57;55;52;106;178;49;102;148;124;94;152;97;1;101;75;86;26;100;121;53,2015012997390049367,0.000000
steepest_intra:edges_start:greedy,159,71968,23472,48496,1,0,159;146;22;18;69;108;140;93;117;143;183;89;0;68;46;139;115;59;118;51;137;176;80;79;63;94;124;152;97;1;101;2;120;82;129;57;92;55;52;49;102;148;9;62;144;14;138;178;106;185;165;40;90;81;196;179;145;78;31;56;113;175;171;16;25;44;75;86;26;100;121;53;180;154;70;135;133;151;162;127;123;149;65;116;43;184;84;4;190;10;177;54;48;160;34;181;42;5;41;193,7827629722587195109,0.000000
steepest_intra:edges_start:greedy,160,71385,23490,47895,1,0,160;48;54;177;10;190;4;112;84;184;42;43;116;65;149;123;127;162;151;133;135;70;154;180;53;121;100;26;86;75;44;25;16;171;175;113;56;31;78;145;179;196;81;90;40;165;185;106;178;138;14;144;62;9;148;102;49;52;55;92;57;129;82;120;2;101;1;97;152;124;94;63;79;80;176;137;23;186;89;183;143;117;0;51;118;59;115;46;68;139;41;193;159;69;108;18;22;146;181;34,7342119661282106473,0.000000
steepest_intra:edges_start:greedy,161,73384,23693,49691,1,0,161;133;135;70;180;154;158;53;121;100;26;86;75;44;25;16;171;175;113;56;31;78;145;179;196;81;90;40;165;185;106;178;138;14;144;62;9;148;102;49;52;55;92;57;129;82;120;2;101;1;97;152;124;94;63;79;80;176;137;23;186;89;183;143;117;0;51;118;59;115;46;68;139;193;41;5;42;181;159;69;108;18;22;146;34;160;48;54;177;10;190;184;43;116;65;131;149;151;162;123,5041744154510527296,0.000000
steepest_intra:edges_start:greedy,162,71947,23578,48369,1,0,162;151;133;135;70;154;180;53;121;100;26;86;75;44;25;16;171;175;113;56;31;78;145;179;196;81;90;40;165;185;106;178;138;14;144;62;9;148;102;49;52;55;92;57;129;82;120;2;101;1;97;152;124;94;63;79;80;176;137;23;186;89;183;143;117;0;51;118;59;115;46;68;139;193;41;5;42;181;159;69;108;18;22;146;34;160;48;54;177;10;190;4;84;184;43;116;65;149;123;127,2861427586329086688,0.000000
steepest_intra:edges_start:greedy,163,72555,23328,49227,1,0,163;139;68;46;115;59;118;51;0;117;143;183;89;186;23;137;176;80;79;63;94;124;152;97;1;101;2;120;82;129;57;92;55;52;49;102;148;9;62;144;14;138;178;106;185;165;40;90;81;196;179;145;78;31;56;113;175;171;16;25;44;75;86;26;100;121;53;180;154;70;135;133;151;162;127;123;149;65;116;43;184;84;190;10;177;54;48;160;34;181;42;5;41;193;159;146;22;20;18;108,217624956953822490,0.000000
steepest_intra:edges_start:greedy,164,72164,23636,48528,1,0,164;7;95;39;165;138;14;144;62;9;148;102;49;178;106;52;55;57;92;129;2;152;97;1;101;100;53;180;154;135;70;127;123;162;149;65;116;43;184;177;54;48;160;34;146;22;18;108;69;159;181;42;5;41;193;139;68;140;93;117;143;183;89;23;137;0;46;115;59;118;51;151;133;176;80;79;63;94;26;86;75;120;44;25;16;171;175;113;56;31;78;145;179;196;81;185;40;90;27;71,167686247774402267,0.000000
steepest_intra:edges_start:greedy,165,71523,23197,48326,1,0,165;40;185;90;81;196;179;145;78;31;56;113;175;171;16;25;44;120;75;86;26;189;94;63;79;80;176;133;151;51;118;59;115;46;0;137;23;186;89;183;143;117;93;140;68;139;193;41;5;42;181;159;69;108;18;22;146;34;160;48;54;177;10;190;84;184;43;116;65;131;149;162;123;127;70;135;154;180;53;100;101;1;97;152;2;129;92;57;55;52;106;178;49;102;148;9;62;144;14;138,6475014232579764966,0.000000
steepest_intra:edges_start:greedy,166,72595,23537,49058,1,0,166;184;190;10;177;54;48;160;34;146;22;18;108;69;159;181;42;5;41;193;139;68;140;93;117;143;183;89;186;23;137;176;80;79;63;94;124;152;97;1;101;2;120;82;129;57;92;55;52;49;102;148;9;62;144;14;138;178;106;185;165;40;90;81;196;179;145;78;31;56;113;175;171;16;25;44;75;86;26;100;121;53;180;154;135;70;127;123;162;133;151;51;0;46;115;118;59;116;65;43,174103477210096282,0.000000
steepest_intra:edges_start:greedy,167,72713,24137,48576,1,0,167;148;9;62;102;144;14;49;178;106;165;39;95;7;164;71;27;90;81;196;40;185;52;55;57;129;92;179;145;78;31;56;113;175;171;16;25;44;120;2;75;101;1;97;152;26;100;86;53;154;70;135;180;63;79;133;51;118;59;115;46;0;89;183;143;117;93;140;68;139;193;41;5;42;181;159;69;108;18;22;146;34;160;48;54;177;184;43;116;65;149;123;127;162;151;80;176;137;94;124,3166751205620541275,0.000000
steepest_intra:edges_start:greedy,168,72772,23521,49251,1,0,168;145;179;196;81;90;40;165;185;106;178;138;14;144;62;9;148;102;49;52;55;92;57;129;2;152;97;1;101;100;53;180;154;135;70;127;123;162;149;131;65;116;43;184;190;10;177;54;48;160;34;146;22;18;108;69;159;181;42;5;41;193;139;68;140;93;117;143;183;89;186;23;137;0;46;115;59;118;51;151;133;176;80;79;63;94;189;26;86;75;120;44;25;16;171;175;113;56;31;78,2079602711110374640,0.000000
steepest_intra:edges_start:greedy,169,72402,23479,48923,1,0,169;40;90;165;138;14;144;62;9;148;102;49;178;106;52;55;57;92;129;2;152;97;1;101;100;53;180;154;135;70;127;123;162;149;131;65;116;43;184;190;10;177;54;48;160;34;146;22;18;108;69;159;181;42;5;41;193;139;68;140;93;117;143;183;89;186;23;137;0;46;115;59;118;51;151;133;176;80;79;63;94;189;26;86;75;120;44;25;16;171;175;113;56;31;78;145;179;185;81;196,2814694068666815908,0.000000
steepest_intra:edges_start:greedy,170,71641,22771,48870,1,0,170;117;0;46;68;139;193;41;115;5;42;181;159;69;108;18;22;146;34;160;48;54;177;10;190;4;84;184;43;116;65;59;118;51;151;133;162;123;127;70;135;154;180;53;121;100;26;86;75;44;25;16;171;175;113;56;31;78;145;179;196;81;90;40;165;185;106;178;138;14;144;62;9;148;102;49;52;55;92;57;129;82;120;2;101;1;97;152;124;94;63;79;80;176;137;23;186;89;183;143,849524686067200564,0.000000
steepest_intra:edges_start:greedy,171,72017,23691,48326,1,0,171;175;113;56;31;145;78;92;179;196;81;90;40;165;185;106;178;138;14;144;62;9;148;102;49;52;55;57;129;2;152;97;1;101;100;53;180;154;135;70;127;123;162;149;131;65;116;43;184;84;190;10;177;54;48;160;34;146;22;18;108;69;159;181;42;5;41;193;139;68;140;93;117;143;183;89;186;23;137;0;46;115;59;118;51;151;133;176;80;79;63;94;189;26;86;75;120;44;25;16,7987148853564623573,0.000000
steepest_intra:edges_start:greedy,172,72794,23350,49444,1,0,172;167;148;9;62;102;144;14;49;178;106;165;39;27;90;81;196;40;185;52;55;57;129;92;179;145;78;31;56;113;175;171;16;25;44;120;2;75;86;26;189;94;63;79;80;176;133;151;51;118;59;115;46;0;137;23;186;89;183;143;117;93;140;68;139;193;41;5;42;181;159;69;108;18;22;146;34;160;48;54;177;184;43;116;65;131;149;162;123;127;70;135;154;180;53;100;101;1;97;152,7642620189594450421,0.000000
steepest_intra:edges_start:greedy,173,72487,22851,49636,1,0,173;135;70;154;158;53;121;100;26;86;75;101;1;97;152;94;124;148;102;49;178;106;52;55;57;92;129;2;120;44;25;16;171;175;113;56;31;78;145;179;196;81;90;185;40;165;138;14;144;62;9;15;114;186;89;183;23;137;176;80;151;162;123;149;65;116;43;184;177;54;48;160;34;146;22;18;108;69;159;181;42;5;41;193;139;68;140;93;117;143;0;46;115;59;118;51;133;79;63;180,2969769174540544663,0.000000
steepest_intra:edges_start:greedy,174,72441,23126,49315,1,0,174;40;185;179;145;78;31;56;113;175;171;16;25;44;120;75;86;26;189;94;63;79;80;176;133;151;51;118;59;115;46;0;137;23;186;89;183;143;117;93;140;68;139;193;41;5;42;181;159;69;108;18;22;146;34;160;48;54;177;10;190;84;184;43;116;65;131;149;162;123;127;70;135;154;180;53;100;101;1;97;152;2;129;92;57;55;52;106;178;49;102;148;9;62;144;14;138;165;90;81,8933566934446074150,0.000000
steepest_intra:edges_start:greedy,175,72017,23691,48326,1,0,175;113;56;31;145;78;92;179;196;81;90;40;165;185;106;178;138;14;144;62;9;148;102;49;52;55;57;129;2;152;97;1;101;100;53;180;154;135;70;127;123;162;149;131;65;116;43;184;84;190;10;177;54;48;160;34;146;22;18;108;69;159;181;42;5;41;193;139;68;140;93;117;143;183;89;186;23;137;0;46;115;59;118;51;151;133;176;80;79;63;94;189;26;86;75;120;44;25;16;171,118220703416861339,0.000000
steepest_intra:edges_start:greedy,176,71940,23456,48484,1,0,176;80;79;63;94;124;152;97;1;101;2;120;82;129;57;92;55;52;49;102;148;9;62;144;14;138;178;106;185;165;40;90;81;196;179;145;78;31;56;113;175;171;16;25;44;75;86;26;100;121;53;180;154;135;70;127;123;162;133;151;149;131;65;116;43;184;84;190;10;177;54;48;160;34;146;22;18;108;69;159;181;42;5;41;193;139;68;46;115;59;118;51;0;117;143;183;89;186;23;137,812081082383867132,0.000000
steepest_intra:edges_start:greedy,177,72287,23801,48486,1,0,177;54;48;34;160;181;42;195;146;22;18;108;69;159;41;193;139;68;140;93;117;143;183;89;186;23;137;176;80;79;63;94;124;152;97;1;101;2;120;82;129;57;92;55;52;49;102;148;9;62;144;14;138;178;106;185;165;40;90;81;196;179;145;78;31;56;113;175;171;16;25;44;75;86;26;100;121;53;180;154;135;70;127;123;162;133;151;51;0;46;115;118;59;116;65;43;184;84;190;10,8095145121268214009,0.000000
steepest_intra:edges_start:greedy,178,71523,23197,48326,1,0,178;49;102;148;9;62;144;14;138;165;40;185;90;81;196;179;145;78;31;56;113;175;171;16;25;44;120;75;86;26;189;94;63;79;80;176;133;151;51;118;59;115;46;0;137;23;186;89;183;143;117;93;140;68;139;193;41;5;42;181;159;69;108;18;22;146;34;160;48;54;177;10;190;84;184;43;116;65;131;149;162;123;127;70;135;154;180;53;100;101;1;97;152;2;129;92;57;55;52;106,146182552431343634,0.000000
steepest_intra:edges_start:greedy,179,71704,23378,48326,1,0,179;145;78;31;56;113;175;171;16;25;44;120;75;86;26;189;94;63;79;80;176;133;151;51;118;59;115;46;0;137;23;186;89;183;143;117;93;140;68;139;193;41;5;42;181;159;69;108;18;22;146;34;160;48;54;177;10;190;84;184;43;116;65;131;149;162;123;127;70;135;154;180;53;100;101;1;97;152;2;129;92;57;55;52;49;102;148;9;62;144;14;138;178;106;185;165;40;90;81;196,7898305585923159247,0.000000
steepest_intra:edges_start:greedy,180,71750,23180,48570,1,0,180;135;70;154;158;53;121;100;26;86;75;101;1;97;152;94;124;148;102;49;178;106;52;55;57;92;129;2;120;44;25;16;171;175;113;56;31;78;145;179;196;81;90;185;40;165;138;14;144;62;9;15;114;186;89;183;23;137;176;80;151;162;127;123;149;65;116;43;184;177;54;48;160;34;146;22;18;108;69;159;181;42;5;41;193;139;68;140;93;117;143;0;46;115;59;118;51;133;79;63,6496468865228044426,0.000000
steepest_intra:edges_start:greedy,181,71385,23490,47895,1,0,181;34;160;48;54;177;10;190;4;112;84;184;42;43;116;65;149;123;127;162;151;133;135;70;154;180;53;121;100;26;86;75;44;25;16;171;175;113;56;31;78;145;179;196;81;90;40;165;185;106;178;138;14;144;62;9;148;102;49;52;55;92;57;129;82;120;2;101;1;97;152;124;94;63;79;80;176;137;23;186;89;183;143;117;0;51;118;59;115;46;68;139;41;193;159;69;108;18;22;146,6523200173355658929,0.000000
steepest_intra:edges_start:greedy,182,72008,23266,48742,1,0,182;121;100;26;86;75;101;1;97;152;94;124;148;102;49;178;106;52;55;57;92;129;2;120;44;25;16;171;175;113;56;31;78;145;179;196;81;90;185;40;165;138;14;144;62;9;15;114;186;89;183;23;137;176;80;151;162;127;123;149;65;116;43;184;177;54;48;160;34;146;22;18;108;69;159;181;42;5;41;193;139;68;140;93;117;143;0;46;115;59;118;51;133;79;63;180;135;70;154;53,2004732070110698733,0.000000
steepest_intra:edges_start:greedy,183,71108,22981,48127,1,0,183;89;186;23;137;176;80;79;63;94;124;152;97;1;101;2;120;82;129;57;92;55;52;49;102;148;9;62;144;14;138;178;106;185;165;40;90;81;196;179;145;78;31;56;113;175;171;16;25;44;75;86;26;100;121;53;180;154;135;70;127;123;162;133;151;51;118;59;65;116;43;184;84;112;4;190;10;177;54;48;160;34;146;22;18;108;69;159;181;42;5;115;41;193;139;68;46;0;117;143,2052835343572235018,0.000000
steepest_intra:edges_start:greedy,184,72083,23661,48422,1,0,184;43;65;116;59;118;115;46;0;51;151;133;162;123;127;70;135;154;180;53;121;100;26;86;75;44;25;16;171;175;113;56;31;78;145;179;196;81;90;40;165;185;106;178;138;14;144;62;9;148;102;49;52;55;92;57;129;82;120;2;101;1;97;152;124;94;63;79;80;176;137;23;186;89;183;143;117;93;140;68;139;193;41;5;42;181;159;69;108;18;22;146;34;160;48;54;177;10;190;84,3906062423051855112,0.000000
steepest_intra:edges_start:greedy,185,71523,23197,48326,1,0,185;90;81;196;179;145;78;31;56;113;175;171;16;25;44;120;75;86;26;189;94;63;79;80;176;133;151;51;118;59;115;46;0;137;23;186;89;183;143;117;93;140;68;139;193;41;5;42;181;159;69;108;18;22;146;34;160;48;54;177;10;190;84;184;43;116;65;131;149;162;123;127;70;135;154;180;53;100;101;1;97;152;2;129;92;57;55;52;106;178;49;102;148;9;62;144;14;138;165;40,2323558374684103249,0.000000
steepest_intra:edges_start:greedy,186,71108,22981,48127,1,0,186;89;183;143;117;0;46;68;139;193;41;115;5;42;181;159;69;108;18;22;146;34;160;48;54;177;10;190;4;112;84;184;43;116;65;59;118;51;151;133;162;123;127;70;135;154;180;53;121;100;26;86;75;44;25;16;171;175;113;56;31;78;145;179;196;81;90;40;165;185;106;178;138;14;144;62;9;148;102;49;52;55;92;57;129;82;120;2;101;1;97;152;124;94;63;79;80;176;137;23,6685411273133961662,0.000000
steepest_intra:edges_start:greedy,187,72151,23121,49030,1,0,187;81;196;40;185;179;145;78;31;56;113;175;171;16;25;44;120;75;86;26;189;94;63;79;80;176;133;151;51;118;59;115;46;0;137;23;186;89;183;143;117;93;140;68;139;193;41;5;42;181;159;69;108;18;22;146;34;160;48;54;177;10;190;184;43;116;65;131;149;162;123;127;70;135;154;180;53;100;101;1;97;152;2;129;92;57;55;52;106;178;49;102;148;9;62;144;14;138;165;90,7276621499682458614,0.000000
steepest_intra:edges_start:greedy,188,73045,23657,49388,1,0,188;31;145;78;92;179;196;81;90;40;165;185;106;178;138;14;144;62;9;148;102;49;52;55;57;129;2;152;97;1;101;100;53;180;154;135;70;127;123;162;149;131;65;116;43;184;190;10;177;54;48;160;34;146;22;18;108;69;159;181;42;5;41;193;139;68;140;93;117;143;183;89;186;23;137;0;46;115;59;118;51;151;133;176;80;79;63;94;189;26;86;75;120;44;25;16;171;175;113;56,7748064855355534654,0.000000
steepest_intra:edges_start:greedy,189,71945,22885,49060,1,0,189;94;124;148;102;49;178;106;52;55;57;92;129;2;120;44;25;16;171;175;113;56;31;78;145;179;196;81;90;185;40;165;138;14;144;62;9;15;114;186;89;183;23;137;176;80;151;162;123;149;65;116;43;184;177;54;48;160;34;146;22;18;108;69;159;181;42;5;41;193;139;68;140;93;117;143;0;46;115;59;118;51;133;79;63;180;135;70;154;158;53;121;100;26;86;75;101;1;97;152,8106984731920650742,0.000000
steepest_intra:edges_start:greedy,190,72214,24115,48099,1,0,190;10;177;54;48;34;160;181;42;146;22;18;108;69;159;41;193;139;68;46;115;118;59;116;65;43;184;35;131;149;123;162;151;133;51;0;117;143;183;89;23;137;176;80;79;63;94;124;152;97;1;101;2;120;82;129;57;92;55;52;49;102;148;9;62;144;14;138;178;106;185;165;40;90;81;196;179;145;78;31;56;113;175;171;16;25;44;75;86;26;100;121;53;180;154;135;70;127;112;4,8027047738751737527,0.000000
steepest_intra:edges_start:greedy,191,72529,23490,49039,1,0,191;193;41;5;42;181;159;69;108;18;22;146;34;160;48;54;177;10;190;84;184;43;116;65;149;123;127;162;151;133;135;70;154;180;53;121;100;26;86;75;44;25;16;171;175;113;56;31;78;145;179;196;81;90;40;165;185;106;178;138;14;144;62;9;148;102;49;52;55;92;57;129;82;120;2;101;1;97;152;124;94;63;79;80;176;137;23;186;89;183;143;117;0;51;118;59;115;46;68;139,2681510713783469490,0.000000
steepest_intra:edges_start:greedy,192,72789,23609,49180,1,0,192;42;5;41;193;139;68;140;93;117;143;183;89;186;23;137;176;80;79;63;94;124;152;97;1;101;2;120;82;129;57;92;55;52;49;102;148;9;62;144;14;138;178;106;185;165;40;90;81;196;179;145;78;31;56;113;175;171;16;25;44;75;86;26;100;121;53;180;154;135;70;127;123;162;133;151;51;0;46;115;118;59;116;65;43;184;190;10;177;54;48;160;34;146;22;18;108;69;159;181,217036535644830653,0.000000
steepest_intra:edges_start:greedy,193,71947,23578,48369,1,0,193;139;68;46;115;59;118;51;0;117;143;183;89;186;23;137;176;80;79;63;94;124;152;97;1;101;2;120;82;129;57;92;55;52;49;102;148;9;62;144;14;138;178;106;185;165;40;90;81;196;179;145;78;31;56;113;175;171;16;25;44;75;86;26;100;121;53;180;154;70;135;133;151;162;127;123;149;65;116;43;184;84;4;190;10;177;54;48;160;34;146;22;18;108;69;159;181;42;5;41,4439047545147000080,0.000000
steepest_intra:edges_start:greedy,194,72641,23748,48893,1,0,194;127;123;162;133;151;149;131;65;116;43;184;190;10;177;54;48;160;34;146;22;18;108;69;159;181;42;5;41;193;139;68;46;115;59;118;51;0;117;143;183;89;186;23;137;176;80;79;63;94;124;152;97;1;101;2;120;82;129;57;92;55;52;49;102;148;9;62;144;14;138;178;106;185;165;40;90;81;196;179;145;78;31;56;113;175;171;16;25;44;75;86;26;100;121;180;53;154;70;135,8901533443455325458,0.000000
steepest_intra:edges_start:greedy,195,71734,23301,48433,1,0,195;181;34;160;48;54;177;10;190;4;84;184;42;43;116;65;149;123;127;162;151;133;135;70;154;180;53;121;100;26;86;75;44;25;16;171;175;113;56;31;78;145;179;196;81;90;40;165;185;106;178;138;14;144;62;9;148;102;49;52;55;92;57;129;82;120;2;101;1;97;152;124;94;63;79;80;176;137;23;186;89;183;143;117;0;51;118;59;115;46;68;139;41;193;159;69;108;18;22;146,2828813195814960704,0.000000
steepest_intra:edges_start:greedy,196,72377,23517,48860,1,0,196;81;90;40;165;185;106;178;138;14;144;62;9;148;102;49;52;55;57;129;92;179;145;78;82;2;152;97;1;101;100;53;180;154;135;70;127;123;162;149;131;65;116;43;184;190;177;54;48;160;34;146;22;18;108;69;159;181;42;5;41;193;139;68;140;93;117;143;183;89;186;23;137;0;46;115;59;118;51;151;133;176;80;79;63;94;189;26;86;75;120;44;25;16;171;175;113;56;31;157,4103692168710516096,0.000000
steepest_intra:edges_start:greedy,197,72970,23867,49103,1,0,197;46;68;139;193;41;5;42;181;159;69;108;18;22;146;34;160;48;54;177;10;190;84;184;43;116;65;149;123;127;162;151;133;135;70;154;180;53;121;100;26;86;75;44;25;16;171;175;113;56;31;78;145;179;196;81;90;40;165;185;106;178;138;14;144;62;9;148;102;49;52;55;92;57;129;82;120;2;101;1;97;152;124;94;63;79;80;176;137;23;186;89;183;143;117;0;51;118;59;115,1809294469890981752,0.000000
steepest_intra:edges_start:greedy,198,72216,23377,48839,1,0,198;46;115;59;118;51;0;117;143;183;89;186;23;137;176;80;79;63;94;124;152;97;1;101;2;120;82;129;57;92;55;52;49;102;148;9;62;144;14;138;178;106;185;165;40;90;81;196;179;145;78;31;56;113;175;171;16;25;44;75;86;26;100;121;53;180;154;70;135;133;151;162;127;123;149;65;116;43;184;84;4;190;10;177;54;48;160;34;146;22;18;108;69;159;181;42;5;41;193;139,8898995349576170460,0.000000
steepest_intra:edges_start:greedy,199,72263,23490,48773,1,0,199;139;68;46;115;59;118;51;0;117;143;183;89;186;23;137;176;80;79;63;94;124;152;97;1;101;2;120;82;129;57;92;55;52;49;102;148;9;62;144;14;138;178;106;185;165;40;90;81;196;179;145;78;31;56;113;175;171;16;25;44;75;86;26;100;121;53;180;154;70;135;133;151;162;127;123;149;65;116;43;184;84;190;10;177;54;48;160;34;181;42;5;41;193;159;146;22;18;108;69,8614938865897827250,0.000000
greedy_intra:nodes_start:random,0,244723,149247,95476,2,1,44;172;153;179;198;94;60;106;167;87;125;88;2;166;17;67;177;121;26;114;90;6;46;136;15;9;19;25;193;53;165;73;195;103;20;72;129;86;70;184;168;35;93;38;45;162;52;97;14;100;183;81;149;107;23;78;110;141;178;186;69;118;158;33;105;80;42;47;123;112;24;180;120;79;34;11;137;182;102;10;130;1;21;150;127;161;18;3;68;133;173;163;151;148;196;71;181;5;131;155,139784976637665483,0.001009
greedy_intra:nodes_start:random,1,270188,165621,104567,1,0,71;8;126;11;156;0;48;145;26;157;17;52;116;106;36;80;122;30;50;147;45;186;182;136;180;39;23;192;161;70;43;185;93;175;88;65;142;84;7;59;107;78;91;154;191;150;85;35;160;152;77;28;9;171;151;130;184;13;83;196;187;74;115;72;4;5;15;2;177;158;10;172;127;144;181;174;105;24;6;193;168;159;100;42;47;162;96;111;63;141;134;103;149;58;82;38;112;133;66;56,5064781110790905411,0.000000
greedy_intra:nodes_start:random,2,250929,161881,89048,4,3,116;59;88;78;178;108;193;92;101;22;24;50;63;113;87;149;81;3;73;27;164;64;195;1;180;176;65;69;21;192;174;45;160;106;99;10;159;61;165;188;52;48;153;41;115;46;145;79;130;121;197;167;120;133;31;43;15;25;77;13;80;34;62;70;141;168;12;171;2;155;90;135;169;185;71;104;75;94;53;23;110;118;29;89;96;57;105;33;144;172;28;47;158;181;156;44;131;125;66;14,5056160402558419037,0.000991
greedy_intra:nodes_start:random,3,265822,167431,98391,2,1,151;197;141;199;85;120;65;106;99;109;118;154;55;158;165;13;186;50;6;176;61;129;60;131;54;157;90;110;161;191;159;139;105;91;83;136;23;76;27;101;152;79;96;137;112;100;68;14;82;92;179;142;180;174;184;43;25;73;88;170;40;30;17;75;78;166;128;122;104;103;59;155;124;58;97;113;172;175;149;111;164;15;93;119;46;44;145;127;196;146;169;3;181;5;95;130;134;56;189;115,9113852901041883234,0.000000
greedy_intra:nodes_start:random,4,285359,184685,100674,1,0,27;84;72;177;92;8;76;187;135;62;86;49;167;133;50;104;119;140;23;85;158;162;18;44;181;13;127;51;42;47;20;180;144;168;103;98;170;159;131;126;68;55;70;169;61;115;73;163;191;190;171;79;96;112;91;147;136;9;194;138;172;134;102;95;53;110;59;193;130;146;142;183;34;161;3;66;24;67;107;69;11;4;186;113;197;2;121;108;39;30;94;21;75;178;150;122;145;166;29;165,2751668180473510368,0.000000
greedy_intra:nodes_start:random,5,255208,158005,97203,1,0,117;16;89;126;18;165;27;105;50;81;90;173;182;104;0;62;162;138;40;127;11;197;180;23;61;187;25;78;87;2;4;191;151;33;159;98;113;12;21;58;51;143;30;110;75;64;198;86;48;141;189;76;49;22;148;26;24;108;43;82;136;184;192;79;99;133;178;169;185;130;15;121;65;170;37;8;69;149;168;154;72;73;88;100;171;142;193;54;164;116;131;115;39;5;17;97;7;28;199;111,122724430706045192,0.000000
greedy_intra:nodes_start:random,6,276380,179991,96389,1,0,45;68;146;131;128;119;36;7;192;136;147;186;13;117;138;102;199;167;30;100;158;12;101;170;193;95;198;78;133;27;178;103;180;44;127;14;189;28;77;80;125;91;172;160;60;66;165;134;73;32;34;96;162;81;38;122;188;129;173;17;11;196;151;48;120;62;98;31;111;47;176;177;126;16;118;113;89;191;56;40;104;50;46;179;153;144;132;51;116;106;26;164;154;123;185;21;70;43;63;88,5753969902759503245,0.000000
greedy_intra:nodes_start:random,7,247112,151812,95300,3,2,137;30;126;75;165;66;42;62;69;64;52;89;81;107;44;28;53;163;146;86;19;4;153;59;155;38;82;113;136;73;103;79;14;151;70;194;131;76;16;102;144;152;172;61;68;78;45;47;33;65;85;145;183;185;49;3;140;6;122;54;141;106;32;176;29;179;21;11;22;94;84;98;27;124;20;139;129;147;166;25;189;199;74;2;96;111;174;182;142;34;162;43;116;170;148;110;105;156;184;55,8079668391459358847,0.001030
greedy_intra:nodes_start:random,8,241392,148108,93284,1,0,36;114;84;159;108;102;185;158;146;198;6;123;59;181;11;140;104;154;135;175;82;197;180;173;42;43;110;194;54;77;93;115;119;31;131;73;55;107;156;139;1;187;128;100;53;37;10;13;97;151;22;44;30;111;68;191;45;125;48;95;47;101;52;90;169;106;178;165;58;99;8;26;177;46;142;32;122;20;23;112;61;117;12;34;109;113;49;87;51;105;86;94;64;149;2;168;186;143;145;157,2903974935780494284,0.000000
greedy_intra:nodes_start:random,9,290889,188971,101918,2,1,132;90;103;10;76;163;91;195;20;7;26;78;87;71;44;147;53;184;114;61;166;185;50;187;0;104;151;65;85;122;19;119;154;37;2;156;149;58;43;41;88;115;22;38;11;27;141;174;177;55;102;124;81;191;164;72;118;176;17;189;23;194;34;121;113;30;56;31;52;165;134;3;167;180;135;130;168;162;33;108;25;12;171;98;198;100;29;148;182;138;199;152;146;196;83;111;77;15;36;123,5908952579739828351,0.000969
greedy_intra:nodes_start:random,10,253574,158283,95291,1,0,164;10;187;16;85;136;147;139;167;124;174;160;199;123;128;193;12;93;36;152;185;40;49;18;155;97;189;107;51;190;73;195;96;183;66;39;143;163;20;105;87;15;159;32;60;191;179;119;109;83;54;98;94;142;127;8;157;65;108;11;145;175;121;6;19;43;38;173;169;86;122;21;81;120;135;137;198;125;140;180;44;37;176;70;112;100;26;57;27;149;111;75;9;132;52;165;22;126;5;68,3974600182492949197,0.000000
greedy_intra:nodes_start:random,11,272021,170678,101343,1,0,100;70;192;72;56;136;173;23;73;39;46;172;79;174;13;155;90;28;186;127;71;12;152;105;110;118;175;148;34;2;188;68;9;113;4;194;35;102;14;154;177;58;74;88;132;108;196;104;122;160;145;40;92;98;89;21;51;18;169;106;38;133;11;86;47;66;146;6;94;91;185;189;29;141;157;20;137;82;65;139;97;143;33;53;126;168;125;199;48;193;69;111;161;17;187;121;16;156;52;103,2812392486074023623,0.000000
greedy_intra:nodes_start:random,12,275194,172350,102844,2,1,186;93;188;64;83;138;76;104;145;124;18;84;151;175;126;72;132;165;135;192;66;87;71;194;58;125;52;27;80;8;6;54;166;49;43;160;179;12;78;189;195;95;86;97;185;100;24;14;39;180;122;63;55;7;110;92;99;74;40;167;4;190;48;114;150;172;82;144;69;147;32;73;94;23;81;156;164;53;47;169;96;155;111;178;21;70;162;41;10;68;85;35;50;42;174;191;13;91;90;142,4912979128103881779,0.000000
greedy_intra:nodes_start:random,13,277488,184050,93438,1,0,135;137;21;102;180;128;91;56;140;143;54;187;162;28;186;73;99;36;152;141;12;86;34;190;188;126;75;65;16;71;63;142;167;0;100;35;32;42;198;10;88;148;77;151;58;78;72;93;171;145;109;139;189;179;45;1;43;85;178;158;144;174;191;30;9;157;48;8;134;90;130;39;49;104;69;44;59;24;138;112;101;7;55;133;27;70;98;123;183;136;61;107;172;166;121;4;115;181;159;31,6850227535244374781,0.000000
greedy_intra:nodes_start:random,14,261626,161509,100117,2,1,72;82;138;2;126;36;127;183;8;86;52;185;93;63;111;130;199;4;162;38;81;170;76;6;77;166;87;104;188;131;12;175;143;48;50;7;58;171;89;46;182;23;198;172;160;61;101;197;119;33;39;181;40;21;56;1;32;19;45;22;79;191;189;98;194;133;142;28;64;154;59;151;164;113;148;10;68;169;29;75;24;103;57;90;25;97;80;44;66;69;110;37;62;146;42;118;31;150;15;140,1554463335904724155,0.000000
greedy_intra:nodes_start:random,15,278331,178244,100087,1,0,90;170;86;140;108;171;175;167;23;147;102;187;94;50;14;33;163;109;181;112;104;195;52;84;143;161;111;18;136;21;197;13;72;2;40;198;199;64;123;19;43;65;63;77;56;129;194;151;44;173;155;142;93;73;83;27;117;45;121;165;196;47;4;188;34;91;87;130;139;88;54;7;17;39;159;122;186;8;131;98;36;154;58;141;97;42;132;184;78;110;101;1;70;156;114;135;124;148;89;118,4105978137476368394,0.001003
greedy_intra:nodes_start:random,16,269838,170378,99460,2,1,179;119;6;188;165;47;195;143;157;40;70;100;66;62;164;158;176;81;104;114;109;196;3;98;93;145;39;139;174;190;166;135;130;74;134;67;57;76;17;128;170;9;153;34;15;169;88;136;118;4;25;155;30;13;60;24;5;87;186;2;22;31;18;92;167;108;161;12;7;1;72;91;51;14;63;26;192;146;48;182;59;149;184;73;185;56;58;75;82;147;110;54;144;133;61;152;0;97;193;142,6050230789147679077,0.000000
greedy_intra:nodes_start:random,17,266433,169509,96924,1,0,61;79;125;124;115;127;15;7;24;56;184;25;186;128;169;31;113;129;181;176;173;27;75;41;140;132;168;52;90;0;14;104;48;197;185;159;69;147;82;116;138;178;162;58;67;192;119;33;193;21;166;86;107;182;142;46;1;137;16;13;106;190;160;199;194;49;34;64;10;37;22;18;68;36;198;189;150;65;55;141;139;12;133;17;188;87;156;145;134;2;11;144;51;175;70;111;121;167;35;6,5761918197345357976,0.000000
greedy_intra:nodes_start:random,18,265571,171766,93805,1,0,73;113;175;99;129;67;42;47;187;34;64;147;15;196;7;13;4;148;31;79;102;77;19;115;17;105;143;18;139;183;12;80;71;0;149;68;32;180;95;50;121;191;144;87;178;101;11;160;58;127;43;154;193;150;192;177;112;133;176;138;125;8;54;120;108;153;189;83;91;52;1;46;26;21;94;173;190;23;40;122;55;59;9;70;164;194;130;36;132;39;90;155;188;89;81;146;197;165;48;126,8388642178642918602,0.000000
greedy_intra:nodes_start:random,19,248224,152253,95971,1,0,188;186;174;78;171;71;128;109;2;68;129;15;87;192;97;120;40;117;123;35;72;106;122;96;112;89;3;110;116;198;81;145;152;158;11;36;101;169;173;94;187;19;25;33;143;132;140;0;180;189;60;111;73;8;154;39;22;44;163;146;151;199;183;80;6;62;108;177;165;95;168;176;5;131;193;29;121;13;69;45;1;70;153;53;166;149;105;172;20;14;102;51;179;64;155;23;104;67;137;54,8631169104329147812,0.000000
greedy_intra:nodes_start:random,20,257071,158239,98832,1,0,118;91;179;174;1;29;138;99;158;16;157;75;56;172;33;108;163;184;43;176;162;133;177;128;114;127;83;125;14;190;153;72;20;115;132;32;182;195;155;107;0;119;161;44;21;168;103;96;149;73;147;48;134;152;112;156;63;144;58;4;45;194;97;55;62;116;185;160;77;37;28;34;84;17;31;49;94;110;25;64;196;5;154;123;171;191;50;146;12;198;102;186;140;92;3;135;66;137;181;39,8967443299567029217,0.001027
greedy_intra:nodes_start:random,21,263126,173102,90024,2,1,120;149;69;76;82;180;112;79;133;28;55;32;124;191;151;126;8;67;138;106;16;172;77;146;115;86;119;111;4;52;143;155;49;109;100;65;54;99;59;74;128;156;135;174;38;68;160;145;33;84;182;190;150;34;132;147;56;103;14;152;144;178;26;96;196;29;10;148;165;90;48;57;108;176;198;181;12;75;88;134;154;163;41;9;31;141;185;94;62;15;43;113;11;64;83;184;167;18;63;118,4299260963791420343,0.000000
greedy_intra:nodes_start:random,22,256651,161031,95620,2,1,128;148;97;34;83;24;58;130;172;4;185;160;50;129;136;107;171;199;79;30;181;9;149;86;191;174;115;71;137;89;140;176;105;177;6;152;73;60;178;11;52;32;17;76;189;182;139;57;38;135;114;29;121;75;117;63;14;70;180;132;88;145;80;184;166;159;33;1;96;190;198;64;170;23;43;150;10;167;101;67;183;161;35;144;21;27;8;95;85;187;15;81;20;66;106;54;49;113;175;62,5884358521167212734,0.000000
greedy_intra:nodes_start:random,23,263136,172478,90658,7,6,63;85;24;50;192;59;193;154;129;0;14;118;49;80;151;175;112;86;150;66;126;155;40;8;144;33;23;53;190;135;1;47;171;113;167;120;184;199;149;105;153;128;4;186;30;32;2;178;159;162;107;13;69;180;106;89;133;3;35;76;170;156;188;10;168;46;62;73;75;121;5;98;182;91;97;56;96;16;64;52;181;92;165;99;58;123;163;79;198;183;145;27;68;45;130;25;37;158;93;31,6082287826437568733,0.001971
greedy_intra:nodes_start:random,24,271620,173897,97723,1,0,161;9;137;0;159;146;64;93;94;102;141;62;145;122;21;149;107;108;26;35;37;130;84;100;66;4;44;74;163;76;176;83;40;165;138;113;127;57;187;190;31;59;188;14;36;7;147;168;13;5;70;119;2;27;115;72;156;98;58;129;118;22;175;87;128;54;52;42;33;60;125;121;101;16;20;112;111;30;97;131;171;157;89;134;55;53;106;73;92;150;109;153;1;90;194;68;136;95;196;172,4937251748842214896,0.000000
greedy_intra:nodes_start:random,25,244323,148876,95447,1,0,14;133;21;36;175;132;56;125;167;161;37;188;145;189;135;26;40;76;150;46;116;190;134;69;54;23;138;119;91;183;87;10;105;75;197;4;34;191;108;160;20;187;199;177;39;13;2;153;143;61;8;81;195;104;77;25;131;162;90;176;73;43;166;152;99;79;93;194;148;82;151;52;168;55;113;92;129;47;65;106;123;0;84;120;68;50;172;170;83;115;32;128;22;64;110;15;57;171;16;186,2417700252095895463,0.000000
greedy_intra:nodes_start:random,26,258748,159036,99712,1,0,65;146;125;96;113;39;151;178;14;31;81;155;152;169;183;158;50;172;51;164;166;6;196;118;185;26;53;8;70;128;36;18;192;19;4;174;170;188;107;44;140;17;139;162;132;62;143;103;186;47;135;77;40;86;10;30;121;153;59;149;104;92;195;24;63;5;194;124;177;79;11;123;136;25;95;168;34;84;116;3;76;42;142;0;180;187;129;85;141;20;37;64;73;117;91;66;148;150;74;159,8864297218672357690,0.000998
greedy_intra:nodes_start:random,27,260116,162164,97952,1,0,78;51;11;7;150;35;103;184;71;154;166;14;180;73;65;54;23;57;174;76;107;152;137;149;64;131;186;10;113;91;44;18;55;188;160;189;6;74;128;159;89;9;169;61;92;192;41;182;27;144;110;48;175;133;139;47;127;135;172;125;185;195;4;96;123;50;148;170;87;46;45;19;171;116;163;79;88;34;151;83;168;16;142;157;140;198;104;0;181;5;24;33;155;53;94;1;112;114;37;102,4865939395703652586,0.000000
greedy_intra:nodes_start:random,28,256000,153871,102129,1,0,157;98;66;5;59;152;75;129;33;49;10;140;60;177;30;191;126;195;84;1;181;103;112;198;141;83;136;53;160;0;68;20;178;3;158;106;72;118;174;18;130;147;39;88;194;159;42;156;162;41;46;119;114;173;48;15;188;14;43;109;13;74;21;180;50;32;7;124;166;57;45;179;34;125;56;35;6;146;145;27;23;168;9;89;17;138;131;161;79;19;86;116;16;132;77;55;4;148;183;58,7922203020786467918,0.000000
greedy_intra:nodes_start:random,29,272348,168649,103699,1,0,186;110;100;11;183;45;76;180;193;27;141;154;131;53;30;80;143;123;102;26;116;138;172;9;93;165;0;104;29;24;70;57;166;155;68;192;19;7;196;142;39;163;52;77;6;146;61;182;74;162;140;63;171;121;128;101;118;98;21;139;125;5;36;84;150;136;79;66;31;168;67;59;32;69;198;92;12;47;181;188;189;40;46;97;99;3;2;43;90;153;87;72;16;156;82;81;37;197;20;149,288368007825931596,0.000000
greedy_intra:nodes_start:random,30,255439,160695,94744,1,0,191;18;24;36;27;117;142;47;167;101;65;131;162;86;23;174;57;165;50;93;84;139;73;39;9;96;5;154;172;95;169;34;14;121;4;108;137;20;136;197;91;60;183;120;138;77;71;66;148;158;58;111;56;3;185;196;106;170;25;193;17;152;40;49;79;30;89;46;74;128;147;149;90;109;186;178;72;180;150;126;163;43;104;33;143;160;107;168;22;194;92;135;53;181;6;113;19;35;62;105,5222688725538014390,0.000999
greedy_intra:nodes_start:random,31,262405,171922,90483,1,0,6;125;47;189;22;103;26;102;194;104;18;4;48;151;39;3;142;139;148;29;69;128;16;32;164;140;38;43;92;109;81;121;144;54;73;101;76;165;156;28;46;184;34;122;89;68;173;145;53;106;115;171;41;0;123;172;91;15;119;93;118;86;10;66;25;112;30;157;193;64;160;96;14;20;44;188;196;67;40;13;52;95;187;179;75;198;120;71;23;117;182;21;105;158;169;65;153;186;176;5,4384255420073412077,0.000000
greedy_intra:nodes_start:random,32,262240,163491,98749,9,8,88;31;45;77;66;69;101;106;20;42;97;170;160;124;128;187;49;105;64;94;119;116;164;40;18;188;37;167;142;86;185;81;84;173;193;22;147;157;67;129;14;98;178;182;33;118;95;78;91;195;61;11;56;144;177;60;10;46;130;58;87;112;63;179;114;39;107;68;136;93;184;1;5;74;57;30;153;50;62;132;166;53;135;181;190;176;23;17;13;72;161;123;146;139;199;194;121;148;0;76,4468774599356516292,0.000999
greedy_intra:nodes_start:random,33,259862,163265,96597,2,1,46;172;119;1;22;181;23;2;90;99;111;125;64;104;83;129;122;18;197;101;41;144;189;162;28;188;193;127;171;42;40;79;178;57;170;138;123;168;120;169;80;116;199;165;27;21;66;5;16;128;12;47;70;25;93;156;52;155;31;192;29;158;76;179;32;6;105;132;182;0;50;10;51;59;163;26;160;20;143;103;60;86;81;75;87;152;65;49;13;24;167;97;38;150;166;164;137;136;68;84,1691342447604942482,0.001000
greedy_intra:nodes_start:random,34,265669,163508,102161,2,1,112;109;166;13;55;120;129;3;153;151;2;187;71;190;105;144;38;43;36;170;99;162;118;188;123;175;52;76;119;158;6;73;94;116;159;172;178;40;113;27;146;15;39;35;196;61;193;24;58;136;75;60;191;150;85;10;141;165;49;154;127;25;167;22;91;103;130;17;179;21;72;0;107;169;126;82;67;45;173;79;100;133;14;1;31;65;9;156;32;115;189;174;184;186;86;125;138;5;195;198,2619684137851000888,0.000000
greedy_intra:nodes_start:random,35,269360,171746,97614,1,0,80;42;163;31;158;64;193;26;19;119;44;3;145;93;122;54;199;128;179;27;88;34;33;160;121;62;12;192;176;82;142;67;72;6;51;57;75;172;108;157;191;107;166;139;91;38;4;29;66;87;149;164;18;15;95;112;151;156;92;123;169;159;10;83;24;40;134;9;144;171;110;177;195;150;180;48;28;132;103;97;186;124;2;52;146;1;68;153;60;96;182;59;84;78;115;5;41;141;46;170,2951292647800398418,0.000000
greedy_intra:nodes_start:random,36,264170,166197,97973,1,0,146;70;96;186;112;62;42;181;127;141;145;133;192;102;36;76;148;82;104;195;54;196;4;49;199;123;13;162;95;72;32;39;86;174;94;116;173;91;87;26;8;23;178;170;20;64;149;89;132;188;143;106;1;107;191;3;167;9;154;136;27;134;65;157;38;108;57;50;142;193;183;14;124;73;126;171;99;45;125;2;135;68;117;31;15;151;80;189;78;92;131;120;114;28;177;83;21;172;30;153,4224610462402237744,0.001000
greedy_intra:nodes_start:random,37,283423,185667,97756,1,0,179;23;57;41;44;163;61;137;98;116;65;78;190;173;55;31;42;84;22;58;82;49;29;139;53;149;172;77;73;20;182;124;103;35;94;26;56;24;118;34;161;95;199;147;123;37;184;192;144;154;18;96;90;159;93;83;120;71;79;107;46;16;11;122;99;113;63;156;27;111;174;176;7;183;155;132;110;12;36;131;168;51;33;171;195;138;14;47;88;45;13;151;158;170;194;108;140;104;100;198,7435893096611477618,0.000000
greedy_intra:nodes_start:random,38,268287,171503,96784,1,0,158;113;35;65;26;52;72;127;109;90;28;147;107;180;194;189;123;48;75;46;93;95;33;97;91;192;20;55;116;36;39;121;168;143;178;76;133;98;81;57;68;19;66;176;25;184;126;188;51;69;134;8;41;141;140;199;103;161;104;114;7;15;42;112;63;24;2;40;135;18;74;12;169;85;173;54;197;92;87;170;62;195;71;154;167;175;0;148;130;139;9;16;165;198;164;146;27;88;22;156,8625741243181377092,0.000000
greedy_intra:nodes_start:random,39,274551,175971,98580,2,1,181;31;87;76;170;50;9;151;35;192;136;68;159;95;58;182;22;27;26;98;21;127;157;69;72;79;38;108;7;28;71;25;88;47;162;196;1;158;73;48;123;140;141;55;102;57;5;39;120;154;115;42;180;4;59;107;166;145;173;49;15;177;125;14;197;150;84;6;178;190;188;19;168;172;106;46;186;40;143;122;113;60;116;17;105;198;90;169;11;41;191;2;20;119;129;130;124;75;176;117,2549055821035700709,0.000000
greedy_intra:nodes_start:random,40,282820,181776,101044,1,0,128;82;18;138;53;141;132;173;41;57;171;118;124;97;166;189;172;120;96;131;45;81;184;114;35;85;22;113;58;93;121;30;154;187;180;162;39;146;181;102;199;108;195;79;13;75;110;140;161;147;74;109;103;176;111;136;69;150;188;152;142;186;38;6;191;149;163;107;126;1;24;62;42;3;157;2;137;88;54;65;73;198;158;32;86;15;26;160;183;27;78;77;83;168;23;52;90;190;36;40,1889219037241544221,0.000000
greedy_intra:nodes_start:random,41,265555,165678,99877,1,0,63;17;69;169;60;196;184;72;117;76;104;180;186;139;163;111;141;100;36;112;178;189;114;4;101;95;175;49;66;32;179;128;164;156;91;124;165;194;173;87;99;20;182;78;151;122;129;198;92;93;19;58;44;29;86;37;135;138;152;77;159;147;23;68;67;74;188;48;155;106;16;181;116;8;107;176;170;14;89;75;161;183;166;21;40;113;94;56;140;71;109;53;121;38;97;150;24;82;26;35,4965271090993216619,0.000000
greedy_intra:nodes_start:random,42,253341,155071,98270,2,1,80;50;89;9;76;148;22;199;169;70;117;77;134;104;190;66;163;183;41;72;68;28;114;15;102;3;123;37;194;109;145;62;18;81;79;46;153;91;184;58;14;175;8;181;13;121;64;11;126;144;90;177;83;122;178;158;107;38;196;111;86;151;6;65;67;180;5;154;140;96;30;94;129;84;93;73;165;7;55;45;198;19;143;147;174;186;4;99;95;49;149;98;21;101;87;85;106;133;162;12,3713230412980392461,0.000000
greedy_intra:nodes_start:random,43,265994,165867,100127,1,0,94;74;21;153;154;67;68;177;175;115;150;43;162;85;196;4;140;166;135;19;46;32;33;87;103;149;47;119;98;37;120;133;178;0;171;23;126;187;50;110;134;116;152;147;122;52;72;71;145;182;158;157;174;155;18;105;130;181;180;2;92;75;89;123;95;27;160;108;35;125;88;142;199;189;79;39;77;41;107;146;55;151;40;49;186;114;38;9;156;124;22;73;31;82;58;60;69;191;170;195,8119553497916692054,0.000000
greedy_intra:nodes_start:random,44,264285,165389,98896,1,0,185;113;69;52;88;199;161;104;112;18;85;123;195;149;105;86;90;53;46;136;30;159;114;20;76;119;132;118;70;79;48;7;140;145;82;152;128;67;194;96;146;47;127;77;170;163;84;92;10;139;98;54;109;68;107;120;144;198;157;188;64;192;125;102;11;186;94;8;142;103;187;78;97;179;169;135;197;115;110;0;89;32;87;173;51;63;28;178;189;74;147;16;116;171;49;176;2;58;29;167,3070146197397560477,0.000000
greedy_intra:nodes_start:random,45,259912,165127,94785,2,1,31;37;176;172;10;34;131;102;167;147;23;69;137;145;189;126;193;185;64;157;79;110;122;24;25;93;123;49;188;67;99;76;32;168;158;21;71;4;73;199;77;75;187;132;90;92;169;42;180;100;52;61;163;81;19;104;135;144;106;146;152;173;130;111;101;178;89;128;171;11;182;38;60;53;194;15;196;186;174;14;30;165;2;44;112;121;151;40;155;113;46;198;16;57;39;109;43;164;97;83,635032049215138757,0.001004
greedy_intra:nodes_start:random,46,262362,167950,94412,1,0,14;43;105;134;39;174;61;98;191;92;181;103;96;138;192;161;176;73;193;131;137;67;90;54;94;102;168;4;100;124;27;117;21;177;183;60;72;119;0;122;115;15;18;75;37;40;140;84;48;153;145;3;91;108;101;44;150;30;199;136;16;147;41;17;79;154;118;22;42;56;83;160;63;155;198;81;116;189;38;70;10;190;109;24;195;152;165;95;186;45;52;123;65;188;85;132;49;64;33;196,4887525307836496605,0.000000
greedy_intra:nodes_start:random,47,258455,160888,97567,2,1,2;18;60;109;72;107;45;102;37;69;144;124;184;36;50;111;164;189;149;90;157;154;83;104;43;123;91;31;68;108;47;100;172;96;15;94;193;70;148;1;155;151;170;24;11;62;10;87;135;58;105;63;4;198;128;161;20;197;42;140;48;127;23;75;84;29;76;180;86;26;34;143;175;132;57;160;92;71;163;81;17;82;115;118;186;147;126;195;116;167;174;101;121;192;21;13;176;67;8;97,394322379031543038,0.000000
greedy_intra:nodes_start:random,48,239891,145304,94587,2,1,39;27;88;32;25;13;53;178;194;145;5;97;72;24;137;167;46;28;34;160;121;175;26;107;165;185;132;0;8;113;191;47;195;187;74;95;111;130;197;11;163;177;169;189;54;65;152;50;10;198;162;62;155;92;59;128;78;117;84;36;126;1;123;93;91;176;68;43;30;4;186;76;51;119;15;124;144;80;174;52;100;75;115;104;150;122;77;83;86;58;112;70;193;66;102;196;140;133;64;171,822453306699541493,0.000000
greedy_intra:nodes_start:random,49,265892,173665,92227,1,0,115;94;2;124;23;38;57;10;147;101;1;172;139;56;79;119;197;15;167;6;113;189;140;103;137;98;196;44;111;199;76;144;162;170;72;27;25;60;82;143;125;159;71;183;78;180;84;158;70;194;106;153;63;178;22;179;50;69;85;102;77;92;66;89;40;28;176;132;19;4;55;184;96;149;134;67;95;152;88;5;80;34;133;51;31;195;185;109;91;192;30;86;0;108;198;118;122;104;90;164,3720017515200852515,0.000000
greedy_intra:nodes_start:random,50,257461,162346,95115,2,1,89;133;155;81;184;135;127;111;36;169;121;2;168;165;12;199;63;159;14;55;177;195;58;188;70;25;175;176;20;15;128;167;84;66;179;80;186;116;75;196;24;59;13;85;34;114;157;17;45;113;65;77;53;194;163;182;158;35;108;91;94;52;86;107;43;78;138;112;72;115;134;192;41;95;181;93;178;57;16;39;64;106;31;56;117;183;50;82;37;76;38;140;152;6;126;5;60;27;4;87,5829907800301422635,0.001000
greedy_intra:nodes_start:random,51,247962,154444,93518,2,1,161;109;97;106;51;134;18;31;68;191;58;153;100;125;154;157;34;86;149;184;105;121;196;126;83;122;113;5;160;54;77;150;172;159;151;120;61;180;101;19;140;37;60;62;9;85;94;6;41;197;143;145;57;76;3;50;66;74;164;91;46;4;175;127;93;182;20;112;15;158;73;174;179;16;92;80;173;55;71;186;137;78;28;135;75;48;190;162;169;90;1;133;170;14;147;129;0;102;88;177,3024544082653127854,0.000000
greedy_intra:nodes_start:random,52,251749,157024,94725,9,8,64;76;4;18;12;92;180;161;44;143;0;7;136;163;98;199;181;192;126;177;124;145;189;96;86;1;152;54;37;169;21;137;130;16;17;112;186;15;5;153;10;133;78;155;41;20;104;194;79;162;197;195;164;14;121;49;190;158;3;144;81;150;135;134;107;25;94;116;55;191;48;129;26;97;142;24;50;74;83;63;13;193;175;166;19;154;36;148;91;45;119;118;65;127;70;46;159;103;62;108,7028185146990788435,0.002000
greedy_intra:nodes_start:random,53,262281,166653,95628,2,1,102;186;7;41;145;177;166;144;171;132;8;190;199;147;95;81;164;3;48;54;63;32;24;98;103;30;127;161;137;12;87;76;188;126;46;111;49;70;31;47;21;13;65;69;94;140;125;26;178;128;53;162;83;56;39;152;72;193;196;167;107;165;9;23;138;100;73;110;159;175;133;180;136;185;37;58;28;173;150;124;77;82;142;113;86;143;78;22;14;20;198;68;169;80;85;1;97;99;108;139,7483338149791025337,0.000000
greedy_intra:nodes_start:random,54,268954,164049,104905,2,1,35;189;28;61;94;84;86;163;47;192;122;20;79;24;73;18;170;119;133;172;198;91;37;126;15;81;16;191;144;128;187;107;180;4;158;138;38;22;150;69;60;29;102;89;152;49;143;48;32;1;141;97;135;6;82;130;62;124;136;13;188;64;147;151;162;77;127;96;56;154;104;54;185;113;106;58;3;139;148;11;27;190;59;169;87;46;186;132;45;153;196;123;76;161;92;173;193;164;51;134,4781311540927272445,0.000999
greedy_intra:nodes_start:random,55,256955,162766,94189,2,1,5;139;3;129;90;10;87;189;2;57;24;25;8;111;1;141;98;194;109;52;134;68;135;118;167;171;65;81;101;107;17;22;48;164;28;185;124;180;196;63;31;155;20;82;158;93;176;148;122;80;61;97;4;99;130;197;152;193;112;58;40;151;114;121;91;198;43;113;46;100;85;178;79;175;138;128;96;95;110;30;120;127;11;123;47;172;84;103;77;66;23;0;18;170;182;149;50;13;9;119,1467346756545848059,0.000000
greedy_intra:nodes_start:random,56,249497,153065,96432,1,0,70;128;20;197;179;102;162;90;75;73;7;139;60;94;176;116;122;67;101;149;156;72;14;171;46;135;161;15;124;140;36;159;40;173;52;187;47;146;83;87;56;62;88;172;79;123;16;45;17;24;151;100;82;180;34;38;158;154;142;96;136;119;49;130;61;28;182;193;144;6;199;18;155;120;4;117;31;189;115;78;134;23;58;194;147;11;51;9;181;10;129;169;157;91;63;190;35;59;86;99,1677445082142373886,0.001001
greedy_intra:nodes_start:random,57,246497,146780,99717,4,3,33;138;151;57;78;157;51;10;189;134;9;90;1;82;169;8;79;145;58;45;131;153;36;68;162;48;195;183;168;31;99;165;72;122;63;167;30;108;116;191;155;97;54;25;117;194;140;159;154;35;149;136;46;172;143;37;176;163;16;3;127;29;161;69;170;6;174;71;179;47;94;144;152;24;139;5;70;27;123;87;60;187;83;166;192;158;186;92;12;77;62;52;188;150;61;181;156;101;93;100,5073709529252416803,0.000997
greedy_intra:nodes_start:random,58,264104,165134,98970,1,0,81;33;49;97;12;4;111;160;108;173;110;144;165;63;50;27;157;100;185;54;168;79;20;114;187;186;125;78;106;18;154;61;129;88;30;171;26;86;140;167;96;142;62;3;51;147;48;91;35;83;102;47;128;109;73;0;122;24;66;7;55;124;131;197;23;25;67;181;198;192;31;149;176;13;170;121;199;180;36;82;28;8;16;139;132;182;38;130;80;101;184;190;159;105;158;193;123;156;2;164,4803134350920970459,0.000000
greedy_intra:nodes_start:random,59,262313,162248,100065,1,0,43;37;139;46;95;4;25;150;193;125;65;84;6;28;126;152;2;161;114;67;164;158;83;169;50;123;53;29;198;98;102;186;23;48;61;31;187;59;104;172;36;182;181;78;88;58;122;165;3;8;168;75;170;107;52;92;71;195;39;82;57;24;34;80;119;185;130;175;56;13;10;171;11;146;68;155;178;93;54;32;55;101;196;17;144;0;110;51;173;188;160;135;20;5;148;30;90;128;86;22,6948609804626671165,0.000000
greedy_intra:nodes_start:random,60,258055,158178,99877,3,2,9;113;6;52;134;77;154;155;122;192;87;125;71;44;78;171;11;43;150;121;147;95;119;128;185;94;197;198;129;130;188;7;116;73;163;148;104;108;51;54;33;62;80;38;115;199;84;70;131;79;61;195;98;106;100;105;37;58;56;144;35;132;102;97;162;142;166;3;158;114;193;180;90;47;146;15;153;13;190;160;65;175;156;135;124;29;103;157;112;136;183;75;83;23;0;118;86;2;111;19,3803817702632841116,0.000000
greedy_intra:nodes_start:random,61,241564,146927,94637,1,0,161;82;135;89;175;62;112;16;152;129;183;111;79;163;114;99;126;51;177;107;0;9;88;124;97;24;189;184;8;28;173;131;179;86;145;74;48;150;121;49;21;39;196;98;60;77;29;26;68;180;144;14;13;128;170;12;1;100;139;27;81;110;36;42;143;132;141;148;15;123;46;84;198;104;65;147;192;171;164;78;166;130;64;61;85;185;93;41;127;149;158;101;162;33;160;165;115;47;197;31,8971901044339433543,0.000000
greedy_intra:nodes_start:random,62,272350,172658,99692,1,0,39;195;176;199;24;27;44;180;155;125;142;95;42;56;15;124;181;1;107;163;164;19;45;96;48;37;32;71;8;135;110;187;137;0;130;61;145;158;136;20;66;123;161;194;118;156;41;152;196;193;57;54;87;105;183;38;197;149;102;139;53;198;31;174;134;143;46;47;67;6;69;140;113;73;147;75;114;28;68;89;129;94;10;21;99;109;122;52;49;58;65;190;29;16;151;59;62;74;192;23,2017625863547116603,0.000000
greedy_intra:nodes_start:random,63,280134,180524,99610,2,1,125;3;179;184;5;58;83;155;112;69;154;123;139;49;67;143;18;17;85;30;101;124;141;82;193;2;40;55;197;174;15;178;181;72;175;161;70;109;16;19;53;44;165;195;113;119;115;64;6;29;194;4;148;188;32;96;149;12;171;25;38;48;105;47;114;120;108;122;132;78;187;182;54;79;121;20;71;93;199;66;13;164;142;39;60;21;41;146;95;180;102;147;170;192;133;7;43;88;27;131,5807381970938447348,0.000987
greedy_intra:nodes_start:random,64,247857,155189,92668,1,0,157;24;133;173;20;184;171;167;147;186;160;131;162;34;125;18;2;70;112;152;93;74;66;124;198;145;69;25;175;138;71;144;166;40;84;149;195;128;127;180;91;15;47;77;100;64;17;49;106;193;197;23;57;83;96;130;139;194;44;31;129;22;116;142;181;153;75;120;190;150;113;46;63;182;98;73;132;95;13;92;119;0;39;114;68;111;97;54;102;94;38;188;10;79;158;62;29;48;99;80,5711638365751236612,0.000000
greedy_intra:nodes_start:random,65,240924,147292,93632,6,5,120;39;6;112;22;156;63;80;143;25;77;84;121;183;81;52;144;94;54;186;123;36;3;110;195;41;76;73;17;32;92;42;197;170;119;64;166;62;14;117;30;59;160;148;7;9;181;98;4;95;179;192;5;103;70;100;12;177;172;43;126;97;190;125;176;175;2;138;132;111;74;141;102;152;104;20;15;83;165;57;153;18;105;149;198;24;114;44;79;65;87;26;189;85;150;145;128;51;78;116,8495173452383703289,0.000990
greedy_intra:nodes_start:random,66,253096,158645,94451,2,1,99;42;159;180;56;57;109;63;124;130;44;84;132;36;170;5;168;107;11;154;14;144;9;193;68;129;43;153;16;176;160;82;3;17;137;119;125;67;157;46;139;83;151;96;87;149;74;60;97;37;148;51;115;38;72;1;112;95;102;161;118;143;73;4;98;146;7;76;100;182;196;8;94;45;185;88;175;92;59;147;22;198;123;145;47;116;169;136;114;80;166;120;21;173;191;61;48;52;78;133,7845683307325021676,0.000000
greedy_intra:nodes_start:random,67,260200,164976,95224,3,2,128;124;166;175;91;12;4;174;54;135;139;1;164;28;64;182;148;26;59;102;30;47;90;126;143;181;67;11;113;65;70;80;132;155;39;195;184;137;116;35;13;151;57;68;77;14;109;66;42;192;98;153;120;74;110;81;25;15;101;193;18;32;125;72;2;27;82;45;107;40;140;178;78;163;197;131;118;157;19;169;84;63;156;10;176;9;106;29;5;190;37;141;94;114;52;86;167;149;48;172,1169249452707751849,0.001002
greedy_intra:nodes_start:random,68,295761,194050,101711,1,0,97;198;55;173;138;197;57;116;7;72;5;160;58;73;193;81;190;147;28;100;184;3;113;62;161;188;156;34;127;157;123;71;45;164;63;92;87;18;148;39;48;27;93;168;118;38;4;83;135;99;126;162;66;110;33;52;144;132;16;17;61;98;86;112;196;68;50;32;91;36;37;15;195;129;12;174;10;153;189;119;192;85;1;175;111;106;20;69;165;133;170;150;102;0;177;105;56;22;75;185,1986431647605930262,0.000000
greedy_intra:nodes_start:random,69,271822,174141,97681,2,1,95;152;165;163;78;80;173;21;132;190;167;134;153;172;104;93;47;22;157;145;101;17;41;188;136;178;111;147;150;194;69;62;68;37;66;90;110;189;84;64;197;107;105;53;8;46;94;103;52;124;6;131;112;15;1;72;129;135;144;70;54;20;89;13;76;146;158;35;100;49;102;87;191;162;121;183;42;30;120;86;18;151;130;16;175;119;9;91;160;199;109;29;36;115;184;27;141;198;74;159,5171735995842142765,0.000000
greedy_intra:nodes_start:random,70,256057,156478,99579,1,0,151;100;112;152;85;181;117;113;140;90;18;19;87;20;55;60;191;164;142;77;51;163;121;75;83;145;25;179;97;82;101;67;168;95;198;73;111;118;144;5;43;11;9;1;190;105;176;36;189;66;54;99;172;39;23;14;128;84;62;193;165;197;185;114;183;177;188;119;155;175;149;126;141;48;34;72;133;96;196;129;13;150;147;167;194;76;49;78;92;174;158;24;131;41;159;6;2;26;74;103,5344917463368891212,0.000000
greedy_intra:nodes_start:random,71,266099,170189,95910,1,0,94;71;126;29;140;99;155;165;192;195;62;176;116;8;45;44;27;130;196;143;60;181;159;12;51;89;102;125;1;131;187;180;104;179;34;19;123;11;101;20;4;129;173;85;184;152;48;38;157;186;67;3;26;148;83;172;53;107;193;32;61;37;14;162;124;31;167;133;178;147;139;175;77;23;88;22;56;111;54;136;66;169;72;55;115;170;46;35;92;93;149;42;160;90;2;154;80;9;150;91,5783348207373203767,0.000000
greedy_intra:nodes_start:random,72,266427,176248,90179,1,0,72;10;168;24;185;121;180;27;60;82;195;44;189;48;175;116;56;20;164;87;7;125;55;123;18;146;183;198;6;0;12;46;182;64;77;133;92;9;99;155;135;89;80;105;2;13;17;154;113;75;104;153;22;35;29;34;184;197;167;108;23;181;57;106;163;190;39;40;110;65;120;129;194;97;117;151;11;94;179;28;176;76;169;177;31;140;16;73;162;115;71;68;63;188;141;143;93;147;136;101,5682724517781517361,0.000000
greedy_intra:nodes_start:random,73,268419,163367,105052,6,5,70;114;60;40;59;194;18;66;168;72;63;105;5;199;124;138;145;115;146;163;191;188;10;161;169;85;26;109;150;13;61;56;37;186;31;135;75;64;130;91;152;28;11;29;62;78;184;43;34;175;2;41;49;125;25;110;87;76;117;166;88;97;50;167;38;0;179;127;165;192;24;178;74;45;23;35;22;197;52;17;180;71;48;69;187;30;153;174;57;90;39;128;36;158;58;55;79;7;113;172,5898072363936717602,0.000997
greedy_intra:nodes_start:random,74,253015,163272,89743,2,1,100;160;196;0;183;31;72;116;51;174;17;190;37;25;27;149;1;154;82;173;42;151;102;165;95;163;156;5;181;134;40;26;195;44;2;177;199;115;88;59;124;91;126;70;66;50;176;182;12;171;69;21;8;118;18;107;65;158;144;52;155;161;46;188;48;112;193;131;129;148;6;162;130;75;150;34;57;9;45;159;68;192;43;117;84;10;78;142;139;178;38;170;141;15;167;157;41;175;185;80,8361747357440261401,0.000000
greedy_intra:nodes_start:random,75,265956,172108,93848,4,3,63;42;29;62;115;87;108;38;124;44;156;141;140;188;122;161;3;142;84;4;194;17;52;81;174;118;58;146;75;46;30;107;67;7;197;78;79;162;149;181;86;5;177;66;182;160;61;0;143;133;136;134;92;154;12;155;10;198;103;101;97;135;138;1;106;121;145;164;185;187;49;139;159;158;127;163;65;31;56;35;80;125;16;147;119;131;20;37;196;113;15;74;167;157;48;13;34;83;129;41,8340065980155579349,0.001387
greedy_intra:nodes_start:random,76,263493,164822,98671,1,0,137;33;94;79;149;175;36;54;110;97;21;45;176;147;178;166;111;76;3;60;58;159;107;136;160;181;182;1;117;5;115;82;27;98;118;47;10;73;7;153;141;14;167;185;121;41;139;102;19;70;114;22;183;13;146;156;12;68;119;122;53;75;0;91;189;105;28;164;67;152;59;172;38;132;128;127;154;186;194;63;26;64;133;199;165;16;32;168;74;113;170;99;190;198;90;103;84;148;81;87,6603686153053342619,0.000000
greedy_intra:nodes_start:random,77,264003,162650,101353,3,2,157;156;124;57;179;64;117;24;89;55;171;90;3;13;42;63;141;159;182;186;103;197;6;168;107;180;60;58;81;193;169;66;17;178;5;121;40;129;43;83;127;122;190;199;130;91;45;136;119;172;175;138;37;189;106;174;94;52;68;7;41;196;61;8;143;72;126;47;88;74;195;75;96;113;44;111;161;67;51;148;108;101;35;151;78;187;99;183;21;15;30;26;27;149;87;97;188;65;120;14,4643411684469441644,0.000000
greedy_intra:nodes_start:random,78,274781,179275,95506,1,0,156;23;184;145;132;127;176;187;169;131;4;86;22;41;75;159;175;35;146;112;55;136;58;151;59;52;24;56;29;114;188;30;89;44;1;110;77;81;124;54;97;183;148;192;36;84;37;82;170;128;119;130;68;12;73;173;7;154;162;138;87;171;66;6;51;94;3;93;190;135;60;164;191;69;65;0;116;174;160;181;155;193;150;147;62;11;101;142;143;118;20;149;198;13;49;26;161;134;2;158,5294166091099317824,0.000000
greedy_intra:nodes_start:random,79,257008,162822,94186,1,0,161;56;130;157;90;188;60;44;177;102;67;52;37;197;76;191;86;91;70;99;39;1;105;53;98;74;38;195;23;43;26;178;138;16;133;142;180;164;129;18;101;96;163;183;151;162;181;113;131;135;77;137;14;66;123;104;174;198;41;2;80;3;155;143;68;30;47;165;89;94;73;95;120;115;154;88;7;45;175;173;124;150;147;65;72;93;182;119;0;187;79;31;190;4;184;85;97;122;84;109,8987395293558064935,0.001009
greedy_intra:nodes_start:random,80,263115,158241,104874,1,0,81;169;119;131;194;3;5;183;126;189;44;19;106;12;42;144;117;20;141;39;21;25;33;137;160;91;101;191;132;139;29;49;36;104;26;157;198;79;178;173;61;70;64;109;86;153;175;68;193;13;138;136;43;100;24;96;129;167;98;105;66;82;63;50;177;120;88;108;47;37;102;53;45;161;150;30;17;168;87;75;52;121;122;128;18;149;83;71;7;28;59;38;145;48;166;180;67;9;97;174,7952690936587532790,0.000000
greedy_intra:nodes_start:random,81,264487,166915,97572,2,1,141;9;87;133;169;83;111;29;165;155;185;126;192;98;70;86;32;42;140;163;173;143;60;78;125;82;16;196;116;175;75;62;39;69;123;190;68;73;2;114;176;65;166;8;99;22;132;67;44;15;120;199;161;36;129;194;50;101;142;79;93;53;162;33;110;63;188;14;136;41;157;102;45;47;27;124;100;0;94;150;51;71;11;172;137;159;170;113;28;189;183;5;74;180;186;148;139;49;95;121,1238511080867250075,0.000000
greedy_intra:nodes_start:random,82,257753,162232,95521,3,2,131;195;41;132;151;4;67;190;184;141;159;144;179;31;55;140;171;25;109;21;167;174;183;166;11;148;20;54;146;62;81;24;127;47;85;93;176;199;59;57;69;6;49;135;104;92;122;152;39;58;1;18;99;14;37;36;117;156;74;90;68;63;192;198;101;107;172;197;113;160;163;103;96;114;180;182;19;147;150;175;194;111;105;26;196;170;138;97;120;126;181;153;23;119;30;51;28;91;193;35,3023296010150430781,0.001000
greedy_intra:nodes_start:random,83,272521,173954,98567,3,2,18;33;91;95;175;192;120;61;66;77;72;181;158;193;51;12;84;106;94;159;187;127;134;79;108;23;141;155;171;92;42;196;157;109;130;107;13;112;21;60;46;132;32;115;153;194;63;24;38;35;34;11;96;89;85;58;86;182;154;162;164;100;118;125;156;37;188;41;101;114;48;71;163;28;183;165;117;180;126;44;36;140;70;22;167;184;31;16;2;8;78;17;76;142;7;5;1;98;129;25,3450825464634746252,0.000000
greedy_intra:nodes_start:random,84,268939,168528,100411,2,1,137;48;36;42;124;171;63;74;163;131;83;152;134;180;73;89;13;61;77;111;88;66;60;192;166;105;21;14;59;84;179;98;164;96;56;86;50;186;79;167;140;185;117;35;174;64;53;11;158;149;15;85;39;187;32;183;7;69;94;142;107;5;18;191;127;148;162;172;157;41;3;103;99;182;17;6;24;37;49;2;25;20;46;144;97;159;115;102;118;65;119;198;91;189;160;145;139;151;0;122,7006572877355993307,0.000000
greedy_intra:nodes_start:random,85,271215,167010,104205,1,0,65;158;194;58;172;37;163;189;78;77;64;23;2;176;109;56;45;9;3;1;174;74;124;129;82;98;171;126;142;154;6;148;198;38;133;39;18;125;22;28;62;16;80;193;40;69;50;167;43;12;83;197;162;169;99;141;134;19;168;95;119;92;35;63;121;30;190;93;199;86;59;31;120;100;185;192;13;76;104;85;165;150;195;157;188;186;146;8;187;151;66;112;166;196;164;48;87;180;178;135,8194266018964638097,0.000000
greedy_intra:nodes_start:random,86,252784,156095,96689,6,5,154;150;106;104;32;71;99;180;137;33;14;163;74;138;41;186;109;182;112;193;151;192;90;177;77;8;61;93;110;159;152;178;122;107;30;173;86;176;52;98;144;101;83;28;96;183;89;130;190;76;38;43;92;78;47;175;81;23;132;187;54;160;35;113;72;66;46;70;174;172;63;1;199;143;111;161;19;55;139;147;12;196;39;25;53;79;155;188;195;16;179;80;124;45;10;3;31;0;100;51,9055261254945158580,0.001002
greedy_intra:nodes_start:random,87,259084,162407,96677,3,2,137;38;8;153;115;16;4;193;132;34;23;170;29;49;144;179;73;13;120;2;19;187;106;160;145;24;33;133;173;77;63;102;32;150;94;152;192;135;182;69;30;166;108;9;118;39;111;55;189;148;5;72;114;12;36;184;70;180;83;176;162;0;191;96;60;44;127;78;113;194;81;195;88;45;25;54;165;112;198;18;51;171;76;99;56;199;50;67;82;161;26;155;40;139;6;169;151;175;172;130,9059725571301731138,0.001351
greedy_intra:nodes_start:random,88,251070,155169,95901,4,3,32;150;47;96;197;125;154;185;6;70;176;69;5;40;80;105;179;10;143;97;26;118;66;50;71;123;46;52;41;166;160;78;31;54;43;53;177;61;76;158;113;127;79;114;195;168;138;121;11;135;161;85;106;60;0;48;192;156;111;33;2;65;30;119;174;104;190;8;159;94;144;34;92;164;196;109;141;23;95;183;187;132;39;139;24;102;3;100;142;19;62;169;13;1;145;199;42;89;178;25,272913608657522644,0.000527
greedy_intra:nodes_start:random,89,251385,152725,98660,1,0,25;63;114;78;65;73;33;84;0;23;106;1;76;116;15;64;61;43;95;129;6;137;150;174;156;123;20;168;167;198;104;91;138;155;197;9;195;118;149;126;27;30;99;56;144;101;117;97;103;159;4;75;136;178;81;71;22;163;122;3;7;24;85;175;94;34;182;40;125;177;194;107;32;51;37;140;59;110;93;147;190;105;115;89;19;165;133;92;189;124;12;47;67;11;39;46;90;186;148;2,5966946807788405742,0.000000
greedy_intra:nodes_start:random,90,256524,163562,92962,1,0,80;27;42;193;126;119;171;166;40;113;74;97;108;187;75;12;95;24;101;59;81;55;122;172;50;62;10;38;153;178;91;195;160;48;182;64;51;47;65;49;179;70;28;185;110;165;107;118;6;128;114;151;3;135;90;188;99;14;198;148;143;100;15;131;46;149;57;30;184;105;31;129;116;76;197;72;138;120;121;136;102;189;106;84;96;130;21;18;43;156;5;7;181;29;169;162;190;33;98;175,8046027296515669290,0.000000
greedy_intra:nodes_start:random,91,270597,165768,104829,3,2,142;69;145;161;32;60;42;7;116;104;1;188;111;63;179;128;33;157;137;147;50;12;61;96;180;77;171;151;45;10;117;4;65;100;82;48;174;153;95;169;191;52;44;16;105;94;198;58;146;112;185;149;75;103;28;152;107;183;121;13;74;172;9;37;186;18;6;89;88;148;56;68;158;135;160;22;119;125;80;99;26;76;31;71;166;122;189;43;5;182;47;66;87;101;170;164;97;106;150;17,6567725237473292713,0.000537
greedy_intra:nodes_start:random,92,243392,148617,94775,1,0,6;125;44;98;19;138;145;155;113;72;148;76;21;50;119;85;38;105;89;24;192;190;156;166;199;34;193;32;181;180;111;83;172;46;36;60;100;143;69;52;37;144;10;80;191;26;102;2;43;186;39;173;170;182;65;178;0;123;5;118;53;78;81;40;1;159;7;169;9;58;27;23;48;139;97;35;109;42;107;197;108;56;110;93;175;174;152;116;3;8;64;121;57;183;158;115;167;137;164;59,2021728789496442562,0.000531
greedy_intra:nodes_start:random,93,244858,153657,91201,2,1,119;73;13;48;35;53;171;148;109;59;39;27;114;130;58;185;189;21;64;60;18;157;52;154;5;33;129;194;44;11;41;51;81;46;87;162;186;71;187;75;72;2;99;177;36;173;149;104;174;24;118;10;159;107;14;176;42;106;1;6;155;43;120;198;153;143;140;163;124;49;178;127;68;122;70;165;12;166;184;126;169;34;62;9;28;74;181;67;69;23;3;117;137;196;180;167;193;152;115;100,7470343083204742032,0.000524
greedy_intra:nodes_start:random,94,255673,157240,98433,1,0,116;22;54;60;145;146;26;191;131;142;52;199;34;153;42;77;72;73;98;173;134;64;177;14;11;19;17;148;65;33;51;9;124;2;127;175;169;85;6;58;137;136;149;165;32;36;138;128;158;168;80;3;133;140;166;132;63;12;94;99;40;81;44;105;57;110;18;75;118;53;25;164;48;0;66;88;198;29;135;71;89;171;172;187;97;76;114;108;70;194;83;178;13;106;102;49;30;160;4;143,7044505890817957371,0.000000
greedy_intra:nodes_start:random,95,267758,175270,92488,2,1,73;14;144;101;145;179;123;140;90;15;2;167;199;3;83;155;190;133;189;9;176;55;138;41;28;174;20;27;16;89;149;185;63;87;154;6;4;64;77;82;153;172;25;96;159;92;164;72;33;156;48;131;52;104;95;23;70;118;13;21;1;191;85;29;158;134;37;148;75;161;30;51;106;0;137;147;173;108;34;24;157;186;69;50;94;116;56;44;181;182;177;42;100;38;130;184;117;62;160;78,2400831517614483325,0.000000
greedy_intra:nodes_start:random,96,254581,155914,98667,1,0,197;38;144;32;64;114;49;96;70;7;195;161;120;133;72;27;90;121;74;78;194;36;151;16;185;182;18;60;105;46;124;149;86;35;139;11;55;40;157;61;140;117;53;169;102;3;123;87;28;183;50;156;73;166;162;10;25;179;122;129;95;89;68;193;152;98;198;45;118;47;171;71;141;192;199;142;119;79;107;51;165;33;5;8;44;189;23;80;17;168;138;181;113;15;109;97;115;188;39;81,3056284978625220081,0.000000
greedy_intra:nodes_start:random,97,274059,178563,95496,1,0,113;59;132;72;14;75;20;25;126;40;103;55;151;177;160;187;31;138;115;17;63;94;148;10;34;85;97;129;184;73;178;50;47;81;58;157;165;142;112;149;39;42;92;150;83;194;143;78;170;15;52;122;54;0;161;104;70;114;68;95;125;162;124;11;67;158;156;101;117;174;172;30;154;166;136;6;7;91;118;23;199;192;171;181;1;183;137;99;106;87;53;102;167;21;134;12;56;169;140;38,7465642688616078914,0.000523
greedy_intra:nodes_start:random,98,282718,182668,100050,3,2,171;150;46;199;53;68;139;124;65;57;84;83;29;106;28;90;153;129;25;192;172;193;197;149;95;130;146;137;70;26;30;128;69;127;164;32;157;117;3;18;161;186;101;107;116;11;58;8;82;176;86;113;140;96;114;180;166;15;73;36;61;42;182;22;152;60;198;167;9;163;196;79;102;156;133;80;126;119;160;138;89;98;110;43;50;47;38;100;190;45;64;87;178;145;12;77;74;4;183;132,4413146657419814693,0.000573
greedy_intra:nodes_start:random,99,281343,175620,105723,1,0,153;26;27;139;127;63;190;66;78;91;98;1;20;136;173;146;188;175;144;9;21;104;32;164;97;81;160;52;10;99;168;55;129;29;155;192;119;6;39;107;178;57;51;76;111;161;88;184;33;30;100;65;114;159;4;62;72;5;118;40;12;198;185;37;38;24;25;45;28;56;193;16;8;23;35;79;132;60;189;142;149;58;61;43;199;169;70;89;95;0;170;87;196;141;75;124;103;151;74;64,7880962241216396089,0.000556
greedy_intra:nodes_start:random,100,266644,164257,102387,2,1,105;6;101;5;66;61;197;93;62;116;114;19;162;40;124;49;126;104;94;143;79;139;108;97;195;38;168;67;98;132;111;179;81;129;3;120;189;161;109;166;102;140;88;70;91;145;9;100;167;119;178;106;181;33;12;20;73;146;165;173;11;87;144;150;134;103;44;127;53;157;199;96;155;50;113;54;68;159;170;176;90;60;188;36;15;192;121;153;136;154;18;75;4;48;64;182;122;57;135;171,1544135792062520315,0.000000
greedy_intra:nodes_start:random,101,265030,163183,101847,2,1,158;108;106;107;74;104;76;100;88;155;26;152;161;20;1;189;84;165;82;181;116;182;25;113;12;66;0;166;199;29;53;176;75;105;61;2;128;141;87;44;49;154;40;190;85;175;70;151;33;39;125;56;94;115;138;120;168;140;109;110;169;122;83;78;118;38;8;72;93;136;30;64;37;31;71;46;99;179;16;185;157;102;13;96;171;163;119;34;58;11;3;111;57;180;191;5;19;35;43;183,1640479428460473229,0.000000
greedy_intra:nodes_start:random,102,259302,162719,96583,6,5,112;64;45;98;94;121;57;7;159;189;99;113;146;54;12;91;70;151;60;163;39;116;10;38;33;62;34;21;193;90;187;2;66;128;114;15;194;40;81;199;191;27;111;178;129;23;100;103;48;20;41;125;165;109;127;26;97;86;31;105;145;185;104;80;56;157;53;14;19;147;158;152;177;156;150;164;13;9;139;124;136;87;16;89;32;182;188;18;155;71;179;195;143;196;24;5;175;3;123;11,3604876512526425948,0.001038
greedy_intra:nodes_start:random,103,269918,165984,103934,2,1,128;117;185;177;120;147;40;138;115;75;26;156;29;8;105;9;66;112;145;119;164;171;198;1;4;50;92;170;23;74;91;134;124;106;168;68;199;18;21;197;32;63;25;64;36;162;148;37;102;77;173;96;3;163;94;81;139;51;195;19;107;86;153;88;79;183;174;16;159;20;160;142;133;166;108;22;167;89;169;70;103;67;45;71;186;6;191;193;35;140;87;125;109;49;7;172;13;24;99;122,1774653741856976944,0.000567
greedy_intra:nodes_start:random,104,264667,164517,100150,1,0,113;171;154;91;103;23;67;183;153;72;105;27;88;43;185;11;147;55;26;52;62;57;182;75;162;123;98;178;61;117;149;157;49;24;142;114;28;84;156;168;34;197;20;4;163;144;133;143;181;37;29;69;76;152;53;187;107;85;95;71;193;70;33;140;164;77;130;9;87;160;172;42;10;3;175;79;161;192;73;141;159;86;83;90;44;0;25;165;166;99;68;101;198;17;158;47;74;81;106;100,6643778812640241157,0.000000
greedy_intra:nodes_start:random,105,269811,174559,95252,1,0,117;38;123;34;67;128;185;87;28;21;179;16;83;18;97;54;158;75;40;96;99;1;156;62;153;135;142;157;166;184;164;146;109;192;183;70;22;198;86;181;150;15;11;190;160;159;36;52;60;180;20;111;23;76;74;170;84;107;143;100;138;79;105;168;4;130;66;81;154;161;132;53;19;147;13;46;31;95;139;72;88;48;5;17;25;145;113;30;82;115;42;140;108;93;137;194;106;14;94;92,4300616408127219603,0.000000
greedy_intra:nodes_start:random,106,259146,166218,92928,1,0,169;127;98;51;142;176;12;186;58;4;7;8;180;154;14;39;153;178;136;109;68;190;75;130;47;76;54;193;92;80;41;197;31;124;89;122;9;137;147;99;49;118;91;65;22;117;164;57;188;168;30;110;44;29;16;163;88;59;84;159;63;70;170;192;83;53;11;174;135;45;146;162;149;40;114;185;66;116;55;62;20;165;46;179;107;38;139;102;64;21;81;141;198;3;148;138;101;113;37;194,1372798940335619963,0.000000
greedy_intra:nodes_start:random,107,251286,157193,94093,1,0,144;53;88;176;148;143;10;108;74;182;100;173;124;178;145;17;113;34;120;191;89;185;111;118;61;112;27;9;125;18;158;66;55;146;163;3;58;117;159;97;76;72;90;132;155;167;174;194;116;62;86;33;56;50;141;137;11;36;52;78;64;109;70;93;57;165;198;15;133;75;103;179;4;24;30;73;14;136;19;49;48;166;79;65;177;0;162;119;199;16;196;131;38;135;168;95;71;138;114;7,7685558012708015759,0.000000
greedy_intra:nodes_start:random,108,264129,169269,94860,1,0,117;110;1;25;175;140;177;165;5;39;130;88;188;43;122;128;80;115;28;103;10;179;96;134;40;56;20;111;174;173;75;42;45;144;199;162;94;69;146;49;13;123;9;163;164;83;154;35;57;51;170;53;187;133;32;27;155;34;192;137;190;54;119;71;81;92;132;101;22;17;16;38;50;168;95;167;70;189;99;121;145;178;31;18;125;98;198;55;148;102;93;141;139;181;129;176;160;14;195;107,4870651137245838450,0.000513
greedy_intra:nodes_start:random,109,263682,164812,98870,2,1,76;55;89;158;2;20;65;117;137;173;84;197;62;95;47;116;36;78;165;39;147;98;161;73;71;7;70;163;67;43;121;63;54;192;18;9;23;32;5;13;101;29;133;156;112;79;168;196;85;77;184;10;188;181;14;109;149;3;146;180;8;102;187;35;60;56;162;87;97;198;115;172;22;21;178;69;157;42;138;135;164;111;52;148;176;0;113;153;46;174;6;171;142;191;139;83;50;129;45;24,1941131520748216560,0.000592
greedy_intra:nodes_start:random,110,254258,159790,94468,1,0,87;190;192;179;14;155;81;69;27;133;105;137;141;181;73;97;10;149;139;83;51;3;118;31;121;151;85;131;104;132;94;144;84;174;140;193;22;18;163;146;191;68;82;145;177;91;156;95;170;72;161;107;189;9;49;108;20;24;6;71;198;80;123;93;90;26;76;62;28;176;8;98;180;183;184;164;142;53;166;70;186;63;130;57;58;158;39;44;171;37;175;188;135;61;124;187;78;55;165;17,1720312457338436177,0.000000
greedy_intra:nodes_start:random,111,263367,165617,97750,4,3,66;21;72;81;162;57;198;79;80;97;187;109;36;173;26;163;124;119;139;142;144;100;69;51;196;76;20;78;185;95;6;171;13;137;48;98;22;133;132;23;52;5;12;195;35;60;125;189;150;102;149;82;175;34;2;85;161;116;1;55;167;148;186;138;89;165;197;129;155;99;28;54;154;172;193;91;68;83;14;160;151;87;118;39;49;110;86;94;166;45;70;71;11;182;24;96;179;127;42;143,2526092893789473627,0.000545
greedy_intra:nodes_start:random,112,271869,174426,97443,2,1,56;65;37;145;105;52;136;154;158;175;169;75;183;161;143;190;148;92;5;171;125;176;112;120;68;111;152;20;85;180;13;195;177;72;18;17;104;60;33;83;84;73;30;98;192;70;132;12;162;53;25;101;62;32;67;160;35;196;61;96;174;119;126;168;149;43;57;133;142;24;2;186;86;76;194;80;110;49;6;193;166;185;108;109;28;59;54;147;31;89;88;117;165;23;121;135;182;116;3;50,7375979410595797813,0.000000
greedy_intra:nodes_start:random,113,264768,165789,98979,3,2,32;11;130;131;152;192;17;170;161;59;115;7;39;68;5;153;118;77;191;13;119;25;6;8;98;159;111;81;179;127;71;3;94;38;53;136;41;176;55;112;162;133;78;189;57;70;134;164;86;185;15;33;138;180;101;48;50;24;45;146;148;96;122;169;199;18;23;121;63;47;80;49;99;95;109;187;149;155;190;135;168;129;171;104;188;74;113;46;140;126;181;67;26;151;117;90;36;184;128;16,8522024418912417676,0.000562
greedy_intra:nodes_start:random,114,275988,176067,99921,1,0,88;86;135;18;100;68;80;122;47;136;46;31;6;79;138;165;103;77;20;66;63;1;42;89;94;148;101;9;185;43;95;116;40;153;155;67;123;174;29;2;72;53;51;107;45;23;141;96;85;24;149;157;65;104;7;54;33;50;151;93;61;186;114;127;177;90;98;126;36;21;55;181;154;130;188;189;106;28;163;160;39;69;146;110;35;71;105;147;13;37;64;175;167;16;12;121;62;5;74;156,2228669047780237162,0.000000
greedy_intra:nodes_start:random,115,251666,152828,98838,1,0,16;13;91;168;120;183;36;135;28;59;92;190;114;97;174;152;122;149;195;99;27;78;76;85;151;132;61;86;167;37;109;14;25;121;42;98;71;74;171;73;182;141;64;70;94;166;100;31;21;115;23;87;143;48;41;192;117;0;165;113;142;118;47;124;129;194;34;57;178;179;15;69;133;39;96;148;158;30;139;147;164;60;169;160;134;197;1;193;8;93;11;45;63;6;170;4;84;51;50;172,1201254627804161446,0.000040
greedy_intra:nodes_start:random,116,273666,177284,96382,2,1,177;128;14;195;169;154;105;56;136;63;163;193;157;94;168;25;170;59;165;37;57;16;73;130;135;181;52;179;122;192;123;76;180;134;140;183;110;191;64;81;109;85;189;115;91;141;103;132;29;19;143;160;104;175;1;166;78;43;185;133;44;142;167;0;74;36;8;28;51;67;198;30;152;31;15;22;71;176;120;46;178;84;83;86;174;92;102;116;49;48;45;96;2;182;50;13;5;61;196;12,1835340213231769452,0.000000
greedy_intra:nodes_start:random,117,258567,159222,99345,1,0,185;99;184;81;182;55;125;9;77;109;98;46;7;107;142;12;154;183;164;31;84;151;68;93;34;124;135;30;35;148;76;50;15;150;199;17;87;101;74;149;196;10;177;115;5;48;110;54;112;187;102;4;136;82;42;173;8;26;100;186;127;139;3;134;122;44;180;168;70;79;45;114;57;59;131;41;188;92;178;23;66;194;37;145;40;132;104;193;157;69;123;121;89;96;28;161;25;126;155;67,592593454384668528,0.000000
greedy_intra:nodes_start:random,118,281659,182848,98811,1,0,103;73;195;116;191;38;10;150;198;23;190;3;192;144;88;161;199;49;155;197;77;29;101;78;95;26;97;107;119;112;138;173;141;55;146;187;174;4;20;2;60;36;14;84;43;118;34;169;35;79;139;127;142;129;6;81;143;44;63;56;111;162;130;175;160;70;92;99;113;134;178;87;75;9;115;124;42;120;76;83;188;135;148;12;71;15;164;74;57;24;16;122;157;153;32;21;167;22;52;196,1678968842000331859,0.000000
greedy_intra:nodes_start:random,119,261840,155616,106224,1,0,118;156;63;72;166;141;103;137;163;12;151;42;187;32;76;179;113;128;186;67;174;50;154;133;30;146;131;158;3;65;66;162;39;64;80;84;105;127;150;16;197;24;43;69;68;192;125;195;143;71;26;176;87;173;35;83;120;81;168;96;157;171;82;194;95;132;85;61;8;102;109;62;190;60;145;177;129;89;10;114;44;199;2;56;23;121;47;25;4;79;55;159;11;185;7;110;74;73;189;29,179827288840283827,0.000513
greedy_intra:nodes_start:random,120,266399,164547,101852,2,1,176;95;168;195;85;117;4;1;0;135;100;9;3;128;70;139;31;56;186;112;142;82;172;181;91;189;63;94;73;71;99;74;22;115;178;107;47;69;191;49;20;12;25;137;10;163;138;44;126;55;103;183;124;198;173;158;157;7;21;104;196;38;60;59;180;66;167;75;29;96;159;87;6;18;147;89;152;141;144;79;17;153;148;113;36;64;110;197;72;114;33;46;35;32;146;156;11;140;101;184,4945896260036529784,0.000532
greedy_intra:nodes_start:random,121,270619,172507,98112,1,0,25;42;39;21;41;196;24;75;43;4;84;40;64;50;62;28;52;110;115;193;88;149;15;167;189;54;118;86;11;168;93;146;135;157;104;150;29;160;70;113;35;6;72;90;7;144;169;94;129;49;109;170;173;198;77;128;106;156;67;8;107;125;183;177;1;57;136;108;17;91;111;13;37;76;47;44;164;154;58;81;176;18;140;2;191;142;101;65;165;45;36;3;148;10;97;80;38;87;192;131,6165286388500530048,0.000000
greedy_intra:nodes_start:random,122,265724,174049,91675,1,0,125;118;18;19;1;121;21;193;157;4;23;109;146;37;143;38;151;20;14;135;16;26;130;115;147;97;110;195;79;15;196;183;95;74;113;83;127;124;3;190;56;173;199;8;108;106;65;36;9;82;72;168;163;67;91;51;139;94;54;7;148;138;142;31;30;24;45;59;187;178;46;120;39;164;117;179;27;55;141;41;77;2;11;175;49;66;136;75;88;160;35;43;112;126;122;70;152;78;61;177,7412102025256361041,0.000000
greedy_intra:nodes_start:random,123,259279,165922,93357,1,0,78;164;22;102;80;69;88;41;124;144;72;104;123;112;116;87;13;168;153;171;28;79;154;27;56;107;110;188;161;195;138;44;40;83;156;103;180;189;38;115;137;29;0;58;16;10;92;158;139;14;174;185;9;148;118;117;159;43;132;133;60;96;61;130;136;109;120;49;75;173;12;193;3;191;108;184;194;31;146;53;192;21;105;70;129;197;170;39;57;128;1;183;6;48;82;37;177;42;47;114,8788961085158140184,0.000514
greedy_intra:nodes_start:random,124,283619,184825,98794,4,3,199;52;65;143;147;126;117;19;85;136;80;178;151;23;120;164;67;56;156;173;50;198;121;191;39;130;78;51;168;38;28;195;152;66;183;90;36;157;194;96;24;1;37;48;45;81;184;155;84;196;146;188;139;82;169;113;33;133;98;187;97;75;142;148;68;5;167;176;105;2;4;58;193;20;109;129;131;62;140;32;106;47;31;122;108;150;59;145;144;177;89;162;104;43;170;116;102;3;64;192,8979895448239550586,0.000000
greedy_intra:nodes_start:random,125,258412,162485,95927,1,0,72;1;126;191;0;142;195;188;130;87;183;49;147;152;196;44;112;95;171;110;150;35;144;27;161;10;73;71;91;92;57;31;30;116;67;151;135;180;111;132;88;108;168;40;53;74;154;120;140;36;166;148;38;64;89;33;83;129;18;187;124;164;3;2;42;48;41;9;23;128;81;90;50;139;159;21;133;162;99;149;157;141;60;160;179;190;109;143;194;98;56;45;75;103;131;165;184;22;175;70,4305384846347371908,0.000000
greedy_intra:nodes_start:random,126,242212,151913,90299,3,2,194;161;111;92;98;153;179;5;37;43;149;184;118;147;127;48;175;137;68;100;97;13;166;54;121;199;59;41;25;139;171;14;53;71;16;39;93;196;73;7;49;136;95;44;72;83;63;102;36;193;1;35;19;159;47;145;180;106;188;152;176;70;134;6;146;103;163;155;132;51;119;38;78;154;20;110;105;27;123;115;120;99;74;2;122;158;135;156;96;31;34;18;130;40;169;198;116;108;24;29,7887748813941568096,0.001058
greedy_intra:nodes_start:random,127,261894,162395,99499,4,3,144;3;98;46;31;25;19;140;175;148;66;116;89;182;28;48;167;15;196;109;77;82;33;23;45;95;13;152;198;39;90;8;153;158;172;135;157;103;76;168;86;96;84;75;156;180;72;149;121;61;11;173;26;67;55;162;99;64;130;14;102;97;193;136;110;166;134;12;79;94;92;105;164;146;143;80;62;160;37;44;47;41;91;22;115;9;176;131;114;30;87;42;88;51;43;68;0;104;188;127,5007616989409488143,0.000000
greedy_intra:nodes_start:random,128,278227,178473,99754,2,1,86;111;4;16;157;195;150;50;78;42;77;110;185;139;169;123;130;64;76;38;15;83;20;120;141;118;122;11;193;137;2;177;160;107;61;188;132;148;176;80;21;36;35;94;69;48;56;88;127;75;28;100;161;186;162;189;70;152;135;98;72;182;167;84;85;134;19;156;3;140;154;168;30;91;126;124;0;147;159;101;117;51;41;90;170;95;10;166;187;131;22;145;172;178;31;102;136;146;184;171,6611444172510224011,0.000547
greedy_intra:nodes_start:random,129,282100,179695,102405,1,0,81;82;70;194;19;47;73;100;24;144;102;97;151;126;161;5;74;76;188;17;53;42;179;142;109;178;187;60;116;54;138;40;46;175;108;154;115;119;20;79;4;168;150;31;44;162;10;189;62;26;3;166;196;87;137;30;57;67;124;117;6;83;105;41;169;136;199;91;107;61;23;112;149;129;147;21;69;156;36;15;185;85;167;193;13;80;176;174;93;84;177;127;7;103;121;58;86;90;130;104,8008211839183535531,0.000000
greedy_intra:nodes_start:random,130,264136,167628,96508,2,1,72;131;121;42;183;186;166;106;66;176;113;122;124;8;80;41;35;130;65;86;148;187;192;188;191;18;23;156;115;119;149;9;162;34;14;126;167;83;128;117;185;69;142;0;59;47;20;74;184;19;144;147;157;46;158;89;95;177;76;109;78;45;37;196;94;61;134;51;145;15;44;96;62;150;101;114;64;108;103;153;140;91;43;175;71;102;90;136;6;32;180;129;164;127;154;110;13;50;31;88,356938198686766613,0.000525
greedy_intra:nodes_start:random,131,271254,170516,100738,2,1,11;123;186;32;46;144;82;9;40;29;24;184;17;88;31;130;72;154;110;109;58;71;70;198;60;62;47;157;23;15;30;150;127;14;33;86;28;172;49;45;36;50;87;89;21;44;169;177;103;0;51;196;59;8;76;85;20;99;67;145;63;35;183;179;174;7;27;188;187;199;140;182;52;54;134;56;65;2;149;90;74;68;42;78;142;125;3;16;118;133;171;136;95;193;137;141;57;173;152;146,34067765022812459,0.000608
greedy_intra:nodes_start:random,132,257847,163575,94272,2,1,180;17;161;33;26;55;199;73;81;133;25;64;130;153;80;118;6;167;117;189;51;86;145;185;115;103;106;139;125;88;188;136;141;182;159;9;43;69;151;85;143;10;8;61;41;96;179;171;40;102;194;124;3;144;89;158;58;49;23;35;36;104;39;42;66;181;193;174;163;59;31;129;34;57;187;119;76;111;123;65;108;56;138;63;12;196;150;72;1;116;110;175;147;160;97;37;157;60;16;95,8876900842348287775,0.000000
greedy_intra:nodes_start:random,133,243338,156970,86368,3,2,144;0;184;22;34;79;97;108;28;164;64;19;167;52;187;71;196;55;36;81;31;175;14;11;174;183;96;146;59;80;155;83;65;73;35;140;87;103;116;99;129;118;145;137;39;89;54;194;104;185;109;95;117;2;148;30;1;13;27;171;114;165;61;143;112;132;119;18;163;5;139;180;53;77;25;162;101;75;190;12;10;47;29;111;46;188;127;161;82;124;189;123;3;21;45;120;131;176;93;152,5928306355418323800,0.000564
greedy_intra:nodes_start:random,134,261178,166565,94613,2,1,44;19;192;160;50;85;95;54;42;194;183;137;195;30;61;121;64;41;161;6;185;14;53;154;110;179;167;96;7;36;75;170;101;43;151;17;78;80;1;112;21;155;79;118;136;153;124;12;92;106;184;156;175;76;174;105;128;93;139;18;89;180;193;126;34;32;159;114;165;187;29;172;3;46;182;24;199;145;130;144;72;147;157;67;119;103;116;162;81;143;173;71;56;62;15;63;38;5;35;169,1772428765709984334,0.000000
greedy_intra:nodes_start:random,135,253550,157249,96301,2,1,128;22;132;9;80;37;26;23;47;138;52;86;152;28;107;101;161;63;154;15;74;79;54;144;33;102;109;174;131;19;91;117;58;65;60;94;147;1;172;116;43;196;46;12;193;68;129;62;42;96;14;77;11;158;135;133;142;122;90;179;120;57;113;145;83;78;195;125;175;3;29;81;7;30;141;183;36;199;166;76;71;167;118;155;56;108;124;162;187;64;50;2;189;163;151;190;159;100;4;191,8249252691941348310,0.000555
greedy_intra:nodes_start:random,136,249944,154197,95747,1,0,34;23;144;166;21;161;143;104;31;33;106;77;137;8;96;197;180;183;26;22;49;71;185;60;130;160;134;76;158;17;39;14;66;173;127;101;175;70;89;195;12;128;148;102;105;25;191;79;150;82;80;52;78;92;50;164;153;152;99;165;10;146;88;83;108;59;178;120;29;4;139;172;58;167;87;177;133;93;129;55;6;13;186;90;16;19;116;41;42;132;56;141;27;124;121;125;95;91;3;151,8199698759811516247,0.000000
greedy_intra:nodes_start:random,137,258000,162584,95416,4,3,62;76;197;134;153;26;133;69;171;88;28;101;86;58;146;175;139;114;148;59;53;154;98;190;168;151;160;113;46;57;44;83;119;78;149;173;104;63;31;186;11;111;51;125;144;19;99;50;135;74;165;39;3;25;12;60;107;170;73;167;36;138;40;10;30;147;66;65;137;195;5;141;179;4;79;181;120;67;9;100;131;180;123;121;97;102;161;27;106;90;130;45;68;158;150;185;18;172;157;184,382376847944391025,0.000544
greedy_intra:nodes_start:random,138,248218,154527,93691,1,0,5;180;52;1;181;69;38;177;143;98;127;113;12;171;56;153;70;41;151;74;31;128;158;13;182;137;29;140;11;114;183;25;33;89;132;88;107;189;195;193;149;45;35;57;184;176;83;16;179;80;22;66;148;23;96;24;51;6;168;178;105;14;46;157;108;199;82;173;32;162;40;15;175;164;125;116;122;68;118;75;19;62;145;100;134;104;141;197;43;42;159;119;81;64;2;126;10;139;115;92,7075919543406850328,0.000000
greedy_intra:nodes_start:random,139,243788,150852,92936,1,0,14;154;179;86;109;180;25;182;95;67;115;72;168;162;28;87;17;52;185;74;160;40;106;27;44;101;23;132;60;78;22;114;172;65;177;125;0;59;31;98;6;68;48;26;107;42;62;145;129;53;103;186;191;150;100;2;111;188;66;57;9;158;63;3;55;133;187;97;12;178;196;77;173;21;164;140;126;118;148;15;113;102;18;10;163;195;136;96;36;1;49;116;176;13;166;93;161;19;198;155,3374836895592441703,0.000525
greedy_intra:nodes_start:random,140,251313,150812,100501,1,0,48;54;63;100;28;11;43;177;110;169;69;186;116;84;31;101;96;27;168;13;111;52;34;74;118;154;141;195;194;164;158;183;6;90;21;109;121;163;165;68;174;40;178;55;150;107;66;12;33;60;50;162;185;80;133;139;36;57;19;71;37;83;197;30;14;8;179;76;189;15;112;99;144;93;148;198;152;176;124;9;2;125;138;82;75;24;56;25;184;79;64;170;67;113;23;41;136;130;29;94,8534445910691403932,0.000000
greedy_intra:nodes_start:random,141,277268,171792,105476,2,1,172;49;54;150;148;174;192;145;92;108;106;76;39;123;198;29;140;168;165;197;93;169;61;74;191;7;65;101;139;183;194;142;58;102;132;13;141;75;35;166;45;23;98;34;38;160;63;78;152;151;95;103;16;130;87;189;175;12;126;111;184;182;6;80;129;3;162;96;99;136;125;157;167;124;128;107;2;199;56;190;146;68;121;72;133;109;4;161;134;114;27;31;69;82;18;131;20;195;105;144,4359646082374788862,0.000000
greedy_intra:nodes_start:random,142,259069,161756,97313,2,1,6;91;120;148;30;15;35;160;147;119;17;90;112;60;165;170;29;47;88;36;192;128;13;130;73;5;198;12;138;157;109;169;184;58;10;127;131;159;0;89;174;50;59;75;31;111;68;105;93;195;54;61;4;102;143;57;84;176;161;141;150;64;151;38;110;24;65;140;41;53;164;181;114;87;55;45;172;193;145;62;18;121;72;149;118;80;123;179;2;135;43;83;23;115;180;9;63;117;133;199,6845576355161449706,0.000000
greedy_intra:nodes_start:random,143,261880,168904,92976,1,0,31;44;142;113;191;109;13;122;35;181;147;66;171;26;169;20;123;18;62;186;80;58;146;139;183;161;27;108;33;71;11;34;1;159;67;23;90;132;106;144;150;125;100;115;38;36;45;41;165;101;174;153;170;116;83;24;140;70;187;40;168;81;97;7;162;152;128;193;118;155;130;112;0;103;25;48;51;78;19;47;131;120;4;175;151;98;49;15;87;92;137;72;167;198;148;99;21;184;111;176,4924489631050557658,0.000065
greedy_intra:nodes_start:random,144,252135,152021,100114,5,4,71;115;141;176;12;167;94;42;65;156;48;168;31;87;152;19;119;197;33;21;88;154;161;101;53;79;11;133;189;37;74;18;15;63;93;16;27;36;73;165;185;113;9;22;130;104;124;110;171;49;159;4;112;140;199;58;81;160;89;132;122;126;60;47;135;52;20;13;55;114;62;77;191;138;137;102;134;10;100;97;95;98;90;35;187;2;66;147;96;24;172;57;44;198;155;195;7;32;17;99,2074136988611573893,0.000538
greedy_intra:nodes_start:random,145,252304,161994,90310,2,1,13;94;114;135;78;18;123;146;60;160;149;110;169;71;33;44;192;65;122;52;111;99;39;41;17;140;145;130;112;68;69;148;7;58;88;184;180;30;187;40;31;170;104;163;139;195;102;128;106;183;137;143;101;138;154;4;34;199;0;74;81;22;43;46;144;171;185;103;159;26;55;38;98;51;113;193;182;118;186;151;172;8;136;5;166;75;27;152;96;173;119;126;197;179;129;10;153;85;23;142,5924745031537371754,0.000550
greedy_intra:nodes_start:random,146,251181,154844,96337,1,0,68;100;13;19;44;180;138;105;72;26;163;64;139;172;52;85;63;86;122;143;135;141;101;60;66;80;148;14;33;69;176;12;7;146;8;126;43;73;67;81;90;1;155;55;15;57;42;28;167;140;76;182;168;154;128;98;183;40;175;30;48;188;171;78;82;136;178;17;50;197;3;107;111;192;39;193;77;129;16;137;118;32;112;165;49;59;70;53;199;38;174;114;166;194;83;144;195;185;89;0,1582917790255912454,0.000000
greedy_intra:nodes_start:random,147,291804,185007,106797,1,0,3;97;58;174;12;166;53;196;35;176;154;148;87;137;177;122;141;82;175;104;79;108;8;29;42;66;151;168;81;195;56;117;34;107;48;98;152;93;130;178;45;171;121;60;54;39;132;65;156;111;100;27;88;10;24;83;38;49;164;161;17;120;145;183;84;91;22;187;197;28;90;179;103;37;147;71;182;155;76;68;170;125;181;112;50;6;184;15;149;129;162;124;191;5;126;180;61;67;134;70,2658218797453526779,0.000000
greedy_intra:nodes_start:random,148,259532,172871,86661,2,1,66;114;154;24;131;148;44;60;36;16;140;40;199;190;102;56;198;195;81;139;88;46;110;156;124;29;107;159;175;33;185;75;145;19;53;100;59;14;97;50;106;180;31;115;94;152;63;48;89;25;30;96;172;70;144;79;163;183;179;121;191;82;12;90;93;113;13;3;158;65;55;69;149;26;150;80;49;157;23;189;43;52;9;86;171;164;181;105;76;87;5;196;123;84;138;64;146;54;127;28,8527395965416571,0.000604
greedy_intra:nodes_start:random,149,264332,164879,99453,1,0,81;157;86;93;77;84;123;146;97;36;59;49;43;168;193;167;53;113;195;180;119;137;88;64;62;129;182;187;95;186;140;190;19;3;197;96;156;125;199;143;52;4;30;27;33;74;65;41;89;63;35;155;192;108;87;99;109;67;25;179;83;165;7;164;24;169;58;55;138;11;14;173;16;126;91;5;120;39;34;102;76;32;12;132;15;115;151;54;158;69;139;8;57;189;1;17;73;28;106;111,8221757665904854676,0.000000
greedy_intra:nodes_start:random,150,271009,174923,96086,2,1,176;63;86;177;42;146;172;34;94;187;72;37;69;92;41;98;140;174;130;102;104;156;91;52;54;118;99;133;87;90;66;62;155;134;68;8;121;196;115;93;194;193;138;197;10;142;158;164;44;76;51;181;0;152;29;106;75;82;96;165;58;2;198;61;148;139;65;25;105;108;189;145;47;114;170;113;5;74;59;60;183;30;116;73;18;38;40;49;173;160;15;28;67;103;13;32;26;83;50;129,7825477049976047157,0.000000
greedy_intra:nodes_start:random,151,255663,158556,97107,1,0,114;199;173;11;13;50;99;80;52;121;177;74;165;142;17;131;140;43;76;123;77;170;151;150;108;87;154;117;160;45;163;0;129;53;71;61;101;41;158;63;171;152;138;110;155;16;147;112;18;37;65;161;57;8;6;100;105;180;64;128;157;164;9;21;59;167;118;69;153;81;95;4;106;73;35;166;181;103;120;127;33;54;190;148;78;130;196;135;96;162;14;146;93;122;31;192;29;193;137;141,1500370893835878353,0.000000
greedy_intra:nodes_start:random,152,240848,152052,88796,1,0,20;109;97;50;27;31;23;173;63;90;176;69;133;156;53;81;132;36;181;129;185;145;48;131;65;22;26;116;46;62;118;199;196;0;76;198;168;72;134;137;179;106;127;142;71;49;64;146;114;170;55;157;178;52;144;60;175;7;2;171;44;100;138;85;77;177;93;51;87;78;122;105;128;89;143;164;15;66;123;141;188;80;135;149;150;169;16;102;103;193;151;187;19;197;47;113;5;56;92;79,7930781815252418272,0.000043
greedy_intra:nodes_start:random,153,264132,168370,95762,3,2,27;17;48;140;124;37;62;118;58;103;171;30;175;115;130;197;60;24;184;32;109;57;71;138;165;88;143;101;121;92;83;128;110;186;82;90;8;16;113;136;15;50;52;135;47;139;173;34;104;3;70;125;127;43;10;119;189;169;76;42;159;2;59;18;193;148;99;106;111;91;157;146;22;35;122;120;191;97;195;45;132;86;112;6;23;117;179;56;126;21;44;151;108;98;181;25;107;11;75;84,3459267634524716012,0.000000
greedy_intra:nodes_start:random,154,255232,154539,100693,2,1,104;112;131;41;39;40;183;45;86;166;187;62;109;179;194;1;79;9;25;36;134;78;162;44;38;127;177;69;20;66;192;185;56;81;156;114;76;7;119;87;154;181;163;96;106;48;57;75;35;8;117;91;191;199;24;139;150;92;77;43;47;145;64;188;2;108;159;13;136;72;120;146;103;4;138;33;82;34;186;61;170;23;95;172;164;65;141;190;28;122;100;158;31;147;51;126;11;59;101;152,559819169168389862,0.001122
greedy_intra:nodes_start:random,155,265465,169362,96103,1,0,171;195;106;120;32;152;6;46;179;82;41;90;85;163;115;11;81;13;37;160;51;75;133;168;55;89;188;192;86;191;136;87;172;8;26;67;72;1;105;53;147;186;39;158;128;199;57;118;116;197;165;100;99;112;155;84;107;20;151;93;148;138;98;181;101;121;124;73;9;135;189;130;79;80;48;18;49;50;137;184;44;167;17;126;52;193;65;140;70;58;27;103;102;28;114;16;174;183;83;78,8039283205971589839,0.000000
greedy_intra:nodes_start:random,156,253819,151743,102076,1,0,143;94;172;40;144;138;56;21;155;81;2;139;127;116;160;187;33;136;154;15;85;141;179;79;105;182;32;91;133;36;112;73;3;22;62;125;166;60;0;194;64;173;50;196;95;10;140;128;59;142;157;41;44;84;12;121;61;80;42;35;66;135;99;51;150;100;28;153;7;197;164;74;106;31;38;47;120;199;23;13;188;122;6;25;90;189;184;67;86;63;118;167;103;115;96;55;110;190;45;65,1486341325637534899,0.000000
greedy_intra:nodes_start:random,157,258554,160157,98397,2,1,68;196;133;183;57;148;191;137;159;165;173;154;147;52;50;189;96;55;26;13;134;199;132;155;185;56;37;92;49;107;114;198;172;101;145;84;197;110;100;48;192;117;195;27;113;47;28;142;88;178;115;33;93;23;16;58;124;152;120;81;119;66;80;46;168;160;14;54;72;40;104;34;35;125;60;127;118;103;20;3;194;105;182;140;153;89;61;6;1;108;53;31;86;71;171;82;41;87;10;136,2514093264422209956,0.000000
greedy_intra:nodes_start:random,158,254103,154235,99868,1,0,32;83;18;158;0;17;92;190;13;121;49;40;195;148;113;16;129;59;166;86;181;60;103;118;56;10;138;188;146;30;122;28;53;137;119;114;90;174;163;74;131;141;173;187;169;2;144;11;194;109;149;20;35;162;152;6;167;164;58;81;25;42;51;120;96;147;29;127;65;3;133;66;142;7;145;156;44;196;15;157;95;117;79;33;154;155;172;93;89;177;61;180;198;39;78;130;64;45;178;91,8385721423457128031,0.000512
greedy_intra:nodes_start:random,159,269428,165785,103643,5,4,153;72;162;159;140;91;149;110;23;199;78;128;68;9;77;56;180;57;84;175;188;98;120;135;132;75;138;27;5;46;187;106;167;182;102;11;4;177;172;184;142;74;113;121;20;183;96;170;179;18;69;76;50;16;38;99;87;29;60;150;97;163;176;107;1;65;147;83;14;154;197;8;157;189;136;12;196;104;64;67;160;165;2;191;156;145;116;169;28;185;192;55;114;103;24;0;43;178;130;133,8982645582657603303,0.000528
greedy_intra:nodes_start:random,160,267111,172958,94153,5,4,10;199;25;187;43;144;7;0;31;101;178;68;37;185;126;39;182;57;179;188;166;120;60;180;15;158;145;17;177;163;133;132;86;36;183;193;140;19;152;119;54;112;146;131;139;174;156;58;35;191;33;167;3;175;170;116;88;115;125;122;85;20;79;108;93;82;44;190;127;138;147;26;23;80;129;9;8;162;45;111;103;48;62;117;169;135;73;90;2;83;128;102;165;84;142;56;154;75;89;5,8448810958651825925,0.000547
greedy_intra:nodes_start:random,161,257806,161916,95890,2,1,166;92;149;151;15;179;170;156;50;51;131;173;182;157;109;52;191;106;84;35;143;0;53;164;163;28;7;38;6;103;83;64;40;171;87;20;63;44;73;65;122;152;78;13;85;183;189;69;111;105;197;161;101;180;31;39;70;41;74;129;134;195;25;176;23;137;72;99;145;110;120;136;100;104;138;96;98;30;42;2;36;168;43;199;175;17;1;77;184;59;48;146;16;94;133;186;12;115;29;4,2857683905127060672,0.000000
greedy_intra:nodes_start:random,162,262885,171436,91449,1,0,129;46;39;84;195;182;196;191;153;16;117;198;35;44;89;15;144;38;76;135;130;102;57;127;51;131;97;21;110;160;25;140;31;116;154;73;162;164;115;5;147;181;94;70;159;93;45;113;128;77;65;91;184;17;74;6;54;69;187;14;165;138;2;82;24;48;7;175;78;199;137;62;170;167;111;157;108;63;104;19;197;81;55;148;106;166;71;66;30;36;95;9;22;56;125;176;23;146;142;37,5229219973428566055,0.000609
greedy_intra:nodes_start:random,163,260166,160507,99659,3,2,86;74;130;7;100;102;53;88;23;110;121;70;95;49;165;198;153;48;128;135;82;120;35;45;108;113;12;81;133;92;3;118;162;132;75;76;143;181;199;78;51;151;197;87;139;182;194;155;52;69;131;29;176;171;21;9;175;159;187;25;58;2;67;60;98;77;55;105;195;183;189;111;27;107;5;18;144;172;80;127;140;13;97;157;186;119;15;104;147;146;122;17;73;1;141;41;83;177;6;56,2070899456925502761,0.000569
greedy_intra:nodes_start:random,164,259676,168744,90932,6,5,107;101;51;10;7;124;105;41;8;177;148;135;152;188;168;139;12;155;86;60;79;197;38;159;151;32;147;194;181;36;78;3;16;113;95;120;4;1;189;129;164;161;63;102;97;115;42;192;116;122;28;128;96;40;196;49;54;198;176;137;158;56;110;62;61;67;6;66;146;52;27;92;143;18;119;149;25;133;31;69;68;84;21;160;33;150;30;153;71;171;57;76;85;5;43;117;23;106;77;186,951353726205502997,0.001072
greedy_intra:nodes_start:random,165,263774,162533,101241,1,0,191;20;119;32;195;69;94;181;114;34;8;168;45;84;172;89;57;79;21;23;83;137;14;16;6;100;186;178;73;110;33;9;104;196;161;115;78;29;99;91;38;152;25;55;199;87;138;148;105;147;190;176;2;159;134;157;42;24;113;52;182;151;90;128;118;15;30;27;66;3;4;133;169;62;165;92;167;17;56;171;142;127;107;7;125;96;37;193;11;74;197;22;139;129;26;180;160;174;126;12,6494499437649980039,0.000000
greedy_intra:nodes_start:random,166,256009,154514,101495,1,0,197;161;163;126;68;40;157;79;56;38;134;153;14;91;61;135;147;177;48;150;28;127;25;2;0;66;24;155;125;189;16;194;99;102;46;108;59;170;185;131;83;183;140;159;63;129;82;29;142;4;55;92;73;106;193;69;119;128;67;71;141;97;5;105;39;139;13;136;72;8;9;64;178;111;114;78;19;85;121;20;167;190;152;110;145;130;52;98;49;173;57;96;179;101;120;44;7;123;196;181,2788293831141395946,0.000000
greedy_intra:nodes_start:random,167,265318,172457,92861,1,0,112;53;106;149;114;154;33;68;50;105;196;127;63;54;66;107;184;97;78;155;124;46;48;59;139;45;199;103;4;39;152;92;90;31;172;147;195;189;15;36;49;80;87;47;62;135;1;117;136;82;190;67;156;0;175;21;181;65;144;119;94;83;174;179;20;52;91;8;167;27;143;192;122;32;22;30;75;193;58;131;64;40;9;132;191;150;18;37;120;157;6;43;61;85;86;19;42;25;69;89,5915776949613146075,0.000000
greedy_intra:nodes_start:random,168,255251,153376,101875,1,0,179;188;101;51;14;82;163;53;122;64;112;43;22;79;86;126;90;139;152;52;58;111;56;77;68;135;155;28;147;106;194;46;150;23;66;84;145;92;120;105;181;129;38;29;8;141;36;156;119;157;50;99;132;70;189;75;2;143;193;32;138;128;144;199;37;130;48;198;83;133;177;1;183;80;142;110;118;73;100;72;69;180;24;19;18;16;168;26;192;167;114;182;27;195;190;74;158;96;161;3,7852416002606546807,0.000510
greedy_intra:nodes_start:random,169,284811,181302,103509,1,0,82;197;61;39;73;152;137;6;188;60;114;67;165;144;113;56;134;92;8;112;29;55;42;94;131;118;120;132;93;23;174;34;10;155;96;95;22;75;146;81;154;99;78;84;20;156;169;98;105;19;9;16;163;18;173;79;45;80;167;40;122;35;186;2;0;50;76;4;166;25;52;179;108;91;192;46;141;150;199;161;195;1;111;198;33;172;41;168;43;103;102;31;27;151;149;128;24;164;63;77,2861992914863968564,0.000000
greedy_intra:nodes_start:random,170,255386,165278,90108,1,0,107;177;95;87;180;110;117;17;199;103;31;142;102;135;123;59;151;45;57;80;154;148;137;187;81;143;161;26;89;0;14;94;116;16;86;42;63;133;170;32;152;198;25;50;33;125;162;195;22;149;69;9;21;159;53;194;179;122;73;65;158;174;140;55;173;48;181;126;8;34;127;56;92;74;165;184;71;156;196;106;93;15;147;111;1;114;175;166;44;145;29;52;88;168;124;144;119;83;90;3,305589808335396639,0.000000
greedy_intra:nodes_start:random,171,281445,181854,99591,1,0,123;130;115;98;143;108;18;181;24;12;172;66;164;117;71;182;124;95;177;192;64;171;73;180;16;93;4;158;112;128;126;9;83;74;97;86;116;162;175;7;199;88;11;34;14;53;100;38;197;44;132;161;102;27;63;150;188;113;10;91;87;140;165;52;13;173;36;78;139;133;107;146;41;25;94;127;170;144;110;84;185;167;183;82;40;37;48;114;61;101;32;169;156;163;103;8;20;50;136;90,1047167114765614507,0.000000
greedy_intra:nodes_start:random,172,256354,156955,99399,3,2,131;88;130;10;172;170;140;43;27;190;117;193;153;107;42;136;109;5;128;183;196;94;135;163;139;78;146;138;174;64;187;28;124;77;103;3;61;184;189;75;175;110;47;51;100;106;2;87;121;182;44;192;60;1;142;62;6;188;152;63;24;145;112;54;22;19;74;79;169;197;80;176;181;46;126;137;158;91;21;17;14;144;76;57;50;29;89;194;102;25;33;38;97;191;82;40;70;92;32;180,3215400188833919073,0.000531
greedy_intra:nodes_start:random,173,258470,165466,93004,1,0,76;161;38;167;91;97;148;35;101;47;147;45;9;20;196;192;84;109;183;140;114;186;72;19;52;41;13;131;146;178;44;138;82;68;142;49;164;5;78;102;174;26;191;22;143;197;159;81;62;2;74;4;193;21;8;15;65;98;163;104;24;171;111;18;162;158;27;80;103;135;137;157;128;154;100;120;195;23;175;106;51;14;189;176;16;86;117;60;85;43;149;130;32;1;198;87;34;172;181;134,2910173932770450907,0.000000
greedy_intra:nodes_start:random,174,260463,157919,102544,1,0,0;26;45;6;41;47;122;133;32;7;48;58;16;50;60;42;78;13;119;28;148;30;146;63;5;142;103;1;59;127;141;40;106;158;185;64;18;82;61;57;149;29;125;74;134;24;19;21;110;161;189;39;112;164;155;150;100;56;152;12;199;179;116;159;34;53;172;75;170;67;14;153;113;35;123;121;104;182;143;129;80;52;131;102;98;138;92;173;66;27;192;55;168;169;15;84;190;37;25;23,7323823375363150218,0.000514
greedy_intra:nodes_start:random,175,268588,166871,101717,1,0,43;187;13;27;17;95;106;176;136;135;67;172;32;183;5;127;98;85;10;155;112;2;26;124;125;173;82;108;77;11;6;147;142;104;54;157;83;4;185;8;166;30;58;55;52;109;31;188;42;193;174;181;119;186;133;1;146;120;61;97;66;50;139;115;111;24;86;3;168;158;90;102;152;16;37;23;81;46;99;34;141;130;100;170;123;149;73;41;101;94;89;175;7;195;88;192;14;198;189;160,7034532581017118581,0.000000
greedy_intra:nodes_start:random,176,264007,165580,98427,1,0,109;5;156;74;194;65;3;90;111;86;39;103;149;0;27;50;77;36;152;193;61;153;168;97;100;104;54;141;93;113;91;62;142;10;137;127;175;179;107;138;130;151;75;196;143;102;13;4;164;135;145;70;169;41;88;178;166;29;23;150;67;58;52;126;84;99;171;42;80;20;63;172;83;43;79;92;183;78;64;117;38;167;32;162;60;16;51;12;37;189;24;191;188;197;48;115;18;121;40;185,5524074828804190046,0.000000
greedy_intra:nodes_start:random,177,257711,161591,96120,4,3,91;35;70;94;54;52;183;190;154;69;174;29;146;92;0;131;153;139;99;89;106;129;130;175;20;57;44;77;56;38;55;120;151;65;127;63;28;197;115;25;5;66;188;148;109;100;93;39;86;101;15;187;167;62;116;147;2;1;73;79;168;122;34;41;30;61;107;8;140;82;85;141;123;43;179;64;152;171;71;76;159;193;84;10;128;72;172;37;104;75;81;11;155;32;98;121;46;36;111;177,1299326927011394326,0.000524
greedy_intra:nodes_start:random,178,274358,171471,102887,1,0,11;144;75;137;108;134;107;173;148;156;13;124;93;67;177;179;76;37;46;184;56;54;95;52;47;24;193;33;186;169;154;105;161;172;99;10;126;129;178;15;190;1;152;31;63;120;8;111;123;199;89;81;66;159;83;28;32;59;71;128;138;130;69;145;140;88;155;55;97;53;41;176;87;38;192;61;79;20;57;102;136;64;49;142;45;39;188;132;160;170;195;153;2;70;86;48;21;143;198;92,5183725474971125612,0.000000
greedy_intra:nodes_start:random,179,270304,167334,102970,2,1,12;142;87;88;93;31;40;83;28;19;14;66;189;80;21;35;52;177;141;91;50;105;72;174;85;86;57;139;100;117;34;41;16;136;194;36;8;167;113;4;32;181;24;135;157;99;25;173;6;73;190;33;103;169;163;54;18;11;98;42;183;74;1;165;143;76;39;137;61;51;13;94;144;159;63;193;112;101;75;198;186;60;46;67;23;71;131;26;3;119;58;172;182;161;107;92;179;90;97;110,7439932206603054107,0.000539
greedy_intra:nodes_start:random,180,244084,152758,91326,1,0,9;169;76;48;96;145;86;73;64;163;23;114;199;27;83;63;1;22;33;31;189;131;154;129;46;77;116;8;113;111;121;70;10;37;180;17;98;158;78;21;196;74;151;192;65;87;115;146;182;141;165;89;44;185;16;130;118;68;120;79;80;148;110;91;11;104;20;133;170;56;127;123;5;2;38;30;12;107;52;105;140;191;137;67;100;59;152;193;175;47;43;4;34;97;106;136;174;72;176;157,8450306278956422649,0.000000
greedy_intra:nodes_start:random,181,248277,152173,96104,3,2,1;74;91;135;132;77;152;57;37;81;26;120;59;54;4;9;24;193;109;198;168;70;131;97;133;194;176;96;169;10;114;158;104;28;50;137;164;27;83;166;188;44;111;47;43;2;55;136;124;23;62;67;22;19;88;187;142;134;13;144;180;66;148;68;155;90;5;103;61;178;112;167;72;25;18;186;163;159;149;184;123;129;6;42;60;122;150;41;139;65;146;36;20;128;175;147;183;190;106;92,7481844255578084925,0.000000
greedy_intra:nodes_start:random,182,271103,163650,107453,2,1,105;132;142;149;44;34;163;157;158;64;32;182;50;104;55;109;76;9;62;16;81;36;38;187;27;194;86;30;14;87;133;39;150;1;80;2;197;83;35;103;184;95;17;85;112;147;136;196;12;120;26;88;11;52;37;115;3;140;59;51;101;167;84;159;130;13;77;107;90;191;6;79;102;91;189;45;141;114;134;72;48;178;82;119;164;155;19;135;137;126;24;171;8;54;98;161;183;175;49;22,9094286417405957061,0.000534
greedy_intra:nodes_start:random,183,249072,150404,98668,1,0,164;187;45;123;194;47;191;87;19;179;127;143;171;59;107;157;29;101;57;75;92;168;73;162;83;63;142;163;154;30;130;33;84;2;108;68;106;70;86;25;38;36;140;125;110;32;16;62;124;0;109;147;139;39;182;40;119;175;9;66;169;12;192;184;158;114;24;1;180;27;98;53;112;173;90;121;37;31;26;48;186;172;149;80;132;189;41;77;102;160;60;185;136;4;134;23;103;146;133;21,302285390977217780,0.000533
greedy_intra:nodes_start:random,184,269471,166520,102951,1,0,23;140;81;55;72;20;26;198;135;186;165;88;39;66;35;114;155;100;96;7;49;160;149;120;190;27;71;151;56;76;154;150;195;50;175;194;197;158;15;53;179;19;166;61;12;121;147;104;126;8;113;177;41;144;174;193;145;17;87;65;192;164;95;14;161;62;101;9;133;31;82;173;191;118;38;2;170;162;45;89;132;46;43;125;84;18;169;168;70;68;163;112;21;3;134;94;30;136;188;67,4201203426983034740,0.000000
greedy_intra:nodes_start:random,185,252979,158171,94808,1,0,86;125;81;97;113;193;166;26;7;47;14;55;50;106;90;157;9;3;124;111;71;144;103;58;179;32;196;56;159;109;89;133;92;132;62;54;61;155;12;40;163;10;181;123;28;34;79;153;108;35;165;85;139;45;68;119;33;77;120;117;156;67;146;162;104;27;151;174;5;93;102;115;76;110;44;57;73;74;63;164;175;182;80;183;126;66;46;24;187;30;29;36;138;158;2;195;116;173;143;51,8260271736957614094,0.000000
greedy_intra:nodes_start:random,186,261296,163696,97600,1,0,0;86;18;75;64;61;184;76;166;37;96;50;67;114;20;136;110;187;174;135;111;181;119;83;30;140;34;80;185;78;149;29;157;133;131;11;70;25;35;180;150;125;22;23;51;101;27;57;138;109;7;171;46;124;186;19;153;188;56;155;14;162;123;105;26;146;74;73;163;191;68;139;2;183;66;106;6;164;60;62;24;104;84;126;113;81;69;43;5;167;39;10;122;1;165;177;160;42;32;141,5789642723726197357,0.000000
greedy_intra:nodes_start:random,187,246641,151444,95197,1,0,11;114;141;18;20;98;198;124;33;78;139;163;106;95;117;109;17;161;138;181;130;194;160;115;60;174;43;16;176;36;126;173;197;56;151;40;166;191;66;145;37;182;6;148;99;24;84;159;169;171;72;94;195;52;149;68;54;143;183;47;154;41;96;80;97;137;63;55;123;101;136;21;85;77;189;129;29;83;133;79;69;4;70;125;31;140;49;158;122;1;32;58;57;107;7;14;188;92;113;65,8930121671334348246,0.000000
greedy_intra:nodes_start:random,188,267974,174741,93233,3,2,75;156;89;56;170;184;57;152;19;70;93;91;87;117;55;99;179;77;175;96;54;41;191;53;129;31;171;44;47;3;140;6;127;18;102;180;131;33;154;82;64;78;186;5;187;142;104;128;35;8;1;40;66;193;153;100;138;115;126;190;196;9;185;195;95;63;164;15;73;23;51;49;84;11;62;181;132;92;194;36;188;72;116;111;37;48;50;83;38;137;26;177;178;28;80;16;39;94;165;32,5255200836792209780,0.000549
greedy_intra:nodes_start:random,189,246423,153582,92841,1,0,101;183;133;102;126;27;198;103;153;176;65;123;143;39;62;47;3;63;78;122;37;149;7;23;137;4;17;182;26;195;141;115;22;186;125;109;56;161;16;50;80;139;184;135;53;136;150;6;124;35;164;104;118;14;90;119;0;45;131;75;46;98;128;196;174;169;85;108;179;31;187;40;68;162;83;100;42;197;76;112;1;55;64;177;92;155;163;172;41;44;13;114;94;79;19;148;21;36;70;60,6885068559689542217,0.000000
greedy_intra:nodes_start:random,190,253871,154548,99323,1,0,88;56;2;12;169;46;49;123;143;66;119;147;37;55;52;6;125;168;159;41;114;53;36;197;160;163;16;91;122;106;138;152;124;86;135;29;45;76;75;67;155;111;72;57;100;192;102;60;176;4;11;14;34;98;134;83;84;144;166;150;140;141;145;165;20;23;27;113;44;62;19;153;190;194;28;31;95;174;175;96;97;13;7;81;164;185;33;105;64;51;79;116;94;117;80;151;32;161;40;167,263009725134359727,0.000526
greedy_intra:nodes_start:random,191,253936,156760,97176,1,0,34;189;168;185;27;31;90;199;21;80;178;0;48;198;125;169;14;25;59;192;127;70;107;33;108;140;57;11;18;191;45;181;186;41;131;193;88;150;144;188;15;172;52;121;105;92;9;124;179;126;175;122;112;66;115;64;62;133;183;54;143;85;147;65;7;149;77;78;8;75;76;86;106;96;197;137;26;114;99;46;2;6;73;12;23;44;39;162;50;152;13;40;17;83;81;103;101;111;138;74,4403264518910626167,0.000000
greedy_intra:nodes_start:random,192,274201,178059,96142,1,0,116;175;64;97;37;108;28;93;120;138;79;168;17;152;104;139;94;47;92;90;74;102;187;34;128;60;10;172;36;133;95;43;170;106;163;23;48;85;39;142;193;114;122;149;197;164;135;8;121;32;113;191;160;59;146;20;73;148;131;2;103;124;196;156;176;118;123;70;1;159;157;192;54;13;134;185;76;41;35;82;183;126;147;18;178;84;109;130;33;26;14;3;51;190;150;179;115;71;137;125,8678797817848100737,0.000000
greedy_intra:nodes_start:random,193,272570,172069,100501,1,0,61;149;111;0;33;171;25;148;81;128;86;10;36;177;104;55;190;90;150;106;180;176;83;198;77;186;129;29;185;131;22;1;169;143;47;142;93;114;110;53;95;9;163;113;66;57;156;41;80;4;50;54;197;127;130;161;136;170;182;39;30;107;79;13;121;76;68;193;155;165;11;49;7;71;92;195;126;87;181;51;158;3;59;164;162;69;132;14;48;2;26;146;72;120;5;105;103;99;84;125,5004354150621268637,0.000529
greedy_intra:nodes_start:random,194,263607,166074,97533,2,1,41;34;160;128;136;53;81;116;4;54;26;156;49;0;127;164;162;153;133;175;129;11;111;139;10;178;134;79;124;80;199;16;126;143;198;22;121;122;151;73;47;76;145;120;142;98;2;88;119;12;62;97;163;68;95;45;89;3;15;13;66;36;102;158;92;56;109;168;107;103;196;39;186;6;104;32;84;169;38;173;28;113;58;52;189;191;135;75;132;8;152;50;138;25;183;167;27;43;193;105,558637878235679652,0.000000
greedy_intra:nodes_start:random,195,271606,169828,101778,1,0,145;149;7;49;182;178;108;177;15;117;123;12;180;56;32;140;76;11;143;114;197;3;166;21;58;46;38;154;48;128;170;35;112;40;54;181;27;19;104;124;102;161;99;64;194;100;151;36;147;8;92;159;34;89;153;183;67;28;162;175;169;86;165;199;105;77;47;134;138;107;193;90;45;188;133;59;22;173;150;29;55;198;146;152;68;179;101;122;88;84;30;87;141;186;96;17;51;111;26;53,6258840205956921500,0.000000
greedy_intra:nodes_start:random,196,257411,156135,101276,1,0,75;85;72;48;123;0;29;179;8;152;12;149;24;118;27;102;162;164;97;188;126;93;39;17;148;128;187;36;66;37;142;71;199;79;98;58;161;60;35;115;34;159;46;90;160;184;38;2;55;119;57;31;69;63;42;177;10;67;91;174;7;114;89;138;175;110;21;23;54;64;145;127;151;190;124;194;122;101;99;156;19;140;157;182;53;111;130;106;170;105;61;178;155;96;143;4;76;107;56;117,4086094143039861383,0.000000
greedy_intra:nodes_start:random,197,266455,170318,96137,4,3,159;162;192;98;22;16;66;60;126;41;195;17;13;100;68;69;197;77;31;153;186;11;90;73;138;115;10;125;23;143;36;70;144;140;131;38;170;198;176;156;157;173;193;20;101;54;174;123;178;67;114;99;121;32;40;49;135;3;86;179;81;103;2;87;183;25;71;136;57;39;110;154;83;165;163;149;80;24;63;14;172;106;112;1;118;37;48;184;5;164;132;55;30;148;34;72;82;102;28;64,550522702711549282,0.000521
greedy_intra:nodes_start:random,198,253197,156555,96642,2,1,140;75;184;118;95;125;176;120;196;7;158;48;123;121;129;109;149;83;189;76;142;133;137;145;163;170;47;51;30;44;0;43;128;70;69;111;1;157;179;108;165;168;35;16;138;112;197;186;28;86;68;166;155;58;87;90;77;172;22;49;105;192;156;46;102;61;159;122;27;106;131;18;62;124;107;98;101;110;126;141;34;114;85;119;82;2;14;9;89;130;20;54;190;84;185;80;6;10;162;36,1392734762362362604,0.000000
greedy_intra:nodes_start:random,199,267671,173195,94476,1,0,5;57;122;174;16;133;46;172;97;170;167;159;162;54;121;143;138;158;77;175;50;44;115;168;27;64;74;112;197;195;78;120;191;179;160;52;48;196;102;139;188;101;190;192;14;183;66;134;140;124;73;119;18;151;106;51;141;56;145;37;185;26;107;149;117;95;13;47;136;60;135;152;34;12;92;79;81;90;15;142;157;71;55;99;103;68;75;43;28;87;89;45;111;93;8;104;32;53;85;176,8301282523793142107,0.000000
greedy_intra:nodes_start:greedy,0,71108,22981,48127,1,0,0;117;143;183;89;186;23;137;176;80;79;63;94;124;152;97;1;101;2;120;82;129;57;92;55;52;49;102;148;9;62;144;14;138;178;106;185;165;40;90;81;196;179;145;78;31;56;113;175;171;16;25;44;75;86;26;100;121;53;180;154;135;70;127;123;162;133;151;51;118;59;65;116;43;184;84;112;4;190;10;177;54;48;160;34;146;22;18;108;69;159;181;42;5;115;41;193;139;68;46,2599116917739852715,0.000549
greedy_intra:nodes_start:greedy,1,71933,23455,48478,1,0,1;101;75;86;53;154;70;135;180;63;79;133;51;118;59;115;46;0;143;117;93;140;68;139;193;41;5;42;181;159;69;108;18;22;146;34;160;48;54;177;190;184;43;116;65;149;123;127;162;151;80;176;137;23;183;89;186;114;15;9;62;144;14;138;165;40;185;90;81;196;179;145;78;31;56;113;175;171;16;25;44;120;2;129;92;57;55;52;106;178;49;102;148;124;94;189;100;26;97;152,3700204474254592322,0.000000
greedy_intra:nodes_start:greedy,2,71905,23579,48326,1,0,2;129;57;92;55;52;49;102;148;9;62;144;14;138;178;106;185;165;40;90;81;196;179;145;78;31;56;113;175;171;16;25;44;120;75;86;26;189;94;63;79;80;176;133;151;51;118;59;115;46;0;137;23;186;89;183;143;117;93;140;68;139;193;41;5;42;181;159;69;108;18;22;146;34;160;48;54;177;10;190;84;184;43;116;65;131;149;162;123;127;70;135;154;180;53;100;101;1;97;152,7470098564097319796,0.000000
greedy_intra:nodes_start:greedy,3,71813,23409,48404,1,0,3;14;144;62;9;148;102;49;178;106;52;55;57;92;129;2;152;97;1;101;100;53;180;154;135;70;127;123;162;149;131;65;116;43;184;84;190;10;177;54;48;160;34;146;22;18;108;69;159;181;42;5;41;193;139;68;140;93;117;143;183;89;186;23;137;0;46;115;59;118;51;151;133;176;80;79;63;94;189;26;86;75;120;44;25;16;171;175;113;56;31;78;145;179;196;81;90;185;40;165,3808144362918046126,0.000000
greedy_intra:nodes_start:greedy,4,72214,24115,48099,1,0,4;190;10;177;54;48;34;160;181;42;146;22;18;108;69;159;41;193;139;68;46;115;118;59;116;65;43;184;35;131;149;123;162;151;133;51;0;117;143;183;89;23;137;176;80;79;63;94;124;152;97;1;101;2;120;82;129;57;92;55;52;49;102;148;9;62;144;14;138;178;106;185;165;40;90;81;196;179;145;78;31;56;113;175;171;16;25;44;75;86;26;100;121;53;180;154;135;70;127;112,3684350092650051234,0.000000
greedy_intra:nodes_start:greedy,5,71757,23388,48369,1,0,5;43;116;65;149;123;127;162;151;133;135;70;154;180;53;121;100;26;86;75;44;25;16;171;175;113;56;31;78;145;179;196;81;90;40;165;185;106;178;138;14;144;62;9;148;102;49;52;55;92;57;129;82;120;2;101;1;97;152;124;94;63;79;80;176;137;23;186;89;183;143;117;0;51;118;59;115;46;68;139;41;193;159;69;108;18;22;146;181;34;160;48;54;177;10;190;4;84;184;42,5719181075883619361,0.000000
greedy_intra:nodes_start:greedy,6,72451,23177,49274,1,0,6;154;53;121;100;26;86;75;101;1;97;152;94;124;148;102;49;178;106;52;55;57;92;129;2;120;44;25;16;171;175;113;56;31;78;145;179;196;81;90;185;40;165;138;14;144;62;9;15;114;186;89;183;23;137;176;80;151;162;127;123;149;65;116;43;184;177;54;48;160;34;146;22;18;108;69;159;181;42;5;41;193;139;68;140;93;117;143;0;46;115;59;118;51;133;79;63;180;70;135,2367351602168670401,0.000000
greedy_intra:nodes_start:greedy,7,72637,24199,48438,1,0,7;21;144;62;9;148;102;14;49;178;106;52;55;165;185;40;179;145;78;92;57;129;2;152;97;1;101;100;53;180;154;135;70;127;123;162;149;65;116;43;184;177;54;48;160;34;146;22;18;108;69;159;181;42;5;41;193;139;68;140;93;117;143;183;89;23;137;0;46;115;59;118;51;151;133;176;80;79;63;94;189;26;86;75;120;44;25;16;171;175;113;56;31;157;196;81;90;27;71;164,1492002795048471010,0.000000
greedy_intra:nodes_start:greedy,8,71847,23063,48784,1,0,8;165;40;185;90;81;196;179;145;78;31;56;113;175;171;16;25;44;120;75;86;26;189;94;63;79;80;176;133;151;51;118;59;115;46;0;137;23;186;89;183;143;117;93;140;68;139;193;41;5;42;181;159;69;108;18;22;146;34;160;48;54;177;10;190;184;43;116;65;131;149;162;123;127;70;135;154;180;53;100;101;1;97;152;2;129;92;57;55;52;106;178;49;102;148;9;62;144;14;138,9109124200373761756,0.000000
greedy_intra:nodes_start:greedy,9,71523,23197,48326,1,0,9;148;102;49;178;106;52;55;57;92;129;2;152;97;1;101;100;53;180;154;135;70;127;123;162;149;131;65;116;43;184;84;190;10;177;54;48;160;34;146;22;18;108;69;159;181;42;5;41;193;139;68;140;93;117;143;183;89;186;23;137;0;46;115;59;118;51;151;133;176;80;79;63;94;189;26;86;75;120;44;25;16;171;175;113;56;31;78;145;179;196;81;90;185;40;165;138;14;144;62,4371172911377363710,0.000000
greedy_intra:nodes_start:greedy,10,72214,24115,48099,1,0,10;190;4;112;127;70;135;154;180;53;121;100;26;86;75;44;25;16;171;175;113;56;31;78;145;179;196;81;90;40;165;185;106;178;138;14;144;62;9;148;102;49;52;55;92;57;129;82;120;2;101;1;97;152;124;94;63;79;80;176;137;23;89;183;143;117;0;51;133;151;162;123;149;131;35;184;43;65;116;59;118;115;46;68;139;193;41;159;69;108;18;22;146;42;181;160;34;48;54;177,6507755157131042448,0.000000
greedy_intra:nodes_start:greedy,11,72516,23391,49125,1,0,11;35;84;4;112;127;123;162;151;133;135;70;154;180;53;121;100;26;86;75;44;25;16;171;175;113;56;31;78;145;179;196;81;90;40;165;185;106;178;138;14;144;62;9;148;102;49;52;55;92;57;129;82;120;2;101;1;97;152;124;94;63;79;80;176;137;23;186;89;183;143;117;0;51;118;59;115;139;68;46;65;116;43;42;5;41;193;159;69;108;18;22;146;181;34;160;48;54;177;184,6633231312626208129,0.000000
greedy_intra:nodes_start:greedy,12,72899,23524,49375,1,0,12;94;152;97;1;101;2;120;82;129;57;92;179;145;78;31;56;113;175;171;16;25;44;75;86;26;100;121;53;158;154;70;135;180;63;79;133;51;118;59;115;46;0;143;117;93;140;68;139;193;41;5;42;181;159;69;108;18;22;146;34;160;48;54;177;184;43;116;65;149;123;162;151;80;176;137;23;183;89;186;114;15;9;62;144;14;138;165;90;81;196;40;185;55;52;106;178;49;102;148,2332075463028673307,0.000000
greedy_intra:nodes_start:greedy,13,72754,23520,49234,1,0,13;31;145;78;92;179;196;81;90;40;165;185;106;178;138;14;144;62;9;148;102;49;52;55;57;129;2;152;97;1;101;100;53;180;154;135;70;127;123;162;149;131;65;116;43;184;190;10;177;54;48;160;34;146;22;18;108;69;159;181;42;5;41;193;139;68;140;93;117;143;183;89;186;23;137;0;46;115;59;118;51;151;133;176;80;79;63;94;189;26;86;75;120;44;25;16;171;175;113;56,2726497754578807276,0.000000
greedy_intra:nodes_start:greedy,14,71523,23197,48326,1,0,14;144;62;9;148;102;49;178;106;52;55;57;92;129;2;152;97;1;101;100;53;180;154;135;70;127;123;162;149;131;65;116;43;184;84;190;10;177;54;48;160;34;146;22;18;108;69;159;181;42;5;41;193;139;68;140;93;117;143;183;89;186;23;137;0;46;115;59;118;51;151;133;176;80;79;63;94;189;26;86;75;120;44;25;16;171;175;113;56;31;78;145;179;196;81;90;185;40;165;138,5376233667939467670,0.000000
greedy_intra:nodes_start:greedy,15,71602,23316,48286,1,0,15;144;14;138;165;40;185;90;81;196;179;145;78;31;56;113;175;171;16;25;44;120;75;86;26;189;94;63;79;80;176;133;151;51;118;59;115;46;0;137;23;186;89;183;143;117;93;140;68;139;193;41;5;42;181;159;69;108;18;22;146;34;160;48;54;177;10;190;184;43;116;65;131;149;162;123;127;70;135;154;180;53;100;101;1;97;152;2;129;92;57;55;52;106;178;49;102;62;9;148,8937410330375835030,0.000000
greedy_intra:nodes_start:greedy,16,72017,23691,48326,1,0,16;25;44;120;75;86;26;189;94;63;79;80;176;133;151;51;118;59;115;46;0;137;23;186;89;183;143;117;93;140;68;139;193;41;5;42;181;159;69;108;18;22;146;34;160;48;54;177;10;190;84;184;43;116;65;131;149;162;123;127;70;135;154;180;53;100;101;1;97;152;2;129;57;55;52;49;102;148;9;62;144;14;138;178;106;185;165;40;90;81;196;179;92;78;145;31;56;113;175;171,1320927928232821831,0.000000
greedy_intra:nodes_start:greedy,17,73438,23931,49507,1,0,17;196;81;90;27;71;164;7;95;39;165;40;185;106;178;138;14;144;62;9;148;102;49;52;55;57;129;92;179;145;78;82;2;152;97;1;101;53;180;154;135;70;127;123;162;149;65;116;43;184;177;54;48;160;34;146;22;18;108;159;181;42;41;193;139;68;140;93;117;143;183;89;23;137;0;46;115;59;118;51;151;133;176;80;79;63;94;26;86;75;120;44;25;16;171;175;113;56;31;157,4848898235943676795,0.001000
greedy_intra:nodes_start:greedy,18,71968,23472,48496,1,0,18;22;146;159;193;41;5;42;181;34;160;48;54;177;10;190;4;84;184;43;116;65;149;123;127;162;151;133;135;70;154;180;53;121;100;26;86;75;44;25;16;171;175;113;56;31;78;145;179;196;81;90;40;165;185;106;178;138;14;144;62;9;148;102;49;52;55;92;57;129;82;120;2;101;1;97;152;124;94;63;79;80;176;137;51;118;59;115;139;46;68;0;89;183;143;117;93;140;108;69,1225120737238539496,0.000000
greedy_intra:nodes_start:greedy,19,72190,22856,49334,1,0,19;94;124;148;102;49;178;106;52;55;57;92;129;2;120;44;25;16;171;175;113;56;31;78;145;179;196;81;90;185;40;165;138;14;144;62;9;15;114;186;89;183;23;137;176;80;151;162;123;149;65;116;43;184;177;54;48;160;34;146;22;18;108;69;159;181;42;5;41;193;139;68;140;93;117;143;0;46;115;59;118;51;133;79;63;180;135;70;154;158;53;121;100;26;86;75;101;1;97;152,1009902287579778832,0.000000
greedy_intra:nodes_start:greedy,20,72394,23430,48964,1,0,20;22;146;159;193;41;5;42;181;34;160;48;54;177;10;190;84;184;43;116;65;149;123;127;162;151;133;135;70;154;180;53;121;100;26;86;75;44;25;16;171;175;113;56;31;78;145;179;196;81;90;40;165;185;106;178;138;14;144;62;9;148;102;49;52;55;92;57;129;82;120;2;101;1;97;152;124;94;63;79;80;176;137;51;118;59;115;139;46;68;0;89;183;143;117;93;140;108;69;18,1492049078172238176,0.000000
greedy_intra:nodes_start:greedy,21,71988,23819,48169,1,0,21;14;138;165;40;185;90;81;196;179;145;78;31;56;113;175;171;16;25;44;120;75;86;26;189;94;63;79;80;176;133;151;51;118;59;115;46;0;137;23;186;89;183;143;117;93;140;68;139;193;41;5;42;181;159;69;108;18;22;146;34;160;48;54;177;10;190;184;43;116;65;131;149;162;123;127;70;135;154;180;53;100;101;1;97;152;2;129;92;57;55;52;106;178;49;102;148;9;62;144,3143193393090250274,0.000000
greedy_intra:nodes_start:greedy,22,71385,23490,47895,1,0,22;146;181;34;160;48;54;177;10;190;4;112;84;184;42;43;116;65;149;123;127;162;151;133;135;70;154;180;53;121;100;26;86;75;44;25;16;171;175;113;56;31;78;145;179;196;81;90;40;165;185;106;178;138;14;144;62;9;148;102;49;52;55;92;57;129;82;120;2;101;1;97;152;124;94;63;79;80;176;137;23;186;89;183;143;117;0;51;118;59;115;46;68;139;41;193;159;69;108;18,1128502969815917365,0.000000
greedy_intra:nodes_start:greedy,23,71108,22981,48127,1,0,23;137;176;80;79;63;94;124;152;97;1;101;2;120;82;129;57;92;55;52;49;102;148;9;62;144;14;138;178;106;185;165;40;90;81;196;179;145;78;31;56;113;175;171;16;25;44;75;86;26;100;121;53;180;154;135;70;127;123;162;133;151;51;118;59;65;116;43;184;84;112;4;190;10;177;54;48;160;34;146;22;18;108;69;159;181;42;5;115;41;193;139;68;46;0;117;143;183;89;186,3376870047853522642,0.000000
greedy_intra:nodes_start:greedy,24,72431,23484,48947,1,0,24;149;65;116;43;184;84;190;10;177;54;48;160;34;146;22;18;108;69;159;181;42;5;41;193;139;68;46;115;59;118;51;0;117;143;183;89;186;23;137;176;80;79;63;94;124;152;97;1;101;2;120;82;129;57;92;55;52;49;102;148;9;62;144;14;138;178;106;185;165;40;90;81;196;179;145;78;31;56;113;175;171;16;25;44;75;86;26;100;121;53;180;154;70;135;133;151;162;127;123,460851461594059130,0.000000
greedy_intra:nodes_start:greedy,25,71905,23579,48326,1,0,25;44;120;75;86;26;189;94;63;79;80;176;133;151;51;118;59;115;46;0;137;23;186;89;183;143;117;93;140;68;139;193;41;5;42;181;159;69;108;18;22;146;34;160;48;54;177;10;190;84;184;43;116;65;131;149;162;123;127;70;135;154;180;53;100;101;1;97;152;2;129;57;92;55;52;49;102;148;9;62;144;14;138;178;106;185;165;40;90;81;196;179;145;78;31;56;113;175;171;16,7240321516613857229,0.000000
greedy_intra:nodes_start:greedy,26,71591,23565,48026,1,0,26;97;1;101;75;86;53;154;70;135;180;63;79;133;51;118;59;115;46;0;143;117;93;140;68;139;193;41;5;42;181;159;69;108;18;22;146;34;160;48;54;177;10;190;184;43;116;65;149;123;127;162;151;80;176;137;23;183;89;186;114;15;9;62;144;14;138;165;40;185;90;81;196;179;145;78;31;56;113;175;171;16;25;44;120;2;129;92;57;55;52;106;178;49;102;148;124;94;152;100,894260989966106628,0.001006
greedy_intra:nodes_start:greedy,27,72164,23636,48528,1,0,27;71;164;7;95;39;165;138;14;144;62;9;148;102;49;178;106;52;55;57;92;129;2;152;97;1;101;100;53;180;154;135;70;127;123;162;149;65;116;43;184;177;54;48;160;34;146;22;18;108;69;159;181;42;5;41;193;139;68;140;93;117;143;183;89;23;137;0;46;115;59;118;51;151;133;176;80;79;63;94;26;86;75;120;44;25;16;171;175;113;56;31;78;145;179;196;81;185;40;90,4199938827405408045,0.000000
greedy_intra:nodes_start:greedy,28,72501,23471,49030,1,0,28;43;65;116;131;149;123;127;162;151;133;135;70;154;180;53;121;100;26;86;75;44;25;16;171;175;113;56;31;78;145;179;196;81;90;40;165;185;106;178;138;14;144;62;9;148;102;49;52;55;92;57;129;82;120;2;101;1;97;152;124;94;63;79;80;176;137;23;186;89;183;143;117;0;51;59;118;115;46;68;139;193;41;5;42;181;159;69;108;18;22;146;34;160;48;54;177;10;190;184,547380172457830631,0.000000
greedy_intra:nodes_start:greedy,29,72298,23401,48897,1,0,29;112;4;84;35;184;177;54;48;160;34;181;146;22;18;108;69;159;193;41;5;42;43;116;65;46;68;139;115;59;118;51;0;117;143;183;89;186;23;137;176;80;79;63;94;124;152;97;1;101;2;120;82;129;57;92;55;52;49;102;148;9;62;144;14;138;178;106;185;165;40;90;81;196;179;145;78;31;56;113;175;171;16;25;44;75;86;26;100;121;53;180;154;70;135;133;151;162;123;127,1936808326365751313,0.000000
greedy_intra:nodes_start:greedy,30,72324,23799,48525,1,0,30;54;177;10;190;84;184;43;65;116;59;118;115;46;0;51;151;133;162;123;127;70;135;154;180;53;121;100;26;86;75;44;25;16;171;175;113;56;31;78;145;179;196;81;90;40;165;185;106;178;138;14;144;62;9;148;102;49;52;55;92;57;129;82;120;2;101;1;97;152;124;94;63;79;80;176;137;23;186;89;183;143;117;93;140;68;139;193;41;159;69;108;18;22;146;195;42;181;160;34,1760734139317043773,0.000999
greedy_intra:nodes_start:greedy,31,72017,23691,48326,1,0,31;145;78;92;179;196;81;90;40;165;185;106;178;138;14;144;62;9;148;102;49;52;55;57;129;2;152;97;1;101;100;53;180;154;135;70;127;123;162;149;131;65;116;43;184;84;190;10;177;54;48;160;34;146;22;18;108;69;159;181;42;5;41;193;139;68;140;93;117;143;183;89;186;23;137;0;46;115;59;118;51;151;133;176;80;79;63;94;189;26;86;75;120;44;25;16;171;175;113;56,4158421104253102719,0.001000
greedy_intra:nodes_start:greedy,32,72151,23295,48856,1,0,32;14;144;62;9;148;102;49;178;106;52;55;57;92;129;2;152;97;1;101;100;53;180;154;135;70;127;123;162;149;131;65;116;43;184;84;190;10;177;54;48;160;34;146;22;18;108;69;159;181;42;5;41;193;139;68;140;93;117;143;183;89;186;23;137;0;46;115;59;118;51;151;133;176;80;79;63;94;189;26;86;75;120;44;25;16;171;175;113;56;31;78;145;179;196;81;90;185;40;165,8124239421627688933,0.000000
greedy_intra:nodes_start:greedy,33,72265,23015,49250,1,0,33;102;49;178;106;52;55;57;92;129;2;152;97;1;101;100;53;180;154;135;70;127;123;162;149;131;65;116;43;184;190;10;177;54;48;160;34;146;22;18;108;69;159;181;42;5;41;193;139;68;140;93;117;143;183;89;186;23;137;0;46;115;59;118;51;151;133;176;80;79;63;94;189;26;86;75;120;44;25;16;171;175;113;56;31;78;145;179;196;81;90;185;40;165;138;14;144;62;9;148,5110090485362767571,0.000000
greedy_intra:nodes_start:greedy,34,71385,23490,47895,1,0,34;181;146;22;18;108;69;159;193;41;139;68;46;115;59;118;51;0;117;143;183;89;186;23;137;176;80;79;63;94;124;152;97;1;101;2;120;82;129;57;92;55;52;49;102;148;9;62;144;14;138;178;106;185;165;40;90;81;196;179;145;78;31;56;113;175;171;16;25;44;75;86;26;100;121;53;180;154;70;135;133;151;162;127;123;149;65;116;43;42;184;84;112;4;190;10;177;54;48;160,5019067125552065969,0.000000
greedy_intra:nodes_start:greedy,35,71935,23606,48329,1,0,35;84;4;112;127;123;162;151;133;135;70;154;180;53;121;100;26;86;75;44;25;16;171;175;113;56;31;78;145;179;196;81;90;40;165;185;106;178;138;14;144;62;9;148;102;49;52;55;92;57;129;82;120;2;101;1;97;152;124;94;63;79;80;176;137;23;186;89;183;143;117;0;51;118;59;115;139;68;46;65;116;43;42;5;41;193;159;69;108;18;22;146;181;34;160;48;54;177;190;184,3339973513528128231,0.000000
greedy_intra:nodes_start:greedy,36,72462,23372,49090,1,0,36;108;69;18;22;146;159;193;41;5;42;181;34;160;48;54;177;10;190;84;184;43;116;65;149;123;127;162;151;133;135;70;154;180;53;121;100;26;86;75;44;25;16;171;175;113;56;31;78;145;179;196;81;90;40;165;185;106;178;138;14;144;62;9;148;102;49;52;55;92;57;129;82;120;2;101;1;97;152;124;94;63;79;80;176;137;51;118;59;115;139;46;68;0;89;183;143;117;93;140,7429382472493517546,0.000999
greedy_intra:nodes_start:greedy,37,71679,23015,48664,1,0,37;102;49;178;106;52;55;57;92;129;2;152;97;1;101;100;53;180;154;135;70;127;123;162;149;131;65;116;43;184;190;10;177;54;48;160;34;146;22;18;108;69;159;181;42;5;41;193;139;68;140;93;117;143;183;89;186;23;137;0;46;115;59;118;51;151;133;176;80;79;63;94;189;26;86;75;120;44;25;16;171;175;113;56;31;78;145;179;196;81;90;185;40;165;138;14;144;62;9;148,4425850196670203576,0.000000
greedy_intra:nodes_start:greedy,38,72529,23535,48994,1,0,38;145;78;92;179;196;81;90;40;165;185;106;178;138;14;144;62;9;148;102;49;52;55;57;129;2;152;97;1;101;100;53;180;154;135;70;127;123;162;149;131;65;116;43;184;190;10;177;54;48;160;34;146;22;18;108;69;159;181;42;5;41;193;139;68;140;93;117;143;183;89;186;23;137;0;46;115;59;118;51;151;133;176;80;79;63;94;189;26;86;75;120;44;25;16;171;175;113;56;31,5895334754776192098,0.000996
greedy_intra:nodes_start:greedy,39,72098,23628,48470,1,0,39;95;7;164;27;90;40;185;81;196;179;145;78;31;56;113;175;171;16;25;44;120;75;86;26;189;94;63;79;80;176;133;151;51;118;59;115;46;0;137;23;89;183;143;117;93;140;68;139;193;41;5;42;181;159;69;108;18;22;146;34;160;48;54;177;184;43;116;65;149;162;123;127;70;135;154;180;53;100;101;1;97;152;2;129;92;57;55;52;106;178;49;102;148;9;62;144;14;138;165,9058230200523848973,0.000000
greedy_intra:nodes_start:greedy,40,71523,23197,48326,1,0,40;165;138;14;144;62;9;148;102;49;178;106;52;55;57;92;129;2;152;97;1;101;100;53;180;154;135;70;127;123;162;149;131;65;116;43;184;84;190;10;177;54;48;160;34;146;22;18;108;69;159;181;42;5;41;193;139;68;140;93;117;143;183;89;186;23;137;0;46;115;59;118;51;151;133;176;80;79;63;94;189;26;86;75;120;44;25;16;171;175;113;56;31;78;145;179;196;81;90;185,1673833414330031640,0.000999
greedy_intra:nodes_start:greedy,41,71947,23578,48369,1,0,41;5;42;181;159;69;108;18;22;146;34;160;48;54;177;10;190;4;84;184;43;116;65;149;123;127;162;151;133;135;70;154;180;53;121;100;26;86;75;44;25;16;171;175;113;56;31;78;145;179;196;81;90;40;165;185;106;178;138;14;144;62;9;148;102;49;52;55;92;57;129;82;120;2;101;1;97;152;124;94;63;79;80;176;137;23;186;89;183;143;117;0;51;118;59;115;46;68;139;193,8876180817657390646,0.000000
greedy_intra:nodes_start:greedy,42,71947,23578,48369,1,0,42;5;41;193;139;68;46;115;59;118;51;0;117;143;183;89;186;23;137;176;80;79;63;94;124;152;97;1;101;2;120;82;129;57;92;55;52;49;102;148;9;62;144;14;138;178;106;185;165;40;90;81;196;179;145;78;31;56;113;175;171;16;25;44;75;86;26;100;121;53;180;154;70;135;133;151;162;127;123;149;65;116;43;184;84;4;190;10;177;54;48;160;34;146;22;18;108;69;159;181,7528189635403831534,0.000000
greedy_intra:nodes_start:greedy,43,72083,23661,48422,1,0,43;65;116;59;118;115;46;0;51;151;133;162;123;127;70;135;154;180;53;121;100;26;86;75;44;25;16;171;175;113;56;31;78;145;179;196;81;90;40;165;185;106;178;138;14;144;62;9;148;102;49;52;55;92;57;129;82;120;2;101;1;97;152;124;94;63;79;80;176;137;23;186;89;183;143;117;93;140;68;139;193;41;5;42;181;159;69;108;18;22;146;34;160;48;54;177;10;190;84;184,1774962859582114408,0.000000
greedy_intra:nodes_start:greedy,44,71905,23579,48326,1,0,44;25;16;171;175;113;56;31;78;145;179;196;81;90;40;165;185;106;178;138;14;144;62;9;148;102;49;52;55;92;57;129;2;152;97;1;101;100;53;180;154;135;70;127;123;162;149;131;65;116;43;184;84;190;10;177;54;48;160;34;146;22;18;108;69;159;181;42;5;41;193;139;68;140;93;117;143;183;89;186;23;137;0;46;115;59;118;51;151;133;176;80;79;63;94;189;26;86;75;120,2459479683372071926,0.000000
greedy_intra:nodes_start:greedy,45,73081,23748,49333,1,0,45;162;133;135;70;154;180;53;121;100;26;86;75;44;25;16;171;175;113;56;31;78;145;179;196;81;90;40;165;185;106;178;138;14;144;62;9;148;102;49;52;55;92;57;129;82;120;2;101;1;97;152;124;94;63;79;80;176;137;23;186;89;183;143;117;0;51;118;59;115;46;68;139;193;41;5;42;181;159;69;108;18;22;146;34;160;48;54;177;10;190;84;184;43;116;65;149;123;127;151,6045146814499990660,0.000000
greedy_intra:nodes_start:greedy,46,71947,23578,48369,1,0,46;115;59;118;51;0;117;143;183;89;186;23;137;176;80;79;63;94;124;152;97;1;101;2;120;82;129;57;92;55;52;49;102;148;9;62;144;14;138;178;106;185;165;40;90;81;196;179;145;78;31;56;113;175;171;16;25;44;75;86;26;100;121;53;180;154;70;135;133;151;162;127;123;149;65;116;43;184;84;4;190;10;177;54;48;160;34;146;22;18;108;69;159;181;42;5;41;193;139;68,6717567581319217852,0.000000
greedy_intra:nodes_start:greedy,47,72248,23594,48654,1,0,47;116;43;184;84;190;10;177;54;48;160;34;146;22;18;108;69;159;181;42;5;41;193;139;68;46;115;118;59;51;0;117;143;183;89;186;23;137;176;80;79;63;94;124;152;97;1;101;2;120;82;129;57;92;55;52;49;102;148;9;62;144;14;138;178;106;185;165;40;90;81;196;179;145;78;31;56;113;175;171;16;25;44;75;86;26;100;121;53;180;154;70;135;133;151;162;127;123;149;65,726392055689987045,0.000000
greedy_intra:nodes_start:greedy,48,72287,23801,48486,1,0,48;34;160;181;42;195;146;22;18;108;69;159;41;193;139;68;140;93;117;143;183;89;186;23;137;176;80;79;63;94;124;152;97;1;101;2;120;82;129;57;92;55;52;49;102;148;9;62;144;14;138;178;106;185;165;40;90;81;196;179;145;78;31;56;113;175;171;16;25;44;75;86;26;100;121;53;180;154;135;70;127;123;162;133;151;51;0;46;115;118;59;116;65;43;184;84;190;10;177;54,7131196996145655020,0.000000
greedy_intra:nodes_start:greedy,49,71523,23197,48326,1,0,49;178;106;52;55;57;92;129;2;152;97;1;101;100;53;180;154;135;70;127;123;162;149;131;65;116;43;184;84;190;10;177;54;48;160;34;146;22;18;108;69;159;181;42;5;41;193;139;68;140;93;117;143;183;89;186;23;137;0;46;115;59;118;51;151;133;176;80;79;63;94;189;26;86;75;120;44;25;16;171;175;113;56;31;78;145;179;196;81;90;185;40;165;138;14;144;62;9;148;102,8652533132243977263,0.000000
greedy_intra:nodes_start:greedy,50,72985,23643,49342,1,0,50;175;171;16;25;44;120;75;86;26;189;94;63;79;80;176;133;151;51;118;59;115;46;0;137;23;186;89;183;143;117;93;140;68;139;193;41;5;42;181;159;69;108;18;22;146;34;160;48;54;177;10;190;184;43;116;65;131;149;162;123;127;70;135;154;180;53;100;101;1;97;152;2;129;57;55;52;49;102;148;9;62;144;14;138;178;106;185;165;40;90;81;196;179;92;78;145;31;56;113,4705346553573281258,0.000000
greedy_intra:nodes_start:greedy,51,71947,23578,48369,1,0,51;118;59;115;46;68;139;193;41;5;42;181;159;69;108;18;22;146;34;160;48;54;177;10;190;4;84;184;43;116;65;149;123;127;162;151;133;135;70;154;180;53;121;100;26;86;75;44;25;16;171;175;113;56;31;78;145;179;196;81;90;40;165;185;106;178;138;14;144;62;9;148;102;49;52;55;92;57;129;82;120;2;101;1;97;152;124;94;63;79;80;176;137;23;186;89;183;143;117;0,4194181725922615006,0.000000
greedy_intra:nodes_start:greedy,52,71590,23264,48326,1,0,52;178;106;49;102;148;9;62;144;14;138;165;40;185;90;81;196;179;145;78;31;56;113;175;171;16;25;44;120;75;86;26;189;94;63;79;80;176;133;151;51;118;59;115;46;0;137;23;186;89;183;143;117;93;140;68;139;193;41;5;42;181;159;69;108;18;22;146;34;160;48;54;177;10;190;84;184;43;116;65;131;149;162;123;127;70;135;154;180;53;100;101;1;97;152;2;129;92;57;55,3234445739460885204,0.000000
greedy_intra:nodes_start:greedy,53,71750,23180,48570,1,0,53;158;154;70;135;180;63;79;133;51;118;59;115;46;0;143;117;93;140;68;139;193;41;5;42;181;159;69;108;18;22;146;34;160;48;54;177;184;43;116;65;149;123;127;162;151;80;176;137;23;183;89;186;114;15;9;62;144;14;138;165;40;185;90;81;196;179;145;78;31;56;113;175;171;16;25;44;120;2;129;92;57;55;52;106;178;49;102;148;124;94;152;97;1;101;75;86;26;100;121,6029363964507082916,0.000000
greedy_intra:nodes_start:greedy,54,72287,23801,48486,1,0,54;48;34;160;181;42;195;146;22;18;108;69;159;41;193;139;68;140;93;117;143;183;89;186;23;137;176;80;79;63;94;124;152;97;1;101;2;120;82;129;57;92;55;52;49;102;148;9;62;144;14;138;178;106;185;165;40;90;81;196;179;145;78;31;56;113;175;171;16;25;44;75;86;26;100;121;53;180;154;135;70;127;123;162;133;151;51;0;46;115;118;59;116;65;43;184;84;190;10;177,6801730391468582239,0.000000
greedy_intra:nodes_start:greedy,55,71590,23264,48326,1,0,55;52;178;106;49;102;148;9;62;144;14;138;165;40;185;90;81;196;179;145;78;31;56;113;175;171;16;25;44;120;75;86;26;189;94;63;79;80;176;133;151;51;118;59;115;46;0;137;23;186;89;183;143;117;93;140;68;139;193;41;5;42;181;159;69;108;18;22;146;34;160;48;54;177;10;190;84;184;43;116;65;131;149;162;123;127;70;135;154;180;53;100;101;1;97;152;2;129;92;57,3832482532651896840,0.000000
greedy_intra:nodes_start:greedy,56,72017,23691,48326,1,0,56;31;145;78;92;179;196;81;90;40;165;185;106;178;138;14;144;62;9;148;102;49;52;55;57;129;2;152;97;1;101;100;53;180;154;135;70;127;123;162;149;131;65;116;43;184;84;190;10;177;54;48;160;34;146;22;18;108;69;159;181;42;5;41;193;139;68;140;93;117;143;183;89;186;23;137;0;46;115;59;118;51;151;133;176;80;79;63;94;189;26;86;75;120;44;25;16;171;175;113,2837243090665327329,0.000000
greedy_intra:nodes_start:greedy,57,71704,23378,48326,1,0,57;55;52;49;102;148;9;62;144;14;138;178;106;185;165;40;90;81;196;179;145;78;31;56;113;175;171;16;25;44;120;75;86;26;189;94;63;79;80;176;133;151;51;118;59;115;46;0;137;23;186;89;183;143;117;93;140;68;139;193;41;5;42;181;159;69;108;18;22;146;34;160;48;54;177;10;190;84;184;43;116;65;131;149;162;123;127;70;135;154;180;53;100;101;1;97;152;2;129;92,7545305938183476915,0.000000
greedy_intra:nodes_start:greedy,58,72703,24207,48496,1,0,58;71;27;90;81;196;157;31;56;113;175;171;16;25;44;120;75;86;26;94;63;79;80;176;133;151;51;118;59;115;46;0;137;23;89;183;143;117;93;140;68;139;193;41;5;42;181;159;69;108;18;22;146;34;160;48;54;177;184;43;116;65;149;162;123;127;70;135;154;180;53;100;101;1;97;152;2;129;57;92;78;145;179;40;185;165;55;52;106;178;49;14;102;148;9;62;144;21;7;164,2216821985909642679,0.000000
greedy_intra:nodes_start:greedy,59,71947,23578,48369,1,0,59;115;46;68;139;193;41;5;42;181;159;69;108;18;22;146;34;160;48;54;177;10;190;4;84;184;43;116;65;149;123;127;162;151;133;135;70;154;180;53;121;100;26;86;75;44;25;16;171;175;113;56;31;78;145;179;196;81;90;40;165;185;106;178;138;14;144;62;9;148;102;49;52;55;92;57;129;82;120;2;101;1;97;152;124;94;63;79;80;176;137;23;186;89;183;143;117;0;51;118,6962287152204096550,0.000000
greedy_intra:nodes_start:greedy,60,72791,23521,49270,1,0,60;46;115;139;193;41;5;42;181;159;69;108;18;22;146;34;160;48;54;177;10;190;4;84;184;43;116;65;149;123;127;162;151;133;135;70;154;180;53;121;100;26;86;75;44;25;16;171;175;113;56;31;78;145;179;196;81;90;40;165;185;106;178;138;14;144;62;9;148;102;49;52;55;92;57;129;82;120;2;101;1;97;152;124;94;63;79;80;176;137;23;186;89;183;143;117;0;51;59;118,6859491293096022968,0.000000
greedy_intra:nodes_start:greedy,61,72475,23085,49390,1,0,61;144;14;138;165;40;185;90;81;196;179;145;78;31;56;113;175;171;16;25;44;120;75;86;26;189;94;63;79;80;176;133;151;51;118;59;115;46;0;137;23;186;89;183;143;117;93;140;68;139;193;41;5;42;181;159;69;108;18;22;146;34;160;48;54;177;10;190;184;43;116;65;131;149;162;123;127;70;135;154;180;53;100;101;1;97;152;2;129;92;57;55;52;106;178;49;102;62;9;148,5157865719637855697,0.000000
greedy_intra:nodes_start:greedy,62,71523,23197,48326,1,0,62;144;14;138;165;40;185;90;81;196;179;145;78;31;56;113;175;171;16;25;44;120;75;86;26;189;94;63;79;80;176;133;151;51;118;59;115;46;0;137;23;186;89;183;143;117;93;140;68;139;193;41;5;42;181;159;69;108;18;22;146;34;160;48;54;177;10;190;84;184;43;116;65;131;149;162;123;127;70;135;154;180;53;100;101;1;97;152;2;129;92;57;55;52;106;178;49;102;148;9,1304245190213868352,0.000000
greedy_intra:nodes_start:greedy,63,71750,23180,48570,1,0,63;180;135;70;154;158;53;121;100;26;86;75;101;1;97;152;94;124;148;102;49;178;106;52;55;57;92;129;2;120;44;25;16;171;175;113;56;31;78;145;179;196;81;90;185;40;165;138;14;144;62;9;15;114;186;89;183;23;137;176;80;151;162;127;123;149;65;116;43;184;177;54;48;160;34;146;22;18;108;69;159;181;42;5;41;193;139;68;140;93;117;143;0;46;115;59;118;51;133;79,7957534251529119710,0.000000
greedy_intra:nodes_start:greedy,64,72373,22854,49519,1,0,64;114;186;89;183;23;137;176;80;151;162;123;149;65;116;43;184;177;54;48;160;34;146;22;18;108;69;159;181;42;5;41;193;139;68;140;93;117;143;0;46;115;59;118;51;133;79;63;180;135;70;154;158;53;121;100;26;86;75;101;1;97;152;94;124;148;9;62;102;49;178;106;52;55;57;92;129;2;120;44;25;16;171;175;113;56;31;78;145;179;196;81;90;185;40;165;138;14;144;15,7248632100118509239,0.000000
greedy_intra:nodes_start:greedy,65,71947,23578,48369,1,0,65;149;123;127;162;151;133;135;70;154;180;53;121;100;26;86;75;44;25;16;171;175;113;56;31;78;145;179;196;81;90;40;165;185;106;178;138;14;144;62;9;148;102;49;52;55;92;57;129;82;120;2;101;1;97;152;124;94;63;79;80;176;137;23;186;89;183;143;117;0;51;118;59;115;46;68;139;193;41;5;42;181;159;69;108;18;22;146;34;160;48;54;177;10;190;4;84;184;43;116,8101852598960654532,0.000000
greedy_intra:nodes_start:greedy,66,72976,23779,49197,1,0,66;51;118;59;115;46;0;89;183;143;117;93;140;68;139;193;41;5;42;181;159;69;108;18;22;146;34;160;48;54;177;10;190;84;184;43;116;65;149;123;127;162;151;133;135;70;154;180;53;121;100;26;86;75;44;25;16;171;175;113;56;31;78;145;179;196;81;90;40;165;185;106;178;138;14;144;62;9;148;102;49;52;55;92;57;129;82;120;2;101;1;97;152;124;94;63;79;80;176;137,7416149717085214954,0.000000
greedy_intra:nodes_start:greedy,67,72645,23364,49281,1,0,67;108;69;18;22;146;159;193;41;5;42;181;34;160;48;54;177;10;190;84;184;43;116;65;149;123;127;162;151;133;135;70;154;180;53;121;100;26;86;75;44;25;16;171;175;113;56;31;78;145;179;196;81;90;40;165;185;106;178;138;14;144;62;9;148;102;49;52;55;92;57;129;82;120;2;101;1;97;152;124;94;63;79;80;176;137;51;118;59;115;139;46;68;0;89;183;143;117;93;140,6579243112381583023,0.000000
greedy_intra:nodes_start:greedy,68,71947,23578,48369,1,0,68;46;115;59;118;51;0;117;143;183;89;186;23;137;176;80;79;63;94;124;152;97;1;101;2;120;82;129;57;92;55;52;49;102;148;9;62;144;14;138;178;106;185;165;40;90;81;196;179;145;78;31;56;113;175;171;16;25;44;75;86;26;100;121;53;180;154;70;135;133;151;162;127;123;149;65;116;43;184;84;4;190;10;177;54;48;160;34;146;22;18;108;69;159;181;42;5;41;193;139,4738225406219260006,0.000000
greedy_intra:nodes_start:greedy,69,72218,23381,48837,1,0,69;108;18;20;22;146;159;193;41;5;42;181;34;160;48;54;177;10;190;84;184;43;116;65;149;123;127;162;151;133;135;70;154;180;53;121;100;26;86;75;44;25;16;171;175;113;56;31;78;145;179;196;81;90;40;165;185;106;178;138;14;144;62;9;148;102;49;52;55;92;57;129;82;120;2;101;1;97;152;124;94;63;79;80;176;137;23;186;89;183;143;117;0;51;118;59;115;46;68;139,2202402565350960197,0.000000
greedy_intra:nodes_start:greedy,70,71750,23180,48570,1,0,70;154;158;53;121;100;26;86;75;101;1;97;152;94;124;148;102;49;178;106;52;55;57;92;129;2;120;44;25;16;171;175;113;56;31;78;145;179;196;81;90;185;40;165;138;14;144;62;9;15;114;186;89;183;23;137;176;80;151;162;127;123;149;65;116;43;184;177;54;48;160;34;146;22;18;108;69;159;181;42;5;41;193;139;68;140;93;117;143;0;46;115;59;118;51;133;79;63;180;135,3430213602334292588,0.000000
greedy_intra:nodes_start:greedy,71,72164,23636,48528,1,0,71;164;7;95;39;165;138;14;144;62;9;148;102;49;178;106;52;55;57;92;129;2;152;97;1;101;100;53;180;154;135;70;127;123;162;149;65;116;43;184;177;54;48;160;34;146;22;18;108;69;159;181;42;5;41;193;139;68;140;93;117;143;183;89;23;137;0;46;115;59;118;51;151;133;176;80;79;63;94;26;86;75;120;44;25;16;171;175;113;56;31;78;145;179;196;81;185;40;90;27,7843807688095914723,0.000000
greedy_intra:nodes_start:greedy,72,72377,23627,48750,1,0,72;51;0;117;143;183;89;186;23;137;176;80;79;63;94;124;152;97;1;101;2;120;82;129;57;92;55;52;49;102;148;9;62;144;14;138;178;106;185;165;40;90;81;196;179;145;78;31;56;113;175;171;16;25;44;75;86;26;100;121;53;180;154;70;135;133;151;162;127;123;149;65;116;43;184;84;190;10;177;54;48;160;34;146;22;18;108;69;159;181;42;5;41;193;139;68;46;115;118;59,5075953998769571917,0.000000
greedy_intra:nodes_start:greedy,73,72456,23554,48902,1,0,73;15;148;9;62;102;49;178;106;52;55;57;92;129;2;152;97;1;101;100;53;180;154;135;70;127;123;162;149;131;65;116;43;184;190;177;54;48;160;34;146;22;18;108;69;159;181;42;5;41;193;139;68;140;93;117;143;183;89;186;23;137;0;46;115;59;118;51;151;133;176;80;79;63;94;189;26;86;75;120;44;25;16;171;175;113;56;31;78;145;179;196;81;90;185;40;165;138;14;144,6434522617137830165,0.000000
greedy_intra:nodes_start:greedy,74,72489,23273,49216,1,0,74;1;101;75;86;53;154;70;135;180;63;79;133;51;118;59;115;46;0;143;117;93;140;68;139;193;41;5;42;181;159;69;108;18;22;146;34;160;48;54;177;184;43;116;65;149;123;127;162;151;80;176;137;23;183;89;186;114;15;9;62;144;14;138;165;40;185;90;81;196;179;145;78;31;56;113;175;171;16;25;44;120;2;129;92;57;55;52;106;178;49;102;148;124;94;189;100;26;97;152,8391333221997626858,0.000000
greedy_intra:nodes_start:greedy,75,72208,23680,48528,1,0,75;44;25;16;171;175;113;56;31;78;145;179;196;81;90;40;165;185;106;178;138;14;144;62;9;148;102;49;52;55;92;57;129;82;120;2;152;97;1;101;100;53;180;154;135;70;127;123;162;149;131;65;116;43;184;190;10;177;54;48;160;34;146;22;18;108;69;159;181;42;5;41;193;139;68;140;93;117;143;183;89;186;23;137;0;46;115;59;118;51;151;133;176;80;79;63;94;189;26;86,8342107290846150279,0.000000
greedy_intra:nodes_start:greedy,76,73321,23737,49584,1,0,76;176;80;151;162;127;123;149;65;116;43;184;190;177;54;48;160;34;146;22;18;108;69;159;181;42;5;41;193;139;68;46;115;59;118;51;133;79;63;180;135;70;154;158;53;121;100;26;86;75;101;1;97;152;94;124;148;102;49;178;106;52;55;57;92;129;2;120;44;25;16;171;175;113;56;31;78;145;179;196;81;90;185;40;165;138;14;144;62;9;15;114;186;137;23;89;183;143;117;0,2183150646093887253,0.000000
greedy_intra:nodes_start:greedy,77,72370,23528,48842,1,0,77;43;184;190;10;177;54;48;160;34;146;22;18;108;69;159;181;42;5;41;193;139;68;140;93;117;143;183;89;186;23;137;176;80;79;63;94;124;152;97;1;101;2;120;82;129;57;92;55;52;49;102;148;9;62;144;14;138;178;106;185;165;40;90;81;196;179;145;78;31;56;113;175;171;16;25;44;75;86;26;100;121;53;180;154;135;70;127;123;162;133;151;51;0;46;115;118;59;116;65,6225877405082842282,0.000000
greedy_intra:nodes_start:greedy,78,71905,23579,48326,1,0,78;31;56;113;175;171;16;25;44;120;75;86;26;189;94;63;79;80;176;133;151;51;118;59;115;46;0;137;23;186;89;183;143;117;93;140;68;139;193;41;5;42;181;159;69;108;18;22;146;34;160;48;54;177;10;190;84;184;43;116;65;131;149;162;123;127;70;135;154;180;53;100;101;1;97;152;2;129;57;92;55;52;49;102;148;9;62;144;14;138;178;106;185;165;40;90;81;196;179;145,7088740882970473458,0.000000
greedy_intra:nodes_start:greedy,79,72330,23522,48808,1,0,79;80;176;133;151;51;118;59;115;46;0;137;23;186;89;183;143;117;93;140;68;139;193;41;5;42;181;159;69;108;18;22;146;34;160;48;54;177;184;43;116;65;131;149;162;123;127;70;135;180;154;158;53;121;100;26;86;75;44;25;16;171;175;113;56;31;78;145;179;196;81;90;40;165;185;106;178;138;14;144;62;9;148;102;49;52;55;92;57;129;82;120;2;101;1;97;152;124;94;63,4624811669072018509,0.000000
greedy_intra:nodes_start:greedy,80,71940,23456,48484,1,0,80;79;63;94;124;152;97;1;101;2;120;82;129;57;92;55;52;49;102;148;9;62;144;14;138;178;106;185;165;40;90;81;196;179;145;78;31;56;113;175;171;16;25;44;75;86;26;100;121;53;180;154;135;70;127;123;162;133;151;149;131;65;116;43;184;84;190;10;177;54;48;160;34;146;22;18;108;69;159;181;42;5;41;193;139;68;46;115;59;118;51;0;117;143;183;89;186;23;137;176,8669739382214311783,0.000000
greedy_intra:nodes_start:greedy,81,71630,23304,48326,1,0,81;196;40;185;179;145;78;31;56;113;175;171;16;25;44;120;75;86;26;189;94;63;79;80;176;133;151;51;118;59;115;46;0;137;23;186;89;183;143;117;93;140;68;139;193;41;5;42;181;159;69;108;18;22;146;34;160;48;54;177;10;190;84;184;43;116;65;131;149;162;123;127;70;135;154;180;53;100;101;1;97;152;2;129;92;57;55;52;106;178;49;102;148;9;62;144;14;138;165;90,6714671126762249110,0.000000
greedy_intra:nodes_start:greedy,82,72236,23708,48528,1,0,82;2;75;86;26;189;94;63;79;80;176;133;151;51;118;59;115;46;0;137;23;186;89;183;143;117;93;140;68;139;193;41;5;42;181;159;69;108;18;22;146;34;160;48;54;177;10;190;184;43;116;65;131;149;162;123;127;70;135;154;180;53;100;101;1;97;152;129;57;92;55;52;49;102;148;9;62;144;14;138;178;106;185;165;40;90;81;196;179;145;78;31;56;113;175;171;16;25;44;120,2480067216729510373,0.001002
greedy_intra:nodes_start:greedy,83,72261,22842,49419,1,0,83;89;183;143;117;0;46;68;139;193;41;115;5;42;181;159;69;108;18;22;146;34;160;48;54;177;10;190;4;84;184;43;116;65;59;118;51;151;133;162;123;127;70;135;154;180;53;121;100;26;86;75;44;25;16;171;175;113;56;31;78;145;179;196;81;90;40;165;185;106;178;138;14;144;62;9;148;102;49;52;55;92;57;129;82;120;2;101;1;97;152;124;94;63;79;80;176;137;23;186,2257824932385665424,0.000000
greedy_intra:nodes_start:greedy,84,71935,23606,48329,1,0,84;4;112;127;123;162;151;133;135;70;154;180;53;121;100;26;86;75;44;25;16;171;175;113;56;31;78;145;179;196;81;90;40;165;185;106;178;138;14;144;62;9;148;102;49;52;55;92;57;129;82;120;2;101;1;97;152;124;94;63;79;80;176;137;23;186;89;183;143;117;0;51;118;59;115;139;68;46;65;116;43;42;5;41;193;159;69;108;18;22;146;181;34;160;48;54;177;190;184;35,9095884075053032570,0.000000
greedy_intra:nodes_start:greedy,85,72861,23848,49013,1,0,85;145;179;196;81;90;40;165;185;106;178;138;14;144;62;9;148;102;49;52;55;92;57;129;2;152;97;1;101;100;53;180;154;135;70;127;123;162;149;131;65;116;43;184;190;10;177;54;48;160;34;146;22;18;108;69;159;181;42;5;41;193;139;68;140;93;117;143;183;89;186;23;137;0;46;115;59;118;51;151;133;176;80;79;63;94;189;26;86;75;120;44;25;78;31;16;171;175;113;56,737426279737020356,0.000000
greedy_intra:nodes_start:greedy,86,71750,23180,48570,1,0,86;75;101;1;97;152;94;124;148;102;49;178;106;52;55;57;92;129;2;120;44;25;16;171;175;113;56;31;78;145;179;196;81;90;185;40;165;138;14;144;62;9;15;114;186;89;183;23;137;176;80;151;162;127;123;149;65;116;43;184;177;54;48;160;34;146;22;18;108;69;159;181;42;5;41;193;139;68;140;93;117;143;0;46;115;59;118;51;133;79;63;180;135;70;154;158;53;121;100;26,6604121106866840630,0.000000
greedy_intra:nodes_start:greedy,87,73165,23569,49596,1,0,87;2;120;82;129;57;92;55;52;49;102;148;9;62;144;14;138;178;106;185;165;40;90;81;196;179;145;78;31;56;113;175;171;16;25;44;75;86;26;189;94;63;79;80;176;133;151;51;118;59;115;46;0;137;23;186;89;183;143;117;93;140;68;139;193;41;5;42;181;159;69;108;18;22;146;34;160;48;54;177;190;184;43;116;65;131;149;162;123;127;70;135;154;180;53;100;101;1;97;152,5795023698440547275,0.000000
greedy_intra:nodes_start:greedy,88,72887,23626,49261,1,0,88;25;44;120;75;86;26;189;94;63;79;80;176;133;151;51;118;59;115;46;0;137;23;186;89;183;143;117;93;140;68;139;193;41;5;42;181;159;69;108;18;22;146;34;160;48;54;177;10;190;184;43;116;65;131;149;162;123;127;70;135;154;180;53;100;101;1;97;152;2;129;57;55;52;49;102;148;9;62;144;14;138;178;106;185;165;40;90;81;196;179;92;78;145;31;56;113;175;171;16,2876087854220292451,0.000000
greedy_intra:nodes_start:greedy,89,71226,22804,48422,1,0,89;186;23;137;176;80;79;63;94;124;152;97;1;101;2;120;82;129;57;92;55;52;49;102;148;9;62;144;14;138;178;106;185;165;40;90;81;196;179;145;78;31;56;113;175;171;16;25;44;75;86;26;100;121;53;180;154;135;70;127;123;162;133;151;51;118;59;65;116;43;184;84;190;10;177;54;48;160;34;146;22;18;108;69;159;181;42;5;115;41;193;139;46;68;140;93;117;0;143;183,2040884397079356112,0.000000
greedy_intra:nodes_start:greedy,90,71673,23347,48326,1,0,90;40;185;81;196;179;145;78;31;56;113;175;171;16;25;44;120;75;86;26;189;94;63;79;80;176;133;151;51;118;59;115;46;0;137;23;186;89;183;143;117;93;140;68;139;193;41;5;42;181;159;69;108;18;22;146;34;160;48;54;177;10;190;84;184;43;116;65;131;149;162;123;127;70;135;154;180;53;100;101;1;97;152;2;129;92;57;55;52;106;178;49;102;148;9;62;144;14;138;165,5173524954616070981,0.000000
greedy_intra:nodes_start:greedy,91,72110,23205,48905,1,0,91;179;145;78;31;56;113;175;171;16;25;44;120;75;86;26;189;94;63;79;80;176;133;151;51;118;59;115;46;0;137;23;186;89;183;143;117;93;140;68;139;193;41;5;42;181;159;69;108;18;22;146;34;160;48;54;177;10;190;184;43;116;65;131;149;162;123;127;70;135;154;180;53;100;101;1;97;152;2;129;92;57;55;52;49;102;148;9;62;144;14;138;178;106;185;165;40;90;81;196,4684678847930411506,0.001001
greedy_intra:nodes_start:greedy,92,71905,23579,48326,1,0,92;55;52;49;102;148;9;62;144;14;138;178;106;185;165;40;90;81;196;179;145;78;31;56;113;175;171;16;25;44;120;75;86;26;189;94;63;79;80;176;133;151;51;118;59;115;46;0;137;23;186;89;183;143;117;93;140;68;139;193;41;5;42;181;159;69;108;18;22;146;34;160;48;54;177;10;190;84;184;43;116;65;131;149;162;123;127;70;135;154;180;53;100;101;1;97;152;2;129;57,1402769580360160719,0.000000
greedy_intra:nodes_start:greedy,93,71968,23472,48496,1,0,93;140;108;69;18;22;146;159;193;41;5;42;181;34;160;48;54;177;10;190;4;84;184;43;116;65;149;123;127;162;151;133;135;70;154;180;53;121;100;26;86;75;44;25;16;171;175;113;56;31;78;145;179;196;81;90;40;165;185;106;178;138;14;144;62;9;148;102;49;52;55;92;57;129;82;120;2;101;1;97;152;124;94;63;79;80;176;137;51;118;59;115;139;46;68;0;89;183;143;117,1518015230913826518,0.001000
greedy_intra:nodes_start:greedy,94,71750,23180,48570,1,0,94;152;97;1;101;75;86;26;100;121;53;158;154;70;135;180;63;79;133;51;118;59;115;46;0;143;117;93;140;68;139;193;41;5;42;181;159;69;108;18;22;146;34;160;48;54;177;184;43;116;65;149;123;127;162;151;80;176;137;23;183;89;186;114;15;9;62;144;14;138;165;40;185;90;81;196;179;145;78;31;56;113;175;171;16;25;44;120;2;129;92;57;55;52;106;178;49;102;148;124,359927779481996478,0.000000
greedy_intra:nodes_start:greedy,95,72164,23636,48528,1,0,95;7;164;71;27;90;40;185;81;196;179;145;78;31;56;113;175;171;16;25;44;120;75;86;26;94;63;79;80;176;133;151;51;118;59;115;46;0;137;23;89;183;143;117;93;140;68;139;193;41;5;42;181;159;69;108;18;22;146;34;160;48;54;177;184;43;116;65;149;162;123;127;70;135;154;180;53;100;101;1;97;152;2;129;92;57;55;52;106;178;49;102;148;9;62;144;14;138;165;39,4776928509537962689,0.000000
greedy_intra:nodes_start:greedy,96,72114,23548,48566,1,0,96;43;116;65;149;123;127;162;151;133;135;70;154;180;53;121;100;26;86;75;44;25;16;171;175;113;56;31;78;145;179;196;81;90;40;165;185;106;178;138;14;144;62;9;148;102;49;52;55;92;57;129;82;120;2;101;1;97;152;124;94;63;79;80;176;137;23;186;89;183;143;117;0;51;118;59;115;46;68;139;41;193;159;69;108;18;22;146;181;34;160;48;54;177;10;190;4;84;184;42,3336273139370714328,0.000000
greedy_intra:nodes_start:greedy,97,71933,23455,48478,1,0,97;152;1;101;75;86;53;154;70;135;180;63;79;133;51;118;59;115;46;0;143;117;93;140;68;139;193;41;5;42;181;159;69;108;18;22;146;34;160;48;54;177;190;184;43;116;65;149;123;127;162;151;80;176;137;23;183;89;186;114;15;9;62;144;14;138;165;40;185;90;81;196;179;145;78;31;56;113;175;171;16;25;44;120;2;129;92;57;55;52;106;178;49;102;148;124;94;189;100;26,2555653403061495817,0.000000
greedy_intra:nodes_start:greedy,98,73217,24027,49190,1,0,98;81;90;27;164;39;165;40;185;106;178;138;14;144;62;9;148;102;49;52;55;57;129;92;179;145;78;82;2;152;97;1;101;100;53;180;154;135;70;127;123;162;149;65;116;43;184;177;54;48;160;34;146;22;18;108;69;159;181;42;5;41;193;139;68;140;93;117;143;183;89;23;137;0;46;115;59;118;51;151;133;176;80;79;63;94;26;86;75;120;44;25;16;171;175;113;56;31;157;196,854023090874574079,0.000000
greedy_intra:nodes_start:greedy,99,72749,23378,49371,1,0,99;97;26;100;86;75;101;1;152;94;124;148;102;49;178;106;52;55;57;92;129;2;120;44;25;16;171;175;113;56;31;78;145;179;196;81;90;185;40;165;138;14;144;62;9;15;114;186;89;183;23;137;176;80;151;162;127;123;149;65;116;43;184;177;54;48;160;34;146;22;18;108;69;159;181;42;5;41;193;139;68;140;93;117;143;0;46;115;59;118;51;133;79;63;180;135;70;154;158;53,5018439713405706593,0.000000
greedy_intra:nodes_start:greedy,100,71750,23180,48570,1,0,100;26;86;75;101;1;97;152;94;124;148;102;49;178;106;52;55;57;92;129;2;120;44;25;16;171;175;113;56;31;78;145;179;196;81;90;185;40;165;138;14;144;62;9;15;114;186;89;183;23;137;176;80;151;162;127;123;149;65;116;43;184;177;54;48;160;34;146;22;18;108;69;159;181;42;5;41;193;139;68;140;93;117;143;0;46;115;59;118;51;133;79;63;180;135;70;154;158;53;121,325813419419649568,0.000000
greedy_intra:nodes_start:greedy,101,71933,23455,48478,1,0,101;1;152;97;26;100;189;94;124;148;102;49;178;106;52;55;57;92;129;2;120;44;25;16;171;175;113;56;31;78;145;179;196;81;90;185;40;165;138;14;144;62;9;15;114;186;89;183;23;137;176;80;151;162;127;123;149;65;116;43;184;190;177;54;48;160;34;146;22;18;108;69;159;181;42;5;41;193;139;68;140;93;117;143;0;46;115;59;118;51;133;79;63;180;135;70;154;53;86;75,4167617523246774693,0.000000
greedy_intra:nodes_start:greedy,102,71523,23197,48326,1,0,102;148;9;62;144;14;138;165;40;185;90;81;196;179;145;78;31;56;113;175;171;16;25;44;120;75;86;26;189;94;63;79;80;176;133;151;51;118;59;115;46;0;137;23;186;89;183;143;117;93;140;68;139;193;41;5;42;181;159;69;108;18;22;146;34;160;48;54;177;10;190;84;184;43;116;65;131;149;162;123;127;70;135;154;180;53;100;101;1;97;152;2;129;92;57;55;52;106;178;49,4258444399093760264,0.000000
greedy_intra:nodes_start:greedy,103,71597,23235,48362,1,0,103;34;160;48;54;177;10;190;4;112;84;184;42;43;116;65;149;123;127;162;151;133;135;70;154;180;53;121;100;26;86;75;44;25;16;171;175;113;56;31;78;145;179;196;81;90;40;165;185;106;178;138;14;144;62;9;148;102;49;52;55;92;57;129;82;120;2;101;1;97;152;124;94;63;79;80;176;137;23;186;89;183;143;117;0;51;118;59;115;46;68;139;41;193;159;69;108;18;22;146,2756199592004952031,0.000000
greedy_intra:nodes_start:greedy,104,73110,23928,49182,1,0,104;54;48;34;160;181;42;195;146;22;18;108;69;159;41;193;139;68;140;93;117;143;183;89;186;23;137;176;80;79;63;94;124;152;97;1;101;2;120;82;129;57;92;55;52;49;102;148;9;62;144;14;138;178;106;185;165;40;90;81;196;179;145;78;31;56;113;175;171;16;25;44;75;86;26;100;121;53;180;154;135;70;127;123;162;133;151;51;0;46;115;118;59;116;65;43;184;4;10;177,5957300848812635540,0.000000
greedy_intra:nodes_start:greedy,105,72453,23604,48849,1,0,105;116;43;184;84;190;10;177;54;48;160;34;146;22;18;108;69;159;181;42;5;41;193;139;68;46;115;118;59;51;0;117;143;183;89;186;23;137;176;80;79;63;94;124;152;97;1;101;2;120;82;129;57;92;55;52;49;102;148;9;62;144;14;138;178;106;185;165;40;90;81;196;179;145;78;31;56;113;175;171;16;25;44;75;86;26;100;121;53;180;154;70;135;133;151;162;127;123;149;65,4024947914129327174,0.000000
greedy_intra:nodes_start:greedy,106,71523,23197,48326,1,0,106;178;49;102;148;9;62;144;14;138;165;40;185;90;81;196;179;145;78;31;56;113;175;171;16;25;44;120;75;86;26;189;94;63;79;80;176;133;151;51;118;59;115;46;0;137;23;186;89;183;143;117;93;140;68;139;193;41;5;42;181;159;69;108;18;22;146;34;160;48;54;177;10;190;84;184;43;116;65;131;149;162;123;127;70;135;154;180;53;100;101;1;97;152;2;129;92;57;55;52,2215541206673223336,0.000000
greedy_intra:nodes_start:greedy,107,72830,23628,49202,1,0,107;27;164;7;95;39;165;138;14;144;62;9;148;102;49;178;106;52;55;57;92;129;2;152;97;1;101;100;53;180;154;135;70;127;123;162;149;65;116;43;184;177;54;48;160;34;146;22;18;108;69;159;181;42;5;41;193;139;68;140;93;117;143;183;89;23;137;0;46;115;59;118;51;151;133;176;80;79;63;94;26;86;75;120;44;25;16;171;175;113;56;31;78;145;179;196;81;185;40;90,7496981551050496272,0.000000
greedy_intra:nodes_start:greedy,108,72218,23381,48837,1,0,108;69;139;68;46;115;59;118;51;0;117;143;183;89;186;23;137;176;80;79;63;94;124;152;97;1;101;2;120;82;129;57;92;55;52;49;102;148;9;62;144;14;138;178;106;185;165;40;90;81;196;179;145;78;31;56;113;175;171;16;25;44;75;86;26;100;121;53;180;154;70;135;133;151;162;127;123;149;65;116;43;184;84;190;10;177;54;48;160;34;181;42;5;41;193;159;146;22;20;18,927722937073751612,0.000000
greedy_intra:nodes_start:greedy,109,72236,23390,48846,1,0,109;118;115;46;68;139;193;41;5;42;181;159;69;108;18;22;146;34;160;48;54;177;10;190;4;84;184;43;65;116;59;151;133;162;123;127;70;135;154;180;53;121;100;26;86;75;44;25;16;171;175;113;56;31;78;145;179;196;81;90;40;165;185;106;178;138;14;144;62;9;148;102;49;52;55;92;57;129;82;120;2;101;1;97;152;124;94;63;79;80;176;137;23;186;89;183;143;117;0;51,2339095148854086981,0.000000
greedy_intra:nodes_start:greedy,110,72558,23584,48974,1,0,110;193;41;5;42;181;159;69;108;18;22;146;34;160;48;54;177;10;190;84;184;43;116;65;149;123;127;162;151;133;135;70;154;180;53;121;100;26;86;75;44;25;16;171;175;113;56;31;78;145;179;196;81;90;40;165;185;106;178;138;14;144;62;9;148;102;49;52;55;92;57;129;82;120;2;101;1;97;152;124;94;63;79;80;176;137;23;186;89;183;143;117;0;51;118;59;115;46;68;139,681190091904196269,0.000000
greedy_intra:nodes_start:greedy,111,72861,23747,49114,1,0,111;148;9;62;102;144;14;49;178;106;165;39;95;164;27;90;81;196;40;185;52;55;57;129;92;179;145;78;31;56;113;175;171;16;25;44;120;2;152;97;1;101;75;86;26;100;121;53;158;154;70;135;180;63;79;133;51;118;59;115;46;0;89;183;143;117;93;140;68;139;193;41;5;42;181;159;69;108;18;22;146;34;160;48;54;177;184;43;116;65;149;123;127;162;151;80;176;137;94;124,4081228083329040052,0.000000
greedy_intra:nodes_start:greedy,112,71935,23606,48329,1,0,112;4;84;35;184;190;177;54;48;160;34;181;146;22;18;108;69;159;193;41;5;42;43;116;65;46;68;139;115;59;118;51;0;117;143;183;89;186;23;137;176;80;79;63;94;124;152;97;1;101;2;120;82;129;57;92;55;52;49;102;148;9;62;144;14;138;178;106;185;165;40;90;81;196;179;145;78;31;56;113;175;171;16;25;44;75;86;26;100;121;53;180;154;70;135;133;151;162;123;127,2508713556067450125,0.000000
greedy_intra:nodes_start:greedy,113,72017,23691,48326,1,0,113;56;31;145;78;92;179;196;81;90;40;165;185;106;178;138;14;144;62;9;148;102;49;52;55;57;129;2;152;97;1;101;100;53;180;154;135;70;127;123;162;149;131;65;116;43;184;84;190;10;177;54;48;160;34;146;22;18;108;69;159;181;42;5;41;193;139;68;140;93;117;143;183;89;186;23;137;0;46;115;59;118;51;151;133;176;80;79;63;94;189;26;86;75;120;44;25;16;171;175,7933880272827070656,0.000000
greedy_intra:nodes_start:greedy,114,71682,23112,48570,1,0,114;186;89;183;23;137;176;80;151;162;127;123;149;65;116;43;184;177;54;48;160;34;146;22;18;108;69;159;181;42;5;41;193;139;68;140;93;117;143;0;46;115;59;118;51;133;79;63;180;135;70;154;158;53;121;100;26;86;75;101;1;97;152;94;124;148;9;62;102;49;178;106;52;55;57;92;129;2;120;44;25;16;171;175;113;56;31;78;145;179;196;81;90;185;40;165;138;14;144;15,2201439337232742048,0.000000
greedy_intra:nodes_start:greedy,115,71947,23578,48369,1,0,115;59;118;51;0;117;143;183;89;186;23;137;176;80;79;63;94;124;152;97;1;101;2;120;82;129;57;92;55;52;49;102;148;9;62;144;14;138;178;106;185;165;40;90;81;196;179;145;78;31;56;113;175;171;16;25;44;75;86;26;100;121;53;180;154;70;135;133;151;162;127;123;149;65;116;43;184;84;4;190;10;177;54;48;160;34;146;22;18;108;69;159;181;42;5;41;193;139;68;46,7868965353665431585,0.000000
greedy_intra:nodes_start:greedy,116,71947,23578,48369,1,0,116;43;184;84;4;190;10;177;54;48;160;34;146;22;18;108;69;159;181;42;5;41;193;139;68;46;115;59;118;51;0;117;143;183;89;186;23;137;176;80;79;63;94;124;152;97;1;101;2;120;82;129;57;92;55;52;49;102;148;9;62;144;14;138;178;106;185;165;40;90;81;196;179;145;78;31;56;113;175;171;16;25;44;75;86;26;100;121;53;180;154;70;135;133;151;162;127;123;149;65,2016656886727927093,0.000235
greedy_intra:nodes_start:greedy,117,71108,22981,48127,1,0,117;0;46;68;139;193;41;115;5;42;181;159;69;108;18;22;146;34;160;48;54;177;10;190;4;112;84;184;43;116;65;59;118;51;151;133;162;123;127;70;135;154;180;53;121;100;26;86;75;44;25;16;171;175;113;56;31;78;145;179;196;81;90;40;165;185;106;178;138;14;144;62;9;148;102;49;52;55;92;57;129;82;120;2;101;1;97;152;124;94;63;79;80;176;137;23;186;89;183;143,3039027333373488005,0.000000
greedy_intra:nodes_start:greedy,118,72006,23637,48369,1,0,118;115;46;68;139;193;41;5;42;181;159;69;108;18;22;146;34;160;48;54;177;10;190;4;84;184;43;116;65;149;123;127;162;151;133;135;70;154;180;53;121;100;26;86;75;44;25;16;171;175;113;56;31;78;145;179;196;81;90;40;165;185;106;178;138;14;144;62;9;148;102;49;52;55;92;57;129;82;120;2;101;1;97;152;124;94;63;79;80;176;137;23;186;89;183;143;117;0;51;59,4886224951801457357,0.000079
greedy_intra:nodes_start:greedy,119,71472,23013,48459,1,0,119;40;185;90;81;196;179;145;78;31;56;113;175;171;16;25;44;120;75;86;26;189;94;63;79;80;176;133;151;51;118;59;115;46;0;137;23;186;89;183;143;117;93;140;68;139;193;41;5;42;181;159;69;108;18;22;146;34;160;48;54;177;10;190;184;43;116;65;131;149;162;123;127;70;135;154;180;53;100;101;1;97;152;2;129;92;57;55;52;106;178;49;102;148;9;62;144;14;138;165,790983615920681419,0.000000
greedy_intra:nodes_start:greedy,120,71905,23579,48326,1,0,120;75;86;26;189;94;63;79;80;176;133;151;51;118;59;115;46;0;137;23;186;89;183;143;117;93;140;68;139;193;41;5;42;181;159;69;108;18;22;146;34;160;48;54;177;10;190;84;184;43;116;65;131;149;162;123;127;70;135;154;180;53;100;101;1;97;152;2;129;57;92;55;52;49;102;148;9;62;144;14;138;178;106;185;165;40;90;81;196;179;145;78;31;56;113;175;171;16;25;44,8978213797628695072,0.000000
greedy_intra:nodes_start:greedy,121,71867,23297,48570,1,0,121;100;26;97;86;75;101;1;152;94;124;148;102;49;178;106;52;55;57;92;129;2;120;44;25;16;171;175;113;56;31;78;145;179;196;81;90;185;40;165;138;14;144;62;9;15;114;186;89;183;23;137;176;80;151;162;127;123;149;65;116;43;184;177;54;48;160;34;146;22;18;108;69;159;181;42;5;41;193;139;68;140;93;117;143;0;46;115;59;118;51;133;79;63;180;135;70;154;158;53,3188409005105511098,0.000000
greedy_intra:nodes_start:greedy,122,72576,23444,49132,1,0,122;176;80;79;133;151;51;118;59;115;46;0;137;23;89;183;143;117;93;140;68;139;193;41;5;42;181;159;69;108;18;22;146;34;160;48;54;177;184;43;116;65;131;149;162;123;127;70;135;180;154;158;53;121;100;26;86;75;44;25;16;171;175;113;56;31;78;145;179;196;81;90;40;165;185;106;178;138;14;144;62;9;148;102;49;52;55;92;57;129;82;120;2;101;1;97;152;124;94;63,4292742064111420082,0.000000
greedy_intra:nodes_start:greedy,123,71940,23456,48484,1,0,123;162;133;151;149;131;65;116;43;184;84;190;10;177;54;48;160;34;146;22;18;108;69;159;181;42;5;41;193;139;68;46;115;59;118;51;0;117;143;183;89;186;23;137;176;80;79;63;94;124;152;97;1;101;2;120;82;129;57;92;55;52;49;102;148;9;62;144;14;138;178;106;185;165;40;90;81;196;179;145;78;31;56;113;175;171;16;25;44;75;86;26;100;121;53;180;154;135;70;127,3447684938429158184,0.000000
greedy_intra:nodes_start:greedy,124,71861,23291,48570,1,0,124;152;97;1;101;75;86;26;100;121;53;158;154;70;135;180;63;79;133;51;118;59;115;46;0;143;117;93;140;68;139;193;41;5;42;181;159;69;108;18;22;146;34;160;48;54;177;184;43;116;65;149;123;127;162;151;80;176;137;23;183;89;186;114;15;9;62;144;14;138;165;40;185;90;81;196;179;145;78;31;56;113;175;171;16;25;44;120;2;129;92;57;55;52;106;178;49;102;148;94,5558452018874446556,0.001002
greedy_intra:nodes_start:greedy,125,73395,23511,49884,1,0,125;2;120;82;129;57;92;179;145;78;31;56;113;175;171;16;25;44;75;86;53;154;70;135;180;63;79;133;51;118;59;115;46;0;143;117;93;140;68;139;193;41;5;42;181;159;69;108;18;22;146;34;160;48;54;177;184;43;116;65;149;123;162;151;80;176;137;23;183;89;186;114;15;9;62;144;14;138;165;90;81;196;40;185;55;52;106;178;49;102;148;124;94;189;100;26;1;101;97;152,1011866859248582517,0.000000
greedy_intra:nodes_start:greedy,126,72420,23391,49029,1,0,126;112;4;84;35;184;177;54;48;160;34;181;146;22;18;108;69;159;193;41;5;42;43;116;65;46;68;139;115;59;118;51;0;117;143;183;89;186;23;137;176;80;79;63;94;124;152;97;1;101;2;120;82;129;57;92;55;52;49;102;148;9;62;144;14;138;178;106;185;165;40;90;81;196;179;145;78;31;56;113;175;171;16;25;44;75;86;26;100;121;53;180;154;70;135;133;151;162;123;127,117710333165780795,0.000000
greedy_intra:nodes_start:greedy,127,72193,23609,48584,1,0,127;70;135;154;180;53;121;100;26;86;75;44;25;16;171;175;113;56;31;78;145;179;196;81;90;40;165;185;106;178;138;14;144;62;9;148;102;49;52;55;92;57;129;82;120;2;101;1;97;152;124;94;63;79;80;176;133;151;51;118;59;115;46;0;137;23;186;89;183;143;117;93;140;68;139;193;41;5;42;181;159;69;108;18;22;146;34;160;48;54;177;190;184;43;116;65;131;149;162;123,4795854775303258358,0.000000
greedy_intra:nodes_start:greedy,128,72267,23379,48888,1,0,128;167;148;9;62;102;144;14;49;178;106;165;40;185;90;81;196;179;145;78;31;56;113;175;171;16;25;44;120;75;86;26;189;94;63;79;80;176;133;151;51;118;59;115;46;0;137;23;186;89;183;143;117;93;140;68;139;193;41;5;42;181;159;69;108;18;22;146;34;160;48;54;177;10;190;184;43;116;65;131;149;162;123;127;70;135;154;180;53;100;101;1;97;152;2;129;92;57;52;55,2806193161879488921,0.000996
greedy_intra:nodes_start:greedy,129,71905,23579,48326,1,0,129;57;92;55;52;49;102;148;9;62;144;14;138;178;106;185;165;40;90;81;196;179;145;78;31;56;113;175;171;16;25;44;120;75;86;26;189;94;63;79;80;176;133;151;51;118;59;115;46;0;137;23;186;89;183;143;117;93;140;68;139;193;41;5;42;181;159;69;108;18;22;146;34;160;48;54;177;10;190;84;184;43;116;65;131;149;162;123;127;70;135;154;180;53;100;101;1;97;152;2,5067331985009456319,0.000000
greedy_intra:nodes_start:greedy,130,72516,23221,49295,1,0,130;148;102;49;178;106;52;55;57;92;129;2;120;44;25;16;171;175;113;56;31;78;145;179;196;81;90;185;40;165;138;14;144;62;9;15;114;186;89;183;23;137;176;80;151;162;127;123;149;65;116;43;184;177;54;48;160;34;146;22;18;108;69;159;181;42;5;41;193;139;68;140;93;117;143;0;46;115;59;118;51;133;79;63;180;135;70;154;158;53;121;100;26;86;75;101;1;97;152;94,4265770000585867180,0.000000
greedy_intra:nodes_start:greedy,131,71993,23509,48484,1,0,131;149;123;127;162;151;133;135;70;154;180;53;121;100;26;86;75;44;25;16;171;175;113;56;31;78;145;179;196;81;90;40;165;185;106;178;138;14;144;62;9;148;102;49;52;55;92;57;129;82;120;2;101;1;97;152;124;94;63;79;80;176;137;23;186;89;183;143;117;0;51;118;59;115;46;68;139;193;41;5;42;181;159;69;108;18;22;146;34;160;48;54;177;10;190;84;184;43;116;65,7323388003750150120,0.000000
greedy_intra:nodes_start:greedy,132,72621,23434,49187,1,0,132;14;138;165;40;185;90;81;196;179;145;78;31;56;113;175;171;16;25;44;120;75;86;26;189;94;63;79;80;176;133;151;51;118;59;115;46;0;137;23;186;89;183;143;117;93;140;68;139;193;41;5;42;181;159;69;108;18;22;146;34;160;48;54;177;10;190;184;43;116;65;131;149;162;123;127;70;135;154;180;53;100;101;1;97;152;2;129;92;57;55;52;106;178;49;102;148;9;62;144,8604518730097790887,0.000000
greedy_intra:nodes_start:greedy,133,72193,23609,48584,1,0,133;151;51;118;59;115;46;0;137;23;186;89;183;143;117;93;140;68;139;193;41;5;42;181;159;69;108;18;22;146;34;160;48;54;177;190;184;43;116;65;131;149;162;123;127;70;135;154;180;53;121;100;26;86;75;44;25;16;171;175;113;56;31;78;145;179;196;81;90;40;165;185;106;178;138;14;144;62;9;148;102;49;52;55;92;57;129;82;120;2;101;1;97;152;124;94;63;79;80;176,5708177770414179866,0.001000
greedy_intra:nodes_start:greedy,134,73278,23531,49747,1,0,134;108;18;69;139;68;46;115;59;118;51;0;117;143;183;89;186;23;137;176;80;79;63;94;124;152;97;1;101;2;120;82;129;57;92;55;52;49;102;148;9;62;144;14;138;178;106;185;165;40;90;81;196;179;145;78;31;56;113;175;171;16;25;44;75;86;26;100;121;53;180;154;70;135;133;151;162;127;123;149;65;116;43;184;190;10;177;54;48;160;34;181;42;5;41;193;159;146;22;20,939855046723814463,0.000000
greedy_intra:nodes_start:greedy,135,71750,23180,48570,1,0,135;70;154;158;53;121;100;26;86;75;101;1;97;152;94;124;148;102;49;178;106;52;55;57;92;129;2;120;44;25;16;171;175;113;56;31;78;145;179;196;81;90;185;40;165;138;14;144;62;9;15;114;186;89;183;23;137;176;80;151;162;127;123;149;65;116;43;184;177;54;48;160;34;146;22;18;108;69;159;181;42;5;41;193;139;68;140;93;117;143;0;46;115;59;118;51;133;79;63;180,2330943548425423367,0.000000
greedy_intra:nodes_start:greedy,136,72536,23768,48768,1,0,136;121;100;26;86;75;44;25;16;171;175;113;56;31;78;145;179;196;81;90;40;165;185;106;178;138;14;144;62;9;148;102;49;52;55;92;57;129;82;120;2;101;1;97;152;124;94;63;79;80;176;137;23;186;89;183;143;117;0;51;118;59;115;46;68;139;193;41;5;42;181;159;69;108;18;22;146;34;160;48;54;177;10;190;84;184;43;116;65;149;123;127;162;151;133;180;135;70;154;53,6198480746111641866,0.000000
greedy_intra:nodes_start:greedy,137,71750,23180,48570,1,0,137;23;183;89;186;114;15;9;62;144;14;138;165;40;185;90;81;196;179;145;78;31;56;113;175;171;16;25;44;120;2;129;92;57;55;52;106;178;49;102;148;124;94;152;97;1;101;75;86;26;100;121;53;158;154;70;135;180;63;79;133;51;118;59;115;46;0;143;117;93;140;68;139;193;41;5;42;181;159;69;108;18;22;146;34;160;48;54;177;184;43;116;65;149;123;127;162;151;80;176,6965499976038070183,0.000000
greedy_intra:nodes_start:greedy,138,71523,23197,48326,1,0,138;14;144;62;9;148;102;49;178;106;52;55;57;92;129;2;152;97;1;101;100;53;180;154;135;70;127;123;162;149;131;65;116;43;184;84;190;10;177;54;48;160;34;146;22;18;108;69;159;181;42;5;41;193;139;68;140;93;117;143;183;89;186;23;137;0;46;115;59;118;51;151;133;176;80;79;63;94;189;26;86;75;120;44;25;16;171;175;113;56;31;78;145;179;196;81;90;185;40;165,9002171218441787970,0.000000
greedy_intra:nodes_start:greedy,139,71947,23578,48369,1,0,139;68;46;115;59;118;51;0;117;143;183;89;186;23;137;176;80;79;63;94;124;152;97;1;101;2;120;82;129;57;92;55;52;49;102;148;9;62;144;14;138;178;106;185;165;40;90;81;196;179;145;78;31;56;113;175;171;16;25;44;75;86;26;100;121;53;180;154;70;135;133;151;162;127;123;149;65;116;43;184;84;4;190;10;177;54;48;160;34;146;22;18;108;69;159;181;42;5;41;193,5329146338206292314,0.000000
greedy_intra:nodes_start:greedy,140,71968,23472,48496,1,0,140;108;69;18;22;146;159;193;41;5;42;181;34;160;48;54;177;10;190;4;84;184;43;116;65;149;123;127;162;151;133;135;70;154;180;53;121;100;26;86;75;44;25;16;171;175;113;56;31;78;145;179;196;81;90;40;165;185;106;178;138;14;144;62;9;148;102;49;52;55;92;57;129;82;120;2;101;1;97;152;124;94;63;79;80;176;137;51;118;59;115;139;46;68;0;89;183;143;117;93,537899995214222155,0.000000
greedy_intra:nodes_start:greedy,141,72824,23488,49336,1,0,141;23;186;89;183;143;117;0;93;140;68;46;115;139;193;41;5;42;181;159;69;108;18;22;146;34;160;48;54;177;10;190;184;43;116;65;59;118;51;151;133;162;123;127;70;135;154;180;53;121;100;26;86;75;44;25;16;171;175;113;56;31;78;145;179;196;81;90;40;165;185;106;178;138;14;144;62;9;148;102;49;52;55;92;57;129;82;120;2;101;1;97;152;124;94;63;79;80;176;137,8816965585819194795,0.000000
greedy_intra:nodes_start:greedy,142,72909,23572,49337,1,0,142;139;68;46;115;59;118;51;0;117;143;183;89;186;23;137;176;80;79;63;94;124;152;97;1;101;2;120;82;129;57;92;55;52;49;102;148;9;62;144;14;138;178;106;185;165;40;90;81;196;179;145;78;31;56;113;175;171;16;25;44;75;86;26;100;121;53;180;154;70;135;133;151;162;127;123;149;65;116;43;184;84;190;10;177;54;48;160;34;146;22;18;108;69;159;181;42;5;41;193,2938998046050538454,0.001032
greedy_intra:nodes_start:greedy,143,71108,22981,48127,1,0,143;117;0;46;68;139;193;41;115;5;42;181;159;69;108;18;22;146;34;160;48;54;177;10;190;4;112;84;184;43;116;65;59;118;51;151;133;162;123;127;70;135;154;180;53;121;100;26;86;75;44;25;16;171;175;113;56;31;78;145;179;196;81;90;40;165;185;106;178;138;14;144;62;9;148;102;49;52;55;92;57;129;82;120;2;101;1;97;152;124;94;63;79;80;176;137;23;186;89;183,5790974810531765816,0.000000
greedy_intra:nodes_start:greedy,144,71523,23197,48326,1,0,144;14;138;165;40;185;90;81;196;179;145;78;31;56;113;175;171;16;25;44;120;75;86;26;189;94;63;79;80;176;133;151;51;118;59;115;46;0;137;23;186;89;183;143;117;93;140;68;139;193;41;5;42;181;159;69;108;18;22;146;34;160;48;54;177;10;190;84;184;43;116;65;131;149;162;123;127;70;135;154;180;53;100;101;1;97;152;2;129;92;57;55;52;106;178;49;102;148;9;62,6055766265033301385,0.000000
greedy_intra:nodes_start:greedy,145,71905,23579,48326,1,0,145;179;196;81;90;40;165;185;106;178;138;14;144;62;9;148;102;49;52;55;92;57;129;2;152;97;1;101;100;53;180;154;135;70;127;123;162;149;131;65;116;43;184;84;190;10;177;54;48;160;34;146;22;18;108;69;159;181;42;5;41;193;139;68;140;93;117;143;183;89;186;23;137;0;46;115;59;118;51;151;133;176;80;79;63;94;189;26;86;75;120;44;25;16;171;175;113;56;31;78,6284486636835746667,0.000000
greedy_intra:nodes_start:greedy,146,71385,23490,47895,1,0,146;181;34;160;48;54;177;10;190;4;112;84;184;42;43;116;65;149;123;127;162;151;133;135;70;154;180;53;121;100;26;86;75;44;25;16;171;175;113;56;31;78;145;179;196;81;90;40;165;185;106;178;138;14;144;62;9;148;102;49;52;55;92;57;129;82;120;2;101;1;97;152;124;94;63;79;80;176;137;23;186;89;183;143;117;0;51;118;59;115;46;68;139;41;193;159;69;108;18;22,8616638236622581668,0.000000
greedy_intra:nodes_start:greedy,147,73391,23933,49458,1,0,147;177;10;4;184;43;65;116;59;118;115;46;0;51;151;133;162;123;127;70;135;154;180;53;121;100;26;86;75;44;25;16;171;175;113;56;31;78;145;179;196;81;90;40;165;185;106;178;138;14;144;62;9;148;102;49;52;55;92;57;129;82;120;2;101;1;97;152;124;94;63;79;80;176;137;23;186;89;183;143;117;93;140;68;139;193;41;159;69;108;18;22;146;195;42;181;160;34;48;54,7937993476171940266,0.000000
greedy_intra:nodes_start:greedy,148,71523,23197,48326,1,0,148;102;49;178;106;52;55;57;92;129;2;152;97;1;101;100;53;180;154;135;70;127;123;162;149;131;65;116;43;184;84;190;10;177;54;48;160;34;146;22;18;108;69;159;181;42;5;41;193;139;68;140;93;117;143;183;89;186;23;137;0;46;115;59;118;51;151;133;176;80;79;63;94;189;26;86;75;120;44;25;16;171;175;113;56;31;78;145;179;196;81;90;185;40;165;138;14;144;62;9,331054322870681282,0.000000
greedy_intra:nodes_start:greedy,149,71947,23578,48369,1,0,149;123;127;162;151;133;135;70;154;180;53;121;100;26;86;75;44;25;16;171;175;113;56;31;78;145;179;196;81;90;40;165;185;106;178;138;14;144;62;9;148;102;49;52;55;92;57;129;82;120;2;101;1;97;152;124;94;63;79;80;176;137;23;186;89;183;143;117;0;51;118;59;115;46;68;139;193;41;5;42;181;159;69;108;18;22;146;34;160;48;54;177;10;190;4;84;184;43;116;65,1608586724624164253,0.000000
greedy_intra:nodes_start:greedy,150,73393,23514,49879,1,0,150;75;44;25;16;171;175;113;56;31;78;145;179;92;57;129;82;120;2;1;152;97;26;100;189;94;124;148;102;49;178;106;52;55;185;40;196;81;90;165;138;14;144;62;9;15;114;186;89;183;23;137;176;80;151;162;123;149;65;116;43;184;177;54;48;160;34;146;22;18;108;69;159;181;42;5;41;193;139;68;140;93;117;143;0;46;115;59;118;51;133;79;63;180;135;70;154;53;86;101,2966017967738265016,0.000000
greedy_intra:nodes_start:greedy,151,71940,23456,48484,1,0,151;133;162;123;127;70;135;154;180;53;121;100;26;86;75;44;25;16;171;175;113;56;31;78;145;179;196;81;90;40;165;185;106;178;138;14;144;62;9;148;102;49;52;55;92;57;129;82;120;2;101;1;97;152;124;94;63;79;80;176;137;23;186;89;183;143;117;0;51;118;59;115;46;68;139;193;41;5;42;181;159;69;108;18;22;146;34;160;48;54;177;10;190;84;184;43;116;65;131;149,4891146990171514570,0.000000
greedy_intra:nodes_start:greedy,152,71933,23455,48478,1,0,152;1;101;75;86;53;154;70;135;180;63;79;133;51;118;59;115;46;0;143;117;93;140;68;139;193;41;5;42;181;159;69;108;18;22;146;34;160;48;54;177;190;184;43;116;65;149;123;127;162;151;80;176;137;23;183;89;186;114;15;9;62;144;14;138;165;40;185;90;81;196;179;145;78;31;56;113;175;171;16;25;44;120;2;129;92;57;55;52;106;178;49;102;148;124;94;189;100;26;97,801171105490883374,0.001000
greedy_intra:nodes_start:greedy,153,71836,23029,48807,1,0,153;0;117;143;183;89;186;23;137;176;80;79;63;94;124;152;97;1;101;2;120;82;129;57;92;55;52;49;102;148;9;62;144;14;138;178;106;185;165;40;90;81;196;179;145;78;31;56;113;175;171;16;25;44;75;86;26;100;121;53;180;154;135;70;127;123;162;133;151;51;118;59;65;116;43;184;84;4;190;10;177;54;48;160;34;146;22;18;108;69;159;181;42;5;115;41;193;139;68;46,4692873872025082526,0.000000
greedy_intra:nodes_start:greedy,154,71750,23180,48570,1,0,154;158;53;121;100;26;86;75;101;1;97;152;94;124;148;102;49;178;106;52;55;57;92;129;2;120;44;25;16;171;175;113;56;31;78;145;179;196;81;90;185;40;165;138;14;144;62;9;15;114;186;89;183;23;137;176;80;151;162;127;123;149;65;116;43;184;177;54;48;160;34;146;22;18;108;69;159;181;42;5;41;193;139;68;140;93;117;143;0;46;115;59;118;51;133;79;63;180;135;70,5917759578730176167,0.000973
greedy_intra:nodes_start:greedy,155,72039,23020,49019,1,0,155;14;138;165;40;185;90;81;196;179;145;78;31;56;113;175;171;16;25;44;120;75;86;26;189;94;63;79;80;176;133;151;51;118;59;115;46;0;137;23;186;89;183;143;117;93;140;68;139;193;41;5;42;181;159;69;108;18;22;146;34;160;48;54;177;10;190;184;43;116;65;131;149;162;123;127;70;135;154;180;53;100;101;1;97;152;2;129;92;57;55;52;106;178;49;102;148;9;62;144,3573604930423236198,0.000000
greedy_intra:nodes_start:greedy,156,72431,23408,49023,1,0,156;112;4;84;35;184;177;54;48;160;34;181;146;22;18;108;69;159;193;41;5;42;43;116;65;46;68;139;115;59;118;51;0;117;143;183;89;186;23;137;176;80;79;63;94;124;152;97;1;101;2;120;82;129;57;92;55;52;49;102;148;9;62;144;14;138;178;106;185;165;40;90;81;196;179;145;78;31;56;113;175;171;16;25;44;75;86;26;100;121;53;180;154;70;135;133;151;162;123;127,9209724808440026202,0.000000
greedy_intra:nodes_start:greedy,157,72008,23507,48501,1,0,157;196;81;90;40;165;185;106;178;138;14;144;62;9;148;102;49;52;55;179;145;78;92;57;129;2;152;97;1;101;100;53;180;154;135;70;127;123;162;149;131;65;116;43;184;190;10;177;54;48;160;34;146;22;18;108;69;159;181;42;5;41;193;139;68;140;93;117;143;183;89;186;23;137;0;46;115;59;118;51;151;133;176;80;79;63;94;189;26;86;75;120;44;25;16;171;175;113;56;31,2311650703887587899,0.000000
greedy_intra:nodes_start:greedy,158,71750,23180,48570,1,0,158;154;70;135;180;63;79;133;51;118;59;115;46;0;143;117;93;140;68;139;193;41;5;42;181;159;69;108;18;22;146;34;160;48;54;177;184;43;116;65;149;123;127;162;151;80;176;137;23;183;89;186;114;15;9;62;144;14;138;165;40;185;90;81;196;179;145;78;31;56;113;175;171;16;25;44;120;2;129;92;57;55;52;106;178;49;102;148;124;94;152;97;1;101;75;86;26;100;121;53,9025623943341345348,0.000000
greedy_intra:nodes_start:greedy,159,71968,23472,48496,1,0,159;146;22;18;69;108;140;93;117;143;183;89;0;68;46;139;115;59;118;51;137;176;80;79;63;94;124;152;97;1;101;2;120;82;129;57;92;55;52;49;102;148;9;62;144;14;138;178;106;185;165;40;90;81;196;179;145;78;31;56;113;175;171;16;25;44;75;86;26;100;121;53;180;154;70;135;133;151;162;127;123;149;65;116;43;184;84;4;190;10;177;54;48;160;34;181;42;5;41;193,5275739895581423710,0.001385
greedy_intra:nodes_start:greedy,160,71385,23490,47895,1,0,160;48;54;177;10;190;4;112;84;184;42;43;116;65;149;123;127;162;151;133;135;70;154;180;53;121;100;26;86;75;44;25;16;171;175;113;56;31;78;145;179;196;81;90;40;165;185;106;178;138;14;144;62;9;148;102;49;52;55;92;57;129;82;120;2;101;1;97;152;124;94;63;79;80;176;137;23;186;89;183;143;117;0;51;118;59;115;46;68;139;41;193;159;69;108;18;22;146;181;34,6667956206274732175,0.001000
greedy_intra:nodes_start:greedy,161,73384,23693,49691,1,0,161;133;135;70;180;154;158;53;121;100;26;86;75;44;25;16;171;175;113;56;31;78;145;179;196;81;90;40;165;185;106;178;138;14;144;62;9;148;102;49;52;55;92;57;129;82;120;2;101;1;97;152;124;94;63;79;80;176;137;23;186;89;183;143;117;0;51;118;59;115;46;68;139;193;41;5;42;181;159;69;108;18;22;146;34;160;48;54;177;10;190;184;43;116;65;131;149;151;162;123,6550982721461543407,0.000000
greedy_intra:nodes_start:greedy,162,71947,23578,48369,1,0,162;151;133;135;70;154;180;53;121;100;26;86;75;44;25;16;171;175;113;56;31;78;145;179;196;81;90;40;165;185;106;178;138;14;144;62;9;148;102;49;52;55;92;57;129;82;120;2;101;1;97;152;124;94;63;79;80;176;137;23;186;89;183;143;117;0;51;118;59;115;46;68;139;193;41;5;42;181;159;69;108;18;22;146;34;160;48;54;177;10;190;4;84;184;43;116;65;149;123;127,1229412556680772316,0.000000
greedy_intra:nodes_start:greedy,163,72555,23328,49227,1,0,163;139;68;46;115;59;118;51;0;117;143;183;89;186;23;137;176;80;79;63;94;124;152;97;1;101;2;120;82;129;57;92;55;52;49;102;148;9;62;144;14;138;178;106;185;165;40;90;81;196;179;145;78;31;56;113;175;171;16;25;44;75;86;26;100;121;53;180;154;70;135;133;151;162;127;123;149;65;116;43;184;84;190;10;177;54;48;160;34;181;42;5;41;193;159;146;22;20;18;108,7228302646887090412,0.000000
greedy_intra:nodes_start:greedy,164,72164,23636,48528,1,0,164;7;95;39;165;138;14;144;62;9;148;102;49;178;106;52;55;57;92;129;2;152;97;1;101;100;53;180;154;135;70;127;123;162;149;65;116;43;184;177;54;48;160;34;146;22;18;108;69;159;181;42;5;41;193;139;68;140;93;117;143;183;89;23;137;0;46;115;59;118;51;151;133;176;80;79;63;94;26;86;75;120;44;25;16;171;175;113;56;31;78;145;179;196;81;185;40;90;27;71,515652119076105085,0.000000
greedy_intra:nodes_start:greedy,165,71523,23197,48326,1,0,165;40;185;90;81;196;179;145;78;31;56;113;175;171;16;25;44;120;75;86;26;189;94;63;79;80;176;133;151;51;118;59;115;46;0;137;23;186;89;183;143;117;93;140;68;139;193;41;5;42;181;159;69;108;18;22;146;34;160;48;54;177;10;190;84;184;43;116;65;131;149;162;123;127;70;135;154;180;53;100;101;1;97;152;2;129;92;57;55;52;106;178;49;102;148;9;62;144;14;138,2359901470176600665,0.000000
greedy_intra:nodes_start:greedy,166,72595,23537,49058,1,0,166;184;190;10;177;54;48;160;34;146;22;18;108;69;159;181;42;5;41;193;139;68;140;93;117;143;183;89;186;23;137;176;80;79;63;94;124;152;97;1;101;2;120;82;129;57;92;55;52;49;102;148;9;62;144;14;138;178;106;185;165;40;90;81;196;179;145;78;31;56;113;175;171;16;25;44;75;86;26;100;121;53;180;154;135;70;127;123;162;133;151;51;0;46;115;118;59;116;65;43,4524547534521561318,0.000000
greedy_intra:nodes_start:greedy,167,72713,24137,48576,1,0,167;148;9;62;102;144;14;49;178;106;165;39;95;7;164;71;27;90;81;196;40;185;52;55;57;129;92;179;145;78;31;56;113;175;171;16;25;44;120;2;75;101;1;97;152;26;100;86;53;154;70;135;180;63;79;133;51;118;59;115;46;0;89;183;143;117;93;140;68;139;193;41;5;42;181;159;69;108;18;22;146;34;160;48;54;177;184;43;116;65;149;123;127;162;151;80;176;137;94;124,4563587357125240902,0.001000
greedy_intra:nodes_start:greedy,168,72772,23521,49251,1,0,168;145;179;196;81;90;40;165;185;106;178;138;14;144;62;9;148;102;49;52;55;92;57;129;2;152;97;1;101;100;53;180;154;135;70;127;123;162;149;131;65;116;43;184;190;10;177;54;48;160;34;146;22;18;108;69;159;181;42;5;41;193;139;68;140;93;117;143;183;89;186;23;137;0;46;115;59;118;51;151;133;176;80;79;63;94;189;26;86;75;120;44;25;16;171;175;113;56;31;78,6497721669523321293,0.000000
greedy_intra:nodes_start:greedy,169,72402,23479,48923,1,0,169;40;90;165;138;14;144;62;9;148;102;49;178;106;52;55;57;92;129;2;152;97;1;101;100;53;180;154;135;70;127;123;162;149;131;65;116;43;184;190;10;177;54;48;160;34;146;22;18;108;69;159;181;42;5;41;193;139;68;140;93;117;143;183;89;186;23;137;0;46;115;59;118;51;151;133;176;80;79;63;94;189;26;86;75;120;44;25;16;171;175;113;56;31;78;145;179;185;81;196,7466591949497453708,0.000000
greedy_intra:nodes_start:greedy,170,71641,22771,48870,1,0,170;117;0;46;68;139;193;41;115;5;42;181;159;69;108;18;22;146;34;160;48;54;177;10;190;4;84;184;43;116;65;59;118;51;151;133;162;123;127;70;135;154;180;53;121;100;26;86;75;44;25;16;171;175;113;56;31;78;145;179;196;81;90;40;165;185;106;178;138;14;144;62;9;148;102;49;52;55;92;57;129;82;120;2;101;1;97;152;124;94;63;79;80;176;137;23;186;89;183;143,7062700185201665594,0.000000
greedy_intra:nodes_start:greedy,171,72017,23691,48326,1,0,171;175;113;56;31;145;78;92;179;196;81;90;40;165;185;106;178;138;14;144;62;9;148;102;49;52;55;57;129;2;152;97;1;101;100;53;180;154;135;70;127;123;162;149;131;65;116;43;184;84;190;10;177;54;48;160;34;146;22;18;108;69;159;181;42;5;41;193;139;68;140;93;117;143;183;89;186;23;137;0;46;115;59;118;51;151;133;176;80;79;63;94;189;26;86;75;120;44;25;16,2779246835916544743,0.001000
greedy_intra:nodes_start:greedy,172,72794,23350,49444,1,0,172;167;148;9;62;102;144;14;49;178;106;165;39;27;90;81;196;40;185;52;55;57;129;92;179;145;78;31;56;113;175;171;16;25;44;120;2;75;86;26;189;94;63;79;80;176;133;151;51;118;59;115;46;0;137;23;186;89;183;143;117;93;140;68;139;193;41;5;42;181;159;69;108;18;22;146;34;160;48;54;177;184;43;116;65;131;149;162;123;127;70;135;154;180;53;100;101;1;97;152,2295632829787407038,0.001000
greedy_intra:nodes_start:greedy,173,72487,22851,49636,1,0,173;135;70;154;158;53;121;100;26;86;75;101;1;97;152;94;124;148;102;49;178;106;52;55;57;92;129;2;120;44;25;16;171;175;113;56;31;78;145;179;196;81;90;185;40;165;138;14;144;62;9;15;114;186;89;183;23;137;176;80;151;162;123;149;65;116;43;184;177;54;48;160;34;146;22;18;108;69;159;181;42;5;41;193;139;68;140;93;117;143;0;46;115;59;118;51;133;79;63;180,3637627183084229092,0.000000
greedy_intra:nodes_start:greedy,174,72441,23126,49315,1,0,174;40;185;179;145;78;31;56;113;175;171;16;25;44;120;75;86;26;189;94;63;79;80;176;133;151;51;118;59;115;46;0;137;23;186;89;183;143;117;93;140;68;139;193;41;5;42;181;159;69;108;18;22;146;34;160;48;54;177;10;190;84;184;43;116;65;131;149;162;123;127;70;135;154;180;53;100;101;1;97;152;2;129;92;57;55;52;106;178;49;102;148;9;62;144;14;138;165;90;81,8264119734962981948,0.000000
greedy_intra:nodes_start:greedy,175,72017,23691,48326,1,0,175;113;56;31;145;78;92;179;196;81;90;40;165;185;106;178;138;14;144;62;9;148;102;49;52;55;57;129;2;152;97;1;101;100;53;180;154;135;70;127;123;162;149;131;65;116;43;184;84;190;10;177;54;48;160;34;146;22;18;108;69;159;181;42;5;41;193;139;68;140;93;117;143;183;89;186;23;137;0;46;115;59;118;51;151;133;176;80;79;63;94;189;26;86;75;120;44;25;16;171,1033147619915492123,0.001030
greedy_intra:nodes_start:greedy,176,71940,23456,48484,1,0,176;80;79;63;94;124;152;97;1;101;2;120;82;129;57;92;55;52;49;102;148;9;62;144;14;138;178;106;185;165;40;90;81;196;179;145;78;31;56;113;175;171;16;25;44;75;86;26;100;121;53;180;154;135;70;127;123;162;133;151;149;131;65;116;43;184;84;190;10;177;54;48;160;34;146;22;18;108;69;159;181;42;5;41;193;139;68;46;115;59;118;51;0;117;143;183;89;186;23;137,5208861336680416723,0.000000
greedy_intra:nodes_start:greedy,177,72287,23801,48486,1,0,177;54;48;34;160;181;42;195;146;22;18;108;69;159;41;193;139;68;140;93;117;143;183;89;186;23;137;176;80;79;63;94;124;152;97;1;101;2;120;82;129;57;92;55;52;49;102;148;9;62;144;14;138;178;106;185;165;40;90;81;196;179;145;78;31;56;113;175;171;16;25;44;75;86;26;100;121;53;180;154;135;70;127;123;162;133;151;51;0;46;115;118;59;116;65;43;184;84;190;10,8162812115979425656,0.001024
greedy_intra:nodes_start:greedy,178,71523,23197,48326,1,0,178;49;102;148;9;62;144;14;138;165;40;185;90;81;196;179;145;78;31;56;113;175;171;16;25;44;120;75;86;26;189;94;63;79;80;176;133;151;51;118;59;115;46;0;137;23;186;89;183;143;117;93;140;68;139;193;41;5;42;181;159;69;108;18;22;146;34;160;48;54;177;10;190;84;184;43;116;65;131;149;162;123;127;70;135;154;180;53;100;101;1;97;152;2;129;92;57;55;52;106,5184491452151361265,0.001002
greedy_intra:nodes_start:greedy,179,71704,23378,48326,1,0,179;145;78;31;56;113;175;171;16;25;44;120;75;86;26;189;94;63;79;80;176;133;151;51;118;59;115;46;0;137;23;186;89;183;143;117;93;140;68;139;193;41;5;42;181;159;69;108;18;22;146;34;160;48;54;177;10;190;84;184;43;116;65;131;149;162;123;127;70;135;154;180;53;100;101;1;97;152;2;129;92;57;55;52;49;102;148;9;62;144;14;138;178;106;185;165;40;90;81;196,675365958020739208,0.000000
greedy_intra:nodes_start:greedy,180,71750,23180,48570,1,0,180;135;70;154;158;53;121;100;26;86;75;101;1;97;152;94;124;148;102;49;178;106;52;55;57;92;129;2;120;44;25;16;171;175;113;56;31;78;145;179;196;81;90;185;40;165;138;14;144;62;9;15;114;186;89;183;23;137;176;80;151;162;127;123;149;65;116;43;184;177;54;48;160;34;146;22;18;108;69;159;181;42;5;41;193;139;68;140;93;117;143;0;46;115;59;118;51;133;79;63,8609829313633467888,0.000000
greedy_intra:nodes_start:greedy,181,71385,23490,47895,1,0,181;34;160;48;54;177;10;190;4;112;84;184;42;43;116;65;149;123;127;162;151;133;135;70;154;180;53;121;100;26;86;75;44;25;16;171;175;113;56;31;78;145;179;196;81;90;40;165;185;106;178;138;14;144;62;9;148;102;49;52;55;92;57;129;82;120;2;101;1;97;152;124;94;63;79;80;176;137;23;186;89;183;143;117;0;51;118;59;115;46;68;139;41;193;159;69;108;18;22;146,7775249001913008495,0.000000
greedy_intra:nodes_start:greedy,182,72008,23266,48742,1,0,182;121;100;26;86;75;101;1;97;152;94;124;148;102;49;178;106;52;55;57;92;129;2;120;44;25;16;171;175;113;56;31;78;145;179;196;81;90;185;40;165;138;14;144;62;9;15;114;186;89;183;23;137;176;80;151;162;127;123;149;65;116;43;184;177;54;48;160;34;146;22;18;108;69;159;181;42;5;41;193;139;68;140;93;117;143;0;46;115;59;118;51;133;79;63;180;135;70;154;53,2685871263115484692,0.000000
greedy_intra:nodes_start:greedy,183,71108,22981,48127,1,0,183;89;186;23;137;176;80;79;63;94;124;152;97;1;101;2;120;82;129;57;92;55;52;49;102;148;9;62;144;14;138;178;106;185;165;40;90;81;196;179;145;78;31;56;113;175;171;16;25;44;75;86;26;100;121;53;180;154;135;70;127;123;162;133;151;51;118;59;65;116;43;184;84;112;4;190;10;177;54;48;160;34;146;22;18;108;69;159;181;42;5;115;41;193;139;68;46;0;117;143,4279645569586406051,0.000000
greedy_intra:nodes_start:greedy,184,72083,23661,48422,1,0,184;43;65;116;59;118;115;46;0;51;151;133;162;123;127;70;135;154;180;53;121;100;26;86;75;44;25;16;171;175;113;56;31;78;145;179;196;81;90;40;165;185;106;178;138;14;144;62;9;148;102;49;52;55;92;57;129;82;120;2;101;1;97;152;124;94;63;79;80;176;137;23;186;89;183;143;117;93;140;68;139;193;41;5;42;181;159;69;108;18;22;146;34;160;48;54;177;10;190;84,210440867633319217,0.000000
greedy_intra:nodes_start:greedy,185,71523,23197,48326,1,0,185;90;81;196;179;145;78;31;56;113;175;171;16;25;44;120;75;86;26;189;94;63;79;80;176;133;151;51;118;59;115;46;0;137;23;186;89;183;143;117;93;140;68;139;193;41;5;42;181;159;69;108;18;22;146;34;160;48;54;177;10;190;84;184;43;116;65;131;149;162;123;127;70;135;154;180;53;100;101;1;97;152;2;129;92;57;55;52;106;178;49;102;148;9;62;144;14;138;165;40,7652847004558373964,0.000000
greedy_intra:nodes_start:greedy,186,71108,22981,48127,1,0,186;89;183;143;117;0;46;68;139;193;41;115;5;42;181;159;69;108;18;22;146;34;160;48;54;177;10;190;4;112;84;184;43;116;65;59;118;51;151;133;162;123;127;70;135;154;180;53;121;100;26;86;75;44;25;16;171;175;113;56;31;78;145;179;196;81;90;40;165;185;106;178;138;14;144;62;9;148;102;49;52;55;92;57;129;82;120;2;101;1;97;152;124;94;63;79;80;176;137;23,3025900459119638105,0.000000
greedy_intra:nodes_start:greedy,187,72151,23121,49030,1,0,187;81;196;40;185;179;145;78;31;56;113;175;171;16;25;44;120;75;86;26;189;94;63;79;80;176;133;151;51;118;59;115;46;0;137;23;186;89;183;143;117;93;140;68;139;193;41;5;42;181;159;69;108;18;22;146;34;160;48;54;177;10;190;184;43;116;65;131;149;162;123;127;70;135;154;180;53;100;101;1;97;152;2;129;92;57;55;52;106;178;49;102;148;9;62;144;14;138;165;90,1081585043056383091,0.000000
greedy_intra:nodes_start:greedy,188,73045,23657,49388,1,0,188;31;145;78;92;179;196;81;90;40;165;185;106;178;138;14;144;62;9;148;102;49;52;55;57;129;2;152;97;1;101;100;53;180;154;135;70;127;123;162;149;131;65;116;43;184;190;10;177;54;48;160;34;146;22;18;108;69;159;181;42;5;41;193;139;68;140;93;117;143;183;89;186;23;137;0;46;115;59;118;51;151;133;176;80;79;63;94;189;26;86;75;120;44;25;16;171;175;113;56,2153965519837013249,0.000000
greedy_intra:nodes_start:greedy,189,71945,22885,49060,1,0,189;94;124;148;102;49;178;106;52;55;57;92;129;2;120;44;25;16;171;175;113;56;31;78;145;179;196;81;90;185;40;165;138;14;144;62;9;15;114;186;89;183;23;137;176;80;151;162;123;149;65;116;43;184;177;54;48;160;34;146;22;18;108;69;159;181;42;5;41;193;139;68;140;93;117;143;0;46;115;59;118;51;133;79;63;180;135;70;154;158;53;121;100;26;86;75;101;1;97;152,584851583019319680,0.000000
greedy_intra:nodes_start:greedy,190,72214,24115,48099,1,0,190;10;177;54;48;34;160;181;42;146;22;18;108;69;159;41;193;139;68;46;115;118;59;116;65;43;184;35;131;149;123;162;151;133;51;0;117;143;183;89;23;137;176;80;79;63;94;124;152;97;1;101;2;120;82;129;57;92;55;52;49;102;148;9;62;144;14;138;178;106;185;165;40;90;81;196;179;145;78;31;56;113;175;171;16;25;44;75;86;26;100;121;53;180;154;135;70;127;112;4,6464654528360993482,0.000999
greedy_intra:nodes_start:greedy,191,72529,23490,49039,1,0,191;193;41;5;42;181;159;69;108;18;22;146;34;160;48;54;177;10;190;84;184;43;116;65;149;123;127;162;151;133;135;70;154;180;53;121;100;26;86;75;44;25;16;171;175;113;56;31;78;145;179;196;81;90;40;165;185;106;178;138;14;144;62;9;148;102;49;52;55;92;57;129;82;120;2;101;1;97;152;124;94;63;79;80;176;137;23;186;89;183;143;117;0;51;118;59;115;46;68;139,5036283550175693443,0.000000
greedy_intra:nodes_start:greedy,192,72789,23609,49180,1,0,192;42;5;41;193;139;68;140;93;117;143;183;89;186;23;137;176;80;79;63;94;124;152;97;1;101;2;120;82;129;57;92;55;52;49;102;148;9;62;144;14;138;178;106;185;165;40;90;81;196;179;145;78;31;56;113;175;171;16;25;44;75;86;26;100;121;53;180;154;135;70;127;123;162;133;151;51;0;46;115;118;59;116;65;43;184;190;10;177;54;48;160;34;146;22;18;108;69;159;181,8288801979803268464,0.000000
greedy_intra:nodes_start:greedy,193,71947,23578,48369,1,0,193;139;68;46;115;59;118;51;0;117;143;183;89;186;23;137;176;80;79;63;94;124;152;97;1;101;2;120;82;129;57;92;55;52;49;102;148;9;62;144;14;138;178;106;185;165;40;90;81;196;179;145;78;31;56;113;175;171;16;25;44;75;86;26;100;121;53;180;154;70;135;133;151;162;127;123;149;65;116;43;184;84;4;190;10;177;54;48;160;34;146;22;18;108;69;159;181;42;5;41,6286771378972447723,0.000000
greedy_intra:nodes_start:greedy,194,72641,23748,48893,1,0,194;127;123;162;133;151;149;131;65;116;43;184;190;10;177;54;48;160;34;146;22;18;108;69;159;181;42;5;41;193;139;68;46;115;59;118;51;0;117;143;183;89;186;23;137;176;80;79;63;94;124;152;97;1;101;2;120;82;129;57;92;55;52;49;102;148;9;62;144;14;138;178;106;185;165;40;90;81;196;179;145;78;31;56;113;175;171;16;25;44;75;86;26;100;121;180;53;154;70;135,1736926512735881657,0.000000
greedy_intra:nodes_start:greedy,195,71734,23301,48433,1,0,195;181;34;160;48;54;177;10;190;4;84;184;42;43;116;65;149;123;127;162;151;133;135;70;154;180;53;121;100;26;86;75;44;25;16;171;175;113;56;31;78;145;179;196;81;90;40;165;185;106;178;138;14;144;62;9;148;102;49;52;55;92;57;129;82;120;2;101;1;97;152;124;94;63;79;80;176;137;23;186;89;183;143;117;0;51;118;59;115;46;68;139;41;193;159;69;108;18;22;146,7276077752874923962,0.000000
greedy_intra:nodes_start:greedy,196,72377,23517,48860,1,0,196;81;90;40;165;185;106;178;138;14;144;62;9;148;102;49;52;55;57;129;92;179;145;78;82;2;152;97;1;101;100;53;180;154;135;70;127;123;162;149;131;65;116;43;184;190;177;54;48;160;34;146;22;18;108;69;159;181;42;5;41;193;139;68;140;93;117;143;183;89;186;23;137;0;46;115;59;118;51;151;133;176;80;79;63;94;189;26;86;75;120;44;25;16;171;175;113;56;31;157,8910823223660352198,0.000000
greedy_intra:nodes_start:greedy,197,72970,23867,49103,1,0,197;46;68;139;193;41;5;42;181;159;69;108;18;22;146;34;160;48;54;177;10;190;84;184;43;116;65;149;123;127;162;151;133;135;70;154;180;53;121;100;26;86;75;44;25;16;171;175;113;56;31;78;145;179;196;81;90;40;165;185;106;178;138;14;144;62;9;148;102;49;52;55;92;57;129;82;120;2;101;1;97;152;124;94;63;79;80;176;137;23;186;89;183;143;117;0;51;118;59;115,4957038253103155079,0.000000
greedy_intra:nodes_start:greedy,198,72216,23377,48839,1,0,198;46;115;59;118;51;0;117;143;183;89;186;23;137;176;80;79;63;94;124;152;97;1;101;2;120;82;129;57;92;55;52;49;102;148;9;62;144;14;138;178;106;185;165;40;90;81;196;179;145;78;31;56;113;175;171;16;25;44;75;86;26;100;121;53;180;154;70;135;133;151;162;127;123;149;65;116;43;184;84;4;190;10;177;54;48;160;34;146;22;18;108;69;159;181;42;5;41;193;139,7609506984536010904,0.000000
greedy_intra:nodes_start:greedy,199,72263,23490,48773,1,0,199;139;68;46;115;59;118;51;0;117;143;183;89;186;23;137;176;80;79;63;94;124;152;97;1;101;2;120;82;129;57;92;55;52;49;102;148;9;62;144;14;138;178;106;185;165;40;90;81;196;179;145;78;31;56;113;175;171;16;25;44;75;86;26;100;121;53;180;154;70;135;133;151;162;127;123;149;65;116;43;184;84;190;10;177;54;48;160;34;181;42;5;41;193;159;146;22;18;108;69,341801767638815373,0.000000
greedy_intra:edges_start:random,0,257062,152786,104276,1,0,197;147;61;50;82;103;169;124;32;14;181;43;30;48;130;155;117;196;183;94;84;176;112;8;100;119;175;66;108;195;28;110;186;40;51;99;31;102;45;29;171;136;97;47;25;38;24;128;153;79;125;179;21;132;126;135;146;159;105;185;62;129;142;134;189;150;71;72;138;88;180;167;122;144;168;22;101;69;37;166;178;187;157;9;131;170;83;12;140;77;2;63;160;172;64;67;92;154;127;42,8276712092888314467,0.000971
greedy_intra:edges_start:random,1,272826,169804,103022,1,0,11;4;168;180;140;18;133;101;186;49;111;161;196;22;62;24;50;86;115;199;88;70;48;30;126;175;64;74;136;187;191;8;132;73;114;41;188;91;144;31;3;149;174;59;83;103;169;16;20;110;141;130;27;194;185;34;69;77;178;52;100;158;190;76;170;142;72;145;85;35;67;45;28;151;192;150;56;29;183;119;23;21;123;129;116;7;122;14;38;42;160;156;26;164;153;117;104;176;137;107,1514963151746749911,0.000000
greedy_intra:edges_start:random,2,257338,160725,96613,2,1,160;20;4;54;77;10;26;66;127;27;115;156;45;124;17;24;95;158;107;145;112;164;138;146;1;83;11;12;172;182;31;191;88;19;93;140;129;167;75;49;57;60;179;155;30;193;181;169;180;170;52;130;143;118;189;21;0;141;106;84;176;197;34;198;175;153;139;163;67;65;126;8;166;192;86;38;97;28;89;187;113;123;102;117;116;183;7;73;165;154;63;159;80;174;61;59;90;98;9;76,6791951694277908540,0.000000
greedy_intra:edges_start:random,3,264263,171449,92814,2,1,167;98;31;41;121;13;124;159;130;71;103;126;76;90;142;197;34;168;158;102;163;25;16;101;180;81;99;120;185;63;113;187;5;186;93;96;69;170;88;164;165;182;147;144;196;57;33;22;169;23;108;193;64;42;133;14;58;3;183;39;51;19;143;160;21;122;61;28;177;175;83;0;117;155;62;114;2;11;95;135;115;7;116;66;48;100;176;192;59;137;112;68;10;74;162;179;32;72;17;20,1374444174640298546,0.001029
greedy_intra:edges_start:random,4,270621,159847,110774,1,0,8;64;168;57;137;86;109;43;170;174;165;99;31;148;42;10;15;186;56;133;11;46;44;13;32;160;118;108;122;157;105;50;182;95;132;27;156;76;179;116;114;183;40;61;150;110;47;130;104;17;188;155;181;153;78;142;0;41;166;119;1;60;51;147;125;178;88;140;62;66;14;20;96;138;192;141;77;169;127;23;12;193;161;195;163;92;48;117;55;185;98;75;26;194;33;28;126;65;74;107,7018214335704715625,0.000000
greedy_intra:edges_start:random,5,256363,164777,91586,2,1,174;185;0;142;190;55;36;128;75;151;152;118;92;104;78;10;107;63;14;80;172;25;13;168;62;1;154;179;41;139;187;42;123;176;73;109;194;143;68;146;112;170;193;116;161;34;23;9;8;134;82;178;90;129;52;6;97;126;54;38;2;160;33;77;157;141;35;155;100;114;21;57;130;51;108;87;89;197;183;37;24;50;192;148;81;105;147;17;182;127;153;133;120;70;117;136;59;49;18;96,8958931647235328683,0.000000
greedy_intra:edges_start:random,6,249932,150820,99112,1,0,62;169;99;153;79;6;141;125;198;159;111;76;25;130;104;123;166;34;80;179;184;98;143;60;180;31;65;3;149;20;91;78;8;127;71;58;56;47;12;49;193;100;64;69;191;41;17;128;155;2;15;158;106;114;0;147;77;174;108;46;39;152;22;154;53;190;44;172;83;136;89;10;110;151;132;52;14;57;88;11;48;54;138;161;21;165;63;51;146;36;18;135;45;5;139;23;9;156;109;170,2494968188570430341,0.000000
greedy_intra:edges_start:random,7,250019,154245,95774,2,1,83;16;195;145;11;154;93;142;4;188;137;27;90;20;42;22;35;47;129;176;8;77;37;107;50;29;128;31;147;79;100;39;122;34;198;51;78;74;196;62;63;105;134;81;156;17;167;60;135;179;133;111;124;103;5;6;49;163;125;86;193;130;0;164;169;25;117;23;36;181;72;66;114;150;26;116;80;136;102;162;118;120;2;24;173;91;138;174;184;189;41;108;97;75;38;119;143;148;180;183,7684240955263139626,0.000000
greedy_intra:edges_start:random,8,272817,173895,98922,2,1,123;147;189;146;120;80;161;94;33;195;20;174;98;30;134;197;180;70;14;105;84;106;13;27;156;58;124;109;32;65;29;155;176;190;119;55;159;157;0;90;1;116;15;75;153;56;34;135;170;60;16;23;78;10;46;48;50;104;110;163;43;36;18;186;81;21;183;35;103;158;142;71;168;12;138;140;99;121;38;191;74;97;199;57;37;63;2;72;111;196;167;162;89;141;54;151;117;125;86;5,8917067862317020706,0.000970
greedy_intra:edges_start:random,9,264650,170370,94280,1,0,144;3;174;9;36;175;70;91;59;163;63;148;169;74;13;60;25;23;168;124;160;156;77;101;129;157;58;66;56;12;137;0;138;195;32;65;140;176;73;88;146;119;108;178;22;79;100;111;143;141;8;81;15;92;134;30;39;126;10;104;159;38;37;194;43;20;115;151;184;71;62;90;64;75;166;48;145;135;133;18;94;180;11;170;116;54;125;72;103;40;189;7;55;4;97;51;76;6;85;139,2361838132724202534,0.000000
greedy_intra:edges_start:random,10,267095,165781,101314,1,0,52;121;85;157;144;155;153;3;50;18;98;53;199;182;169;180;143;146;9;23;24;192;111;142;66;109;138;105;15;38;65;154;91;28;42;118;35;49;188;95;61;106;39;36;59;173;47;92;25;70;110;162;185;172;197;88;147;94;2;181;196;132;4;45;96;0;83;31;62;103;148;58;76;71;133;198;26;167;190;72;60;145;191;101;156;117;84;40;27;123;116;33;55;44;46;129;119;170;93;149,5172987774281128132,0.000000
greedy_intra:edges_start:random,11,267518,163360,104158,1,0,149;182;158;11;83;137;22;15;24;55;152;89;88;126;10;156;141;73;3;190;150;129;82;192;46;143;79;45;61;134;80;40;13;91;68;119;19;121;69;100;14;31;177;186;9;94;184;174;168;197;62;60;12;75;34;107;154;111;139;72;128;113;171;117;138;77;6;17;172;142;123;110;155;39;95;108;176;66;116;193;2;125;135;153;118;28;52;162;38;36;187;131;32;102;161;189;42;21;127;183,576382988039423071,0.000000
greedy_intra:edges_start:random,12,263664,174627,89037,3,2,55;171;78;143;197;51;9;182;152;199;38;21;154;135;120;67;114;75;63;91;141;44;186;95;165;58;125;118;147;159;90;18;81;177;131;193;0;34;98;52;175;42;127;164;93;79;7;89;45;115;24;188;85;134;169;29;84;92;43;76;23;161;116;119;173;151;113;87;48;73;80;108;137;82;190;86;170;172;166;53;103;144;183;106;112;128;12;196;105;14;100;56;157;132;189;139;156;54;158;178,8695838567621975522,0.000000
greedy_intra:edges_start:random,13,262816,160371,102445,2,1,48;88;168;19;50;4;60;98;121;172;40;82;132;74;124;198;86;146;84;13;81;58;108;153;62;104;11;43;49;189;69;154;31;64;52;71;26;188;83;122;135;105;116;7;68;103;162;25;63;42;141;1;165;45;169;149;140;17;184;85;53;14;24;137;32;186;61;145;106;46;110;72;113;128;38;65;73;148;194;142;91;35;47;133;21;23;78;27;12;130;177;89;77;138;99;107;55;123;41;22,5707460308646988490,0.000000
greedy_intra:edges_start:random,14,246320,156647,89673,3,2,184;16;130;61;88;181;11;65;32;186;26;43;193;12;160;89;86;54;185;144;162;22;95;116;93;0;51;141;180;167;57;92;62;38;13;41;105;29;49;109;113;176;177;97;28;173;23;178;10;111;84;123;74;85;40;131;33;114;37;189;48;174;67;142;125;146;18;108;96;73;94;168;145;6;80;52;119;5;121;56;35;136;1;24;129;140;58;170;42;9;133;198;139;34;112;149;172;115;15;55,6750126403287020781,0.001038
greedy_intra:edges_start:random,15,276855,181779,95076,1,0,4;192;129;118;115;99;104;95;17;39;61;9;49;68;38;73;181;92;82;35;124;175;133;189;164;83;12;45;0;149;42;176;98;24;93;156;134;19;78;191;36;106;123;58;122;113;162;158;40;138;135;43;53;64;96;47;25;110;177;50;165;160;146;1;54;154;5;32;108;71;70;90;161;142;182;199;131;184;8;14;150;186;166;116;145;85;178;10;196;22;141;143;180;171;197;174;172;112;16;102,3736125386791059497,0.000000
greedy_intra:edges_start:random,16,234480,144370,90110,2,1,38;31;23;109;44;70;26;199;192;111;83;37;180;16;191;181;66;175;92;100;106;102;132;87;113;155;130;117;3;46;126;150;22;48;183;63;197;148;47;79;81;32;58;187;77;59;78;114;167;185;163;177;108;139;131;96;80;94;179;165;193;74;105;135;65;68;4;89;71;17;118;184;35;198;18;153;86;164;95;54;14;122;178;50;152;140;28;34;134;124;104;127;174;99;25;56;51;154;144;15,5535507512500932857,0.000963
greedy_intra:edges_start:random,17,257160,162865,94295,1,0,60;34;120;97;40;121;104;36;53;46;194;66;38;5;109;28;114;115;62;14;170;112;175;50;39;77;75;8;132;18;0;111;117;74;72;113;54;85;198;1;159;17;19;184;143;37;79;84;162;139;95;55;191;166;88;130;70;48;47;30;187;81;128;11;177;13;98;127;35;196;63;91;52;20;10;3;155;9;86;89;90;141;105;4;78;99;131;135;65;124;57;7;171;157;189;42;118;186;123;181,6135233447120646287,0.000000
greedy_intra:edges_start:random,18,268910,172252,96658,1,0,160;159;76;119;148;107;80;194;73;129;176;58;24;48;1;103;49;34;185;149;182;26;17;170;127;83;122;123;175;128;186;172;11;136;180;147;40;163;171;167;75;6;139;161;138;152;154;7;3;57;181;41;104;144;69;164;70;12;50;105;36;137;183;85;66;59;42;117;63;100;22;90;38;99;52;14;79;187;64;199;157;32;184;124;142;191;98;21;108;118;67;115;82;20;130;53;188;162;96;197,9081196644369168342,0.000000
greedy_intra:edges_start:random,19,250030,146154,103876,1,0,121;188;14;31;52;3;104;100;129;58;168;115;147;99;71;53;109;108;23;125;38;176;84;195;88;191;198;45;43;11;123;189;92;107;154;114;24;18;177;118;80;79;64;1;55;185;194;152;126;105;182;50;85;145;113;6;9;87;135;36;128;62;10;97;54;159;33;156;21;138;94;106;61;134;111;187;117;169;19;86;136;57;127;173;8;170;74;175;165;73;78;77;65;130;110;179;174;181;162;167,5720356164109767130,0.000000
greedy_intra:edges_start:random,20,257724,161946,95778,1,0,13;164;39;146;34;185;74;90;123;113;137;91;134;86;81;194;177;174;27;188;29;4;158;92;80;115;103;67;182;171;143;167;154;1;83;175;22;43;162;186;131;111;145;141;181;129;25;63;45;11;21;170;199;165;198;189;152;119;9;84;114;55;196;58;68;138;49;51;15;12;132;61;78;3;94;30;169;100;70;126;33;82;133;89;121;140;0;130;125;76;161;197;40;155;16;93;179;26;24;36,7226695321522194633,0.000000
greedy_intra:edges_start:random,21,278914,175739,103175,3,2,130;11;95;30;62;51;75;116;173;2;47;182;24;177;17;8;91;157;126;53;170;18;71;44;23;184;191;192;108;167;36;115;134;1;20;29;159;69;25;16;178;135;76;58;120;60;155;147;197;119;140;27;153;73;145;169;92;26;102;32;162;54;125;64;166;103;174;31;181;112;68;175;110;89;86;67;45;13;107;104;9;164;81;70;187;56;122;194;160;90;144;80;189;15;117;158;35;132;199;124,2927589162244074367,0.000000
greedy_intra:edges_start:random,22,264230,162161,102069,1,0,69;187;24;0;173;195;120;38;118;160;159;122;45;53;40;147;133;16;33;89;132;197;90;121;148;111;93;142;34;198;87;112;154;192;114;80;151;85;162;4;30;186;177;104;91;77;35;23;168;193;155;17;189;140;18;11;47;125;117;163;25;49;66;135;97;146;119;79;3;144;105;10;158;150;71;141;95;67;41;26;131;196;100;138;48;22;58;136;59;9;8;167;86;166;156;74;75;72;172;51,6909001692338342605,0.000000
greedy_intra:edges_start:random,23,274922,174087,100835,1,0,129;166;119;178;147;9;82;157;54;149;38;195;107;57;97;154;156;176;101;28;100;142;6;85;81;45;140;159;173;137;76;187;158;93;15;10;88;86;170;189;112;181;98;55;8;177;62;87;60;3;162;114;74;7;190;50;21;160;198;34;37;18;155;150;53;26;186;44;127;0;31;67;126;163;123;180;1;90;69;138;39;169;30;22;179;14;84;48;35;152;61;148;128;83;104;120;77;125;167;92,1504094329395444153,0.000999
greedy_intra:edges_start:random,24,268403,165361,103042,1,0,25;175;93;12;172;184;138;128;38;110;69;106;46;15;83;37;66;79;7;73;70;195;65;166;11;14;126;167;10;63;100;76;72;164;197;198;186;123;165;187;5;74;103;41;125;60;36;71;31;39;108;1;23;131;99;77;160;136;44;177;82;49;84;152;146;155;156;52;169;32;78;104;50;144;127;194;91;80;142;68;53;2;28;183;59;19;97;51;192;107;191;141;133;102;9;34;61;196;33;150,8810242067608454709,0.000000
greedy_intra:edges_start:random,25,259930,160335,99595,1,0,183;51;6;76;157;35;32;198;72;18;64;154;139;171;50;46;153;45;37;127;55;19;82;57;174;40;96;133;69;59;125;128;186;98;65;43;34;77;175;61;161;17;106;163;126;29;146;24;184;102;136;164;165;25;12;131;155;13;49;21;143;60;138;74;108;168;0;192;129;195;152;101;120;15;110;3;187;94;9;47;85;115;177;68;91;196;80;14;27;151;111;116;122;39;83;169;170;135;149;58,7032281180895877334,0.000000
greedy_intra:edges_start:random,26,246082,151217,94865,1,0,112;117;8;13;91;154;152;133;16;129;179;131;166;151;147;96;0;62;36;148;137;2;122;20;182;186;47;167;134;178;5;193;15;54;59;102;138;67;161;121;116;19;195;103;101;109;108;124;76;168;113;3;94;71;181;160;82;111;18;197;77;132;158;42;87;84;150;48;177;164;61;50;107;175;120;165;21;198;159;80;199;24;89;64;86;26;23;136;55;162;190;28;135;119;46;146;75;79;40;141,6955972512726821473,0.000000
greedy_intra:edges_start:random,27,266925,172521,94404,2,1,60;87;63;45;175;64;197;50;141;97;82;123;27;20;48;171;4;131;188;138;128;115;11;59;199;95;139;114;1;58;149;111;68;84;140;145;118;170;196;5;22;159;46;134;31;144;54;91;168;108;189;43;65;62;135;193;164;157;70;153;150;191;3;6;94;106;190;151;83;178;185;165;121;35;33;53;155;127;47;37;102;67;74;2;177;66;136;72;152;86;14;186;29;34;133;179;129;163;39;174,7855564681357260676,0.000000
greedy_intra:edges_start:random,28,262001,165402,96599,1,0,71;181;132;107;131;128;137;192;89;67;169;177;59;0;55;195;46;197;116;47;165;95;19;178;139;40;114;60;7;154;97;146;56;100;69;186;29;54;135;53;193;141;183;142;42;187;38;163;2;176;191;167;82;151;33;75;86;37;36;61;164;83;25;44;8;90;129;52;105;104;115;91;190;4;199;31;62;98;189;12;64;101;109;153;113;127;16;78;43;58;140;161;158;168;150;155;10;66;174;120,5996215499798352068,0.000000
greedy_intra:edges_start:random,29,261743,163175,98568,1,0,101;51;110;14;41;95;105;183;72;44;151;26;142;24;123;64;69;156;121;49;28;47;181;53;3;21;54;124;71;161;34;153;143;77;99;79;103;13;45;17;61;16;56;86;197;83;155;75;163;40;94;109;1;42;177;118;180;165;107;27;176;190;74;6;39;125;81;11;38;37;112;23;138;31;36;131;7;127;198;129;85;185;149;48;84;195;104;159;126;140;182;43;100;90;128;5;12;117;119;120,234558380409653677,0.000000
greedy_intra:edges_start:random,30,248378,149124,99254,1,0,129;99;78;39;24;51;142;174;61;125;15;153;53;169;74;165;151;10;173;158;138;9;152;18;68;1;75;33;62;77;188;117;29;97;162;141;192;101;157;22;41;93;36;100;17;47;37;25;178;48;180;171;63;58;132;116;112;121;102;134;11;146;66;8;54;194;177;0;133;38;111;115;161;148;139;195;45;163;35;85;76;130;118;96;181;88;7;172;137;2;59;30;69;193;23;135;94;72;166;43,8485748360953036234,0.001024
greedy_intra:edges_start:random,31,263348,163658,99690,2,1,150;184;34;26;197;92;124;157;25;93;60;67;20;116;82;102;149;87;75;100;178;143;141;8;6;3;177;77;43;151;181;71;44;187;52;173;9;166;56;148;11;198;103;164;195;73;159;32;36;48;190;193;123;83;41;196;16;186;108;110;182;76;153;163;152;89;58;135;45;23;78;57;130;104;27;142;169;126;133;185;183;162;39;97;22;155;95;49;127;136;15;7;134;65;109;99;80;72;138;168,6628646044481068075,0.000000
greedy_intra:edges_start:random,32,237245,149287,87958,1,0,115;81;31;0;162;124;82;154;151;161;166;195;56;42;199;1;30;50;198;37;70;88;9;172;65;89;142;22;104;186;52;128;129;34;101;106;100;54;133;117;114;85;60;153;76;141;173;16;2;194;191;160;102;3;59;57;139;84;78;177;126;196;119;61;185;178;157;158;74;127;96;123;180;14;187;105;143;80;137;49;164;86;159;45;152;63;110;122;53;125;155;18;190;15;5;4;55;33;75;92,384438556438268298,0.000000
greedy_intra:edges_start:random,33,279313,171918,107395,3,2,44;134;142;177;38;90;55;31;175;81;8;133;73;158;85;109;64;169;87;5;16;160;145;171;119;26;188;77;120;144;168;67;130;192;74;1;82;33;48;178;35;191;57;141;76;181;197;184;45;11;196;89;165;122;95;121;110;59;18;170;71;12;22;58;96;23;47;162;61;70;140;132;78;166;9;60;190;163;40;128;68;161;24;83;118;125;103;159;86;164;131;7;155;113;51;29;174;17;99;154,9015190445661083926,0.000000
greedy_intra:edges_start:random,34,278171,177939,100232,2,1,166;22;176;9;91;114;151;125;197;171;130;19;199;100;172;75;161;25;79;181;95;142;66;97;12;158;7;77;109;94;179;85;51;118;13;10;124;155;167;93;27;49;131;152;70;103;46;98;42;21;123;87;78;60;111;194;170;39;104;121;99;96;116;17;83;147;18;188;6;144;164;108;187;113;82;69;122;184;55;146;40;190;56;74;175;71;63;80;89;196;154;162;34;110;67;126;3;23;73;120,2133744512293687276,0.000000
greedy_intra:edges_start:random,35,275333,169624,105709,2,1,188;94;63;56;194;45;86;17;30;50;140;197;128;7;46;134;61;29;104;64;155;101;139;106;114;143;169;77;126;60;22;176;156;92;135;186;58;180;18;76;9;146;131;38;147;44;199;5;99;165;57;129;8;152;124;175;24;142;67;167;158;182;79;97;195;11;149;116;12;185;141;130;83;163;157;82;47;87;71;193;28;105;36;161;150;35;196;98;190;117;112;103;62;81;110;171;144;181;178;70,4952464667395320705,0.000000
greedy_intra:edges_start:random,36,255024,159485,95539,5,4,154;138;114;175;54;30;190;185;71;126;23;39;86;122;38;119;156;116;186;41;117;51;127;90;35;43;4;184;80;140;72;148;168;187;100;84;18;101;92;14;24;8;123;22;10;27;40;44;132;157;42;37;56;195;174;25;55;166;50;176;150;198;49;118;21;32;163;124;6;106;189;161;57;82;99;93;180;111;64;62;3;11;12;76;139;77;107;26;13;66;110;34;160;36;105;120;69;96;192;94,4689774513817187520,0.001012
greedy_intra:edges_start:random,37,252395,153552,98843,2,1,153;163;17;65;21;151;71;72;172;185;169;112;134;96;171;190;43;177;179;3;126;49;107;1;125;51;67;193;101;100;76;164;19;26;44;165;129;197;104;18;115;99;168;174;25;105;12;103;192;5;0;30;194;170;7;14;176;10;34;133;81;128;139;198;39;191;159;138;146;184;144;73;130;156;142;94;6;50;111;113;90;89;166;82;75;178;55;59;4;60;45;158;2;56;188;58;74;120;41;31,4214074090599956780,0.000000
greedy_intra:edges_start:random,38,269691,176436,93255,2,1,4;129;113;195;183;26;17;5;1;33;104;172;66;175;199;29;196;74;48;107;160;24;62;73;36;51;170;37;177;96;93;31;44;188;127;57;30;174;103;102;132;193;121;163;173;166;145;23;86;21;12;39;78;154;80;156;19;123;71;98;40;95;64;179;45;165;7;148;105;140;138;187;180;0;150;90;58;151;9;27;157;63;92;155;115;110;53;139;22;162;68;119;59;143;75;25;32;131;10;55,7055815507961697794,0.000000
greedy_intra:edges_start:random,39,270032,173338,96694,2,1,54;172;145;21;163;130;36;78;158;113;10;131;6;112;144;95;25;66;126;166;140;32;35;147;77;44;180;183;128;85;199;92;33;18;13;186;162;39;89;22;187;51;75;64;42;37;132;157;0;127;49;171;188;137;84;16;176;165;72;59;1;58;90;164;15;151;80;115;99;88;174;53;122;198;153;31;108;155;182;192;30;17;12;111;46;67;121;7;52;27;154;24;20;48;107;120;86;104;98;118,3741758902544371882,0.000000
greedy_intra:edges_start:random,40,266457,174926,91531,1,0,102;185;197;187;114;107;45;68;4;121;150;33;108;194;182;41;147;127;159;70;142;7;34;169;35;16;133;180;99;154;49;198;8;13;157;146;137;47;63;97;17;186;183;112;119;126;53;25;145;166;79;118;101;96;86;15;152;139;175;40;134;179;65;129;26;123;48;153;1;5;62;59;98;191;52;109;82;177;24;69;189;66;105;149;193;190;164;195;199;71;21;90;19;111;136;78;148;72;18;88,1538680314293607760,0.000000
greedy_intra:edges_start:random,41,254801,163042,91759,2,1,151;198;129;48;43;81;180;146;60;131;51;118;44;178;57;99;8;14;67;102;65;150;86;128;189;169;29;76;186;184;101;0;68;62;97;2;168;22;3;50;133;192;88;63;114;75;34;117;95;35;55;136;145;53;28;130;27;154;135;108;1;66;84;175;92;197;127;199;32;185;157;165;58;116;174;188;83;137;18;107;140;106;158;149;104;152;52;141;6;162;30;177;125;193;172;159;25;176;161;105,5191199319691623955,0.001356
greedy_intra:edges_start:random,42,253848,161802,92046,1,0,193;64;1;6;142;168;92;124;129;93;73;40;170;77;90;158;111;134;37;38;155;173;198;72;146;86;8;115;106;116;156;184;100;166;148;36;107;55;52;59;87;157;171;175;26;50;41;105;62;139;137;12;88;71;160;165;49;69;48;172;118;14;78;178;180;199;104;82;152;99;176;183;25;114;22;33;79;65;0;15;97;130;164;30;53;119;29;179;21;89;181;194;4;135;3;68;67;144;83;163,6406334803610529687,0.000000
greedy_intra:edges_start:random,43,264874,165167,99707,1,0,175;96;157;161;80;138;25;49;6;29;158;50;17;144;58;186;176;98;67;14;121;173;54;169;4;73;30;28;95;102;81;179;156;88;2;32;195;97;46;91;82;62;56;83;122;108;61;181;78;99;12;20;51;199;112;86;107;71;123;148;141;89;10;70;133;143;44;136;0;118;127;3;178;160;92;172;109;119;188;76;117;110;35;90;134;23;16;15;37;182;131;146;84;22;114;191;183;94;187;145,7835674553090770974,0.000000
greedy_intra:edges_start:random,44,261857,165841,96016,2,1,99;179;143;26;74;123;156;75;64;106;89;198;120;171;37;194;176;62;91;177;187;174;108;7;42;35;191;48;25;34;181;155;82;195;23;53;59;90;6;80;20;32;160;29;8;76;135;1;19;28;21;184;167;97;146;183;142;128;94;112;147;68;88;161;65;15;103;93;116;16;149;101;144;71;11;72;162;84;69;153;165;10;163;110;119;107;158;133;124;152;36;131;118;141;13;168;77;115;134;117,8892737440002470727,0.000000
greedy_intra:edges_start:random,45,256484,160845,95639,3,2,150;181;44;162;73;186;132;135;194;126;55;138;17;61;2;74;189;180;198;95;13;185;16;107;105;192;48;45;21;25;163;24;20;66;0;183;42;175;18;27;154;102;152;10;93;109;199;165;39;116;176;68;148;166;179;141;40;119;108;51;89;70;182;77;63;106;195;191;127;90;65;110;58;14;41;69;75;72;149;11;26;151;142;156;144;54;131;177;87;6;173;147;62;35;79;130;31;115;99;96,5244550016735449347,0.000000
greedy_intra:edges_start:random,46,265329,168859,96470,1,0,72;171;53;141;37;58;110;195;153;155;131;73;29;190;143;63;138;166;86;16;174;92;83;24;137;157;132;148;168;169;68;170;49;75;146;33;126;186;71;10;0;2;39;5;121;41;61;156;21;28;108;101;31;9;99;134;67;51;76;88;196;40;177;97;133;90;194;118;78;112;48;59;184;111;162;151;4;27;115;183;60;124;17;152;20;62;128;176;197;193;52;103;122;130;185;188;105;189;57;23,5608105827956604063,0.000000
greedy_intra:edges_start:random,47,276650,174284,102366,1,0,51;158;54;136;83;49;4;92;21;27;131;44;193;57;39;102;84;187;106;42;79;167;7;169;45;69;40;109;66;37;177;112;91;80;95;134;146;191;22;33;11;87;166;153;175;176;6;56;25;108;73;142;141;132;197;99;188;147;152;70;88;97;82;0;47;120;17;128;178;168;46;28;182;140;55;160;181;180;59;71;194;115;150;144;163;101;74;24;119;9;58;13;148;130;114;161;78;118;145;199,5985207963124385726,0.001009
greedy_intra:edges_start:random,48,264265,163669,100596,5,4,109;4;29;190;32;1;177;152;20;140;69;180;36;178;174;63;24;100;61;193;52;68;143;12;150;44;104;67;175;89;155;95;130;167;148;136;49;62;77;119;156;41;170;162;65;50;195;186;112;114;163;60;113;34;42;22;66;161;64;183;51;168;192;176;147;19;122;93;92;110;26;198;103;35;58;0;28;83;189;79;75;11;6;134;182;138;90;108;166;3;111;71;56;59;101;37;23;33;94;160,205910555418960917,0.000000
greedy_intra:edges_start:random,49,252219,151129,101090,2,1,148;48;186;192;93;147;98;31;6;66;136;8;194;83;53;24;43;60;84;185;33;173;118;72;89;64;74;159;87;143;92;116;65;37;100;108;154;172;82;25;59;153;88;184;160;188;187;94;180;23;58;129;95;40;199;151;133;56;121;127;119;145;124;155;12;35;166;123;134;139;141;34;109;178;132;46;125;174;54;196;44;16;146;150;110;182;11;15;63;195;114;28;191;2;76;115;131;42;105;1,3511371057788994105,0.001000
greedy_intra:edges_start:random,50,264289,165115,99174,1,0,77;33;98;176;27;4;101;116;83;70;88;150;48;153;121;2;81;158;51;37;139;189;44;25;1;167;7;140;114;132;92;53;5;50;8;155;127;34;181;115;109;35;192;82;12;99;69;118;21;169;183;106;159;54;78;124;17;104;119;123;149;31;156;175;32;145;103;13;58;179;76;161;96;117;97;90;177;125;170;24;19;163;23;133;74;57;148;67;46;162;180;142;195;165;113;39;20;36;52;147,1661446389144407722,0.000000
greedy_intra:edges_start:random,51,254644,156937,97707,1,0,167;121;184;62;74;109;178;191;122;102;63;112;134;147;176;163;157;37;22;78;72;107;138;113;111;38;126;164;94;135;48;159;91;196;105;42;13;123;130;61;2;162;85;173;140;9;106;155;52;170;80;142;161;46;177;66;7;75;194;133;34;124;73;136;154;92;29;197;128;195;59;86;70;51;14;49;50;87;93;198;27;96;81;23;115;25;125;95;187;19;28;156;97;120;57;192;41;153;77;151,3134330310089996586,0.000000
greedy_intra:edges_start:random,52,270181,172900,97281,1,0,32;58;72;106;18;68;92;149;70;61;158;193;5;146;27;15;43;31;19;65;163;47;53;4;179;166;48;192;115;103;95;108;187;67;161;171;155;190;76;151;164;57;118;121;62;52;154;144;69;29;73;12;148;181;189;197;178;38;20;156;145;96;138;54;147;194;42;182;75;33;157;78;183;94;71;41;126;191;195;175;87;17;13;184;180;25;123;34;150;167;2;66;169;97;51;28;114;173;104;6,506976761356906793,0.000000
greedy_intra:edges_start:random,53,265912,169956,95956,2,1,28;164;99;103;179;125;130;153;192;46;159;1;34;52;145;73;6;149;199;181;107;135;98;193;53;100;59;21;45;51;9;83;86;76;154;65;94;163;37;150;77;147;38;27;187;40;57;165;79;36;171;56;106;72;87;166;8;189;118;148;113;10;146;23;102;185;123;82;41;152;0;97;19;42;140;17;139;122;66;71;138;16;137;156;78;170;182;84;68;190;62;129;96;188;58;60;160;121;132;109,641574133874986478,0.001001
greedy_intra:edges_start:random,54,261277,158344,102933,1,0,70;79;92;16;155;134;116;93;51;54;60;36;163;58;18;80;45;142;196;141;44;53;192;118;5;158;156;164;88;13;162;160;127;137;165;126;152;71;21;180;49;23;140;168;43;178;7;78;69;191;40;19;197;147;114;55;159;86;198;64;68;66;65;99;0;29;41;27;9;28;121;33;56;107;61;125;48;105;172;31;175;87;32;190;82;132;139;148;130;124;173;84;100;85;77;176;161;117;12;62,3438712106626995289,0.000000
greedy_intra:edges_start:random,55,261583,165631,95952,3,2,79;57;194;34;100;118;169;166;175;150;98;130;37;17;26;128;162;141;168;177;42;119;199;70;25;86;133;93;9;144;198;123;73;7;146;53;56;135;187;147;80;131;11;16;40;134;66;124;12;28;84;195;139;132;182;178;62;49;192;161;179;136;46;129;33;111;142;85;61;156;94;171;143;95;90;116;15;30;97;103;39;29;23;167;69;68;186;52;153;109;117;112;60;65;3;152;92;106;180;127,4253184491339926712,0.000000
greedy_intra:edges_start:random,56,277303,175963,101340,1,0,170;194;118;80;198;10;21;63;17;114;98;13;152;74;41;130;142;99;32;187;46;50;181;108;53;25;1;42;35;147;8;51;132;123;82;111;34;154;113;110;119;49;134;96;185;58;43;56;102;112;120;62;156;189;59;167;97;126;124;15;83;179;45;38;195;184;131;84;73;163;48;89;3;166;127;87;183;36;86;75;9;20;27;61;174;149;4;121;69;6;151;168;66;22;71;169;14;5;171;162,3475654567943471722,0.000000
greedy_intra:edges_start:random,57,280373,175472,104901,1,0,91;43;22;158;177;73;98;11;27;12;115;174;71;110;39;45;48;28;95;106;134;143;101;160;187;147;191;136;172;181;41;185;65;190;137;38;50;51;199;182;184;168;5;55;97;17;132;183;100;19;165;138;111;198;90;23;108;195;148;150;85;107;173;164;153;118;87;149;133;64;103;197;61;178;176;109;94;25;4;56;82;170;142;33;125;26;155;2;37;29;129;63;32;18;78;123;102;152;84;131,2438080901654473212,0.000000
greedy_intra:edges_start:random,58,261702,162242,99460,4,3,7;0;9;121;99;132;156;199;162;91;52;170;45;30;110;92;145;51;102;191;72;70;160;161;198;169;71;108;109;6;149;75;136;56;84;37;117;26;139;154;66;159;14;73;19;178;27;32;1;104;112;128;38;25;143;171;131;165;78;142;188;62;15;189;173;12;48;166;181;11;69;127;195;50;23;2;42;58;39;175;105;120;152;125;85;41;185;10;190;179;68;147;28;151;94;81;87;119;135;140,7349792777980543681,0.000999
greedy_intra:edges_start:random,59,267570,165152,102418,2,1,33;134;165;102;21;64;164;103;119;66;41;98;45;22;199;147;1;133;16;87;167;82;78;32;145;179;99;105;193;112;176;131;128;109;110;25;115;74;7;54;190;101;12;11;191;48;195;187;30;91;73;113;36;93;189;85;125;34;52;163;111;75;26;80;118;31;174;84;158;171;56;186;50;92;49;19;170;61;172;121;14;59;71;142;108;129;40;46;143;43;198;154;197;17;181;44;169;24;104;122,5582094567334819447,0.000000
greedy_intra:edges_start:random,60,264563,167995,96568,4,3,79;124;17;81;123;150;27;18;136;196;59;66;118;175;12;32;102;151;111;152;3;15;98;49;128;47;40;156;159;183;41;145;13;167;43;69;38;162;83;75;103;158;5;105;195;37;149;132;36;114;85;70;90;80;35;58;20;88;71;77;148;133;185;139;23;155;119;131;146;54;63;91;113;121;193;39;55;76;14;107;169;89;45;135;168;138;190;194;22;65;31;95;197;141;86;64;21;172;115;30,8818115822198967511,0.000000
greedy_intra:edges_start:random,61,262377,160096,102281,1,0,188;121;143;67;175;135;40;126;142;184;118;96;15;134;87;6;182;137;22;149;180;42;114;186;128;61;147;32;26;157;3;62;12;197;72;187;113;168;106;66;198;98;85;71;115;140;190;81;55;150;1;28;185;101;25;165;111;53;65;46;68;20;23;80;151;30;110;41;194;156;179;74;167;141;8;11;196;37;95;117;164;155;181;58;77;154;73;17;44;69;4;97;144;50;48;56;163;92;199;172,8881377280891346363,0.001017
greedy_intra:edges_start:random,62,263079,172277,90802,3,2,150;46;65;127;52;11;49;134;135;117;133;131;90;114;129;139;80;3;30;185;76;25;71;37;144;121;101;184;162;10;125;35;47;41;82;16;40;115;105;118;26;167;19;124;176;179;147;6;160;132;166;7;126;44;151;34;96;88;77;180;8;51;20;186;70;33;18;182;119;84;2;5;108;29;198;86;58;171;50;104;15;122;48;39;143;165;136;148;128;79;42;199;81;9;53;93;170;100;111;85,6710044969383705946,0.000000
greedy_intra:edges_start:random,63,248033,161612,86421,1,0,14;28;179;124;148;23;5;78;154;79;195;135;178;184;186;155;180;166;187;173;100;108;120;144;24;60;68;3;36;156;146;31;72;97;191;153;119;174;116;112;2;165;47;117;37;158;16;190;51;41;57;122;26;45;73;0;193;90;152;40;58;55;171;35;94;129;32;25;99;131;137;127;141;65;4;52;19;63;164;126;150;118;12;192;110;113;92;39;53;185;115;80;198;30;6;106;143;93;11;199,6284526634502348260,0.000000
greedy_intra:edges_start:random,64,254721,162030,92691,4,3,129;34;30;70;31;43;76;28;58;187;131;87;52;8;89;128;190;13;185;102;176;124;144;95;108;183;12;65;157;66;145;120;0;84;167;104;133;68;75;49;97;115;79;126;48;155;160;171;110;21;3;143;105;50;174;172;53;80;10;69;195;83;123;130;169;125;78;25;88;137;164;44;59;122;181;72;121;94;135;93;184;180;61;179;151;11;37;73;192;118;38;140;199;147;81;33;67;63;117;186,176414017991946143,0.000984
greedy_intra:edges_start:random,65,255222,163355,91867,1,0,164;107;139;176;40;118;38;73;116;15;111;154;110;171;27;21;94;120;196;66;8;54;145;115;36;88;162;187;22;140;29;191;95;151;126;59;10;141;127;45;165;123;82;3;103;18;190;41;193;167;72;85;42;86;84;89;179;39;17;13;183;102;173;32;113;16;175;181;142;65;131;48;19;49;147;93;101;81;68;161;166;74;67;51;130;136;79;117;124;44;158;178;6;7;26;25;121;163;37;62,5323950353863083007,0.000000
greedy_intra:edges_start:random,66,265758,170046,95712,3,2,152;184;50;107;12;146;188;51;129;111;134;27;79;193;103;87;197;47;84;1;55;33;14;38;23;42;166;95;143;19;29;133;177;20;120;174;169;98;113;85;89;82;39;53;144;195;52;141;92;0;121;194;37;127;164;43;153;81;48;67;16;175;22;49;97;140;57;76;104;59;2;40;148;73;137;182;165;187;64;5;191;158;13;168;122;147;34;78;25;77;72;176;186;71;172;18;171;83;108;63,1342550556095616627,0.000000
greedy_intra:edges_start:random,67,263927,172390,91537,1,0,83;127;54;69;21;84;181;76;195;50;34;109;189;183;0;78;90;144;103;177;108;193;152;25;23;107;105;20;125;145;27;66;93;131;190;102;159;81;94;154;19;26;133;99;73;36;139;174;166;106;143;55;58;157;7;141;89;51;67;138;53;116;180;4;10;170;114;137;17;41;184;191;175;87;18;60;188;160;185;11;123;149;52;88;158;38;39;1;182;196;147;92;115;28;40;44;153;62;126;124,4958223698026803111,0.000000
greedy_intra:edges_start:random,68,266779,167710,99069,1,0,129;13;112;86;90;127;95;47;113;8;132;151;62;54;19;77;148;64;23;163;10;101;38;27;146;145;44;56;43;131;184;42;168;156;149;181;16;63;199;103;130;80;73;24;121;106;173;185;32;107;189;93;68;26;36;17;187;12;76;39;31;180;9;147;46;150;50;124;115;2;15;114;197;182;72;165;117;110;49;122;170;169;55;178;161;186;61;135;144;78;30;3;85;191;28;5;152;142;157;108,6668194418822045822,0.000000
greedy_intra:edges_start:random,69,253303,156937,96366,4,3,109;110;51;40;79;64;87;187;139;188;45;173;162;90;98;108;151;143;107;175;184;106;137;124;176;128;171;115;194;168;35;192;6;7;165;186;15;142;14;63;2;86;126;33;145;196;88;3;81;66;174;18;161;163;46;92;103;50;43;121;102;57;149;150;61;91;113;100;49;94;138;19;146;178;71;154;37;118;58;1;127;22;29;48;166;122;155;129;31;198;131;76;125;135;116;34;190;104;193;53,6234401575911333745,0.001000
greedy_intra:edges_start:random,70,263180,163684,99496,1,0,169;45;182;46;8;95;180;135;77;185;116;195;32;112;37;48;143;105;58;107;73;30;28;118;92;151;193;10;72;161;0;163;157;123;99;63;93;183;33;7;86;81;111;138;158;170;17;11;133;36;53;82;140;173;134;145;38;89;186;106;197;114;120;147;44;179;187;66;41;55;113;109;74;64;126;52;16;79;166;142;189;50;4;198;150;43;9;115;54;164;15;102;155;132;1;26;78;139;42;13,761007934095132848,0.000000
greedy_intra:edges_start:random,71,249069,153633,95436,3,2,139;158;123;3;137;40;144;135;191;61;6;188;156;146;42;36;81;78;73;130;92;49;125;12;74;116;165;48;44;185;0;53;47;131;8;84;133;167;99;90;43;198;183;77;195;60;52;9;178;106;142;80;143;108;153;94;160;175;121;87;57;169;176;82;5;31;86;38;154;59;189;88;75;124;155;107;172;33;177;15;4;72;11;21;85;134;140;109;89;117;79;27;150;23;39;28;45;19;56;127,8722668858313824846,0.001000
greedy_intra:edges_start:random,72,254900,157057,97843,3,2,115;57;29;178;8;114;117;180;5;80;2;76;67;20;123;164;169;82;162;13;161;125;68;174;151;0;36;142;101;4;192;188;56;26;154;1;153;40;24;186;191;45;58;62;182;65;110;172;134;81;49;139;97;78;167;47;184;88;3;12;133;86;44;129;196;136;121;144;52;137;34;166;54;106;28;51;141;85;27;19;171;23;15;74;41;96;130;22;149;107;163;37;17;79;198;18;157;168;156;92,1390226336567312451,0.000000
greedy_intra:edges_start:random,73,254687,155706,98981,1,0,60;101;10;98;133;193;95;175;112;96;128;174;184;15;69;137;62;63;79;48;24;192;5;25;157;107;145;172;138;146;173;123;135;194;34;104;50;179;99;141;186;185;59;144;132;54;159;68;105;73;153;165;178;113;93;161;51;126;39;36;26;6;89;100;21;136;11;134;163;27;55;18;97;32;88;81;191;87;1;80;53;14;35;199;122;124;166;3;45;167;8;2;130;74;195;162;16;58;176;77,728236744564404606,0.000000
greedy_intra:edges_start:random,74,257125,155890,101235,1,0,11;64;133;179;176;174;46;119;189;182;63;94;59;130;92;25;57;38;188;95;196;183;28;134;86;147;35;139;37;66;85;9;93;89;7;10;6;127;150;99;118;137;143;151;115;145;148;50;123;191;53;124;51;142;2;103;71;23;36;29;198;146;159;87;173;111;77;197;83;26;107;172;154;30;4;162;175;55;78;190;32;39;75;104;106;5;138;84;156;41;194;88;184;117;79;67;91;101;21;13,75484309445200783,0.000000
greedy_intra:edges_start:random,75,266868,171016,95852,1,0,168;140;16;26;132;139;118;137;49;78;106;0;154;80;177;115;103;58;189;153;81;8;35;194;94;133;87;121;24;199;159;40;79;160;36;83;23;92;135;185;41;54;113;15;45;69;5;138;171;109;146;25;136;195;114;86;27;196;198;33;190;31;75;163;126;104;7;144;71;97;174;127;187;84;148;197;123;152;166;150;147;73;100;191;50;111;9;56;29;119;57;85;42;12;110;192;112;173;102;82,9209006969640435592,0.000000
greedy_intra:edges_start:random,76,263908,163177,100731,1,0,167;107;106;50;140;128;75;152;126;55;159;125;74;89;138;33;29;99;58;149;77;145;148;136;101;53;82;160;61;18;87;122;130;165;31;51;170;24;2;62;93;115;37;88;186;54;103;118;198;11;8;135;153;98;0;83;68;17;26;38;112;158;80;164;108;69;175;183;5;151;1;155;15;177;96;139;76;180;30;146;144;173;78;79;73;48;71;45;172;28;70;67;192;105;3;22;65;60;131;191,1032487107603061088,0.001001
greedy_intra:edges_start:random,77,273873,174862,99011,2,1,8;80;42;54;160;25;77;41;50;175;44;90;141;43;190;188;110;107;105;181;3;47;145;96;81;146;119;189;117;194;63;86;122;56;11;57;111;153;173;48;168;134;124;184;23;183;61;180;156;103;132;109;82;85;167;196;104;143;71;15;33;99;127;113;118;79;98;170;78;26;20;115;131;133;89;179;72;52;92;150;29;9;69;97;195;84;135;40;192;34;17;187;137;95;38;101;94;39;125;152,6266261138625217477,0.000000
greedy_intra:edges_start:random,78,258130,162346,95784,7,6,79;85;32;178;128;20;118;55;84;39;106;78;37;163;199;129;115;196;186;33;90;176;68;18;74;175;195;102;193;170;47;2;27;188;25;112;91;75;137;111;155;97;98;24;53;73;157;60;197;135;50;168;131;183;133;154;67;38;149;105;19;164;130;132;22;7;180;71;42;146;151;40;145;113;17;77;162;81;124;185;174;86;29;103;147;109;165;62;87;99;143;49;11;177;45;54;56;136;104;5,4957235316262578474,0.001001
greedy_intra:edges_start:random,79,272472,173649,98823,2,1,16;173;165;181;104;135;88;164;85;168;159;162;172;68;32;154;86;166;95;153;103;122;138;58;144;177;189;55;158;12;72;49;139;43;69;9;1;93;167;142;27;2;17;161;188;176;171;128;25;117;3;112;175;0;169;54;73;125;147;21;38;136;170;42;179;56;94;29;130;63;123;52;174;51;100;19;185;129;145;74;101;33;196;109;149;195;108;141;6;90;62;13;34;61;53;77;8;36;89;199,6244981425696353675,0.000000
greedy_intra:edges_start:random,80,271803,175230,96573,2,1,169;173;73;55;76;89;28;171;121;146;140;175;154;163;74;119;115;38;34;174;85;46;22;101;183;82;114;158;196;95;126;139;195;148;98;105;123;186;152;104;157;16;177;13;122;21;125;184;96;133;66;70;60;87;136;39;172;48;50;15;176;4;120;26;25;159;79;199;37;36;67;165;167;117;0;182;20;193;56;149;197;130;179;63;44;127;93;78;113;58;83;168;92;129;142;72;118;2;51;69,3497640472509109040,0.000000
greedy_intra:edges_start:random,81,268187,174601,93586,1,0,146;167;160;154;150;27;156;44;45;2;158;91;4;25;42;103;197;87;183;180;7;55;107;17;90;157;72;71;147;162;64;129;94;93;73;59;101;33;81;118;82;114;166;188;62;140;190;86;179;34;95;31;119;78;58;199;36;43;126;186;181;53;3;124;189;195;152;137;136;132;177;68;52;75;46;84;18;37;198;28;1;69;54;173;9;171;80;134;143;164;116;125;144;122;5;14;12;41;76;74,4325339912908192556,0.000000
greedy_intra:edges_start:random,82,244389,149847,94542,1,0,11;112;198;186;190;75;1;13;15;124;188;149;130;122;50;185;59;51;34;98;14;189;144;199;152;120;191;110;87;111;102;132;103;18;176;125;36;44;37;183;53;170;129;77;79;4;137;39;121;101;3;164;139;143;55;94;33;71;66;161;41;160;90;131;92;38;16;8;17;114;163;58;83;32;62;26;73;140;159;117;197;67;65;118;192;74;63;27;29;179;184;2;133;72;181;162;89;95;180;147,2679586114153033218,0.000000
greedy_intra:edges_start:random,83,254662,161677,92985,2,1,176;107;24;197;182;144;15;118;104;76;46;80;57;26;155;40;111;86;133;194;129;146;175;132;39;162;11;136;33;88;119;69;153;54;196;22;36;125;122;83;137;35;16;110;58;1;0;62;25;145;185;130;199;116;112;134;101;191;106;18;9;143;78;170;32;97;193;164;27;60;89;149;19;66;173;192;34;113;181;55;65;148;94;74;167;51;186;28;124;31;157;165;82;90;13;126;12;184;23;72,317903307024570129,0.000998
greedy_intra:edges_start:random,84,267636,171060,96576,1,0,147;194;76;58;94;160;103;70;92;1;167;51;197;88;138;95;196;35;182;131;145;45;118;20;104;44;166;90;86;72;125;11;124;50;139;154;117;24;187;83;66;163;82;150;78;153;71;184;181;63;55;108;135;105;198;113;49;134;130;132;17;25;14;16;30;141;176;80;188;68;180;7;169;64;164;31;175;22;168;52;23;152;84;91;26;37;5;3;148;106;158;192;19;41;101;65;144;186;81;157,2381922297001421221,0.000000
greedy_intra:edges_start:random,85,257292,159055,98237,3,2,3;135;0;60;160;2;128;37;122;178;176;95;156;199;146;41;166;196;52;168;58;27;126;155;56;93;23;193;131;192;61;71;116;1;44;21;150;101;14;183;170;113;100;143;22;127;69;162;191;64;50;138;66;117;10;67;119;136;94;187;148;42;43;12;5;125;133;54;98;70;161;186;87;121;147;181;171;110;169;86;39;102;28;195;29;151;48;167;180;185;59;11;190;189;188;152;17;18;104;108,124696583752602224,0.000000
greedy_intra:edges_start:random,86,261079,168324,92755,2,1,154;74;21;29;7;39;43;110;157;16;193;87;34;14;56;4;22;94;79;97;91;6;38;171;40;146;96;37;105;52;13;123;142;147;118;8;119;178;140;20;64;72;9;86;186;65;182;12;125;108;121;113;198;106;156;63;66;88;61;92;0;187;139;184;127;77;177;82;31;164;115;145;58;93;32;44;185;81;2;17;60;98;95;174;149;117;196;24;135;89;84;153;195;26;53;131;11;160;152;27,7348598859120288020,0.000000
greedy_intra:edges_start:random,87,252299,156744,95555,2,1,191;2;184;19;124;0;125;182;120;148;39;92;135;144;82;117;168;112;198;11;80;81;161;188;12;61;137;108;13;38;9;130;35;109;107;121;193;165;127;48;199;43;90;75;55;152;195;7;91;196;136;41;123;46;126;134;140;110;94;132;179;15;151;192;160;53;3;97;171;67;84;158;52;8;138;190;104;111;22;45;71;16;88;141;40;37;69;156;114;102;145;29;159;116;57;65;197;176;167;157,4816767855548803741,0.001000
greedy_intra:edges_start:random,88,263421,161791,101630,1,0,147;29;10;70;21;184;97;159;95;37;141;178;116;61;161;191;198;164;68;165;9;130;11;60;48;140;39;77;113;6;17;45;33;129;102;139;153;167;154;4;25;90;173;169;119;172;66;138;58;131;56;3;1;150;62;182;74;0;156;27;65;176;12;57;28;193;121;180;35;67;177;51;8;96;179;185;117;36;112;7;20;122;162;135;136;189;99;195;187;40;53;118;26;14;54;72;126;111;194;80,7172020088003596210,0.000000
greedy_intra:edges_start:random,89,266173,166249,99924,1,0,162;73;4;120;14;151;139;125;97;188;192;190;66;35;153;112;138;81;15;186;180;61;145;58;47;45;94;191;159;103;16;123;136;72;154;62;178;2;43;3;194;83;87;196;22;172;144;115;107;155;84;132;32;65;11;91;99;163;68;75;92;197;129;109;25;88;117;34;56;101;168;134;142;135;173;179;36;1;110;6;149;199;24;195;0;166;147;169;49;133;165;93;52;164;29;182;23;193;121;131,185389948823179165,0.000000
greedy_intra:edges_start:random,90,262002,163326,98676,2,1,17;70;72;102;42;153;25;132;147;168;177;27;9;83;8;123;58;0;196;77;129;99;80;161;33;116;159;158;189;162;10;157;191;16;59;85;38;169;57;73;104;35;61;95;55;121;75;5;199;49;174;28;45;178;101;119;143;172;175;100;138;29;24;109;133;137;81;48;184;18;111;124;139;136;14;41;60;154;78;122;146;105;182;43;56;126;89;110;140;112;176;141;97;31;63;19;91;93;52;187,9029128484592566368,0.000000
greedy_intra:edges_start:random,91,241364,143267,98097,1,0,11;86;76;168;19;81;152;128;61;185;180;157;181;35;84;150;122;18;176;22;126;55;196;119;140;109;124;130;23;178;158;102;91;73;90;71;5;135;189;142;134;21;110;54;179;101;2;30;41;107;3;79;127;115;96;49;38;12;74;97;44;7;164;25;117;182;108;118;153;95;141;145;58;165;155;40;29;149;198;98;175;26;144;16;28;151;39;34;197;156;33;187;70;129;82;188;174;56;1;121,3749122644820476898,0.000000
greedy_intra:edges_start:random,92,254842,154442,100400,2,1,84;49;50;165;44;96;105;111;182;114;136;26;56;24;10;167;38;150;122;106;199;79;127;99;181;169;97;85;163;141;4;53;48;68;149;5;145;104;116;130;151;59;16;32;15;108;120;78;118;90;159;190;134;37;61;121;21;191;176;13;27;57;125;162;51;153;137;8;66;144;9;152;139;46;146;126;194;129;69;115;158;138;60;62;76;83;117;110;197;88;30;187;170;192;45;188;154;140;193;0,7162163644000656829,0.000000
greedy_intra:edges_start:random,93,271108,171692,99416,1,0,6;44;59;181;153;140;117;16;35;179;190;158;43;175;195;154;23;10;199;37;161;142;36;60;116;94;28;68;18;11;40;95;132;58;45;71;53;133;162;21;113;29;193;70;198;73;83;139;13;151;101;50;31;141;114;137;144;27;184;17;109;61;111;82;187;93;57;110;180;15;169;192;172;107;121;77;173;160;66;128;9;38;183;168;84;75;185;24;106;102;88;100;171;149;98;124;146;20;34;14,2614274476126116719,0.001001
greedy_intra:edges_start:random,94,280032,185469,94563,1,0,54;52;153;75;36;177;100;193;180;183;123;43;188;148;18;90;16;184;102;126;68;24;30;76;15;73;65;144;19;4;113;178;79;14;157;55;159;196;74;194;199;161;176;98;140;120;109;56;175;139;147;64;63;22;42;190;57;7;195;38;186;51;138;198;167;156;171;9;173;86;136;72;151;134;192;125;12;91;10;137;87;119;191;45;84;83;150;53;187;185;50;170;13;80;108;92;21;29;69;174,6511834063424031636,0.000000
greedy_intra:edges_start:random,95,272333,170028,102305,1,0,146;171;82;3;83;47;194;49;187;10;170;74;185;24;92;199;20;84;157;36;75;19;144;99;152;159;110;41;130;129;62;195;126;186;117;27;143;48;142;138;155;182;90;132;107;174;100;167;8;43;18;190;69;2;81;112;148;71;197;189;30;165;55;66;113;88;42;31;156;38;172;168;173;162;153;158;21;120;67;122;96;52;25;54;76;175;188;12;53;125;193;104;149;111;183;166;16;56;102;39,3323107974454913041,0.000000
greedy_intra:edges_start:random,96,261977,165912,96065,2,1,196;39;19;53;21;32;7;194;42;54;75;71;103;78;3;86;133;92;94;171;95;87;122;12;129;174;150;100;151;121;61;191;25;64;50;17;98;198;179;83;185;108;123;152;97;163;120;124;27;46;26;20;89;192;18;135;157;68;66;172;28;67;36;91;45;119;0;6;2;114;137;56;23;193;177;136;115;161;141;34;15;162;175;149;44;93;35;10;14;47;52;77;62;24;74;184;110;96;11;139,5621341027538341296,0.000000
greedy_intra:edges_start:random,97,268359,170600,97759,1,0,192;122;19;58;57;175;12;7;30;84;168;0;191;2;116;152;45;199;137;104;78;146;120;35;32;138;159;179;183;164;194;158;95;83;39;11;147;178;36;63;25;102;118;69;143;66;72;110;133;135;62;163;89;90;144;105;51;156;198;59;166;68;77;94;182;132;6;181;29;50;52;26;14;27;187;54;131;154;40;177;112;34;13;44;134;60;98;172;171;185;140;86;148;103;173;99;38;184;160;174,1035119158882045737,0.000000
greedy_intra:edges_start:random,98,266477,168797,97680,1,0,121;160;167;49;162;5;11;55;25;69;81;142;16;103;109;198;197;193;156;98;172;21;26;59;2;119;195;165;112;170;145;131;38;91;90;70;148;40;99;79;66;13;19;176;35;166;181;185;105;93;10;182;27;127;179;15;183;175;77;186;153;23;22;199;39;75;54;177;18;149;158;134;80;114;192;129;151;104;132;138;106;163;58;50;33;194;87;164;17;174;154;56;6;133;168;8;65;48;135;173,6756819449341032023,0.000000
greedy_intra:edges_start:random,99,251653,154892,96761,1,0,46;28;139;193;8;198;162;3;130;71;72;120;19;125;11;24;107;144;132;98;43;4;21;126;177;49;7;129;83;51;60;194;149;55;27;53;191;34;135;157;153;85;26;59;33;197;115;62;108;32;136;86;111;6;47;150;128;112;78;116;109;176;29;127;97;104;25;76;196;133;9;186;42;69;165;137;77;187;189;117;73;30;122;10;89;192;170;143;188;95;119;80;94;44;57;113;185;12;48;190,3867162282838867521,0.000000
greedy_intra:edges_start:random,100,263765,168851,94914,1,0,68;1;10;194;87;165;102;24;84;41;61;175;52;25;116;134;190;49;94;152;163;23;178;130;173;140;120;158;37;95;197;184;98;176;43;31;137;188;122;139;128;51;123;125;144;40;4;198;138;99;55;124;77;121;79;19;0;14;69;135;155;151;143;160;57;81;50;132;27;64;73;34;187;101;93;145;126;172;59;85;18;38;75;150;110;170;131;106;6;8;82;114;168;30;46;26;48;70;36;89,4270206658442737687,0.000000
greedy_intra:edges_start:random,101,256452,167508,88944,1,0,91;42;130;36;78;113;46;43;143;93;45;196;27;123;53;115;136;186;138;57;105;34;135;177;15;100;190;157;189;118;95;80;30;51;134;21;60;56;73;99;12;124;9;77;81;47;6;17;29;26;62;59;193;31;61;7;82;54;32;1;195;83;3;162;97;55;16;107;144;182;96;110;35;22;171;188;66;41;128;133;172;178;153;4;52;127;131;163;10;114;0;106;5;158;40;49;75;79;90;154,4264514928146513765,0.000000
greedy_intra:edges_start:random,102,273757,169867,103890,1,0,166;51;58;22;52;110;157;126;5;146;35;25;95;135;104;46;88;7;16;170;108;128;180;164;100;41;66;139;60;177;82;142;131;134;69;57;55;13;94;182;116;192;67;138;188;72;90;28;59;145;197;47;8;124;19;119;179;127;75;152;168;101;27;63;32;123;130;99;107;115;189;87;151;196;98;77;68;160;17;56;89;133;187;91;136;39;30;149;114;181;48;132;79;54;198;122;190;85;156;191,6609336843838325124,0.000000
greedy_intra:edges_start:random,103,269709,168608,101101,2,1,72;57;142;49;24;43;152;192;109;40;104;197;26;93;55;139;146;175;150;182;7;115;16;144;126;99;59;73;100;159;135;62;174;141;154;151;53;155;70;188;51;95;194;156;121;79;36;10;184;45;47;128;25;189;148;21;6;198;28;136;50;190;31;33;3;13;114;12;160;60;173;81;83;4;167;27;78;118;195;170;106;129;110;130;64;42;97;89;0;168;38;177;66;138;133;67;82;178;44;48,8735365706746175140,0.000000
greedy_intra:edges_start:random,104,268077,167249,100828,1,0,80;73;187;155;198;175;39;29;33;188;89;19;190;20;178;107;4;83;16;157;61;119;161;132;24;32;43;51;76;106;172;102;34;120;49;54;128;82;181;46;130;95;91;153;147;65;74;114;60;70;148;177;63;150;131;12;2;173;99;1;146;23;137;62;77;25;121;30;75;197;5;9;47;152;84;31;118;116;112;156;42;117;93;0;133;139;182;67;94;169;193;38;37;36;115;125;179;160;40;192,7037966505337755620,0.001001
greedy_intra:edges_start:random,105,256267,159623,96644,5,4,100;168;91;115;137;19;136;26;15;175;10;166;155;138;199;50;150;151;44;142;182;73;154;77;1;130;82;127;13;62;192;80;39;34;180;172;147;7;18;131;57;98;124;66;5;86;53;149;65;72;70;45;2;139;64;152;122;194;32;135;157;117;52;20;170;110;101;25;78;87;148;30;16;28;128;171;174;144;85;24;89;141;119;102;33;146;118;63;108;106;158;59;60;123;22;134;92;55;47;9,3458984255924653584,0.001001
greedy_intra:edges_start:random,106,277546,170843,106703,1,0,116;167;140;138;57;144;186;108;119;84;104;8;9;150;115;74;58;126;0;78;87;50;47;1;96;71;95;88;6;128;174;17;41;197;25;192;143;106;151;60;67;109;112;120;77;187;148;83;69;61;198;137;154;36;100;37;141;130;129;64;52;105;7;111;31;173;189;175;194;163;23;146;32;56;156;91;28;181;133;122;160;131;123;11;66;15;29;164;18;159;89;86;3;24;171;118;188;121;190;63,4707000528977273778,0.000000
greedy_intra:edges_start:random,107,252519,154798,97721,2,1,191;169;89;163;54;106;133;74;64;13;75;27;87;158;39;31;32;132;114;194;180;102;185;113;14;5;152;140;44;43;130;8;40;196;170;182;162;4;92;15;150;9;11;78;94;29;137;82;56;141;100;189;111;37;164;46;62;85;25;142;69;190;45;144;67;58;117;19;10;17;96;41;107;42;103;184;65;97;1;119;175;26;187;139;121;118;135;61;12;36;115;68;179;174;165;166;88;149;116;192,3592207509937658619,0.000000
greedy_intra:edges_start:random,108,273573,182357,91216,1,0,151;155;56;113;12;19;133;10;150;108;63;162;13;97;145;37;149;11;144;115;167;176;5;91;94;3;90;23;119;46;40;134;135;71;154;188;180;174;68;54;15;195;116;175;66;92;35;129;196;189;93;107;43;169;142;182;55;50;31;22;74;164;193;102;117;106;83;33;78;141;109;28;121;146;41;8;139;153;87;95;158;70;34;24;79;16;4;58;186;127;166;168;161;81;157;103;160;183;14;84,4724960676873421510,0.000000
greedy_intra:edges_start:random,109,267876,169215,98661,3,2,175;93;121;39;55;189;127;165;3;32;30;73;108;4;38;7;50;155;123;78;116;59;41;6;130;100;158;44;188;134;14;97;45;154;52;146;149;22;111;166;53;24;74;159;198;195;56;125;162;11;29;105;141;136;51;170;177;83;118;103;193;23;199;76;72;182;164;70;143;42;67;131;62;87;128;46;117;139;91;20;88;197;119;163;54;8;86;120;89;34;132;138;84;27;106;140;144;194;63;190,579949097820827159,0.000000
greedy_intra:edges_start:random,110,252519,154564,97955,3,2,176;94;38;142;8;180;23;105;168;100;170;131;14;3;107;90;4;125;81;67;16;95;179;122;185;19;190;10;181;53;36;33;72;118;141;82;102;66;98;9;54;148;78;62;70;195;65;192;34;104;198;96;77;178;39;24;149;13;35;97;44;151;155;111;116;175;22;173;158;165;112;159;160;71;188;74;110;51;162;109;193;41;123;121;5;45;73;91;135;153;163;11;106;129;28;147;30;7;120;197,4585946114411267480,0.000998
greedy_intra:edges_start:random,111,276419,180736,95683,1,0,36;72;177;23;81;164;16;148;48;37;123;154;7;53;185;172;41;105;118;83;43;80;180;175;170;97;156;10;31;51;94;0;17;130;139;140;155;64;34;49;191;93;186;111;163;15;174;133;38;67;136;160;98;25;169;47;88;165;6;8;149;198;65;143;146;184;95;56;45;33;124;3;150;190;194;147;9;145;20;125;109;179;115;110;161;178;96;187;4;71;22;5;1;86;92;18;50;176;157;55,5789809123956450990,0.000000
greedy_intra:edges_start:random,112,264512,168829,95683,1,0,63;28;114;4;58;126;145;23;109;140;75;22;139;68;120;101;198;143;127;150;156;154;184;167;9;174;175;50;192;138;94;149;96;190;66;130;36;98;153;169;10;16;131;195;7;151;165;44;117;137;35;40;21;121;191;31;42;3;15;56;103;128;18;0;102;142;182;24;159;39;187;199;180;116;166;163;90;119;189;57;99;77;61;148;173;38;171;157;152;32;107;71;183;186;26;6;185;14;76;118,7139842683269992211,0.000000
greedy_intra:edges_start:random,113,250089,154632,95457,4,3,61;36;103;165;183;160;44;41;110;77;84;166;197;60;11;185;19;131;42;34;100;26;101;142;145;124;32;75;28;73;168;96;173;87;4;172;86;150;137;82;92;140;9;14;187;113;69;94;64;139;178;25;102;56;154;144;132;16;118;104;6;93;114;10;35;80;148;31;106;50;58;186;45;138;27;98;59;20;158;123;5;121;63;108;97;174;112;143;109;159;72;67;90;161;157;29;177;2;89;55,2632842973408260901,0.000000
greedy_intra:edges_start:random,114,252066,155085,96981,5,4,11;66;198;47;106;164;145;1;165;42;41;92;99;68;141;193;102;108;116;64;148;35;73;93;75;185;77;195;138;183;25;12;175;159;199;136;50;94;52;139;111;176;187;55;178;40;130;16;170;137;101;115;4;180;109;76;182;152;120;172;37;160;190;124;17;107;74;161;135;70;18;181;5;166;45;48;58;192;173;71;54;87;174;128;79;125;110;168;59;162;3;169;34;95;51;158;60;150;91;131,3368179891399202293,0.001002
greedy_intra:edges_start:random,115,279945,181725,98220,1,0,125;79;183;42;142;73;189;13;34;92;82;45;20;3;67;41;99;49;1;130;19;143;91;165;6;22;139;85;138;167;57;7;11;43;113;147;55;47;144;115;76;77;164;151;150;81;54;192;60;188;161;63;114;169;163;46;129;195;104;88;2;29;89;56;112;18;172;159;39;83;121;119;122;149;14;27;199;178;154;162;140;106;10;157;30;32;135;31;4;12;33;95;194;97;158;176;137;52;8;148,5239963691413216206,0.000000
greedy_intra:edges_start:random,116,272012,172230,99782,1,0,179;18;199;23;53;124;106;12;135;28;104;193;34;148;190;47;40;45;7;99;93;27;2;195;180;162;46;165;198;157;130;150;32;50;98;88;140;113;49;167;144;163;169;109;100;10;60;29;14;191;114;56;101;1;138;194;102;94;168;181;110;132;136;133;153;187;77;146;125;20;61;188;63;129;21;51;142;76;117;108;184;151;155;122;15;154;22;92;8;170;31;166;13;185;118;119;30;197;121;65,8769751730457396515,0.000000
greedy_intra:edges_start:random,117,260307,166007,94300,5,4,12;103;32;181;14;166;93;94;74;172;146;60;123;3;158;18;73;141;150;25;161;1;59;76;53;135;48;109;189;152;75;128;183;193;191;95;83;160;155;22;46;136;69;65;98;63;140;130;51;29;138;107;133;64;179;151;28;184;13;5;115;15;194;80;36;78;168;182;144;52;114;169;121;31;176;186;34;192;185;112;196;116;84;89;106;99;43;37;149;180;26;197;33;68;164;142;174;159;2;44,2676828143300080319,0.000997
greedy_intra:edges_start:random,118,252174,154306,97868,4,3,60;77;151;193;40;86;83;132;110;194;148;62;105;2;104;14;175;10;130;4;45;173;7;178;154;1;171;143;31;179;22;11;88;16;145;149;158;190;69;79;187;163;161;113;87;144;156;96;6;35;162;70;195;8;133;109;20;3;36;99;129;75;74;150;120;139;176;67;64;153;23;177;28;82;118;137;155;197;116;199;185;44;136;167;52;50;93;61;111;114;12;124;123;66;43;33;146;135;92;48,8850965831807617491,0.000000
greedy_intra:edges_start:random,119,252017,148476,103541,2,1,74;68;98;12;16;172;32;155;100;48;166;170;197;89;119;39;183;99;57;112;167;179;163;134;101;13;2;17;97;193;58;53;29;191;106;73;94;125;104;71;3;77;152;79;43;138;86;150;186;102;36;110;175;60;171;64;7;33;173;159;109;5;24;135;51;162;9;111;75;61;107;161;178;120;176;88;121;188;49;114;65;115;144;8;40;136;69;20;132;130;174;180;149;59;4;62;153;27;52;66,694424078484870227,0.001001
greedy_intra:edges_start:random,120,269657,167504,102153,3,2,194;152;128;189;32;172;178;110;159;177;46;4;58;87;169;80;86;190;40;28;186;155;27;15;150;116;164;2;143;23;154;89;10;51;181;137;180;126;117;85;21;7;93;196;26;187;99;94;146;185;151;142;108;63;149;38;84;71;174;102;70;198;173;112;24;147;161;197;74;195;91;145;19;184;191;183;33;68;156;101;162;157;96;6;168;188;103;55;144;165;30;41;107;11;61;67;76;53;175;148,1217763563821912247,0.000000
greedy_intra:edges_start:random,121,258464,163307,95157,2,1,59;168;68;139;181;173;163;27;127;130;169;17;91;3;159;84;199;74;176;89;21;120;166;107;60;144;88;108;102;136;31;43;96;79;142;53;33;156;75;38;106;73;149;65;138;185;145;122;198;103;167;186;52;196;9;191;150;80;192;125;63;62;92;37;18;182;126;85;152;179;30;109;113;123;16;112;162;41;132;118;98;11;4;161;1;194;82;22;111;133;95;154;151;137;42;64;189;170;143;86,6991521799701006331,0.000000
greedy_intra:edges_start:random,122,241731,150681,91050,1,0,102;119;23;57;36;59;109;42;151;183;75;90;43;181;148;162;76;147;74;152;196;92;144;18;17;8;61;137;48;22;66;71;141;135;93;7;173;166;5;179;106;184;68;138;14;115;39;171;50;85;83;177;192;65;84;88;19;143;56;35;34;49;136;129;38;1;134;198;186;142;139;193;77;94;133;185;67;30;190;167;72;46;52;168;112;78;80;105;146;117;55;16;6;99;53;28;20;125;79;191,3683859074468947565,0.000000
greedy_intra:edges_start:random,123,242552,150154,92398,3,2,38;92;167;45;80;118;195;156;94;43;101;198;31;37;139;57;99;44;178;183;123;111;75;110;129;189;98;0;66;116;83;154;36;108;81;62;42;196;15;40;191;65;180;74;17;115;11;63;117;176;137;131;13;174;6;39;102;157;165;169;144;52;105;153;145;55;88;128;20;77;186;9;46;147;138;149;194;151;14;87;7;155;58;107;21;53;160;56;78;41;49;141;47;18;72;82;187;85;126;164,4202211783120643230,0.001002
greedy_intra:edges_start:random,124,271080,174951,96129,3,2,169;150;143;125;36;13;15;46;21;180;159;71;33;62;146;34;29;107;119;90;9;168;149;179;118;116;25;186;42;11;193;14;3;151;113;189;183;104;55;41;175;165;69;114;94;77;30;51;109;110;85;101;198;16;154;83;144;27;76;195;147;54;81;38;2;63;78;5;121;56;24;134;68;145;190;64;127;53;17;37;126;1;130;31;194;174;135;39;163;67;35;167;166;99;108;158;128;92;7;79,5085402522970377024,0.000000
greedy_intra:edges_start:random,125,274218,179159,95059,1,0,4;53;57;87;177;71;10;165;150;110;29;17;65;49;25;48;101;179;160;79;0;193;21;121;185;148;20;170;141;35;78;120;181;37;80;88;198;102;56;127;151;140;105;167;131;77;84;109;189;107;133;146;155;136;14;18;159;7;33;104;2;187;50;61;83;154;46;32;69;174;143;91;52;59;3;132;9;16;190;96;41;15;81;182;145;54;161;23;67;51;176;47;90;64;194;106;58;166;26;157,6957497985854596610,0.000998
greedy_intra:edges_start:random,126,260251,163029,97222,1,0,185;124;162;188;106;155;157;137;130;59;112;43;102;141;57;28;70;123;151;94;93;63;189;127;194;144;101;175;138;74;176;132;181;21;65;153;97;64;167;0;58;27;166;78;6;136;46;196;164;154;160;95;139;32;174;168;134;198;5;23;41;77;76;117;104;75;4;22;173;13;62;73;51;146;85;126;34;37;38;36;80;47;67;152;135;140;33;184;150;86;31;61;131;169;60;156;99;149;71;158,6623154797381444510,0.000000
greedy_intra:edges_start:random,127,256889,162687,94202,2,1,22;126;118;21;4;3;42;10;78;34;155;103;109;148;37;92;76;187;106;63;52;77;83;190;71;46;93;110;55;89;75;115;195;43;191;119;132;111;117;62;45;116;193;162;108;28;49;98;146;185;48;41;100;140;149;56;54;131;73;179;59;163;197;189;80;145;29;152;178;27;50;64;143;160;112;5;12;96;74;19;150;14;120;11;168;180;86;9;24;124;188;85;169;176;60;84;159;114;133;134,7167191551432920474,0.000000
greedy_intra:edges_start:random,128,259002,162436,96566,1,0,151;107;124;159;8;179;92;91;186;123;122;2;114;144;25;156;93;34;142;81;138;110;74;99;136;23;82;167;191;150;40;52;28;67;195;38;65;84;14;121;63;132;19;79;149;168;68;180;22;154;72;148;145;119;103;50;137;85;175;62;36;24;170;188;108;61;17;12;185;32;80;75;163;71;10;4;130;158;49;183;29;129;21;15;64;18;193;190;164;3;115;11;143;77;70;55;35;194;111;106,8889990478269676032,0.000000
greedy_intra:edges_start:random,129,254678,163130,91548,5,4,60;3;139;168;181;135;46;187;145;176;80;73;179;117;106;82;131;100;118;167;97;186;185;194;144;74;2;107;109;17;151;25;63;34;77;114;152;166;141;197;27;50;103;67;59;5;22;105;84;190;64;121;188;29;78;21;119;159;61;137;24;158;32;162;183;182;26;191;16;71;39;62;113;180;189;142;99;9;120;160;129;86;44;57;56;54;79;92;133;68;112;138;48;12;41;55;52;150;20;125,6811364967283605087,0.000000
greedy_intra:edges_start:random,130,272769,176361,96408,6,5,72;107;67;124;171;26;66;120;49;187;4;121;40;159;38;78;175;57;47;63;95;100;179;177;143;88;92;169;56;5;46;19;185;9;1;114;90;69;45;20;0;85;158;77;164;194;109;81;36;147;152;144;50;2;76;28;142;7;39;153;150;176;184;98;54;128;181;11;75;105;168;60;68;59;17;55;24;186;41;34;89;37;132;74;163;51;146;190;25;151;196;188;193;133;126;70;108;80;145;65,8030811193848588994,0.000990
greedy_intra:edges_start:random,131,253343,157319,96024,2,1,29;157;179;37;49;110;190;141;45;97;98;0;30;175;53;120;173;168;79;184;192;15;67;89;82;83;85;107;116;12;17;78;31;128;144;70;7;75;52;18;112;133;152;65;132;81;100;59;187;9;126;57;134;129;1;43;87;167;35;119;90;160;24;54;77;40;38;121;66;162;36;80;16;111;186;156;104;105;124;88;150;21;69;14;13;174;44;26;159;96;180;169;176;68;178;5;109;137;199;22,8570764981452193283,0.000000
greedy_intra:edges_start:random,132,274039,179760,94279,1,0,165;95;86;87;78;45;163;83;16;3;162;44;129;125;18;15;199;161;145;25;42;63;190;64;94;164;148;154;7;65;98;14;77;23;99;54;185;191;128;142;133;112;151;92;138;179;97;79;60;118;0;17;111;56;103;61;29;12;186;158;13;181;187;70;49;36;5;150;105;9;50;19;31;141;144;121;41;137;126;117;120;71;24;22;68;130;58;81;180;90;188;100;184;40;80;140;1;34;107;192,2217027759559620131,0.000000
greedy_intra:edges_start:random,133,264462,166981,97481,2,1,91;139;86;61;189;19;112;111;5;28;72;167;98;3;13;8;129;71;187;193;185;120;123;190;57;67;39;125;77;103;34;25;128;168;93;22;10;55;186;163;122;144;146;56;17;16;154;11;179;30;85;43;74;164;76;178;169;29;198;47;188;180;97;153;160;183;158;161;182;4;65;37;175;143;80;0;151;177;87;133;135;127;174;33;51;119;106;60;165;130;196;195;145;50;7;31;20;162;155;81,520978940668838252,0.001012
greedy_intra:edges_start:random,134,285367,184240,101127,1,0,2;16;43;168;174;113;135;191;53;110;172;47;44;63;155;147;129;65;0;33;69;189;185;93;130;149;38;108;165;36;177;163;20;125;58;187;178;78;70;98;164;30;37;15;158;50;140;190;18;183;192;73;152;68;75;67;92;11;154;118;25;121;107;194;100;132;112;157;146;62;32;83;7;3;131;182;86;143;111;159;170;166;199;22;114;56;99;27;116;60;97;161;179;35;167;6;82;102;153;41,6037480902905930820,0.000000
greedy_intra:edges_start:random,135,257199,165405,91794,2,1,188;41;177;30;48;90;102;170;104;154;167;157;88;75;138;0;191;129;45;61;107;110;4;39;50;117;51;122;116;17;125;31;49;69;103;43;93;175;143;162;63;20;139;185;144;65;136;85;15;159;131;199;134;171;84;87;111;38;193;29;52;130;133;181;22;96;81;187;18;10;27;53;78;119;189;2;145;16;79;94;14;73;98;112;71;60;174;176;40;74;115;19;124;114;70;158;192;62;42;132,3044969072889776792,0.000000
greedy_intra:edges_start:random,136,251923,157161,94762,4,3,35;187;2;180;179;62;64;44;28;55;128;83;132;165;184;52;198;170;190;48;131;156;12;72;136;106;58;151;77;158;194;169;24;56;17;46;4;93;160;49;113;76;3;20;141;199;111;148;120;34;10;126;33;122;36;133;155;61;81;191;140;117;70;118;19;167;22;173;90;127;166;79;154;92;159;85;116;197;183;189;84;100;139;110;47;31;40;115;112;164;193;94;69;124;98;119;121;86;5;65,2773519024677191258,0.000999
greedy_intra:edges_start:random,137,252756,160486,92270,5,4,146;46;170;42;82;10;110;144;28;113;87;13;58;121;129;34;190;125;69;172;40;80;11;109;94;59;0;126;18;160;67;74;184;157;92;32;53;135;148;105;114;122;63;165;89;91;152;25;119;23;187;20;41;149;9;199;64;73;68;137;90;49;117;77;103;182;154;168;150;116;197;3;16;127;56;138;27;108;175;1;37;38;169;158;44;164;78;30;136;198;65;174;120;107;96;118;54;101;155;132,8470502836917746559,0.000000
greedy_intra:edges_start:random,138,268653,176004,92649,1,0,149;136;39;43;98;66;7;61;8;71;123;20;139;191;72;21;15;135;9;63;162;134;189;116;16;69;137;25;44;128;4;144;121;160;165;92;91;41;141;47;62;102;79;0;13;17;14;130;73;190;53;197;78;51;85;182;55;172;186;11;37;54;166;31;94;188;68;193;169;179;46;132;192;176;117;108;38;114;131;185;18;81;65;156;77;36;113;35;155;145;84;119;124;167;178;107;10;49;2;161,8963256791973533709,0.000000
greedy_intra:edges_start:random,139,261706,162935,98771,3,2,89;164;110;109;176;72;62;18;134;5;168;189;50;111;63;171;101;147;102;157;69;83;68;104;32;95;64;52;132;165;74;17;4;9;149;153;151;190;106;121;87;37;126;44;1;92;135;180;66;2;84;193;81;156;98;71;182;28;41;51;16;42;107;181;141;36;155;40;130;198;75;145;136;161;14;78;177;11;118;70;20;144;47;179;178;7;113;140;10;30;100;197;86;186;27;99;91;82;85;46,4284506903961178116,0.000999
greedy_intra:edges_start:random,140,277507,184350,93157,1,0,115;106;171;40;18;81;183;161;7;182;177;176;146;36;74;195;135;113;82;6;58;14;59;60;104;86;197;126;62;91;190;46;167;169;163;111;92;181;127;83;102;44;0;193;110;3;160;45;199;65;109;52;134;49;68;66;54;95;124;137;159;94;78;154;112;155;90;22;188;142;64;151;17;180;57;147;93;30;96;79;77;88;21;120;71;31;37;194;164;192;4;173;149;172;136;56;108;144;38;170,5666750460138199760,0.000000
greedy_intra:edges_start:random,141,268145,169290,98855,2,1,0;143;77;103;1;148;170;50;74;32;120;142;152;43;157;196;109;183;162;114;21;122;62;31;172;191;160;155;151;90;5;141;175;66;64;190;73;69;158;40;119;59;95;173;63;139;14;182;127;116;102;144;41;104;24;111;166;3;124;184;29;17;38;52;10;53;33;54;30;36;13;164;117;197;128;49;88;48;15;167;187;146;159;47;171;11;19;99;26;67;194;108;163;86;35;7;85;149;44;57,7088567970166411019,0.000000
greedy_intra:edges_start:random,142,239841,148838,91003,1,0,119;83;89;59;120;29;0;18;182;145;81;127;109;24;79;87;93;171;164;121;128;76;106;4;35;21;143;8;138;172;16;188;58;12;108;162;187;40;41;117;50;178;63;44;47;84;146;153;62;116;140;61;68;112;57;113;169;167;173;80;129;196;99;91;139;155;92;36;14;190;55;179;9;26;170;180;183;166;48;64;111;151;102;94;101;135;60;5;107;33;193;149;66;176;82;72;69;177;96;165,1403262504684347739,0.000000
greedy_intra:edges_start:random,143,259844,155876,103968,5,4,122;66;57;50;64;7;90;151;46;164;128;11;149;189;173;144;28;58;119;100;188;86;72;48;157;113;43;99;83;81;19;147;96;114;27;174;124;22;98;52;146;31;21;135;193;143;150;107;178;17;16;24;132;180;78;167;179;109;33;170;101;69;156;75;186;30;172;29;47;133;191;18;65;159;40;9;1;94;73;53;136;130;88;13;177;190;12;37;187;74;104;118;23;199;5;153;42;182;77;108,8435037576994395916,0.000000
greedy_intra:edges_start:random,144,270214,175883,94331,1,0,53;176;147;68;52;101;55;66;17;4;182;117;145;131;13;46;184;175;83;90;162;49;72;2;8;12;142;89;102;18;194;178;85;36;32;75;192;177;37;15;157;42;79;20;116;60;189;119;106;124;40;137;22;25;39;169;92;114;160;43;140;88;134;107;158;161;33;5;61;6;70;181;148;78;170;41;105;31;183;168;167;186;67;21;165;65;82;63;9;120;96;81;26;87;143;126;122;50;23;156,7300423610620715049,0.001022
greedy_intra:edges_start:random,145,277301,173126,104175,3,2,133;58;94;97;104;46;152;21;140;197;85;70;84;143;176;51;48;188;63;71;180;126;141;151;173;110;24;86;45;76;93;114;184;61;166;191;196;77;164;59;33;105;92;158;103;134;56;28;36;189;132;163;31;102;5;20;38;117;172;177;74;17;160;88;81;49;57;144;62;124;175;149;43;41;23;181;111;99;2;170;142;150;128;52;123;35;9;179;198;129;96;26;72;15;12;75;91;186;147;155,2245183497406427095,0.000000
greedy_intra:edges_start:random,146,250310,150824,99486,2,1,113;197;162;159;103;127;72;147;78;89;152;27;115;191;193;67;95;170;134;145;50;65;112;68;54;10;181;24;45;104;160;55;90;7;156;99;12;142;29;122;102;151;85;63;19;116;47;139;98;153;120;187;16;46;21;79;42;173;176;20;3;6;149;57;101;87;166;141;169;64;94;114;183;175;150;132;73;182;146;130;26;185;148;8;177;43;189;59;49;109;121;97;32;192;155;56;143;74;71;107,5404286910399868728,0.000000
greedy_intra:edges_start:random,147,248144,157884,90260,4,3,197;44;74;52;51;193;91;111;164;66;86;177;73;70;180;151;67;127;137;191;171;189;130;32;72;142;186;31;18;78;89;117;22;82;183;101;122;129;184;45;25;162;41;160;42;114;21;63;153;139;144;100;75;19;79;8;169;156;80;199;194;9;56;152;77;179;133;26;105;112;93;168;178;17;68;98;149;30;29;165;110;141;166;47;146;108;48;172;107;14;84;76;118;198;2;6;175;154;62;135,931735303286023117,0.001007
greedy_intra:edges_start:random,148,265262,173819,91443,2,1,130;70;165;184;66;118;148;1;3;28;27;60;109;119;41;102;7;174;199;195;159;42;132;36;127;137;61;101;126;162;142;5;32;55;2;35;129;57;85;115;23;138;63;78;133;98;76;14;178;151;112;92;135;108;155;47;16;18;128;22;77;45;21;147;166;93;104;84;49;181;38;8;152;43;124;59;51;15;12;172;163;164;131;106;145;31;182;81;11;186;100;171;192;139;40;48;179;54;191;30,7022995510967041689,0.000000
greedy_intra:edges_start:random,149,257155,158340,98815,1,0,65;25;130;101;42;71;52;94;115;162;150;113;127;193;182;155;90;29;62;43;27;117;85;16;91;30;136;168;13;174;129;89;133;22;18;184;134;141;14;61;144;167;7;31;121;137;151;178;189;114;40;95;4;63;72;57;67;191;110;132;79;98;135;76;6;88;83;158;66;183;188;111;26;3;166;197;36;20;33;28;84;154;64;15;55;49;185;159;92;102;177;73;196;87;199;17;146;181;8;82,4691108980747616730,0.000000
greedy_intra:edges_start:random,150,242283,145844,96439,2,1,16;190;144;32;8;26;25;170;3;107;140;99;79;49;181;122;77;105;193;51;104;28;68;136;124;125;55;5;6;194;65;87;169;2;178;133;117;137;44;97;75;127;131;46;89;83;52;115;114;48;29;154;9;34;33;22;198;15;155;63;113;172;160;98;176;112;84;1;199;129;10;103;196;187;67;72;11;171;138;185;47;161;66;167;182;195;151;17;45;197;126;165;19;78;88;111;42;41;162;166,6065550155508841499,0.000000
greedy_intra:edges_start:random,151,269585,171987,97598,1,0,112;102;135;181;16;163;191;49;80;65;108;152;132;70;100;179;53;131;166;154;27;107;61;168;83;104;55;11;178;126;17;75;167;187;120;7;109;37;58;23;22;62;153;45;26;158;29;141;88;34;146;164;157;147;18;198;196;92;59;69;137;48;155;66;195;54;28;162;186;125;136;35;9;85;116;98;30;89;169;97;150;40;183;5;119;93;42;138;68;86;51;63;176;84;78;161;173;64;91;199,4651700197514200328,0.000000
greedy_intra:edges_start:random,152,253830,159883,93947,3,2,15;62;143;161;191;134;101;121;131;55;18;28;189;49;32;126;146;76;184;177;6;7;183;75;199;66;72;79;78;2;193;160;197;125;56;74;43;185;115;37;81;94;129;150;113;54;141;124;61;0;71;145;119;139;17;42;73;48;99;4;21;157;93;41;156;159;118;192;85;80;133;5;13;51;171;180;89;50;196;53;154;116;170;39;33;165;83;52;92;23;45;16;95;169;198;24;128;136;148;164,6843871779274484369,0.000970
greedy_intra:edges_start:random,153,254409,160501,93908,5,4,166;189;172;184;21;51;11;73;32;165;118;60;150;107;193;79;110;42;57;182;31;92;158;82;140;128;40;89;46;144;85;176;70;39;2;102;48;16;185;78;36;95;66;149;20;35;127;62;99;26;106;17;97;8;1;4;94;18;75;53;114;108;132;47;93;137;61;49;14;58;119;186;90;191;83;163;74;52;41;164;24;59;109;5;129;71;151;135;103;121;33;50;28;100;138;155;190;67;116;12,1941298153763379198,0.000000
greedy_intra:edges_start:random,154,261499,160992,100507,1,0,178;3;91;26;132;120;153;167;79;76;22;27;135;64;170;17;166;197;86;137;20;85;111;95;193;122;6;37;21;12;31;172;182;196;56;146;73;102;168;154;35;125;66;199;1;61;131;144;124;136;94;50;184;147;75;98;157;97;171;63;47;104;59;161;145;198;162;112;117;186;149;36;53;72;87;189;84;185;187;90;11;194;14;159;40;71;69;16;119;57;127;5;108;68;30;58;188;32;195;44,392155436905211646,0.000000
greedy_intra:edges_start:random,155,254478,150603,103875,1,0,66;172;124;11;20;68;155;74;70;113;114;185;26;162;37;164;2;58;1;4;156;72;38;138;80;150;88;35;18;159;173;27;112;199;186;32;196;175;6;31;115;97;57;128;107;9;135;85;119;118;12;149;108;99;102;143;103;105;33;198;146;197;139;87;134;47;132;62;147;161;0;22;194;148;100;127;189;158;77;67;130;46;110;71;98;160;183;151;166;137;76;184;176;73;141;152;93;169;25;116,272734153815022698,0.000000
greedy_intra:edges_start:random,156,274738,174337,100401,1,0,3;154;179;76;28;135;79;134;50;186;122;19;70;16;126;130;191;193;174;60;23;71;188;48;90;131;125;82;22;95;117;143;196;62;128;199;169;198;113;31;123;92;136;140;190;20;150;1;32;167;189;158;64;63;141;41;133;153;86;85;38;102;121;24;138;194;155;7;168;116;2;44;114;149;120;34;91;118;139;127;13;29;192;83;98;5;77;111;171;112;42;163;36;180;15;25;103;137;53;160,1752455803026395345,0.000000
greedy_intra:edges_start:random,157,253872,159661,94211,1,0,12;54;199;137;65;148;47;117;156;176;155;179;132;140;121;89;198;59;141;28;7;189;195;18;66;147;10;49;187;1;0;178;88;26;115;135;80;111;138;194;186;158;69;182;9;163;5;169;35;4;91;167;112;110;160;126;113;30;32;14;16;95;143;149;50;61;99;3;37;64;101;157;100;124;48;144;181;31;139;62;168;21;134;183;129;114;159;22;41;122;74;174;116;133;102;72;192;180;162;145,6497085440011274778,0.001029
greedy_intra:edges_start:random,158,262476,162587,99889,1,0,126;105;4;153;80;113;160;103;164;62;159;3;33;127;48;148;100;67;22;191;21;81;39;58;96;82;196;161;106;43;125;190;36;130;123;84;149;186;116;199;71;178;118;20;151;73;165;147;59;108;88;35;11;9;53;85;19;129;72;2;114;69;174;168;61;31;166;10;136;170;5;119;97;157;117;194;63;24;169;16;187;49;139;0;26;144;110;184;176;64;192;179;13;54;177;37;76;141;142;131,2984106826344595096,0.000000
greedy_intra:edges_start:random,159,281718,174553,107165,1,0,197;0;181;60;48;143;10;15;107;90;69;170;188;72;77;70;187;35;98;85;103;84;172;142;101;156;3;125;45;141;111;112;192;193;46;95;166;177;115;91;44;100;169;163;135;34;26;93;124;36;24;191;81;19;130;137;185;123;73;53;178;25;8;126;14;66;23;199;138;102;32;116;99;104;56;160;52;67;174;194;152;154;97;128;75;78;149;47;13;198;6;37;61;28;140;11;58;176;57;119,66255528100332817,0.000000
greedy_intra:edges_start:random,160,264232,168201,96031,1,0,87;89;64;176;152;188;141;148;117;34;50;136;108;128;129;190;90;164;151;72;198;169;161;71;195;56;154;66;112;142;10;192;33;81;150;29;116;61;11;60;6;95;121;153;75;19;119;138;146;180;166;157;42;83;187;171;0;48;58;80;113;15;55;12;137;114;18;69;111;78;26;104;53;59;120;197;133;62;85;21;110;86;82;123;63;25;31;68;193;143;65;175;145;13;23;125;57;88;194;27,3675496998861250177,0.000000
greedy_intra:edges_start:random,161,251734,155270,96464,1,0,53;36;44;55;164;148;52;192;138;94;80;107;43;162;81;66;113;191;83;13;124;116;167;168;56;37;79;143;129;163;48;45;38;175;74;47;90;120;59;182;121;6;141;195;60;41;46;153;127;21;185;72;39;105;22;166;160;4;101;68;117;62;115;170;189;197;118;152;32;135;109;91;194;42;61;11;71;106;86;123;169;150;84;10;26;161;29;176;23;9;96;130;154;183;25;0;132;147;155;158,6354506208945792968,0.000000
greedy_intra:edges_start:random,162,254834,156882,97952,2,1,144;107;82;14;89;70;182;96;52;81;141;76;88;190;54;0;139;13;83;3;157;22;127;101;185;58;150;138;43;128;103;169;102;34;79;8;152;68;33;64;191;163;137;122;159;110;164;9;74;25;143;124;195;121;23;78;161;183;18;49;60;77;125;26;186;177;197;166;45;184;109;113;187;56;20;192;134;100;97;117;2;66;16;175;55;30;162;99;94;71;160;92;168;32;147;51;123;53;75;155,8692864339757567047,0.000000
greedy_intra:edges_start:random,163,255239,154673,100566,2,1,113;38;106;141;43;164;136;8;0;155;152;34;76;36;77;161;7;151;25;52;83;14;66;53;58;94;37;57;109;55;102;170;140;166;137;64;87;16;182;150;148;103;48;121;147;79;97;61;119;56;84;172;127;18;195;108;46;78;9;33;110;1;22;63;133;129;178;116;187;191;146;23;30;32;107;131;5;130;98;120;81;101;122;6;29;190;188;114;196;181;71;105;104;143;162;180;96;60;142;41,864404062112045746,0.000000
greedy_intra:edges_start:random,164,266387,174689,91698,3,2,121;17;124;70;18;116;177;23;82;93;80;12;57;129;182;157;196;50;48;198;151;163;59;67;49;143;58;164;155;87;117;103;150;35;92;69;8;1;165;176;174;156;73;68;119;34;127;108;122;99;146;112;13;100;149;27;183;62;42;171;56;4;126;128;76;154;173;101;147;110;51;113;102;32;192;107;53;15;86;72;65;132;185;46;160;162;159;144;30;25;180;131;136;134;139;95;190;16;10;96,2542342581882279091,0.001444
greedy_intra:edges_start:random,165,259927,164648,95279,2,1,76;154;97;66;192;195;120;157;82;53;117;0;77;131;51;106;37;47;103;190;144;174;172;121;141;184;84;63;22;155;126;123;6;161;160;79;130;42;180;185;134;142;18;92;91;17;20;186;132;46;59;191;78;109;7;85;125;36;88;93;69;135;87;34;137;166;118;41;33;145;67;61;16;153;105;175;32;143;80;9;128;19;177;102;116;127;188;94;81;43;90;108;150;193;86;159;50;52;112;25,3417782577750210086,0.000529
greedy_intra:edges_start:random,166,265229,165445,99784,2,1,191;8;15;10;90;188;37;113;122;192;167;131;19;177;67;175;49;6;152;52;187;199;32;137;165;2;13;97;58;111;197;66;160;76;7;98;109;42;176;144;29;138;166;180;148;115;128;65;78;145;129;134;108;55;146;33;104;182;62;157;40;110;51;154;155;150;99;130;174;106;105;125;30;142;112;159;23;101;173;193;149;26;124;39;85;22;84;198;56;3;87;189;164;77;151;80;140;94;72;38,122272916646245819,0.000000
greedy_intra:edges_start:random,167,257607,159160,98447,1,0,68;26;45;58;61;66;108;29;137;159;180;39;123;90;177;136;161;182;62;132;30;22;172;19;166;141;116;150;1;153;36;41;38;70;91;64;63;59;34;194;98;92;162;183;78;100;50;165;46;5;144;0;111;121;110;181;176;127;171;75;25;28;142;99;12;74;115;147;134;94;197;11;14;37;188;189;102;192;173;49;148;114;35;103;80;163;93;20;44;67;40;120;4;95;117;6;193;195;84;55,7702047440764102951,0.000000
greedy_intra:edges_start:random,168,266424,169696,96728,1,0,33;112;196;93;54;194;66;143;149;107;117;132;106;161;188;27;152;1;156;170;167;125;189;94;145;82;17;108;72;197;191;45;138;180;25;184;173;101;30;183;185;78;77;163;182;9;5;148;14;56;150;89;79;50;139;137;166;147;44;154;34;174;83;6;67;16;121;159;39;172;91;115;0;49;63;160;127;181;64;55;4;81;100;73;13;105;153;23;123;119;102;146;31;190;140;141;92;118;116;48,595300627193714177,0.000000
greedy_intra:edges_start:random,169,257401,154391,103010,1,0,57;32;5;161;100;42;129;141;38;3;83;196;177;117;130;193;66;113;166;97;133;73;148;20;64;189;45;59;174;125;26;6;17;159;155;132;82;182;149;12;115;8;71;74;58;28;144;151;0;198;44;169;27;107;167;93;195;48;24;121;152;124;25;79;51;77;139;33;91;179;156;47;1;173;86;110;114;41;123;134;10;188;180;56;142;16;181;18;95;164;98;122;160;127;46;34;52;21;75;150,6197700725699801016,0.000000
greedy_intra:edges_start:random,170,251591,154890,96701,2,1,82;37;53;15;11;111;174;128;7;153;164;196;151;108;107;45;182;86;39;114;141;123;127;89;69;66;156;49;47;180;36;106;26;43;29;9;90;113;191;135;19;16;195;184;48;84;166;42;131;54;105;192;1;99;198;187;190;193;31;23;194;149;181;59;5;130;24;13;173;74;63;171;51;148;122;55;4;133;115;50;20;157;57;100;119;165;103;121;152;33;170;158;145;178;17;183;70;159;83;126,2773278360015318307,0.000000
greedy_intra:edges_start:random,171,265542,170935,94607,6,5,55;8;190;112;34;116;193;31;50;53;66;189;61;70;104;57;199;41;44;160;75;36;140;69;179;147;91;173;153;37;18;144;74;155;109;72;90;150;21;106;158;96;130;149;59;40;5;56;0;175;157;68;182;7;148;58;110;51;121;123;46;169;131;85;6;133;64;62;105;49;196;195;146;152;137;168;119;145;35;4;94;3;117;60;159;128;156;78;126;138;93;125;124;45;15;27;97;79;183;20,1021709338648976346,0.001001
greedy_intra:edges_start:random,172,261114,163189,97925,1,0,131;10;32;125;8;169;92;56;52;110;199;138;18;141;81;128;123;13;46;137;133;76;65;180;26;194;35;115;78;176;184;48;6;72;98;50;43;187;186;149;151;96;21;24;197;85;196;170;185;49;118;134;181;129;117;183;139;77;2;60;40;90;59;64;25;105;80;190;37;57;58;130;87;156;55;177;95;91;7;101;109;84;167;11;15;150;69;66;163;157;146;136;171;179;143;0;31;124;173;126,2270081909130695751,0.000000
greedy_intra:edges_start:random,173,269103,169482,99621,1,0,75;54;130;142;173;34;51;192;108;30;124;109;19;93;23;0;24;170;16;145;161;52;188;151;99;194;47;126;62;42;143;70;174;107;162;128;101;154;32;82;121;45;120;123;27;18;50;5;127;85;61;181;152;186;7;81;163;80;177;149;63;10;136;160;64;106;111;69;9;164;166;135;13;73;175;26;118;125;150;155;148;157;40;104;86;39;89;116;14;134;67;187;197;96;113;91;146;168;57;2,499916896629745850,0.001021
greedy_intra:edges_start:random,174,260234,162236,97998,3,2,172;44;24;162;178;174;170;8;160;57;175;2;105;176;169;107;72;69;134;18;148;179;45;75;35;163;12;5;143;68;184;13;149;25;140;27;135;34;100;127;42;50;51;4;14;119;130;183;83;17;86;30;58;62;101;95;29;141;194;147;40;61;161;53;63;191;138;199;129;37;97;131;152;6;48;1;79;192;94;198;150;59;137;108;84;109;32;113;111;114;117;66;55;33;73;110;7;82;165;39,7334368728867315968,0.000668
greedy_intra:edges_start:random,175,284218,183948,100270,2,1,120;58;126;186;42;163;77;171;44;183;39;96;7;156;121;134;110;195;104;53;0;82;72;22;89;175;63;177;17;118;141;13;11;51;187;5;124;23;103;69;155;10;18;25;93;109;123;119;12;38;173;37;105;4;19;113;54;107;167;32;131;8;15;189;76;137;87;90;55;193;114;50;30;168;136;196;128;164;33;92;176;47;81;127;165;27;91;98;28;122;159;31;185;84;191;46;100;20;86;75,6338047110204134904,0.000000
greedy_intra:edges_start:random,176,258020,165375,92645,2,1,104;90;15;102;54;100;80;89;2;117;196;27;113;170;38;154;186;10;146;174;92;162;30;145;112;159;88;73;62;152;0;69;86;3;180;77;167;43;127;53;82;11;121;109;49;140;130;192;141;78;108;151;51;81;138;13;12;33;143;76;94;68;173;45;103;24;50;5;129;123;110;25;126;41;172;1;74;199;115;19;125;128;4;178;46;18;56;188;75;79;14;63;198;157;120;98;165;105;26;184,5570893660671767939,0.000000
greedy_intra:edges_start:random,177,271988,171504,100484,1,0,98;46;152;82;128;113;62;16;138;67;195;132;88;51;13;76;144;20;38;90;104;120;8;44;155;91;173;170;41;31;28;37;9;36;148;73;34;63;32;143;193;80;191;126;39;110;134;30;81;136;97;159;79;179;114;111;166;11;135;54;86;78;49;66;182;145;105;186;96;21;93;117;45;154;161;95;5;197;40;164;69;27;189;194;6;198;12;92;127;33;85;0;180;141;10;109;160;26;149;169,6806825534879836104,0.000000
greedy_intra:edges_start:random,178,271267,170901,100366,4,3,18;38;61;32;26;109;187;170;144;36;116;168;100;39;157;196;138;161;111;108;46;171;174;114;43;14;197;96;104;85;154;7;156;186;107;176;188;133;72;192;33;135;82;66;179;185;103;142;141;198;56;112;164;113;52;105;199;42;2;28;172;40;75;79;35;91;74;8;148;81;97;16;98;76;151;147;67;139;57;23;73;88;110;194;119;195;191;127;34;183;0;1;193;45;84;55;22;94;49;190,2788724730839174939,0.001007
greedy_intra:edges_start:random,179,251457,155929,95528,3,2,173;69;117;31;26;20;126;46;152;122;198;151;177;193;57;9;158;192;160;29;60;170;61;91;142;38;82;14;6;1;136;150;0;81;139;155;2;30;24;90;64;92;121;28;41;146;93;137;100;86;165;185;25;36;55;72;35;96;195;62;194;40;182;83;180;167;134;66;131;140;4;43;79;114;154;110;120;97;42;87;19;141;145;76;144;184;148;32;181;52;80;78;10;75;13;153;168;17;147;65,634789359412897949,0.000000
greedy_intra:edges_start:random,180,252547,160819,91728,5,4,39;37;10;43;3;42;162;191;79;159;176;54;151;157;90;74;161;184;190;122;88;179;44;93;104;13;20;109;82;97;94;73;56;28;120;41;9;101;189;100;178;106;110;135;164;92;80;115;116;197;99;65;57;199;140;32;58;149;181;180;108;23;155;64;0;76;6;66;22;174;136;138;160;130;133;123;187;194;51;2;81;1;198;146;102;25;35;15;30;34;91;83;103;114;183;69;11;124;121;46,1243378688736265127,0.000000
greedy_intra:edges_start:random,181,258409,156060,102349,4,3,44;104;19;58;24;177;118;56;18;73;107;122;102;1;182;103;179;117;55;81;140;41;162;167;101;158;192;155;91;187;150;119;178;16;50;35;92;34;78;52;0;43;3;28;154;67;36;10;131;160;115;132;105;110;183;100;6;185;5;87;49;152;112;60;82;195;166;126;114;17;198;142;125;196;9;7;61;176;45;51;124;14;169;121;135;173;157;97;172;149;120;23;136;174;98;66;37;47;79;27,637917834665049954,0.000983
greedy_intra:edges_start:random,182,262951,163511,99440,1,0,161;171;76;51;101;189;164;53;167;199;163;43;158;8;153;74;94;124;148;149;44;113;146;116;34;122;55;187;4;0;71;160;134;56;57;79;88;123;128;50;114;64;183;176;95;69;198;70;15;131;21;68;188;185;139;125;1;33;72;89;130;47;28;154;93;112;157;19;35;184;121;100;141;127;32;59;107;172;138;169;58;54;155;177;42;197;173;11;81;37;30;26;104;193;111;192;85;175;180;105,2457315852270948320,0.000000
greedy_intra:edges_start:random,183,265064,165631,99433,1,0,22;11;101;100;130;68;148;34;144;73;164;9;156;167;57;176;10;162;170;134;58;98;126;16;190;43;152;188;7;12;168;51;177;146;138;40;119;120;49;140;194;86;94;69;184;8;89;71;166;193;110;4;63;25;23;39;28;77;90;30;84;107;79;132;97;66;46;196;150;74;56;163;91;82;172;60;6;95;62;55;13;109;125;160;114;45;122;117;111;175;41;139;61;3;195;31;64;26;37;155,1493271174288063401,0.000000
greedy_intra:edges_start:random,184,261280,165410,95870,2,1,99;75;135;51;173;85;25;27;70;127;83;62;146;166;149;162;103;144;14;147;95;0;10;178;98;91;156;28;73;82;168;137;52;34;107;5;78;86;101;113;165;171;141;12;61;96;189;152;136;35;2;115;186;11;118;38;50;131;145;121;198;133;160;19;199;17;22;164;117;94;154;157;140;192;177;26;49;76;68;81;92;64;110;191;31;44;105;72;143;172;67;100;40;195;4;9;169;57;175;130,2953001167742478253,0.000000
greedy_intra:edges_start:random,185,277870,176978,100892,3,2,142;68;107;89;112;190;72;138;97;98;71;44;74;22;136;35;154;124;20;133;179;189;150;40;85;4;54;24;114;82;181;61;41;93;166;104;3;126;42;46;29;130;137;116;197;123;69;125;156;115;151;171;192;52;5;86;48;165;183;121;77;95;18;32;110;88;51;76;67;45;157;139;193;188;113;191;117;158;108;30;109;36;172;127;140;184;80;50;141;34;17;66;145;162;64;25;111;106;160;94,2654896108498793759,0.000000
greedy_intra:edges_start:random,186,289260,186001,103259,1,0,174;106;162;123;163;77;187;112;37;20;71;86;84;172;60;109;116;184;98;87;173;189;53;9;67;56;90;199;171;17;192;198;188;157;158;195;127;88;63;50;118;185;7;64;65;89;119;196;183;12;58;160;74;124;42;194;91;107;23;141;24;14;159;85;51;179;125;110;6;170;38;131;46;100;135;59;175;21;47;151;164;45;134;97;78;54;153;138;22;95;36;30;168;167;76;33;75;34;146;113,6608813821895454095,0.000000
greedy_intra:edges_start:random,187,250417,153862,96555,1,0,45;187;17;4;54;67;3;89;83;146;197;148;12;50;78;132;16;22;107;165;168;29;128;134;21;65;9;44;30;191;108;15;94;145;40;143;20;25;170;194;190;147;10;120;115;149;35;34;60;88;74;69;171;98;81;130;82;43;133;154;184;66;110;126;127;176;180;96;62;32;164;102;156;166;177;103;199;151;57;182;46;91;118;5;123;159;186;48;90;55;19;31;172;59;37;73;47;135;157;117,8697908202460786474,0.000000
greedy_intra:edges_start:random,188,274880,168853,106027,1,0,160;7;108;32;9;103;129;33;196;184;126;67;81;76;22;61;8;37;145;149;163;177;90;166;107;175;142;43;190;195;148;119;125;52;189;17;50;21;146;138;6;147;186;104;128;141;179;26;84;47;159;197;23;78;130;68;150;25;167;80;127;118;97;83;161;111;171;100;169;153;194;99;28;117;45;65;1;66;64;156;109;49;92;86;85;40;140;170;187;11;36;12;62;94;42;10;58;46;14;18,5168793490166314706,0.001000
greedy_intra:edges_start:random,189,257162,153024,104138,2,1,88;53;113;23;117;179;11;112;155;38;62;24;190;83;122;129;162;91;146;175;165;185;109;50;110;131;0;26;125;118;47;67;169;63;33;168;184;114;145;191;96;167;182;45;166;89;178;73;81;39;76;64;19;130;105;27;10;66;147;124;159;18;42;59;128;9;14;142;140;20;195;1;25;174;71;149;135;103;84;189;157;78;32;120;134;148;6;115;143;164;3;7;136;31;100;98;119;152;107;87,4021388956838625826,0.000000
greedy_intra:edges_start:random,190,266751,162489,104262,1,0,199;118;3;34;156;117;74;185;6;50;45;124;163;196;176;104;177;9;106;13;153;43;99;181;15;183;87;90;82;55;95;107;100;151;4;147;198;91;195;58;75;165;159;35;114;67;182;111;194;80;125;164;138;170;174;157;0;63;65;122;47;1;173;66;149;152;101;17;145;25;18;109;54;19;141;96;79;178;38;136;48;8;32;29;76;98;155;129;36;187;166;31;186;78;68;144;49;150;172;16,5091862676945723023,0.000000
greedy_intra:edges_start:random,191,267805,171078,96727,1,0,65;3;197;155;187;186;78;190;144;54;90;71;86;45;56;149;177;105;10;18;159;94;102;116;12;43;192;129;196;89;70;8;145;180;174;76;50;15;146;127;96;164;160;147;20;23;81;91;110;123;55;64;39;59;69;134;61;58;29;150;194;63;47;168;120;48;195;79;193;101;121;138;34;75;117;108;125;42;132;60;172;31;191;22;183;66;62;104;0;122;49;11;198;77;40;169;87;21;182;166,8792287374853312469,0.000000
greedy_intra:edges_start:random,192,263344,166449,96895,2,1,124;63;103;151;52;167;5;163;76;20;156;81;179;4;71;198;135;118;59;53;147;185;35;128;144;132;1;106;86;142;191;177;89;79;85;166;72;186;43;15;109;88;102;73;62;24;0;161;18;173;93;101;158;170;150;100;187;40;146;148;99;176;90;140;123;42;136;183;162;56;58;190;16;122;197;2;39;8;77;157;98;29;78;47;112;143;9;6;97;28;192;22;107;87;105;199;25;115;36;26,3114541990604784668,0.000000
greedy_intra:edges_start:random,193,247308,149641,97667,6,5,193;72;46;158;99;127;108;183;145;82;118;92;111;83;39;133;63;189;34;104;194;62;174;107;123;59;176;90;113;161;77;76;35;96;91;186;31;185;112;37;75;13;67;51;100;53;36;115;98;12;22;18;136;55;38;73;11;142;198;105;2;103;56;32;140;141;132;24;79;84;33;121;165;81;25;119;192;148;27;102;16;157;88;175;131;199;94;66;9;130;162;44;7;182;17;70;116;1;110;74,6440253033907880926,0.001000
greedy_intra:edges_start:random,194,263476,165427,98049,5,4,134;12;111;185;141;38;59;148;49;102;174;5;1;9;94;17;128;118;92;29;117;57;58;110;43;149;3;21;8;109;62;18;143;161;88;150;168;91;84;85;33;44;6;42;155;180;133;144;30;126;188;26;186;46;103;106;74;48;93;139;175;13;64;101;23;70;75;130;119;80;60;2;184;187;86;11;172;135;198;177;171;67;36;183;124;152;95;156;137;35;65;167;56;105;7;166;37;81;27;145,1241658467933193904,0.001004
greedy_intra:edges_start:random,195,270680,179295,91385,1,0,107;148;3;143;15;30;117;180;34;97;118;191;171;111;63;8;52;151;85;19;96;187;44;38;60;45;95;122;127;119;43;175;100;152;112;71;199;98;4;51;54;157;162;40;139;72;102;7;167;114;2;189;129;116;164;155;28;181;134;94;154;178;144;125;124;198;64;166;59;130;93;66;58;138;21;142;196;132;6;165;35;145;99;123;14;36;86;193;55;27;149;160;188;42;49;135;65;89;109;126,2817434882612178928,0.000000
greedy_intra:edges_start:random,196,261929,163879,98050,1,0,174;110;117;102;184;153;171;172;178;187;12;142;134;148;79;159;29;145;150;87;118;199;92;14;96;101;30;93;51;122;67;21;70;19;58;68;37;149;123;157;165;22;11;180;140;80;16;73;126;6;170;41;144;132;27;155;85;43;55;120;141;94;119;84;108;107;35;88;158;188;52;56;18;176;99;162;151;168;147;127;57;115;4;47;156;65;109;186;0;189;95;17;137;42;74;54;146;103;105;175,2331297633495033118,0.000000
greedy_intra:edges_start:random,197,265605,165222,100383,1,0,75;45;35;164;78;49;190;67;137;154;124;10;109;167;160;126;104;106;54;141;24;156;99;145;77;55;139;88;174;111;59;76;9;38;119;57;95;64;3;33;13;69;61;122;133;58;102;163;103;169;91;34;5;148;110;166;28;172;30;170;11;185;92;123;22;65;159;144;1;25;83;97;108;150;16;105;158;17;191;146;56;27;32;155;182;43;39;20;127;6;89;90;40;53;142;112;63;153;101;42,4362127720771408275,0.000000
greedy_intra:edges_start:random,198,261749,161385,100364,3,2,11;47;119;27;170;185;163;6;164;112;118;193;179;126;178;68;158;96;135;91;19;155;60;59;199;64;93;187;40;78;183;23;165;130;115;48;63;42;161;2;123;88;4;106;125;26;141;95;105;3;81;148;76;15;101;138;70;167;108;194;13;80;174;186;83;110;24;75;45;100;132;71;121;162;146;142;180;192;65;133;90;36;111;109;128;46;149;72;195;43;157;113;57;69;117;169;150;191;92;114,3693377573032052007,0.000000
greedy_intra:edges_start:random,199,259136,162695,96441,1,0,162;189;72;122;57;135;128;73;8;160;137;10;107;74;114;38;80;157;76;97;148;178;33;84;119;20;164;91;106;161;45;123;130;18;37;180;95;101;195;184;26;103;11;47;16;181;48;124;125;99;134;3;68;197;52;13;65;167;176;105;169;150;159;185;120;66;15;2;46;186;190;108;41;136;183;198;49;75;5;62;142;94;100;140;90;133;60;71;39;194;98;63;96;116;28;79;179;129;87;111,334746868810611448,0.000000
greedy_intra:edges_start:greedy,0,71108,22981,48127,1,0,0;117;143;183;89;186;23;137;176;80;79;63;94;124;152;97;1;101;2;120;82;129;57;92;55;52;49;102;148;9;62;144;14;138;178;106;185;165;40;90;81;196;179;145;78;31;56;113;175;171;16;25;44;75;86;26;100;121;53;180;154;135;70;127;123;162;133;151;51;118;59;65;116;43;184;84;112;4;190;10;177;54;48;160;34;146;22;18;108;69;159;181;42;5;115;41;193;139;68;46,11530283595482630,0.000000
greedy_intra:edges_start:greedy,1,71933,23455,48478,1,0,1;101;75;86;53;154;70;135;180;63;79;133;51;118;59;115;46;0;143;117;93;140;68;139;193;41;5;42;181;159;69;108;18;22;146;34;160;48;54;177;190;184;43;116;65;149;123;127;162;151;80;176;137;23;183;89;186;114;15;9;62;144;14;138;165;40;185;90;81;196;179;145;78;31;56;113;175;171;16;25;44;120;2;129;92;57;55;52;106;178;49;102;148;124;94;189;100;26;97;152,2484354568480038571,0.000000
greedy_intra:edges_start:greedy,2,71905,23579,48326,1,0,2;129;57;92;55;52;49;102;148;9;62;144;14;138;178;106;185;165;40;90;81;196;179;145;78;31;56;113;175;171;16;25;44;120;75;86;26;189;94;63;79;80;176;133;151;51;118;59;115;46;0;137;23;186;89;183;143;117;93;140;68;139;193;41;5;42;181;159;69;108;18;22;146;34;160;48;54;177;10;190;84;184;43;116;65;131;149;162;123;127;70;135;154;180;53;100;101;1;97;152,7896145180824417023,0.000000
greedy_intra:edges_start:greedy,3,71813,23409,48404,1,0,3;14;144;62;9;148;102;49;178;106;52;55;57;92;129;2;152;97;1;101;100;53;180;154;135;70;127;123;162;149;131;65;116;43;184;84;190;10;177;54;48;160;34;146;22;18;108;69;159;181;42;5;41;193;139;68;140;93;117;143;183;89;186;23;137;0;46;115;59;118;51;151;133;176;80;79;63;94;189;26;86;75;120;44;25;16;171;175;113;56;31;78;145;179;196;81;90;185;40;165,8369462169296383276,0.000998
greedy_intra:edges_start:greedy,4,72214,24115,48099,1,0,4;190;10;177;54;48;34;160;181;42;146;22;18;108;69;159;41;193;139;68;46;115;118;59;116;65;43;184;35;131;149;123;162;151;133;51;0;117;143;183;89;23;137;176;80;79;63;94;124;152;97;1;101;2;120;82;129;57;92;55;52;49;102;148;9;62;144;14;138;178;106;185;165;40;90;81;196;179;145;78;31;56;113;175;171;16;25;44;75;86;26;100;121;53;180;154;135;70;127;112,9132682473641131872,0.000000
greedy_intra:edges_start:greedy,5,71757,23388,48369,1,0,5;43;116;65;149;123;127;162;151;133;135;70;154;180;53;121;100;26;86;75;44;25;16;171;175;113;56;31;78;145;179;196;81;90;40;165;185;106;178;138;14;144;62;9;148;102;49;52;55;92;57;129;82;120;2;101;1;97;152;124;94;63;79;80;176;137;23;186;89;183;143;117;0;51;118;59;115;46;68;139;41;193;159;69;108;18;22;146;181;34;160;48;54;177;10;190;4;84;184;42,8280142042819185539,0.000000
greedy_intra:edges_start:greedy,6,72451,23177,49274,1,0,6;154;53;121;100;26;86;75;101;1;97;152;94;124;148;102;49;178;106;52;55;57;92;129;2;120;44;25;16;171;175;113;56;31;78;145;179;196;81;90;185;40;165;138;14;144;62;9;15;114;186;89;183;23;137;176;80;151;162;127;123;149;65;116;43;184;177;54;48;160;34;146;22;18;108;69;159;181;42;5;41;193;139;68;140;93;117;143;0;46;115;59;118;51;133;79;63;180;70;135,5099744599457231308,0.000000
greedy_intra:edges_start:greedy,7,72637,24199,48438,1,0,7;21;144;62;9;148;102;14;49;178;106;52;55;165;185;40;179;145;78;92;57;129;2;152;97;1;101;100;53;180;154;135;70;127;123;162;149;65;116;43;184;177;54;48;160;34;146;22;18;108;69;159;181;42;5;41;193;139;68;140;93;117;143;183;89;23;137;0;46;115;59;118;51;151;133;176;80;79;63;94;189;26;86;75;120;44;25;16;171;175;113;56;31;157;196;81;90;27;71;164,1079640023361479946,0.000000
greedy_intra:edges_start:greedy,8,71847,23063,48784,1,0,8;165;40;185;90;81;196;179;145;78;31;56;113;175;171;16;25;44;120;75;86;26;189;94;63;79;80;176;133;151;51;118;59;115;46;0;137;23;186;89;183;143;117;93;140;68;139;193;41;5;42;181;159;69;108;18;22;146;34;160;48;54;177;10;190;184;43;116;65;131;149;162;123;127;70;135;154;180;53;100;101;1;97;152;2;129;92;57;55;52;106;178;49;102;148;9;62;144;14;138,7395724659216328778,0.000518
greedy_intra:edges_start:greedy,9,71523,23197,48326,1,0,9;148;102;49;178;106;52;55;57;92;129;2;152;97;1;101;100;53;180;154;135;70;127;123;162;149;131;65;116;43;184;84;190;10;177;54;48;160;34;146;22;18;108;69;159;181;42;5;41;193;139;68;140;93;117;143;183;89;186;23;137;0;46;115;59;118;51;151;133;176;80;79;63;94;189;26;86;75;120;44;25;16;171;175;113;56;31;78;145;179;196;81;90;185;40;165;138;14;144;62,2031269111815285095,0.000000
greedy_intra:edges_start:greedy,10,72214,24115,48099,1,0,10;190;4;112;127;70;135;154;180;53;121;100;26;86;75;44;25;16;171;175;113;56;31;78;145;179;196;81;90;40;165;185;106;178;138;14;144;62;9;148;102;49;52;55;92;57;129;82;120;2;101;1;97;152;124;94;63;79;80;176;137;23;89;183;143;117;0;51;133;151;162;123;149;131;35;184;43;65;116;59;118;115;46;68;139;193;41;159;69;108;18;22;146;42;181;160;34;48;54;177,6855980840225177609,0.000000
greedy_intra:edges_start:greedy,11,72516,23391,49125,1,0,11;35;84;4;112;127;123;162;151;133;135;70;154;180;53;121;100;26;86;75;44;25;16;171;175;113;56;31;78;145;179;196;81;90;40;165;185;106;178;138;14;144;62;9;148;102;49;52;55;92;57;129;82;120;2;101;1;97;152;124;94;63;79;80;176;137;23;186;89;183;143;117;0;51;118;59;115;139;68;46;65;116;43;42;5;41;193;159;69;108;18;22;146;181;34;160;48;54;177;184,2530467362060522530,0.000000
greedy_intra:edges_start:greedy,12,72899,23524,49375,1,0,12;94;152;97;1;101;2;120;82;129;57;92;179;145;78;31;56;113;175;171;16;25;44;75;86;26;100;121;53;158;154;70;135;180;63;79;133;51;118;59;115;46;0;143;117;93;140;68;139;193;41;5;42;181;159;69;108;18;22;146;34;160;48;54;177;184;43;116;65;149;123;162;151;80;176;137;23;183;89;186;114;15;9;62;144;14;138;165;90;81;196;40;185;55;52;106;178;49;102;148,5451870768912337506,0.000000
greedy_intra:edges_start:greedy,13,72754,23520,49234,1,0,13;31;145;78;92;179;196;81;90;40;165;185;106;178;138;14;144;62;9;148;102;49;52;55;57;129;2;152;97;1;101;100;53;180;154;135;70;127;123;162;149;131;65;116;43;184;190;10;177;54;48;160;34;146;22;18;108;69;159;181;42;5;41;193;139;68;140;93;117;143;183;89;186;23;137;0;46;115;59;118;51;151;133;176;80;79;63;94;189;26;86;75;120;44;25;16;171;175;113;56,6291869897973725400,0.000000
greedy_intra:edges_start:greedy,14,71523,23197,48326,1,0,14;144;62;9;148;102;49;178;106;52;55;57;92;129;2;152;97;1;101;100;53;180;154;135;70;127;123;162;149;131;65;116;43;184;84;190;10;177;54;48;160;34;146;22;18;108;69;159;181;42;5;41;193;139;68;140;93;117;143;183;89;186;23;137;0;46;115;59;118;51;151;133;176;80;79;63;94;189;26;86;75;120;44;25;16;171;175;113;56;31;78;145;179;196;81;90;185;40;165;138,7673261940423777834,0.000000
greedy_intra:edges_start:greedy,15,71602,23316,48286,1,0,15;144;14;138;165;40;185;90;81;196;179;145;78;31;56;113;175;171;16;25;44;120;75;86;26;189;94;63;79;80;176;133;151;51;118;59;115;46;0;137;23;186;89;183;143;117;93;140;68;139;193;41;5;42;181;159;69;108;18;22;146;34;160;48;54;177;10;190;184;43;116;65;131;149;162;123;127;70;135;154;180;53;100;101;1;97;152;2;129;92;57;55;52;106;178;49;102;62;9;148,5842972981831032738,0.000000
greedy_intra:edges_start:greedy,16,72017,23691,48326,1,0,16;25;44;120;75;86;26;189;94;63;79;80;176;133;151;51;118;59;115;46;0;137;23;186;89;183;143;117;93;140;68;139;193;41;5;42;181;159;69;108;18;22;146;34;160;48;54;177;10;190;84;184;43;116;65;131;149;162;123;127;70;135;154;180;53;100;101;1;97;152;2;129;57;55;52;49;102;148;9;62;144;14;138;178;106;185;165;40;90;81;196;179;92;78;145;31;56;113;175;171,2476555353416818359,0.000000
greedy_intra:edges_start:greedy,17,73438,23931,49507,1,0,17;196;81;90;27;71;164;7;95;39;165;40;185;106;178;138;14;144;62;9;148;102;49;52;55;57;129;92;179;145;78;82;2;152;97;1;101;53;180;154;135;70;127;123;162;149;65;116;43;184;177;54;48;160;34;146;22;18;108;159;181;42;41;193;139;68;140;93;117;143;183;89;23;137;0;46;115;59;118;51;151;133;176;80;79;63;94;26;86;75;120;44;25;16;171;175;113;56;31;157,806994410671474774,0.000000
greedy_intra:edges_start:greedy,18,71968,23472,48496,1,0,18;22;146;159;193;41;5;42;181;34;160;48;54;177;10;190;4;84;184;43;116;65;149;123;127;162;151;133;135;70;154;180;53;121;100;26;86;75;44;25;16;171;175;113;56;31;78;145;179;196;81;90;40;165;185;106;178;138;14;144;62;9;148;102;49;52;55;92;57;129;82;120;2;101;1;97;152;124;94;63;79;80;176;137;51;118;59;115;139;46;68;0;89;183;143;117;93;140;108;69,9096879122909770290,0.000000
greedy_intra:edges_start:greedy,19,72190,22856,49334,1,0,19;94;124;148;102;49;178;106;52;55;57;92;129;2;120;44;25;16;171;175;113;56;31;78;145;179;196;81;90;185;40;165;138;14;144;62;9;15;114;186;89;183;23;137;176;80;151;162;123;149;65;116;43;184;177;54;48;160;34;146;22;18;108;69;159;181;42;5;41;193;139;68;140;93;117;143;0;46;115;59;118;51;133;79;63;180;135;70;154;158;53;121;100;26;86;75;101;1;97;152,4306245327871687639,0.000000
greedy_intra:edges_start:greedy,20,72394,23430,48964,1,0,20;22;146;159;193;41;5;42;181;34;160;48;54;177;10;190;84;184;43;116;65;149;123;127;162;151;133;135;70;154;180;53;121;100;26;86;75;44;25;16;171;175;113;56;31;78;145;179;196;81;90;40;165;185;106;178;138;14;144;62;9;148;102;49;52;55;92;57;129;82;120;2;101;1;97;152;124;94;63;79;80;176;137;51;118;59;115;139;46;68;0;89;183;143;117;93;140;108;69;18,5564848974561539239,0.000000
greedy_intra:edges_start:greedy,21,71988,23819,48169,1,0,21;14;138;165;40;185;90;81;196;179;145;78;31;56;113;175;171;16;25;44;120;75;86;26;189;94;63;79;80;176;133;151;51;118;59;115;46;0;137;23;186;89;183;143;117;93;140;68;139;193;41;5;42;181;159;69;108;18;22;146;34;160;48;54;177;10;190;184;43;116;65;131;149;162;123;127;70;135;154;180;53;100;101;1;97;152;2;129;92;57;55;52;106;178;49;102;148;9;62;144,1885517658775405437,0.001005
greedy_intra:edges_start:greedy,22,71385,23490,47895,1,0,22;146;181;34;160;48;54;177;10;190;4;112;84;184;42;43;116;65;149;123;127;162;151;133;135;70;154;180;53;121;100;26;86;75;44;25;16;171;175;113;56;31;78;145;179;196;81;90;40;165;185;106;178;138;14;144;62;9;148;102;49;52;55;92;57;129;82;120;2;101;1;97;152;124;94;63;79;80;176;137;23;186;89;183;143;117;0;51;118;59;115;46;68;139;41;193;159;69;108;18,5714564862100532647,0.000000
greedy_intra:edges_start:greedy,23,71108,22981,48127,1,0,23;137;176;80;79;63;94;124;152;97;1;101;2;120;82;129;57;92;55;52;49;102;148;9;62;144;14;138;178;106;185;165;40;90;81;196;179;145;78;31;56;113;175;171;16;25;44;75;86;26;100;121;53;180;154;135;70;127;123;162;133;151;51;118;59;65;116;43;184;84;112;4;190;10;177;54;48;160;34;146;22;18;108;69;159;181;42;5;115;41;193;139;68;46;0;117;143;183;89;186,9016248756885944093,0.000000
greedy_intra:edges_start:greedy,24,72431,23484,48947,1,0,24;149;65;116;43;184;84;190;10;177;54;48;160;34;146;22;18;108;69;159;181;42;5;41;193;139;68;46;115;59;118;51;0;117;143;183;89;186;23;137;176;80;79;63;94;124;152;97;1;101;2;120;82;129;57;92;55;52;49;102;148;9;62;144;14;138;178;106;185;165;40;90;81;196;179;145;78;31;56;113;175;171;16;25;44;75;86;26;100;121;53;180;154;70;135;133;151;162;127;123,1429693150662096738,0.000999
greedy_intra:edges_start:greedy,25,71905,23579,48326,1,0,25;44;120;75;86;26;189;94;63;79;80;176;133;151;51;118;59;115;46;0;137;23;186;89;183;143;117;93;140;68;139;193;41;5;42;181;159;69;108;18;22;146;34;160;48;54;177;10;190;84;184;43;116;65;131;149;162;123;127;70;135;154;180;53;100;101;1;97;152;2;129;57;92;55;52;49;102;148;9;62;144;14;138;178;106;185;165;40;90;81;196;179;145;78;31;56;113;175;171;16,9189813284133801976,0.000000
greedy_intra:edges_start:greedy,26,71591,23565,48026,1,0,26;97;1;101;75;86;53;154;70;135;180;63;79;133;51;118;59;115;46;0;143;117;93;140;68;139;193;41;5;42;181;159;69;108;18;22;146;34;160;48;54;177;10;190;184;43;116;65;149;123;127;162;151;80;176;137;23;183;89;186;114;15;9;62;144;14;138;165;40;185;90;81;196;179;145;78;31;56;113;175;171;16;25;44;120;2;129;92;57;55;52;106;178;49;102;148;124;94;152;100,4100670939499454530,0.000000
greedy_intra:edges_start:greedy,27,72164,23636,48528,1,0,27;71;164;7;95;39;165;138;14;144;62;9;148;102;49;178;106;52;55;57;92;129;2;152;97;1;101;100;53;180;154;135;70;127;123;162;149;65;116;43;184;177;54;48;160;34;146;22;18;108;69;159;181;42;5;41;193;139;68;140;93;117;143;183;89;23;137;0;46;115;59;118;51;151;133;176;80;79;63;94;26;86;75;120;44;25;16;171;175;113;56;31;78;145;179;196;81;185;40;90,5661830841442429576,0.000000
greedy_intra:edges_start:greedy,28,72501,23471,49030,1,0,28;43;65;116;131;149;123;127;162;151;133;135;70;154;180;53;121;100;26;86;75;44;25;16;171;175;113;56;31;78;145;179;196;81;90;40;165;185;106;178;138;14;144;62;9;148;102;49;52;55;92;57;129;82;120;2;101;1;97;152;124;94;63;79;80;176;137;23;186;89;183;143;117;0;51;59;118;115;46;68;139;193;41;5;42;181;159;69;108;18;22;146;34;160;48;54;177;10;190;184,7872865894214656541,0.000000
greedy_intra:edges_start:greedy,29,72298,23401,48897,1,0,29;112;4;84;35;184;177;54;48;160;34;181;146;22;18;108;69;159;193;41;5;42;43;116;65;46;68;139;115;59;118;51;0;117;143;183;89;186;23;137;176;80;79;63;94;124;152;97;1;101;2;120;82;129;57;92;55;52;49;102;148;9;62;144;14;138;178;106;185;165;40;90;81;196;179;145;78;31;56;113;175;171;16;25;44;75;86;26;100;121;53;180;154;70;135;133;151;162;123;127,5870711292752463128,0.000000
greedy_intra:edges_start:greedy,30,72324,23799,48525,1,0,30;54;177;10;190;84;184;43;65;116;59;118;115;46;0;51;151;133;162;123;127;70;135;154;180;53;121;100;26;86;75;44;25;16;171;175;113;56;31;78;145;179;196;81;90;40;165;185;106;178;138;14;144;62;9;148;102;49;52;55;92;57;129;82;120;2;101;1;97;152;124;94;63;79;80;176;137;23;186;89;183;143;117;93;140;68;139;193;41;159;69;108;18;22;146;195;42;181;160;34,8393938530325156632,0.000000
greedy_intra:edges_start:greedy,31,72017,23691,48326,1,0,31;145;78;92;179;196;81;90;40;165;185;106;178;138;14;144;62;9;148;102;49;52;55;57;129;2;152;97;1;101;100;53;180;154;135;70;127;123;162;149;131;65;116;43;184;84;190;10;177;54;48;160;34;146;22;18;108;69;159;181;42;5;41;193;139;68;140;93;117;143;183;89;186;23;137;0;46;115;59;118;51;151;133;176;80;79;63;94;189;26;86;75;120;44;25;16;171;175;113;56,4739503655328784436,0.000000
greedy_intra:edges_start:greedy,32,72151,23295,48856,1,0,32;14;144;62;9;148;102;49;178;106;52;55;57;92;129;2;152;97;1;101;100;53;180;154;135;70;127;123;162;149;131;65;116;43;184;84;190;10;177;54;48;160;34;146;22;18;108;69;159;181;42;5;41;193;139;68;140;93;117;143;183;89;186;23;137;0;46;115;59;118;51;151;133;176;80;79;63;94;189;26;86;75;120;44;25;16;171;175;113;56;31;78;145;179;196;81;90;185;40;165,7693440147677319173,0.000000
greedy_intra:edges_start:greedy,33,72265,23015,49250,1,0,33;102;49;178;106;52;55;57;92;129;2;152;97;1;101;100;53;180;154;135;70;127;123;162;149;131;65;116;43;184;190;10;177;54;48;160;34;146;22;18;108;69;159;181;42;5;41;193;139;68;140;93;117;143;183;89;186;23;137;0;46;115;59;118;51;151;133;176;80;79;63;94;189;26;86;75;120;44;25;16;171;175;113;56;31;78;145;179;196;81;90;185;40;165;138;14;144;62;9;148,6308881388092314057,0.000000
greedy_intra:edges_start:greedy,34,71385,23490,47895,1,0,34;181;146;22;18;108;69;159;193;41;139;68;46;115;59;118;51;0;117;143;183;89;186;23;137;176;80;79;63;94;124;152;97;1;101;2;120;82;129;57;92;55;52;49;102;148;9;62;144;14;138;178;106;185;165;40;90;81;196;179;145;78;31;56;113;175;171;16;25;44;75;86;26;100;121;53;180;154;70;135;133;151;162;127;123;149;65;116;43;42;184;84;112;4;190;10;177;54;48;160,2193550080310420185,0.001011
greedy_intra:edges_start:greedy,35,71935,23606,48329,1,0,35;84;4;112;127;123;162;151;133;135;70;154;180;53;121;100;26;86;75;44;25;16;171;175;113;56;31;78;145;179;196;81;90;40;165;185;106;178;138;14;144;62;9;148;102;49;52;55;92;57;129;82;120;2;101;1;97;152;124;94;63;79;80;176;137;23;186;89;183;143;117;0;51;118;59;115;139;68;46;65;116;43;42;5;41;193;159;69;108;18;22;146;181;34;160;48;54;177;190;184,9151615577467240234,0.000000
greedy_intra:edges_start:greedy,36,72462,23372,49090,1,0,36;108;69;18;22;146;159;193;41;5;42;181;34;160;48;54;177;10;190;84;184;43;116;65;149;123;127;162;151;133;135;70;154;180;53;121;100;26;86;75;44;25;16;171;175;113;56;31;78;145;179;196;81;90;40;165;185;106;178;138;14;144;62;9;148;102;49;52;55;92;57;129;82;120;2;101;1;97;152;124;94;63;79;80;176;137;51;118;59;115;139;46;68;0;89;183;143;117;93;140,7516670654713022008,0.000000
greedy_intra:edges_start:greedy,37,71679,23015,48664,1,0,37;102;49;178;106;52;55;57;92;129;2;152;97;1;101;100;53;180;154;135;70;127;123;162;149;131;65;116;43;184;190;10;177;54;48;160;34;146;22;18;108;69;159;181;42;5;41;193;139;68;140;93;117;143;183;89;186;23;137;0;46;115;59;118;51;151;133;176;80;79;63;94;189;26;86;75;120;44;25;16;171;175;113;56;31;78;145;179;196;81;90;185;40;165;138;14;144;62;9;148,5738340844614119475,0.000000
greedy_intra:edges_start:greedy,38,72529,23535,48994,1,0,38;145;78;92;179;196;81;90;40;165;185;106;178;138;14;144;62;9;148;102;49;52;55;57;129;2;152;97;1;101;100;53;180;154;135;70;127;123;162;149;131;65;116;43;184;190;10;177;54;48;160;34;146;22;18;108;69;159;181;42;5;41;193;139;68;140;93;117;143;183;89;186;23;137;0;46;115;59;118;51;151;133;176;80;79;63;94;189;26;86;75;120;44;25;16;171;175;113;56;31,6744156890250012742,0.000000
greedy_intra:edges_start:greedy,39,72098,23628,48470,1,0,39;95;7;164;27;90;40;185;81;196;179;145;78;31;56;113;175;171;16;25;44;120;75;86;26;189;94;63;79;80;176;133;151;51;118;59;115;46;0;137;23;89;183;143;117;93;140;68;139;193;41;5;42;181;159;69;108;18;22;146;34;160;48;54;177;184;43;116;65;149;162;123;127;70;135;154;180;53;100;101;1;97;152;2;129;92;57;55;52;106;178;49;102;148;9;62;144;14;138;165,8993322133878077610,0.000000
greedy_intra:edges_start:greedy,40,71523,23197,48326,1,0,40;165;138;14;144;62;9;148;102;49;178;106;52;55;57;92;129;2;152;97;1;101;100;53;180;154;135;70;127;123;162;149;131;65;116;43;184;84;190;10;177;54;48;160;34;146;22;18;108;69;159;181;42;5;41;193;139;68;140;93;117;143;183;89;186;23;137;0;46;115;59;118;51;151;133;176;80;79;63;94;189;26;86;75;120;44;25;16;171;175;113;56;31;78;145;179;196;81;90;185,6254929804730183384,0.000000
greedy_intra:edges_start:greedy,41,71947,23578,48369,1,0,41;5;42;181;159;69;108;18;22;146;34;160;48;54;177;10;190;4;84;184;43;116;65;149;123;127;162;151;133;135;70;154;180;53;121;100;26;86;75;44;25;16;171;175;113;56;31;78;145;179;196;81;90;40;165;185;106;178;138;14;144;62;9;148;102;49;52;55;92;57;129;82;120;2;101;1;97;152;124;94;63;79;80;176;137;23;186;89;183;143;117;0;51;118;59;115;46;68;139;193,9117405807374322181,0.000968
greedy_intra:edges_start:greedy,42,71947,23578,48369,1,0,42;5;41;193;139;68;46;115;59;118;51;0;117;143;183;89;186;23;137;176;80;79;63;94;124;152;97;1;101;2;120;82;129;57;92;55;52;49;102;148;9;62;144;14;138;178;106;185;165;40;90;81;196;179;145;78;31;56;113;175;171;16;25;44;75;86;26;100;121;53;180;154;70;135;133;151;162;127;123;149;65;116;43;184;84;4;190;10;177;54;48;160;34;146;22;18;108;69;159;181,1194512560443076318,0.000000
greedy_intra:edges_start:greedy,43,72083,23661,48422,1,0,43;65;116;59;118;115;46;0;51;151;133;162;123;127;70;135;154;180;53;121;100;26;86;75;44;25;16;171;175;113;56;31;78;145;179;196;81;90;40;165;185;106;178;138;14;144;62;9;148;102;49;52;55;92;57;129;82;120;2;101;1;97;152;124;94;63;79;80;176;137;23;186;89;183;143;117;93;140;68;139;193;41;5;42;181;159;69;108;18;22;146;34;160;48;54;177;10;190;84;184,2063938610749127530,0.000000
greedy_intra:edges_start:greedy,44,71905,23579,48326,1,0,44;25;16;171;175;113;56;31;78;145;179;196;81;90;40;165;185;106;178;138;14;144;62;9;148;102;49;52;55;92;57;129;2;152;97;1;101;100;53;180;154;135;70;127;123;162;149;131;65;116;43;184;84;190;10;177;54;48;160;34;146;22;18;108;69;159;181;42;5;41;193;139;68;140;93;117;143;183;89;186;23;137;0;46;115;59;118;51;151;133;176;80;79;63;94;189;26;86;75;120,991767895673246553,0.000000
greedy_intra:edges_start:greedy,45,73081,23748,49333,1,0,45;162;133;135;70;154;180;53;121;100;26;86;75;44;25;16;171;175;113;56;31;78;145;179;196;81;90;40;165;185;106;178;138;14;144;62;9;148;102;49;52;55;92;57;129;82;120;2;101;1;97;152;124;94;63;79;80;176;137;23;186;89;183;143;117;0;51;118;59;115;46;68;139;193;41;5;42;181;159;69;108;18;22;146;34;160;48;54;177;10;190;84;184;43;116;65;149;123;127;151,1698002036114008322,0.000000
greedy_intra:edges_start:greedy,46,71947,23578,48369,1,0,46;115;59;118;51;0;117;143;183;89;186;23;137;176;80;79;63;94;124;152;97;1;101;2;120;82;129;57;92;55;52;49;102;148;9;62;144;14;138;178;106;185;165;40;90;81;196;179;145;78;31;56;113;175;171;16;25;44;75;86;26;100;121;53;180;154;70;135;133;151;162;127;123;149;65;116;43;184;84;4;190;10;177;54;48;160;34;146;22;18;108;69;159;181;42;5;41;193;139;68,6186683004119929801,0.000000
greedy_intra:edges_start:greedy,47,72248,23594,48654,1,0,47;116;43;184;84;190;10;177;54;48;160;34;146;22;18;108;69;159;181;42;5;41;193;139;68;46;115;118;59;51;0;117;143;183;89;186;23;137;176;80;79;63;94;124;152;97;1;101;2;120;82;129;57;92;55;52;49;102;148;9;62;144;14;138;178;106;185;165;40;90;81;196;179;145;78;31;56;113;175;171;16;25;44;75;86;26;100;121;53;180;154;70;135;133;151;162;127;123;149;65,929966735349750361,0.000998
greedy_intra:edges_start:greedy,48,72287,23801,48486,1,0,48;34;160;181;42;195;146;22;18;108;69;159;41;193;139;68;140;93;117;143;183;89;186;23;137;176;80;79;63;94;124;152;97;1;101;2;120;82;129;57;92;55;52;49;102;148;9;62;144;14;138;178;106;185;165;40;90;81;196;179;145;78;31;56;113;175;171;16;25;44;75;86;26;100;121;53;180;154;135;70;127;123;162;133;151;51;0;46;115;118;59;116;65;43;184;84;190;10;177;54,5998418710908708742,0.000000
greedy_intra:edges_start:greedy,49,71523,23197,48326,1,0,49;178;106;52;55;57;92;129;2;152;97;1;101;100;53;180;154;135;70;127;123;162;149;131;65;116;43;184;84;190;10;177;54;48;160;34;146;22;18;108;69;159;181;42;5;41;193;139;68;140;93;117;143;183;89;186;23;137;0;46;115;59;118;51;151;133;176;80;79;63;94;189;26;86;75;120;44;25;16;171;175;113;56;31;78;145;179;196;81;90;185;40;165;138;14;144;62;9;148;102,8922091749660809184,0.000000
greedy_intra:edges_start:greedy,50,72985,23643,49342,1,0,50;175;171;16;25;44;120;75;86;26;189;94;63;79;80;176;133;151;51;118;59;115;46;0;137;23;186;89;183;143;117;93;140;68;139;193;41;5;42;181;159;69;108;18;22;146;34;160;48;54;177;10;190;184;43;116;65;131;149;162;123;127;70;135;154;180;53;100;101;1;97;152;2;129;57;55;52;49;102;148;9;62;144;14;138;178;106;185;165;40;90;81;196;179;92;78;145;31;56;113,7058993577041341902,0.000000
greedy_intra:edges_start:greedy,51,71947,23578,48369,1,0,51;118;59;115;46;68;139;193;41;5;42;181;159;69;108;18;22;146;34;160;48;54;177;10;190;4;84;184;43;116;65;149;123;127;162;151;133;135;70;154;180;53;121;100;26;86;75;44;25;16;171;175;113;56;31;78;145;179;196;81;90;40;165;185;106;178;138;14;144;62;9;148;102;49;52;55;92;57;129;82;120;2;101;1;97;152;124;94;63;79;80;176;137;23;186;89;183;143;117;0,8254637649548921742,0.000000
greedy_intra:edges_start:greedy,52,71590,23264,48326,1,0,52;178;106;49;102;148;9;62;144;14;138;165;40;185;90;81;196;179;145;78;31;56;113;175;171;16;25;44;120;75;86;26;189;94;63;79;80;176;133;151;51;118;59;115;46;0;137;23;186;89;183;143;117;93;140;68;139;193;41;5;42;181;159;69;108;18;22;146;34;160;48;54;177;10;190;84;184;43;116;65;131;149;162;123;127;70;135;154;180;53;100;101;1;97;152;2;129;92;57;55,1310398007235877965,0.000000
greedy_intra:edges_start:greedy,53,71750,23180,48570,1,0,53;158;154;70;135;180;63;79;133;51;118;59;115;46;0;143;117;93;140;68;139;193;41;5;42;181;159;69;108;18;22;146;34;160;48;54;177;184;43;116;65;149;123;127;162;151;80;176;137;23;183;89;186;114;15;9;62;144;14;138;165;40;185;90;81;196;179;145;78;31;56;113;175;171;16;25;44;120;2;129;92;57;55;52;106;178;49;102;148;124;94;152;97;1;101;75;86;26;100;121,4273982584615188685,0.000000
greedy_intra:edges_start:greedy,54,72287,23801,48486,1,0,54;48;34;160;181;42;195;146;22;18;108;69;159;41;193;139;68;140;93;117;143;183;89;186;23;137;176;80;79;63;94;124;152;97;1;101;2;120;82;129;57;92;55;52;49;102;148;9;62;144;14;138;178;106;185;165;40;90;81;196;179;145;78;31;56;113;175;171;16;25;44;75;86;26;100;121;53;180;154;135;70;127;123;162;133;151;51;0;46;115;118;59;116;65;43;184;84;190;10;177,8169571380944551533,0.000000
greedy_intra:edges_start:greedy,55,71590,23264,48326,1,0,55;52;178;106;49;102;148;9;62;144;14;138;165;40;185;90;81;196;179;145;78;31;56;113;175;171;16;25;44;120;75;86;26;189;94;63;79;80;176;133;151;51;118;59;115;46;0;137;23;186;89;183;143;117;93;140;68;139;193;41;5;42;181;159;69;108;18;22;146;34;160;48;54;177;10;190;84;184;43;116;65;131;149;162;123;127;70;135;154;180;53;100;101;1;97;152;2;129;92;57,3508324569815026185,0.000000
greedy_intra:edges_start:greedy,56,72017,23691,48326,1,0,56;31;145;78;92;179;196;81;90;40;165;185;106;178;138;14;144;62;9;148;102;49;52;55;57;129;2;152;97;1;101;100;53;180;154;135;70;127;123;162;149;131;65;116;43;184;84;190;10;177;54;48;160;34;146;22;18;108;69;159;181;42;5;41;193;139;68;140;93;117;143;183;89;186;23;137;0;46;115;59;118;51;151;133;176;80;79;63;94;189;26;86;75;120;44;25;16;171;175;113,7999663084787258566,0.000000
greedy_intra:edges_start:greedy,57,71704,23378,48326,1,0,57;55;52;49;102;148;9;62;144;14;138;178;106;185;165;40;90;81;196;179;145;78;31;56;113;175;171;16;25;44;120;75;86;26;189;94;63;79;80;176;133;151;51;118;59;115;46;0;137;23;186;89;183;143;117;93;140;68;139;193;41;5;42;181;159;69;108;18;22;146;34;160;48;54;177;10;190;84;184;43;116;65;131;149;162;123;127;70;135;154;180;53;100;101;1;97;152;2;129;92,6040348667934741852,0.000000
greedy_intra:edges_start:greedy,58,72703,24207,48496,1,0,58;71;27;90;81;196;157;31;56;113;175;171;16;25;44;120;75;86;26;94;63;79;80;176;133;151;51;118;59;115;46;0;137;23;89;183;143;117;93;140;68;139;193;41;5;42;181;159;69;108;18;22;146;34;160;48;54;177;184;43;116;65;149;162;123;127;70;135;154;180;53;100;101;1;97;152;2;129;57;92;78;145;179;40;185;165;55;52;106;178;49;14;102;148;9;62;144;21;7;164,1454019050356726010,0.000000
greedy_intra:edges_start:greedy,59,71947,23578,48369,1,0,59;115;46;68;139;193;41;5;42;181;159;69;108;18;22;146;34;160;48;54;177;10;190;4;84;184;43;116;65;149;123;127;162;151;133;135;70;154;180;53;121;100;26;86;75;44;25;16;171;175;113;56;31;78;145;179;196;81;90;40;165;185;106;178;138;14;144;62;9;148;102;49;52;55;92;57;129;82;120;2;101;1;97;152;124;94;63;79;80;176;137;23;186;89;183;143;117;0;51;118,830713569255650732,0.000000
greedy_intra:edges_start:greedy,60,72791,23521,49270,1,0,60;46;115;139;193;41;5;42;181;159;69;108;18;22;146;34;160;48;54;177;10;190;4;84;184;43;116;65;149;123;127;162;151;133;135;70;154;180;53;121;100;26;86;75;44;25;16;171;175;113;56;31;78;145;179;196;81;90;40;165;185;106;178;138;14;144;62;9;148;102;49;52;55;92;57;129;82;120;2;101;1;97;152;124;94;63;79;80;176;137;23;186;89;183;143;117;0;51;59;118,8564923192847408428,0.000000
greedy_intra:edges_start:greedy,61,72475,23085,49390,1,0,61;144;14;138;165;40;185;90;81;196;179;145;78;31;56;113;175;171;16;25;44;120;75;86;26;189;94;63;79;80;176;133;151;51;118;59;115;46;0;137;23;186;89;183;143;117;93;140;68;139;193;41;5;42;181;159;69;108;18;22;146;34;160;48;54;177;10;190;184;43;116;65;131;149;162;123;127;70;135;154;180;53;100;101;1;97;152;2;129;92;57;55;52;106;178;49;102;62;9;148,6935277060764285694,0.000000
greedy_intra:edges_start:greedy,62,71523,23197,48326,1,0,62;144;14;138;165;40;185;90;81;196;179;145;78;31;56;113;175;171;16;25;44;120;75;86;26;189;94;63;79;80;176;133;151;51;118;59;115;46;0;137;23;186;89;183;143;117;93;140;68;139;193;41;5;42;181;159;69;108;18;22;146;34;160;48;54;177;10;190;84;184;43;116;65;131;149;162;123;127;70;135;154;180;53;100;101;1;97;152;2;129;92;57;55;52;106;178;49;102;148;9,2052198339565167739,0.000000
greedy_intra:edges_start:greedy,63,71750,23180,48570,1,0,63;180;135;70;154;158;53;121;100;26;86;75;101;1;97;152;94;124;148;102;49;178;106;52;55;57;92;129;2;120;44;25;16;171;175;113;56;31;78;145;179;196;81;90;185;40;165;138;14;144;62;9;15;114;186;89;183;23;137;176;80;151;162;127;123;149;65;116;43;184;177;54;48;160;34;146;22;18;108;69;159;181;42;5;41;193;139;68;140;93;117;143;0;46;115;59;118;51;133;79,8142099610503367368,0.000000
greedy_intra:edges_start:greedy,64,72373,22854,49519,1,0,64;114;186;89;183;23;137;176;80;151;162;123;149;65;116;43;184;177;54;48;160;34;146;22;18;108;69;159;181;42;5;41;193;139;68;140;93;117;143;0;46;115;59;118;51;133;79;63;180;135;70;154;158;53;121;100;26;86;75;101;1;97;152;94;124;148;9;62;102;49;178;106;52;55;57;92;129;2;120;44;25;16;171;175;113;56;31;78;145;179;196;81;90;185;40;165;138;14;144;15,886621042573334438,0.000000
greedy_intra:edges_start:greedy,65,71947,23578,48369,1,0,65;149;123;127;162;151;133;135;70;154;180;53;121;100;26;86;75;44;25;16;171;175;113;56;31;78;145;179;196;81;90;40;165;185;106;178;138;14;144;62;9;148;102;49;52;55;92;57;129;82;120;2;101;1;97;152;124;94;63;79;80;176;137;23;186;89;183;143;117;0;51;118;59;115;46;68;139;193;41;5;42;181;159;69;108;18;22;146;34;160;48;54;177;10;190;4;84;184;43;116,3868564293869463115,0.000000
greedy_intra:edges_start:greedy,66,72976,23779,49197,1,0,66;51;118;59;115;46;0;89;183;143;117;93;140;68;139;193;41;5;42;181;159;69;108;18;22;146;34;160;48;54;177;10;190;84;184;43;116;65;149;123;127;162;151;133;135;70;154;180;53;121;100;26;86;75;44;25;16;171;175;113;56;31;78;145;179;196;81;90;40;165;185;106;178;138;14;144;62;9;148;102;49;52;55;92;57;129;82;120;2;101;1;97;152;124;94;63;79;80;176;137,4012009146744343080,0.000000
greedy_intra:edges_start:greedy,67,72645,23364,49281,1,0,67;108;69;18;22;146;159;193;41;5;42;181;34;160;48;54;177;10;190;84;184;43;116;65;149;123;127;162;151;133;135;70;154;180;53;121;100;26;86;75;44;25;16;171;175;113;56;31;78;145;179;196;81;90;40;165;185;106;178;138;14;144;62;9;148;102;49;52;55;92;57;129;82;120;2;101;1;97;152;124;94;63;79;80;176;137;51;118;59;115;139;46;68;0;89;183;143;117;93;140,5540744215368722773,0.000000
greedy_intra:edges_start:greedy,68,71947,23578,48369,1,0,68;46;115;59;118;51;0;117;143;183;89;186;23;137;176;80;79;63;94;124;152;97;1;101;2;120;82;129;57;92;55;52;49;102;148;9;62;144;14;138;178;106;185;165;40;90;81;196;179;145;78;31;56;113;175;171;16;25;44;75;86;26;100;121;53;180;154;70;135;133;151;162;127;123;149;65;116;43;184;84;4;190;10;177;54;48;160;34;146;22;18;108;69;159;181;42;5;41;193;139,7024606760359581697,0.000000
greedy_intra:edges_start:greedy,69,72218,23381,48837,1,0,69;108;18;20;22;146;159;193;41;5;42;181;34;160;48;54;177;10;190;84;184;43;116;65;149;123;127;162;151;133;135;70;154;180;53;121;100;26;86;75;44;25;16;171;175;113;56;31;78;145;179;196;81;90;40;165;185;106;178;138;14;144;62;9;148;102;49;52;55;92;57;129;82;120;2;101;1;97;152;124;94;63;79;80;176;137;23;186;89;183;143;117;0;51;118;59;115;46;68;139,1705077050352692993,0.000000
greedy_intra:edges_start:greedy,70,71750,23180,48570,1,0,70;154;158;53;121;100;26;86;75;101;1;97;152;94;124;148;102;49;178;106;52;55;57;92;129;2;120;44;25;16;171;175;113;56;31;78;145;179;196;81;90;185;40;165;138;14;144;62;9;15;114;186;89;183;23;137;176;80;151;162;127;123;149;65;116;43;184;177;54;48;160;34;146;22;18;108;69;159;181;42;5;41;193;139;68;140;93;117;143;0;46;115;59;118;51;133;79;63;180;135,1541048187186826619,0.000000
greedy_intra:edges_start:greedy,71,72164,23636,48528,1,0,71;164;7;95;39;165;138;14;144;62;9;148;102;49;178;106;52;55;57;92;129;2;152;97;1;101;100;53;180;154;135;70;127;123;162;149;65;116;43;184;177;54;48;160;34;146;22;18;108;69;159;181;42;5;41;193;139;68;140;93;117;143;183;89;23;137;0;46;115;59;118;51;151;133;176;80;79;63;94;26;86;75;120;44;25;16;171;175;113;56;31;78;145;179;196;81;185;40;90;27,4097773313432471708,0.000000
greedy_intra:edges_start:greedy,72,72377,23627,48750,1,0,72;51;0;117;143;183;89;186;23;137;176;80;79;63;94;124;152;97;1;101;2;120;82;129;57;92;55;52;49;102;148;9;62;144;14;138;178;106;185;165;40;90;81;196;179;145;78;31;56;113;175;171;16;25;44;75;86;26;100;121;53;180;154;70;135;133;151;162;127;123;149;65;116;43;184;84;190;10;177;54;48;160;34;146;22;18;108;69;159;181;42;5;41;193;139;68;46;115;118;59,8836975220022518662,0.000000
greedy_intra:edges_start:greedy,73,72456,23554,48902,1,0,73;15;148;9;62;102;49;178;106;52;55;57;92;129;2;152;97;1;101;100;53;180;154;135;70;127;123;162;149;131;65;116;43;184;190;177;54;48;160;34;146;22;18;108;69;159;181;42;5;41;193;139;68;140;93;117;143;183;89;186;23;137;0;46;115;59;118;51;151;133;176;80;79;63;94;189;26;86;75;120;44;25;16;171;175;113;56;31;78;145;179;196;81;90;185;40;165;138;14;144,6899023363358560335,0.000000
greedy_intra:edges_start:greedy,74,72489,23273,49216,1,0,74;1;101;75;86;53;154;70;135;180;63;79;133;51;118;59;115;46;0;143;117;93;140;68;139;193;41;5;42;181;159;69;108;18;22;146;34;160;48;54;177;184;43;116;65;149;123;127;162;151;80;176;137;23;183;89;186;114;15;9;62;144;14;138;165;40;185;90;81;196;179;145;78;31;56;113;175;171;16;25;44;120;2;129;92;57;55;52;106;178;49;102;148;124;94;189;100;26;97;152,2684212604454501760,0.000000
greedy_intra:edges_start:greedy,75,72208,23680,48528,1,0,75;44;25;16;171;175;113;56;31;78;145;179;196;81;90;40;165;185;106;178;138;14;144;62;9;148;102;49;52;55;92;57;129;82;120;2;152;97;1;101;100;53;180;154;135;70;127;123;162;149;131;65;116;43;184;190;10;177;54;48;160;34;146;22;18;108;69;159;181;42;5;41;193;139;68;140;93;117;143;183;89;186;23;137;0;46;115;59;118;51;151;133;176;80;79;63;94;189;26;86,8778383341883838802,0.000000
greedy_intra:edges_start:greedy,76,73321,23737,49584,1,0,76;176;80;151;162;127;123;149;65;116;43;184;190;177;54;48;160;34;146;22;18;108;69;159;181;42;5;41;193;139;68;46;115;59;118;51;133;79;63;180;135;70;154;158;53;121;100;26;86;75;101;1;97;152;94;124;148;102;49;178;106;52;55;57;92;129;2;120;44;25;16;171;175;113;56;31;78;145;179;196;81;90;185;40;165;138;14;144;62;9;15;114;186;137;23;89;183;143;117;0,6546180170482441311,0.000000
greedy_intra:edges_start:greedy,77,72370,23528,48842,1,0,77;43;184;190;10;177;54;48;160;34;146;22;18;108;69;159;181;42;5;41;193;139;68;140;93;117;143;183;89;186;23;137;176;80;79;63;94;124;152;97;1;101;2;120;82;129;57;92;55;52;49;102;148;9;62;144;14;138;178;106;185;165;40;90;81;196;179;145;78;31;56;113;175;171;16;25;44;75;86;26;100;121;53;180;154;135;70;127;123;162;133;151;51;0;46;115;118;59;116;65,3139759762218831029,0.000000
greedy_intra:edges_start:greedy,78,71905,23579,48326,1,0,78;31;56;113;175;171;16;25;44;120;75;86;26;189;94;63;79;80;176;133;151;51;118;59;115;46;0;137;23;186;89;183;143;117;93;140;68;139;193;41;5;42;181;159;69;108;18;22;146;34;160;48;54;177;10;190;84;184;43;116;65;131;149;162;123;127;70;135;154;180;53;100;101;1;97;152;2;129;57;92;55;52;49;102;148;9;62;144;14;138;178;106;185;165;40;90;81;196;179;145,5518907817753756642,0.000000
greedy_intra:edges_start:greedy,79,72330,23522,48808,1,0,79;80;176;133;151;51;118;59;115;46;0;137;23;186;89;183;143;117;93;140;68;139;193;41;5;42;181;159;69;108;18;22;146;34;160;48;54;177;184;43;116;65;131;149;162;123;127;70;135;180;154;158;53;121;100;26;86;75;44;25;16;171;175;113;56;31;78;145;179;196;81;90;40;165;185;106;178;138;14;144;62;9;148;102;49;52;55;92;57;129;82;120;2;101;1;97;152;124;94;63,8177692706351947702,0.000000
greedy_intra:edges_start:greedy,80,71940,23456,48484,1,0,80;79;63;94;124;152;97;1;101;2;120;82;129;57;92;55;52;49;102;148;9;62;144;14;138;178;106;185;165;40;90;81;196;179;145;78;31;56;113;175;171;16;25;44;75;86;26;100;121;53;180;154;135;70;127;123;162;133;151;149;131;65;116;43;184;84;190;10;177;54;48;160;34;146;22;18;108;69;159;181;42;5;41;193;139;68;46;115;59;118;51;0;117;143;183;89;186;23;137;176,4358941282345081420,0.000000
greedy_intra:edges_start:greedy,81,71630,23304,48326,1,0,81;196;40;185;179;145;78;31;56;113;175;171;16;25;44;120;75;86;26;189;94;63;79;80;176;133;151;51;118;59;115;46;0;137;23;186;89;183;143;117;93;140;68;139;193;41;5;42;181;159;69;108;18;22;146;34;160;48;54;177;10;190;84;184;43;116;65;131;149;162;123;127;70;135;154;180;53;100;101;1;97;152;2;129;92;57;55;52;106;178;49;102;148;9;62;144;14;138;165;90,8055443182902506299,0.000000
greedy_intra:edges_start:greedy,82,72236,23708,48528,1,0,82;2;75;86;26;189;94;63;79;80;176;133;151;51;118;59;115;46;0;137;23;186;89;183;143;117;93;140;68;139;193;41;5;42;181;159;69;108;18;22;146;34;160;48;54;177;10;190;184;43;116;65;131;149;162;123;127;70;135;154;180;53;100;101;1;97;152;129;57;92;55;52;49;102;148;9;62;144;14;138;178;106;185;165;40;90;81;196;179;145;78;31;56;113;175;171;16;25;44;120,1478532076025006075,0.000000
greedy_intra:edges_start:greedy,83,72261,22842,49419,1,0,83;89;183;143;117;0;46;68;139;193;41;115;5;42;181;159;69;108;18;22;146;34;160;48;54;177;10;190;4;84;184;43;116;65;59;118;51;151;133;162;123;127;70;135;154;180;53;121;100;26;86;75;44;25;16;171;175;113;56;31;78;145;179;196;81;90;40;165;185;106;178;138;14;144;62;9;148;102;49;52;55;92;57;129;82;120;2;101;1;97;152;124;94;63;79;80;176;137;23;186,2553301890479694943,0.000000
greedy_intra:edges_start:greedy,84,71935,23606,48329,1,0,84;4;112;127;123;162;151;133;135;70;154;180;53;121;100;26;86;75;44;25;16;171;175;113;56;31;78;145;179;196;81;90;40;165;185;106;178;138;14;144;62;9;148;102;49;52;55;92;57;129;82;120;2;101;1;97;152;124;94;63;79;80;176;137;23;186;89;183;143;117;0;51;118;59;115;139;68;46;65;116;43;42;5;41;193;159;69;108;18;22;146;181;34;160;48;54;177;190;184;35,5219794672508864715,0.001000
greedy_intra:edges_start:greedy,85,72861,23848,49013,1,0,85;145;179;196;81;90;40;165;185;106;178;138;14;144;62;9;148;102;49;52;55;92;57;129;2;152;97;1;101;100;53;180;154;135;70;127;123;162;149;131;65;116;43;184;190;10;177;54;48;160;34;146;22;18;108;69;159;181;42;5;41;193;139;68;140;93;117;143;183;89;186;23;137;0;46;115;59;118;51;151;133;176;80;79;63;94;189;26;86;75;120;44;25;78;31;16;171;175;113;56,4766632621866517538,0.000000
greedy_intra:edges_start:greedy,86,71750,23180,48570,1,0,86;75;101;1;97;152;94;124;148;102;49;178;106;52;55;57;92;129;2;120;44;25;16;171;175;113;56;31;78;145;179;196;81;90;185;40;165;138;14;144;62;9;15;114;186;89;183;23;137;176;80;151;162;127;123;149;65;116;43;184;177;54;48;160;34;146;22;18;108;69;159;181;42;5;41;193;139;68;140;93;117;143;0;46;115;59;118;51;133;79;63;180;135;70;154;158;53;121;100;26,5471483565350277617,0.000000
greedy_intra:edges_start:greedy,87,73165,23569,49596,1,0,87;2;120;82;129;57;92;55;52;49;102;148;9;62;144;14;138;178;106;185;165;40;90;81;196;179;145;78;31;56;113;175;171;16;25;44;75;86;26;189;94;63;79;80;176;133;151;51;118;59;115;46;0;137;23;186;89;183;143;117;93;140;68;139;193;41;5;42;181;159;69;108;18;22;146;34;160;48;54;177;190;184;43;116;65;131;149;162;123;127;70;135;154;180;53;100;101;1;97;152,5479445303019777763,0.000997
greedy_intra:edges_start:greedy,88,72887,23626,49261,1,0,88;25;44;120;75;86;26;189;94;63;79;80;176;133;151;51;118;59;115;46;0;137;23;186;89;183;143;117;93;140;68;139;193;41;5;42;181;159;69;108;18;22;146;34;160;48;54;177;10;190;184;43;116;65;131;149;162;123;127;70;135;154;180;53;100;101;1;97;152;2;129;57;55;52;49;102;148;9;62;144;14;138;178;106;185;165;40;90;81;196;179;92;78;145;31;56;113;175;171;16,4974636467658309572,0.000000
greedy_intra:edges_start:greedy,89,71226,22804,48422,1,0,89;186;23;137;176;80;79;63;94;124;152;97;1;101;2;120;82;129;57;92;55;52;49;102;148;9;62;144;14;138;178;106;185;165;40;90;81;196;179;145;78;31;56;113;175;171;16;25;44;75;86;26;100;121;53;180;154;135;70;127;123;162;133;151;51;118;59;65;116;43;184;84;190;10;177;54;48;160;34;146;22;18;108;69;159;181;42;5;115;41;193;139;46;68;140;93;117;0;143;183,8558803522651363638,0.000000
greedy_intra:edges_start:greedy,90,71673,23347,48326,1,0,90;40;185;81;196;179;145;78;31;56;113;175;171;16;25;44;120;75;86;26;189;94;63;79;80;176;133;151;51;118;59;115;46;0;137;23;186;89;183;143;117;93;140;68;139;193;41;5;42;181;159;69;108;18;22;146;34;160;48;54;177;10;190;84;184;43;116;65;131;149;162;123;127;70;135;154;180;53;100;101;1;97;152;2;129;92;57;55;52;106;178;49;102;148;9;62;144;14;138;165,362686874900616731,0.001000
greedy_intra:edges_start:greedy,91,72110,23205,48905,1,0,91;179;145;78;31;56;113;175;171;16;25;44;120;75;86;26;189;94;63;79;80;176;133;151;51;118;59;115;46;0;137;23;186;89;183;143;117;93;140;68;139;193;41;5;42;181;159;69;108;18;22;146;34;160;48;54;177;10;190;184;43;116;65;131;149;162;123;127;70;135;154;180;53;100;101;1;97;152;2;129;92;57;55;52;49;102;148;9;62;144;14;138;178;106;185;165;40;90;81;196,6864397484870385841,0.000000
greedy_intra:edges_start:greedy,92,71905,23579,48326,1,0,92;55;52;49;102;148;9;62;144;14;138;178;106;185;165;40;90;81;196;179;145;78;31;56;113;175;171;16;25;44;120;75;86;26;189;94;63;79;80;176;133;151;51;118;59;115;46;0;137;23;186;89;183;143;117;93;140;68;139;193;41;5;42;181;159;69;108;18;22;146;34;160;48;54;177;10;190;84;184;43;116;65;131;149;162;123;127;70;135;154;180;53;100;101;1;97;152;2;129;57,4691250146219629419,0.000000
greedy_intra:edges_start:greedy,93,71968,23472,48496,1,0,93;140;108;69;18;22;146;159;193;41;5;42;181;34;160;48;54;177;10;190;4;84;184;43;116;65;149;123;127;162;151;133;135;70;154;180;53;121;100;26;86;75;44;25;16;171;175;113;56;31;78;145;179;196;81;90;40;165;185;106;178;138;14;144;62;9;148;102;49;52;55;92;57;129;82;120;2;101;1;97;152;124;94;63;79;80;176;137;51;118;59;115;139;46;68;0;89;183;143;117,7058584539612577405,0.000000
greedy_intra:edges_start:greedy,94,71750,23180,48570,1,0,94;152;97;1;101;75;86;26;100;121;53;158;154;70;135;180;63;79;133;51;118;59;115;46;0;143;117;93;140;68;139;193;41;5;42;181;159;69;108;18;22;146;34;160;48;54;177;184;43;116;65;149;123;127;162;151;80;176;137;23;183;89;186;114;15;9;62;144;14;138;165;40;185;90;81;196;179;145;78;31;56;113;175;171;16;25;44;120;2;129;92;57;55;52;106;178;49;102;148;124,2763942696691029697,0.000000
greedy_intra:edges_start:greedy,95,72164,23636,48528,1,0,95;7;164;71;27;90;40;185;81;196;179;145;78;31;56;113;175;171;16;25;44;120;75;86;26;94;63;79;80;176;133;151;51;118;59;115;46;0;137;23;89;183;143;117;93;140;68;139;193;41;5;42;181;159;69;108;18;22;146;34;160;48;54;177;184;43;116;65;149;162;123;127;70;135;154;180;53;100;101;1;97;152;2;129;92;57;55;52;106;178;49;102;148;9;62;144;14;138;165;39,7181915300995865249,0.000000
greedy_intra:edges_start:greedy,96,72114,23548,48566,1,0,96;43;116;65;149;123;127;162;151;133;135;70;154;180;53;121;100;26;86;75;44;25;16;171;175;113;56;31;78;145;179;196;81;90;40;165;185;106;178;138;14;144;62;9;148;102;49;52;55;92;57;129;82;120;2;101;1;97;152;124;94;63;79;80;176;137;23;186;89;183;143;117;0;51;118;59;115;46;68;139;41;193;159;69;108;18;22;146;181;34;160;48;54;177;10;190;4;84;184;42,7471041137183849895,0.000000
greedy_intra:edges_start:greedy,97,71933,23455,48478,1,0,97;152;1;101;75;86;53;154;70;135;180;63;79;133;51;118;59;115;46;0;143;117;93;140;68;139;193;41;5;42;181;159;69;108;18;22;146;34;160;48;54;177;190;184;43;116;65;149;123;127;162;151;80;176;137;23;183;89;186;114;15;9;62;144;14;138;165;40;185;90;81;196;179;145;78;31;56;113;175;171;16;25;44;120;2;129;92;57;55;52;106;178;49;102;148;124;94;189;100;26,7632897327269348191,0.000000
greedy_intra:edges_start:greedy,98,73217,24027,49190,1,0,98;81;90;27;164;39;165;40;185;106;178;138;14;144;62;9;148;102;49;52;55;57;129;92;179;145;78;82;2;152;97;1;101;100;53;180;154;135;70;127;123;162;149;65;116;43;184;177;54;48;160;34;146;22;18;108;69;159;181;42;5;41;193;139;68;140;93;117;143;183;89;23;137;0;46;115;59;118;51;151;133;176;80;79;63;94;26;86;75;120;44;25;16;171;175;113;56;31;157;196,4376634381514394239,0.000000
greedy_intra:edges_start:greedy,99,72749,23378,49371,1,0,99;97;26;100;86;75;101;1;152;94;124;148;102;49;178;106;52;55;57;92;129;2;120;44;25;16;171;175;113;56;31;78;145;179;196;81;90;185;40;165;138;14;144;62;9;15;114;186;89;183;23;137;176;80;151;162;127;123;149;65;116;43;184;177;54;48;160;34;146;22;18;108;69;159;181;42;5;41;193;139;68;140;93;117;143;0;46;115;59;118;51;133;79;63;180;135;70;154;158;53,8977701302223264035,0.000000
greedy_intra:edges_start:greedy,100,71750,23180,48570,1,0,100;26;86;75;101;1;97;152;94;124;148;102;49;178;106;52;55;57;92;129;2;120;44;25;16;171;175;113;56;31;78;145;179;196;81;90;185;40;165;138;14;144;62;9;15;114;186;89;183;23;137;176;80;151;162;127;123;149;65;116;43;184;177;54;48;160;34;146;22;18;108;69;159;181;42;5;41;193;139;68;140;93;117;143;0;46;115;59;118;51;133;79;63;180;135;70;154;158;53;121,6102535727707226900,0.000000
greedy_intra:edges_start:greedy,101,71933,23455,48478,1,0,101;1;152;97;26;100;189;94;124;148;102;49;178;106;52;55;57;92;129;2;120;44;25;16;171;175;113;56;31;78;145;179;196;81;90;185;40;165;138;14;144;62;9;15;114;186;89;183;23;137;176;80;151;162;127;123;149;65;116;43;184;190;177;54;48;160;34;146;22;18;108;69;159;181;42;5;41;193;139;68;140;93;117;143;0;46;115;59;118;51;133;79;63;180;135;70;154;53;86;75,3817349353761533631,0.000971
greedy_intra:edges_start:greedy,102,71523,23197,48326,1,0,102;148;9;62;144;14;138;165;40;185;90;81;196;179;145;78;31;56;113;175;171;16;25;44;120;75;86;26;189;94;63;79;80;176;133;151;51;118;59;115;46;0;137;23;186;89;183;143;117;93;140;68;139;193;41;5;42;181;159;69;108;18;22;146;34;160;48;54;177;10;190;84;184;43;116;65;131;149;162;123;127;70;135;154;180;53;100;101;1;97;152;2;129;92;57;55;52;106;178;49,2635389898024137002,0.000000
greedy_intra:edges_start:greedy,103,71597,23235,48362,1,0,103;34;160;48;54;177;10;190;4;112;84;184;42;43;116;65;149;123;127;162;151;133;135;70;154;180;53;121;100;26;86;75;44;25;16;171;175;113;56;31;78;145;179;196;81;90;40;165;185;106;178;138;14;144;62;9;148;102;49;52;55;92;57;129;82;120;2;101;1;97;152;124;94;63;79;80;176;137;23;186;89;183;143;117;0;51;118;59;115;46;68;139;41;193;159;69;108;18;22;146,2318661302723480507,0.000000
greedy_intra:edges_start:greedy,104,73110,23928,49182,1,0,104;54;48;34;160;181;42;195;146;22;18;108;69;159;41;193;139;68;140;93;117;143;183;89;186;23;137;176;80;79;63;94;124;152;97;1;101;2;120;82;129;57;92;55;52;49;102;148;9;62;144;14;138;178;106;185;165;40;90;81;196;179;145;78;31;56;113;175;171;16;25;44;75;86;26;100;121;53;180;154;135;70;127;123;162;133;151;51;0;46;115;118;59;116;65;43;184;4;10;177,4870916696242371181,0.001000
greedy_intra:edges_start:greedy,105,72453,23604,48849,1,0,105;116;43;184;84;190;10;177;54;48;160;34;146;22;18;108;69;159;181;42;5;41;193;139;68;46;115;118;59;51;0;117;143;183;89;186;23;137;176;80;79;63;94;124;152;97;1;101;2;120;82;129;57;92;55;52;49;102;148;9;62;144;14;138;178;106;185;165;40;90;81;196;179;145;78;31;56;113;175;171;16;25;44;75;86;26;100;121;53;180;154;70;135;133;151;162;127;123;149;65,4797585213858082991,0.000000
greedy_intra:edges_start:greedy,106,71523,23197,48326,1,0,106;178;49;102;148;9;62;144;14;138;165;40;185;90;81;196;179;145;78;31;56;113;175;171;16;25;44;120;75;86;26;189;94;63;79;80;176;133;151;51;118;59;115;46;0;137;23;186;89;183;143;117;93;140;68;139;193;41;5;42;181;159;69;108;18;22;146;34;160;48;54;177;10;190;84;184;43;116;65;131;149;162;123;127;70;135;154;180;53;100;101;1;97;152;2;129;92;57;55;52,7672780650022704207,0.000000
greedy_intra:edges_start:greedy,107,72830,23628,49202,1,0,107;27;164;7;95;39;165;138;14;144;62;9;148;102;49;178;106;52;55;57;92;129;2;152;97;1;101;100;53;180;154;135;70;127;123;162;149;65;116;43;184;177;54;48;160;34;146;22;18;108;69;159;181;42;5;41;193;139;68;140;93;117;143;183;89;23;137;0;46;115;59;118;51;151;133;176;80;79;63;94;26;86;75;120;44;25;16;171;175;113;56;31;78;145;179;196;81;185;40;90,3677880304356207591,0.000000
greedy_intra:edges_start:greedy,108,72218,23381,48837,1,0,108;69;139;68;46;115;59;118;51;0;117;143;183;89;186;23;137;176;80;79;63;94;124;152;97;1;101;2;120;82;129;57;92;55;52;49;102;148;9;62;144;14;138;178;106;185;165;40;90;81;196;179;145;78;31;56;113;175;171;16;25;44;75;86;26;100;121;53;180;154;70;135;133;151;162;127;123;149;65;116;43;184;84;190;10;177;54;48;160;34;181;42;5;41;193;159;146;22;20;18,6592944095855793934,0.000999
greedy_intra:edges_start:greedy,109,72236,23390,48846,1,0,109;118;115;46;68;139;193;41;5;42;181;159;69;108;18;22;146;34;160;48;54;177;10;190;4;84;184;43;65;116;59;151;133;162;123;127;70;135;154;180;53;121;100;26;86;75;44;25;16;171;175;113;56;31;78;145;179;196;81;90;40;165;185;106;178;138;14;144;62;9;148;102;49;52;55;92;57;129;82;120;2;101;1;97;152;124;94;63;79;80;176;137;23;186;89;183;143;117;0;51,8294651026343613468,0.000000
greedy_intra:edges_start:greedy,110,72558,23584,48974,1,0,110;193;41;5;42;181;159;69;108;18;22;146;34;160;48;54;177;10;190;84;184;43;116;65;149;123;127;162;151;133;135;70;154;180;53;121;100;26;86;75;44;25;16;171;175;113;56;31;78;145;179;196;81;90;40;165;185;106;178;138;14;144;62;9;148;102;49;52;55;92;57;129;82;120;2;101;1;97;152;124;94;63;79;80;176;137;23;186;89;183;143;117;0;51;118;59;115;46;68;139,5988727832456933724,0.000000
greedy_intra:edges_start:greedy,111,72861,23747,49114,1,0,111;148;9;62;102;144;14;49;178;106;165;39;95;164;27;90;81;196;40;185;52;55;57;129;92;179;145;78;31;56;113;175;171;16;25;44;120;2;152;97;1;101;75;86;26;100;121;53;158;154;70;135;180;63;79;133;51;118;59;115;46;0;89;183;143;117;93;140;68;139;193;41;5;42;181;159;69;108;18;22;146;34;160;48;54;177;184;43;116;65;149;123;127;162;151;80;176;137;94;124,4476222283747163143,0.000000
greedy_intra:edges_start:greedy,112,71935,23606,48329,1,0,112;4;84;35;184;190;177;54;48;160;34;181;146;22;18;108;69;159;193;41;5;42;43;116;65;46;68;139;115;59;118;51;0;117;143;183;89;186;23;137;176;80;79;63;94;124;152;97;1;101;2;120;82;129;57;92;55;52;49;102;148;9;62;144;14;138;178;106;185;165;40;90;81;196;179;145;78;31;56;113;175;171;16;25;44;75;86;26;100;121;53;180;154;70;135;133;151;162;123;127,8042375310671591485,0.000000
greedy_intra:edges_start:greedy,113,72017,23691,48326,1,0,113;56;31;145;78;92;179;196;81;90;40;165;185;106;178;138;14;144;62;9;148;102;49;52;55;57;129;2;152;97;1;101;100;53;180;154;135;70;127;123;162;149;131;65;116;43;184;84;190;10;177;54;48;160;34;146;22;18;108;69;159;181;42;5;41;193;139;68;140;93;117;143;183;89;186;23;137;0;46;115;59;118;51;151;133;176;80;79;63;94;189;26;86;75;120;44;25;16;171;175,2911479254629227723,0.000000
greedy_intra:edges_start:greedy,114,71682,23112,48570,1,0,114;186;89;183;23;137;176;80;151;162;127;123;149;65;116;43;184;177;54;48;160;34;146;22;18;108;69;159;181;42;5;41;193;139;68;140;93;117;143;0;46;115;59;118;51;133;79;63;180;135;70;154;158;53;121;100;26;86;75;101;1;97;152;94;124;148;9;62;102;49;178;106;52;55;57;92;129;2;120;44;25;16;171;175;113;56;31;78;145;179;196;81;90;185;40;165;138;14;144;15,3653385295544863906,0.000000
greedy_intra:edges_start:greedy,115,71947,23578,48369,1,0,115;59;118;51;0;117;143;183;89;186;23;137;176;80;79;63;94;124;152;97;1;101;2;120;82;129;57;92;55;52;49;102;148;9;62;144;14;138;178;106;185;165;40;90;81;196;179;145;78;31;56;113;175;171;16;25;44;75;86;26;100;121;53;180;154;70;135;133;151;162;127;123;149;65;116;43;184;84;4;190;10;177;54;48;160;34;146;22;18;108;69;159;181;42;5;41;193;139;68;46,2053613904001592329,0.000000
greedy_intra:edges_start:greedy,116,71947,23578,48369,1,0,116;43;184;84;4;190;10;177;54;48;160;34;146;22;18;108;69;159;181;42;5;41;193;139;68;46;115;59;118;51;0;117;143;183;89;186;23;137;176;80;79;63;94;124;152;97;1;101;2;120;82;129;57;92;55;52;49;102;148;9;62;144;14;138;178;106;185;165;40;90;81;196;179;145;78;31;56;113;175;171;16;25;44;75;86;26;100;121;53;180;154;70;135;133;151;162;127;123;149;65,553434036984211726,0.000000
greedy_intra:edges_start:greedy,117,71108,22981,48127,1,0,117;0;46;68;139;193;41;115;5;42;181;159;69;108;18;22;146;34;160;48;54;177;10;190;4;112;84;184;43;116;65;59;118;51;151;133;162;123;127;70;135;154;180;53;121;100;26;86;75;44;25;16;171;175;113;56;31;78;145;179;196;81;90;40;165;185;106;178;138;14;144;62;9;148;102;49;52;55;92;57;129;82;120;2;101;1;97;152;124;94;63;79;80;176;137;23;186;89;183;143,1389677860486131096,0.000000
greedy_intra:edges_start:greedy,118,72006,23637,48369,1,0,118;115;46;68;139;193;41;5;42;181;159;69;108;18;22;146;34;160;48;54;177;10;190;4;84;184;43;116;65;149;123;127;162;151;133;135;70;154;180;53;121;100;26;86;75;44;25;16;171;175;113;56;31;78;145;179;196;81;90;40;165;185;106;178;138;14;144;62;9;148;102;49;52;55;92;57;129;82;120;2;101;1;97;152;124;94;63;79;80;176;137;23;186;89;183;143;117;0;51;59,7770642910524922974,0.000000
greedy_intra:edges_start:greedy,119,71472,23013,48459,1,0,119;40;185;90;81;196;179;145;78;31;56;113;175;171;16;25;44;120;75;86;26;189;94;63;79;80;176;133;151;51;118;59;115;46;0;137;23;186;89;183;143;117;93;140;68;139;193;41;5;42;181;159;69;108;18;22;146;34;160;48;54;177;10;190;184;43;116;65;131;149;162;123;127;70;135;154;180;53;100;101;1;97;152;2;129;92;57;55;52;106;178;49;102;148;9;62;144;14;138;165,3760713201697626068,0.000000
greedy_intra:edges_start:greedy,120,71905,23579,48326,1,0,120;75;86;26;189;94;63;79;80;176;133;151;51;118;59;115;46;0;137;23;186;89;183;143;117;93;140;68;139;193;41;5;42;181;159;69;108;18;22;146;34;160;48;54;177;10;190;84;184;43;116;65;131;149;162;123;127;70;135;154;180;53;100;101;1;97;152;2;129;57;92;55;52;49;102;148;9;62;144;14;138;178;106;185;165;40;90;81;196;179;145;78;31;56;113;175;171;16;25;44,5283860345182027594,0.000000
greedy_intra:edges_start:greedy,121,71867,23297,48570,1,0,121;100;26;97;86;75;101;1;152;94;124;148;102;49;178;106;52;55;57;92;129;2;120;44;25;16;171;175;113;56;31;78;145;179;196;81;90;185;40;165;138;14;144;62;9;15;114;186;89;183;23;137;176;80;151;162;127;123;149;65;116;43;184;177;54;48;160;34;146;22;18;108;69;159;181;42;5;41;193;139;68;140;93;117;143;0;46;115;59;118;51;133;79;63;180;135;70;154;158;53,2434579603199198079,0.000000
greedy_intra:edges_start:greedy,122,72576,23444,49132,1,0,122;176;80;79;133;151;51;118;59;115;46;0;137;23;89;183;143;117;93;140;68;139;193;41;5;42;181;159;69;108;18;22;146;34;160;48;54;177;184;43;116;65;131;149;162;123;127;70;135;180;154;158;53;121;100;26;86;75;44;25;16;171;175;113;56;31;78;145;179;196;81;90;40;165;185;106;178;138;14;144;62;9;148;102;49;52;55;92;57;129;82;120;2;101;1;97;152;124;94;63,4712625685593155551,0.000000
greedy_intra:edges_start:greedy,123,71940,23456,48484,1,0,123;162;133;151;149;131;65;116;43;184;84;190;10;177;54;48;160;34;146;22;18;108;69;159;181;42;5;41;193;139;68;46;115;59;118;51;0;117;143;183;89;186;23;137;176;80;79;63;94;124;152;97;1;101;2;120;82;129;57;92;55;52;49;102;148;9;62;144;14;138;178;106;185;165;40;90;81;196;179;145;78;31;56;113;175;171;16;25;44;75;86;26;100;121;53;180;154;135;70;127,3496786602376177174,0.000000
greedy_intra:edges_start:greedy,124,71861,23291,48570,1,0,124;152;97;1;101;75;86;26;100;121;53;158;154;70;135;180;63;79;133;51;118;59;115;46;0;143;117;93;140;68;139;193;41;5;42;181;159;69;108;18;22;146;34;160;48;54;177;184;43;116;65;149;123;127;162;151;80;176;137;23;183;89;186;114;15;9;62;144;14;138;165;40;185;90;81;196;179;145;78;31;56;113;175;171;16;25;44;120;2;129;92;57;55;52;106;178;49;102;148;94,3726923764474665114,0.000000
greedy_intra:edges_start:greedy,125,73395,23511,49884,1,0,125;2;120;82;129;57;92;179;145;78;31;56;113;175;171;16;25;44;75;86;53;154;70;135;180;63;79;133;51;118;59;115;46;0;143;117;93;140;68;139;193;41;5;42;181;159;69;108;18;22;146;34;160;48;54;177;184;43;116;65;149;123;162;151;80;176;137;23;183;89;186;114;15;9;62;144;14;138;165;90;81;196;40;185;55;52;106;178;49;102;148;124;94;189;100;26;1;101;97;152,2185945603357238652,0.000000
greedy_intra:edges_start:greedy,126,72420,23391,49029,1,0,126;112;4;84;35;184;177;54;48;160;34;181;146;22;18;108;69;159;193;41;5;42;43;116;65;46;68;139;115;59;118;51;0;117;143;183;89;186;23;137;176;80;79;63;94;124;152;97;1;101;2;120;82;129;57;92;55;52;49;102;148;9;62;144;14;138;178;106;185;165;40;90;81;196;179;145;78;31;56;113;175;171;16;25;44;75;86;26;100;121;53;180;154;70;135;133;151;162;123;127,821401422715270305,0.000000
greedy_intra:edges_start:greedy,127,72193,23609,48584,1,0,127;70;135;154;180;53;121;100;26;86;75;44;25;16;171;175;113;56;31;78;145;179;196;81;90;40;165;185;106;178;138;14;144;62;9;148;102;49;52;55;92;57;129;82;120;2;101;1;97;152;124;94;63;79;80;176;133;151;51;118;59;115;46;0;137;23;186;89;183;143;117;93;140;68;139;193;41;5;42;181;159;69;108;18;22;146;34;160;48;54;177;190;184;43;116;65;131;149;162;123,8384608366663525073,0.000000
greedy_intra:edges_start:greedy,128,72267,23379,48888,1,0,128;167;148;9;62;102;144;14;49;178;106;165;40;185;90;81;196;179;145;78;31;56;113;175;171;16;25;44;120;75;86;26;189;94;63;79;80;176;133;151;51;118;59;115;46;0;137;23;186;89;183;143;117;93;140;68;139;193;41;5;42;181;159;69;108;18;22;146;34;160;48;54;177;10;190;184;43;116;65;131;149;162;123;127;70;135;154;180;53;100;101;1;97;152;2;129;92;57;52;55,1195098842985680952,0.000000
greedy_intra:edges_start:greedy,129,71905,23579,48326,1,0,129;57;92;55;52;49;102;148;9;62;144;14;138;178;106;185;165;40;90;81;196;179;145;78;31;56;113;175;171;16;25;44;120;75;86;26;189;94;63;79;80;176;133;151;51;118;59;115;46;0;137;23;186;89;183;143;117;93;140;68;139;193;41;5;42;181;159;69;108;18;22;146;34;160;48;54;177;10;190;84;184;43;116;65;131;149;162;123;127;70;135;154;180;53;100;101;1;97;152;2,1664384556345056955,0.000000
greedy_intra:edges_start:greedy,130,72516,23221,49295,1,0,130;148;102;49;178;106;52;55;57;92;129;2;120;44;25;16;171;175;113;56;31;78;145;179;196;81;90;185;40;165;138;14;144;62;9;15;114;186;89;183;23;137;176;80;151;162;127;123;149;65;116;43;184;177;54;48;160;34;146;22;18;108;69;159;181;42;5;41;193;139;68;140;93;117;143;0;46;115;59;118;51;133;79;63;180;135;70;154;158;53;121;100;26;86;75;101;1;97;152;94,2003669949957837588,0.000000
greedy_intra:edges_start:greedy,131,71993,23509,48484,1,0,131;149;123;127;162;151;133;135;70;154;180;53;121;100;26;86;75;44;25;16;171;175;113;56;31;78;145;179;196;81;90;40;165;185;106;178;138;14;144;62;9;148;102;49;52;55;92;57;129;82;120;2;101;1;97;152;124;94;63;79;80;176;137;23;186;89;183;143;117;0;51;118;59;115;46;68;139;193;41;5;42;181;159;69;108;18;22;146;34;160;48;54;177;10;190;84;184;43;116;65,7106316189365318459,0.000000
greedy_intra:edges_start:greedy,132,72621,23434,49187,1,0,132;14;138;165;40;185;90;81;196;179;145;78;31;56;113;175;171;16;25;44;120;75;86;26;189;94;63;79;80;176;133;151;51;118;59;115;46;0;137;23;186;89;183;143;117;93;140;68;139;193;41;5;42;181;159;69;108;18;22;146;34;160;48;54;177;10;190;184;43;116;65;131;149;162;123;127;70;135;154;180;53;100;101;1;97;152;2;129;92;57;55;52;106;178;49;102;148;9;62;144,664107376827415547,0.000000
greedy_intra:edges_start:greedy,133,72193,23609,48584,1,0,133;151;51;118;59;115;46;0;137;23;186;89;183;143;117;93;140;68;139;193;41;5;42;181;159;69;108;18;22;146;34;160;48;54;177;190;184;43;116;65;131;149;162;123;127;70;135;154;180;53;121;100;26;86;75;44;25;16;171;175;113;56;31;78;145;179;196;81;90;40;165;185;106;178;138;14;144;62;9;148;102;49;52;55;92;57;129;82;120;2;101;1;97;152;124;94;63;79;80;176,7482492599285759799,0.000000
greedy_intra:edges_start:greedy,134,73278,23531,49747,1,0,134;108;18;69;139;68;46;115;59;118;51;0;117;143;183;89;186;23;137;176;80;79;63;94;124;152;97;1;101;2;120;82;129;57;92;55;52;49;102;148;9;62;144;14;138;178;106;185;165;40;90;81;196;179;145;78;31;56;113;175;171;16;25;44;75;86;26;100;121;53;180;154;70;135;133;151;162;127;123;149;65;116;43;184;190;10;177;54;48;160;34;181;42;5;41;193;159;146;22;20,4665622233446058698,0.000000
greedy_intra:edges_start:greedy,135,71750,23180,48570,1,0,135;70;154;158;53;121;100;26;86;75;101;1;97;152;94;124;148;102;49;178;106;52;55;57;92;129;2;120;44;25;16;171;175;113;56;31;78;145;179;196;81;90;185;40;165;138;14;144;62;9;15;114;186;89;183;23;137;176;80;151;162;127;123;149;65;116;43;184;177;54;48;160;34;146;22;18;108;69;159;181;42;5;41;193;139;68;140;93;117;143;0;46;115;59;118;51;133;79;63;180,4098117105039154149,0.000000
greedy_intra:edges_start:greedy,136,72536,23768,48768,1,0,136;121;100;26;86;75;44;25;16;171;175;113;56;31;78;145;179;196;81;90;40;165;185;106;178;138;14;144;62;9;148;102;49;52;55;92;57;129;82;120;2;101;1;97;152;124;94;63;79;80;176;137;23;186;89;183;143;117;0;51;118;59;115;46;68;139;193;41;5;42;181;159;69;108;18;22;146;34;160;48;54;177;10;190;84;184;43;116;65;149;123;127;162;151;133;180;135;70;154;53,5069366436831107983,0.000000
greedy_intra:edges_start:greedy,137,71750,23180,48570,1,0,137;23;183;89;186;114;15;9;62;144;14;138;165;40;185;90;81;196;179;145;78;31;56;113;175;171;16;25;44;120;2;129;92;57;55;52;106;178;49;102;148;124;94;152;97;1;101;75;86;26;100;121;53;158;154;70;135;180;63;79;133;51;118;59;115;46;0;143;117;93;140;68;139;193;41;5;42;181;159;69;108;18;22;146;34;160;48;54;177;184;43;116;65;149;123;127;162;151;80;176,533352216678712756,0.001003
greedy_intra:edges_start:greedy,138,71523,23197,48326,1,0,138;14;144;62;9;148;102;49;178;106;52;55;57;92;129;2;152;97;1;101;100;53;180;154;135;70;127;123;162;149;131;65;116;43;184;84;190;10;177;54;48;160;34;146;22;18;108;69;159;181;42;5;41;193;139;68;140;93;117;143;183;89;186;23;137;0;46;115;59;118;51;151;133;176;80;79;63;94;189;26;86;75;120;44;25;16;171;175;113;56;31;78;145;179;196;81;90;185;40;165,5358018118885895466,0.000000
greedy_intra:edges_start:greedy,139,71947,23578,48369,1,0,139;68;46;115;59;118;51;0;117;143;183;89;186;23;137;176;80;79;63;94;124;152;97;1;101;2;120;82;129;57;92;55;52;49;102;148;9;62;144;14;138;178;106;185;165;40;90;81;196;179;145;78;31;56;113;175;171;16;25;44;75;86;26;100;121;53;180;154;70;135;133;151;162;127;123;149;65;116;43;184;84;4;190;10;177;54;48;160;34;146;22;18;108;69;159;181;42;5;41;193,996079361589128594,0.000000
greedy_intra:edges_start:greedy,140,71968,23472,48496,1,0,140;108;69;18;22;146;159;193;41;5;42;181;34;160;48;54;177;10;190;4;84;184;43;116;65;149;123;127;162;151;133;135;70;154;180;53;121;100;26;86;75;44;25;16;171;175;113;56;31;78;145;179;196;81;90;40;165;185;106;178;138;14;144;62;9;148;102;49;52;55;92;57;129;82;120;2;101;1;97;152;124;94;63;79;80;176;137;51;118;59;115;139;46;68;0;89;183;143;117;93,1663158016590351103,0.000000
greedy_intra:edges_start:greedy,141,72824,23488,49336,1,0,141;23;186;89;183;143;117;0;93;140;68;46;115;139;193;41;5;42;181;159;69;108;18;22;146;34;160;48;54;177;10;190;184;43;116;65;59;118;51;151;133;162;123;127;70;135;154;180;53;121;100;26;86;75;44;25;16;171;175;113;56;31;78;145;179;196;81;90;40;165;185;106;178;138;14;144;62;9;148;102;49;52;55;92;57;129;82;120;2;101;1;97;152;124;94;63;79;80;176;137,8440623184532030156,0.000000
greedy_intra:edges_start:greedy,142,72909,23572,49337,1,0,142;139;68;46;115;59;118;51;0;117;143;183;89;186;23;137;176;80;79;63;94;124;152;97;1;101;2;120;82;129;57;92;55;52;49;102;148;9;62;144;14;138;178;106;185;165;40;90;81;196;179;145;78;31;56;113;175;171;16;25;44;75;86;26;100;121;53;180;154;70;135;133;151;162;127;123;149;65;116;43;184;84;190;10;177;54;48;160;34;146;22;18;108;69;159;181;42;5;41;193,5260282230997906247,0.000000
greedy_intra:edges_start:greedy,143,71108,22981,48127,1,0,143;117;0;46;68;139;193;41;115;5;42;181;159;69;108;18;22;146;34;160;48;54;177;10;190;4;112;84;184;43;116;65;59;118;51;151;133;162;123;127;70;135;154;180;53;121;100;26;86;75;44;25;16;171;175;113;56;31;78;145;179;196;81;90;40;165;185;106;178;138;14;144;62;9;148;102;49;52;55;92;57;129;82;120;2;101;1;97;152;124;94;63;79;80;176;137;23;186;89;183,8960706693906649095,0.000000
greedy_intra:edges_start:greedy,144,71523,23197,48326,1,0,144;14;138;165;40;185;90;81;196;179;145;78;31;56;113;175;171;16;25;44;120;75;86;26;189;94;63;79;80;176;133;151;51;118;59;115;46;0;137;23;186;89;183;143;117;93;140;68;139;193;41;5;42;181;159;69;108;18;22;146;34;160;48;54;177;10;190;84;184;43;116;65;131;149;162;123;127;70;135;154;180;53;100;101;1;97;152;2;129;92;57;55;52;106;178;49;102;148;9;62,9105045706258215871,0.000000
greedy_intra:edges_start:greedy,145,71905,23579,48326,1,0,145;179;196;81;90;40;165;185;106;178;138;14;144;62;9;148;102;49;52;55;92;57;129;2;152;97;1;101;100;53;180;154;135;70;127;123;162;149;131;65;116;43;184;84;190;10;177;54;48;160;34;146;22;18;108;69;159;181;42;5;41;193;139;68;140;93;117;143;183;89;186;23;137;0;46;115;59;118;51;151;133;176;80;79;63;94;189;26;86;75;120;44;25;16;171;175;113;56;31;78,8466145879974162779,0.000000
greedy_intra:edges_start:greedy,146,71385,23490,47895,1,0,146;181;34;160;48;54;177;10;190;4;112;84;184;42;43;116;65;149;123;127;162;151;133;135;70;154;180;53;121;100;26;86;75;44;25;16;171;175;113;56;31;78;145;179;196;81;90;40;165;185;106;178;138;14;144;62;9;148;102;49;52;55;92;57;129;82;120;2;101;1;97;152;124;94;63;79;80;176;137;23;186;89;183;143;117;0;51;118;59;115;46;68;139;41;193;159;69;108;18;22,4103073640156846309,0.000000
greedy_intra:edges_start:greedy,147,73391,23933,49458,1,0,147;177;10;4;184;43;65;116;59;118;115;46;0;51;151;133;162;123;127;70;135;154;180;53;121;100;26;86;75;44;25;16;171;175;113;56;31;78;145;179;196;81;90;40;165;185;106;178;138;14;144;62;9;148;102;49;52;55;92;57;129;82;120;2;101;1;97;152;124;94;63;79;80;176;137;23;186;89;183;143;117;93;140;68;139;193;41;159;69;108;18;22;146;195;42;181;160;34;48;54,8609930220136604715,0.000000
greedy_intra:edges_start:greedy,148,71523,23197,48326,1,0,148;102;49;178;106;52;55;57;92;129;2;152;97;1;101;100;53;180;154;135;70;127;123;162;149;131;65;116;43;184;84;190;10;177;54;48;160;34;146;22;18;108;69;159;181;42;5;41;193;139;68;140;93;117;143;183;89;186;23;137;0;46;115;59;118;51;151;133;176;80;79;63;94;189;26;86;75;120;44;25;16;171;175;113;56;31;78;145;179;196;81;90;185;40;165;138;14;144;62;9,4345281015160448646,0.000000
greedy_intra:edges_start:greedy,149,71947,23578,48369,1,0,149;123;127;162;151;133;135;70;154;180;53;121;100;26;86;75;44;25;16;171;175;113;56;31;78;145;179;196;81;90;40;165;185;106;178;138;14;144;62;9;148;102;49;52;55;92;57;129;82;120;2;101;1;97;152;124;94;63;79;80;176;137;23;186;89;183;143;117;0;51;118;59;115;46;68;139;193;41;5;42;181;159;69;108;18;22;146;34;160;48;54;177;10;190;4;84;184;43;116;65,7878063462764510794,0.000000
greedy_intra:edges_start:greedy,150,73393,23514,49879,1,0,150;75;44;25;16;171;175;113;56;31;78;145;179;92;57;129;82;120;2;1;152;97;26;100;189;94;124;148;102;49;178;106;52;55;185;40;196;81;90;165;138;14;144;62;9;15;114;186;89;183;23;137;176;80;151;162;123;149;65;116;43;184;177;54;48;160;34;146;22;18;108;69;159;181;42;5;41;193;139;68;140;93;117;143;0;46;115;59;118;51;133;79;63;180;135;70;154;53;86;101,1967378732820999327,0.000000
greedy_intra:edges_start:greedy,151,71940,23456,48484,1,0,151;133;162;123;127;70;135;154;180;53;121;100;26;86;75;44;25;16;171;175;113;56;31;78;145;179;196;81;90;40;165;185;106;178;138;14;144;62;9;148;102;49;52;55;92;57;129;82;120;2;101;1;97;152;124;94;63;79;80;176;137;23;186;89;183;143;117;0;51;118;59;115;46;68;139;193;41;5;42;181;159;69;108;18;22;146;34;160;48;54;177;10;190;84;184;43;116;65;131;149,7031372304874152367,0.000000
greedy_intra:edges_start:greedy,152,71933,23455,48478,1,0,152;1;101;75;86;53;154;70;135;180;63;79;133;51;118;59;115;46;0;143;117;93;140;68;139;193;41;5;42;181;159;69;108;18;22;146;34;160;48;54;177;190;184;43;116;65;149;123;127;162;151;80;176;137;23;183;89;186;114;15;9;62;144;14;138;165;40;185;90;81;196;179;145;78;31;56;113;175;171;16;25;44;120;2;129;92;57;55;52;106;178;49;102;148;124;94;189;100;26;97,2946354420378949621,0.000000
greedy_intra:edges_start:greedy,153,71836,23029,48807,1,0,153;0;117;143;183;89;186;23;137;176;80;79;63;94;124;152;97;1;101;2;120;82;129;57;92;55;52;49;102;148;9;62;144;14;138;178;106;185;165;40;90;81;196;179;145;78;31;56;113;175;171;16;25;44;75;86;26;100;121;53;180;154;135;70;127;123;162;133;151;51;118;59;65;116;43;184;84;4;190;10;177;54;48;160;34;146;22;18;108;69;159;181;42;5;115;41;193;139;68;46,5080558262765021494,0.000000
greedy_intra:edges_start:greedy,154,71750,23180,48570,1,0,154;158;53;121;100;26;86;75;101;1;97;152;94;124;148;102;49;178;106;52;55;57;92;129;2;120;44;25;16;171;175;113;56;31;78;145;179;196;81;90;185;40;165;138;14;144;62;9;15;114;186;89;183;23;137;176;80;151;162;127;123;149;65;116;43;184;177;54;48;160;34;146;22;18;108;69;159;181;42;5;41;193;139;68;140;93;117;143;0;46;115;59;118;51;133;79;63;180;135;70,6983558710361719335,0.000000
greedy_intra:edges_start:greedy,155,72039,23020,49019,1,0,155;14;138;165;40;185;90;81;196;179;145;78;31;56;113;175;171;16;25;44;120;75;86;26;189;94;63;79;80;176;133;151;51;118;59;115;46;0;137;23;186;89;183;143;117;93;140;68;139;193;41;5;42;181;159;69;108;18;22;146;34;160;48;54;177;10;190;184;43;116;65;131;149;162;123;127;70;135;154;180;53;100;101;1;97;152;2;129;92;57;55;52;106;178;49;102;148;9;62;144,2688113510118449789,0.000000
greedy_intra:edges_start:greedy,156,72431,23408,49023,1,0,156;112;4;84;35;184;177;54;48;160;34;181;146;22;18;108;69;159;193;41;5;42;43;116;65;46;68;139;115;59;118;51;0;117;143;183;89;186;23;137;176;80;79;63;94;124;152;97;1;101;2;120;82;129;57;92;55;52;49;102;148;9;62;144;14;138;178;106;185;165;40;90;81;196;179;145;78;31;56;113;175;171;16;25;44;75;86;26;100;121;53;180;154;70;135;133;151;162;123;127,8539660972929424805,0.000000
greedy_intra:edges_start:greedy,157,72008,23507,48501,1,0,157;196;81;90;40;165;185;106;178;138;14;144;62;9;148;102;49;52;55;179;145;78;92;57;129;2;152;97;1;101;100;53;180;154;135;70;127;123;162;149;131;65;116;43;184;190;10;177;54;48;160;34;146;22;18;108;69;159;181;42;5;41;193;139;68;140;93;117;143;183;89;186;23;137;0;46;115;59;118;51;151;133;176;80;79;63;94;189;26;86;75;120;44;25;16;171;175;113;56;31,984027310122692570,0.000000
greedy_intra:edges_start:greedy,158,71750,23180,48570,1,0,158;154;70;135;180;63;79;133;51;118;59;115;46;0;143;117;93;140;68;139;193;41;5;42;181;159;69;108;18;22;146;34;160;48;54;177;184;43;116;65;149;123;127;162;151;80;176;137;23;183;89;186;114;15;9;62;144;14;138;165;40;185;90;81;196;179;145;78;31;56;113;175;171;16;25;44;120;2;129;92;57;55;52;106;178;49;102;148;124;94;152;97;1;101;75;86;26;100;121;53,1625067477588480577,0.000000
greedy_intra:edges_start:greedy,159,71968,23472,48496,1,0,159;146;22;18;69;108;140;93;117;143;183;89;0;68;46;139;115;59;118;51;137;176;80;79;63;94;124;152;97;1;101;2;120;82;129;57;92;55;52;49;102;148;9;62;144;14;138;178;106;185;165;40;90;81;196;179;145;78;31;56;113;175;171;16;25;44;75;86;26;100;121;53;180;154;70;135;133;151;162;127;123;149;65;116;43;184;84;4;190;10;177;54;48;160;34;181;42;5;41;193,6056008637517930484,0.000965
greedy_intra:edges_start:greedy,160,71385,23490,47895,1,0,160;48;54;177;10;190;4;112;84;184;42;43;116;65;149;123;127;162;151;133;135;70;154;180;53;121;100;26;86;75;44;25;16;171;175;113;56;31;78;145;179;196;81;90;40;165;185;106;178;138;14;144;62;9;148;102;49;52;55;92;57;129;82;120;2;101;1;97;152;124;94;63;79;80;176;137;23;186;89;183;143;117;0;51;118;59;115;46;68;139;41;193;159;69;108;18;22;146;181;34,8276035490073519753,0.000000
greedy_intra:edges_start:greedy,161,73384,23693,49691,1,0,161;133;135;70;180;154;158;53;121;100;26;86;75;44;25;16;171;175;113;56;31;78;145;179;196;81;90;40;165;185;106;178;138;14;144;62;9;148;102;49;52;55;92;57;129;82;120;2;101;1;97;152;124;94;63;79;80;176;137;23;186;89;183;143;117;0;51;118;59;115;46;68;139;193;41;5;42;181;159;69;108;18;22;146;34;160;48;54;177;10;190;184;43;116;65;131;149;151;162;123,7731839257171986072,0.000000
greedy_intra:edges_start:greedy,162,71947,23578,48369,1,0,162;151;133;135;70;154;180;53;121;100;26;86;75;44;25;16;171;175;113;56;31;78;145;179;196;81;90;40;165;185;106;178;138;14;144;62;9;148;102;49;52;55;92;57;129;82;120;2;101;1;97;152;124;94;63;79;80;176;137;23;186;89;183;143;117;0;51;118;59;115;46;68;139;193;41;5;42;181;159;69;108;18;22;146;34;160;48;54;177;10;190;4;84;184;43;116;65;149;123;127,8224673154794769004,0.000000
greedy_intra:edges_start:greedy,163,72555,23328,49227,1,0,163;139;68;46;115;59;118;51;0;117;143;183;89;186;23;137;176;80;79;63;94;124;152;97;1;101;2;120;82;129;57;92;55;52;49;102;148;9;62;144;14;138;178;106;185;165;40;90;81;196;179;145;78;31;56;113;175;171;16;25;44;75;86;26;100;121;53;180;154;70;135;133;151;162;127;123;149;65;116;43;184;84;190;10;177;54;48;160;34;181;42;5;41;193;159;146;22;20;18;108,1292097773375325459,0.000538
greedy_intra:edges_start:greedy,164,72164,23636,48528,1,0,164;7;95;39;165;138;14;144;62;9;148;102;49;178;106;52;55;57;92;129;2;152;97;1;101;100;53;180;154;135;70;127;123;162;149;65;116;43;184;177;54;48;160;34;146;22;18;108;69;159;181;42;5;41;193;139;68;140;93;117;143;183;89;23;137;0;46;115;59;118;51;151;133;176;80;79;63;94;26;86;75;120;44;25;16;171;175;113;56;31;78;145;179;196;81;185;40;90;27;71,6263215909242686854,0.000000
greedy_intra:edges_start:greedy,165,71523,23197,48326,1,0,165;40;185;90;81;196;179;145;78;31;56;113;175;171;16;25;44;120;75;86;26;189;94;63;79;80;176;133;151;51;118;59;115;46;0;137;23;186;89;183;143;117;93;140;68;139;193;41;5;42;181;159;69;108;18;22;146;34;160;48;54;177;10;190;84;184;43;116;65;131;149;162;123;127;70;135;154;180;53;100;101;1;97;152;2;129;92;57;55;52;106;178;49;102;148;9;62;144;14;138,6324513030603009052,0.000000
greedy_intra:edges_start:greedy,166,72595,23537,49058,1,0,166;184;190;10;177;54;48;160;34;146;22;18;108;69;159;181;42;5;41;193;139;68;140;93;117;143;183;89;186;23;137;176;80;79;63;94;124;152;97;1;101;2;120;82;129;57;92;55;52;49;102;148;9;62;144;14;138;178;106;185;165;40;90;81;196;179;145;78;31;56;113;175;171;16;25;44;75;86;26;100;121;53;180;154;135;70;127;123;162;133;151;51;0;46;115;118;59;116;65;43,2373548021928944214,0.000000
greedy_intra:edges_start:greedy,167,72713,24137,48576,1,0,167;148;9;62;102;144;14;49;178;106;165;39;95;7;164;71;27;90;81;196;40;185;52;55;57;129;92;179;145;78;31;56;113;175;171;16;25;44;120;2;75;101;1;97;152;26;100;86;53;154;70;135;180;63;79;133;51;118;59;115;46;0;89;183;143;117;93;140;68;139;193;41;5;42;181;159;69;108;18;22;146;34;160;48;54;177;184;43;116;65;149;123;127;162;151;80;176;137;94;124,5737272985221081753,0.000000
greedy_intra:edges_start:greedy,168,72772,23521,49251,1,0,168;145;179;196;81;90;40;165;185;106;178;138;14;144;62;9;148;102;49;52;55;92;57;129;2;152;97;1;101;100;53;180;154;135;70;127;123;162;149;131;65;116;43;184;190;10;177;54;48;160;34;146;22;18;108;69;159;181;42;5;41;193;139;68;140;93;117;143;183;89;186;23;137;0;46;115;59;118;51;151;133;176;80;79;63;94;189;26;86;75;120;44;25;16;171;175;113;56;31;78,6180791879581973713,0.000000
greedy_intra:edges_start:greedy,169,72402,23479,48923,1,0,169;40;90;165;138;14;144;62;9;148;102;49;178;106;52;55;57;92;129;2;152;97;1;101;100;53;180;154;135;70;127;123;162;149;131;65;116;43;184;190;10;177;54;48;160;34;146;22;18;108;69;159;181;42;5;41;193;139;68;140;93;117;143;183;89;186;23;137;0;46;115;59;118;51;151;133;176;80;79;63;94;189;26;86;75;120;44;25;16;171;175;113;56;31;78;145;179;185;81;196,1627188964112131543,0.000000
greedy_intra:edges_start:greedy,170,71641,22771,48870,1,0,170;117;0;46;68;139;193;41;115;5;42;181;159;69;108;18;22;146;34;160;48;54;177;10;190;4;84;184;43;116;65;59;118;51;151;133;162;123;127;70;135;154;180;53;121;100;26;86;75;44;25;16;171;175;113;56;31;78;145;179;196;81;90;40;165;185;106;178;138;14;144;62;9;148;102;49;52;55;92;57;129;82;120;2;101;1;97;152;124;94;63;79;80;176;137;23;186;89;183;143,3106018615807548498,0.000000
greedy_intra:edges_start:greedy,171,72017,23691,48326,1,0,171;175;113;56;31;145;78;92;179;196;81;90;40;165;185;106;178;138;14;144;62;9;148;102;49;52;55;57;129;2;152;97;1;101;100;53;180;154;135;70;127;123;162;149;131;65;116;43;184;84;190;10;177;54;48;160;34;146;22;18;108;69;159;181;42;5;41;193;139;68;140;93;117;143;183;89;186;23;137;0;46;115;59;118;51;151;133;176;80;79;63;94;189;26;86;75;120;44;25;16,7708173175546535020,0.000000
greedy_intra:edges_start:greedy,172,72794,23350,49444,1,0,172;167;148;9;62;102;144;14;49;178;106;165;39;27;90;81;196;40;185;52;55;57;129;92;179;145;78;31;56;113;175;171;16;25;44;120;2;75;86;26;189;94;63;79;80;176;133;151;51;118;59;115;46;0;137;23;186;89;183;143;117;93;140;68;139;193;41;5;42;181;159;69;108;18;22;146;34;160;48;54;177;184;43;116;65;131;149;162;123;127;70;135;154;180;53;100;101;1;97;152,1138289683634071752,0.000000
greedy_intra:edges_start:greedy,173,72487,22851,49636,1,0,173;135;70;154;158;53;121;100;26;86;75;101;1;97;152;94;124;148;102;49;178;106;52;55;57;92;129;2;120;44;25;16;171;175;113;56;31;78;145;179;196;81;90;185;40;165;138;14;144;62;9;15;114;186;89;183;23;137;176;80;151;162;123;149;65;116;43;184;177;54;48;160;34;146;22;18;108;69;159;181;42;5;41;193;139;68;140;93;117;143;0;46;115;59;118;51;133;79;63;180,7058500489584133633,0.000999
greedy_intra:edges_start:greedy,174,72441,23126,49315,1,0,174;40;185;179;145;78;31;56;113;175;171;16;25;44;120;75;86;26;189;94;63;79;80;176;133;151;51;118;59;115;46;0;137;23;186;89;183;143;117;93;140;68;139;193;41;5;42;181;159;69;108;18;22;146;34;160;48;54;177;10;190;84;184;43;116;65;131;149;162;123;127;70;135;154;180;53;100;101;1;97;152;2;129;92;57;55;52;106;178;49;102;148;9;62;144;14;138;165;90;81,956919840904884032,0.000000
greedy_intra:edges_start:greedy,175,72017,23691,48326,1,0,175;113;56;31;145;78;92;179;196;81;90;40;165;185;106;178;138;14;144;62;9;148;102;49;52;55;57;129;2;152;97;1;101;100;53;180;154;135;70;127;123;162;149;131;65;116;43;184;84;190;10;177;54;48;160;34;146;22;18;108;69;159;181;42;5;41;193;139;68;140;93;117;143;183;89;186;23;137;0;46;115;59;118;51;151;133;176;80;79;63;94;189;26;86;75;120;44;25;16;171,5238380809590096123,0.001000
greedy_intra:edges_start:greedy,176,71940,23456,48484,1,0,176;80;79;63;94;124;152;97;1;101;2;120;82;129;57;92;55;52;49;102;148;9;62;144;14;138;178;106;185;165;40;90;81;196;179;145;78;31;56;113;175;171;16;25;44;75;86;26;100;121;53;180;154;135;70;127;123;162;133;151;149;131;65;116;43;184;84;190;10;177;54;48;160;34;146;22;18;108;69;159;181;42;5;41;193;139;68;46;115;59;118;51;0;117;143;183;89;186;23;137,2373986584755367896,0.000000
greedy_intra:edges_start:greedy,177,72287,23801,48486,1,0,177;54;48;34;160;181;42;195;146;22;18;108;69;159;41;193;139;68;140;93;117;143;183;89;186;23;137;176;80;79;63;94;124;152;97;1;101;2;120;82;129;57;92;55;52;49;102;148;9;62;144;14;138;178;106;185;165;40;90;81;196;179;145;78;31;56;113;175;171;16;25;44;75;86;26;100;121;53;180;154;135;70;127;123;162;133;151;51;0;46;115;118;59;116;65;43;184;84;190;10,7343556313673152259,0.000000
greedy_intra:edges_start:greedy,178,71523,23197,48326,1,0,178;49;102;148;9;62;144;14;138;165;40;185;90;81;196;179;145;78;31;56;113;175;171;16;25;44;120;75;86;26;189;94;63;79;80;176;133;151;51;118;59;115;46;0;137;23;186;89;183;143;117;93;140;68;139;193;41;5;42;181;159;69;108;18;22;146;34;160;48;54;177;10;190;84;184;43;116;65;131;149;162;123;127;70;135;154;180;53;100;101;1;97;152;2;129;92;57;55;52;106,4506151370690268091,0.000000
greedy_intra:edges_start:greedy,179,71704,23378,48326,1,0,179;145;78;31;56;113;175;171;16;25;44;120;75;86;26;189;94;63;79;80;176;133;151;51;118;59;115;46;0;137;23;186;89;183;143;117;93;140;68;139;193;41;5;42;181;159;69;108;18;22;146;34;160;48;54;177;10;190;84;184;43;116;65;131;149;162;123;127;70;135;154;180;53;100;101;1;97;152;2;129;92;57;55;52;49;102;148;9;62;144;14;138;178;106;185;165;40;90;81;196,7922400717811192851,0.000000
greedy_intra:edges_start:greedy,180,71750,23180,48570,1,0,180;135;70;154;158;53;121;100;26;86;75;101;1;97;152;94;124;148;102;49;178;106;52;55;57;92;129;2;120;44;25;16;171;175;113;56;31;78;145;179;196;81;90;185;40;165;138;14;144;62;9;15;114;186;89;183;23;137;176;80;151;162;127;123;149;65;116;43;184;177;54;48;160;34;146;22;18;108;69;159;181;42;5;41;193;139;68;140;93;117;143;0;46;115;59;118;51;133;79;63,6502381442708109526,0.000000
greedy_intra:edges_start:greedy,181,71385,23490,47895,1,0,181;34;160;48;54;177;10;190;4;112;84;184;42;43;116;65;149;123;127;162;151;133;135;70;154;180;53;121;100;26;86;75;44;25;16;171;175;113;56;31;78;145;179;196;81;90;40;165;185;106;178;138;14;144;62;9;148;102;49;52;55;92;57;129;82;120;2;101;1;97;152;124;94;63;79;80;176;137;23;186;89;183;143;117;0;51;118;59;115;46;68;139;41;193;159;69;108;18;22;146,2825412015381795920,0.000000
greedy_intra:edges_start:greedy,182,72008,23266,48742,1,0,182;121;100;26;86;75;101;1;97;152;94;124;148;102;49;178;106;52;55;57;92;129;2;120;44;25;16;171;175;113;56;31;78;145;179;196;81;90;185;40;165;138;14;144;62;9;15;114;186;89;183;23;137;176;80;151;162;127;123;149;65;116;43;184;177;54;48;160;34;146;22;18;108;69;159;181;42;5;41;193;139;68;140;93;117;143;0;46;115;59;118;51;133;79;63;180;135;70;154;53,7614481678837945740,0.000000
greedy_intra:edges_start:greedy,183,71108,22981,48127,1,0,183;89;186;23;137;176;80;79;63;94;124;152;97;1;101;2;120;82;129;57;92;55;52;49;102;148;9;62;144;14;138;178;106;185;165;40;90;81;196;179;145;78;31;56;113;175;171;16;25;44;75;86;26;100;121;53;180;154;135;70;127;123;162;133;151;51;118;59;65;116;43;184;84;112;4;190;10;177;54;48;160;34;146;22;18;108;69;159;181;42;5;115;41;193;139;68;46;0;117;143,886648906360681718,0.000000
greedy_intra:edges_start:greedy,184,72083,23661,48422,1,0,184;43;65;116;59;118;115;46;0;51;151;133;162;123;127;70;135;154;180;53;121;100;26;86;75;44;25;16;171;175;113;56;31;78;145;179;196;81;90;40;165;185;106;178;138;14;144;62;9;148;102;49;52;55;92;57;129;82;120;2;101;1;97;152;124;94;63;79;80;176;137;23;186;89;183;143;117;93;140;68;139;193;41;5;42;181;159;69;108;18;22;146;34;160;48;54;177;10;190;84,7089136050967845316,0.000000
greedy_intra:edges_start:greedy,185,71523,23197,48326,1,0,185;90;81;196;179;145;78;31;56;113;175;171;16;25;44;120;75;86;26;189;94;63;79;80;176;133;151;51;118;59;115;46;0;137;23;186;89;183;143;117;93;140;68;139;193;41;5;42;181;159;69;108;18;22;146;34;160;48;54;177;10;190;84;184;43;116;65;131;149;162;123;127;70;135;154;180;53;100;101;1;97;152;2;129;92;57;55;52;106;178;49;102;148;9;62;144;14;138;165;40,3100196121386342015,0.000000
greedy_intra:edges_start:greedy,186,71108,22981,48127,1,0,186;89;183;143;117;0;46;68;139;193;41;115;5;42;181;159;69;108;18;22;146;34;160;48;54;177;10;190;4;112;84;184;43;116;65;59;118;51;151;133;162;123;127;70;135;154;180;53;121;100;26;86;75;44;25;16;171;175;113;56;31;78;145;179;196;81;90;40;165;185;106;178;138;14;144;62;9;148;102;49;52;55;92;57;129;82;120;2;101;1;97;152;124;94;63;79;80;176;137;23,849403143156539200,0.000000
greedy_intra:edges_start:greedy,187,72151,23121,49030,1,0,187;81;196;40;185;179;145;78;31;56;113;175;171;16;25;44;120;75;86;26;189;94;63;79;80;176;133;151;51;118;59;115;46;0;137;23;186;89;183;143;117;93;140;68;139;193;41;5;42;181;159;69;108;18;22;146;34;160;48;54;177;10;190;184;43;116;65;131;149;162;123;127;70;135;154;180;53;100;101;1;97;152;2;129;92;57;55;52;106;178;49;102;148;9;62;144;14;138;165;90,2595114133500849134,0.000000
greedy_intra:edges_start:greedy,188,73045,23657,49388,1,0,188;31;145;78;92;179;196;81;90;40;165;185;106;178;138;14;144;62;9;148;102;49;52;55;57;129;2;152;97;1;101;100;53;180;154;135;70;127;123;162;149;131;65;116;43;184;190;10;177;54;48;160;34;146;22;18;108;69;159;181;42;5;41;193;139;68;140;93;117;143;183;89;186;23;137;0;46;115;59;118;51;151;133;176;80;79;63;94;189;26;86;75;120;44;25;16;171;175;113;56,3498435910136525323,0.000000
greedy_intra:edges_start:greedy,189,71945,22885,49060,1,0,189;94;124;148;102;49;178;106;52;55;57;92;129;2;120;44;25;16;171;175;113;56;31;78;145;179;196;81;90;185;40;165;138;14;144;62;9;15;114;186;89;183;23;137;176;80;151;162;123;149;65;116;43;184;177;54;48;160;34;146;22;18;108;69;159;181;42;5;41;193;139;68;140;93;117;143;0;46;115;59;118;51;133;79;63;180;135;70;154;158;53;121;100;26;86;75;101;1;97;152,8640666111008577768,0.000000
greedy_intra:edges_start:greedy,190,72214,24115,48099,1,0,190;10;177;54;48;34;160;181;42;146;22;18;108;69;159;41;193;139;68;46;115;118;59;116;65;43;184;35;131;149;123;162;151;133;51;0;117;143;183;89;23;137;176;80;79;63;94;124;152;97;1;101;2;120;82;129;57;92;55;52;49;102;148;9;62;144;14;138;178;106;185;165;40;90;81;196;179;145;78;31;56;113;175;171;16;25;44;75;86;26;100;121;53;180;154;135;70;127;112;4,2979113534277298099,0.000000
greedy_intra:edges_start:greedy,191,72529,23490,49039,1,0,191;193;41;5;42;181;159;69;108;18;22;146;34;160;48;54;177;10;190;84;184;43;116;65;149;123;127;162;151;133;135;70;154;180;53;121;100;26;86;75;44;25;16;171;175;113;56;31;78;145;179;196;81;90;40;165;185;106;178;138;14;144;62;9;148;102;49;52;55;92;57;129;82;120;2;101;1;97;152;124;94;63;79;80;176;137;23;186;89;183;143;117;0;51;118;59;115;46;68;139,3828797221935876423,0.000000
greedy_intra:edges_start:greedy,192,72789,23609,49180,1,0,192;42;5;41;193;139;68;140;93;117;143;183;89;186;23;137;176;80;79;63;94;124;152;97;1;101;2;120;82;129;57;92;55;52;49;102;148;9;62;144;14;138;178;106;185;165;40;90;81;196;179;145;78;31;56;113;175;171;16;25;44;75;86;26;100;121;53;180;154;135;70;127;123;162;133;151;51;0;46;115;118;59;116;65;43;184;190;10;177;54;48;160;34;146;22;18;108;69;159;181,8954695815442484321,0.000000
greedy_intra:edges_start:greedy,193,71947,23578,48369,1,0,193;139;68;46;115;59;118;51;0;117;143;183;89;186;23;137;176;80;79;63;94;124;152;97;1;101;2;120;82;129;57;92;55;52;49;102;148;9;62;144;14;138;178;106;185;165;40;90;81;196;179;145;78;31;56;113;175;171;16;25;44;75;86;26;100;121;53;180;154;70;135;133;151;162;127;123;149;65;116;43;184;84;4;190;10;177;54;48;160;34;146;22;18;108;69;159;181;42;5;41,7007406287548109604,0.000000
greedy_intra:edges_start:greedy,194,72641,23748,48893,1,0,194;127;123;162;133;151;149;131;65;116;43;184;190;10;177;54;48;160;34;146;22;18;108;69;159;181;42;5;41;193;139;68;46;115;59;118;51;0;117;143;183;89;186;23;137;176;80;79;63;94;124;152;97;1;101;2;120;82;129;57;92;55;52;49;102;148;9;62;144;14;138;178;106;185;165;40;90;81;196;179;145;78;31;56;113;175;171;16;25;44;75;86;26;100;121;180;53;154;70;135,6698271434180578769,0.000000
greedy_intra:edges_start:greedy,195,71734,23301,48433,1,0,195;181;34;160;48;54;177;10;190;4;84;184;42;43;116;65;149;123;127;162;151;133;135;70;154;180;53;121;100;26;86;75;44;25;16;171;175;113;56;31;78;145;179;196;81;90;40;165;185;106;178;138;14;144;62;9;148;102;49;52;55;92;57;129;82;120;2;101;1;97;152;124;94;63;79;80;176;137;23;186;89;183;143;117;0;51;118;59;115;46;68;139;41;193;159;69;108;18;22;146,8939059911261157345,0.000000
greedy_intra:edges_start:greedy,196,72377,23517,48860,1,0,196;81;90;40;165;185;106;178;138;14;144;62;9;148;102;49;52;55;57;129;92;179;145;78;82;2;152;97;1;101;100;53;180;154;135;70;127;123;162;149;131;65;116;43;184;190;177;54;48;160;34;146;22;18;108;69;159;181;42;5;41;193;139;68;140;93;117;143;183;89;186;23;137;0;46;115;59;118;51;151;133;176;80;79;63;94;189;26;86;75;120;44;25;16;171;175;113;56;31;157,1863908305955409639,0.000000
greedy_intra:edges_start:greedy,197,72970,23867,49103,1,0,197;46;68;139;193;41;5;42;181;159;69;108;18;22;146;34;160;48;54;177;10;190;84;184;43;116;65;149;123;127;162;151;133;135;70;154;180;53;121;100;26;86;75;44;25;16;171;175;113;56;31;78;145;179;196;81;90;40;165;185;106;178;138;14;144;62;9;148;102;49;52;55;92;57;129;82;120;2;101;1;97;152;124;94;63;79;80;176;137;23;186;89;183;143;117;0;51;118;59;115,5348412248104736751,0.000000
greedy_intra:edges_start:greedy,198,72216,23377,48839,1,0,198;46;115;59;118;51;0;117;143;183;89;186;23;137;176;80;79;63;94;124;152;97;1;101;2;120;82;129;57;92;55;52;49;102;148;9;62;144;14;138;178;106;185;165;40;90;81;196;179;145;78;31;56;113;175;171;16;25;44;75;86;26;100;121;53;180;154;70;135;133;151;162;127;123;149;65;116;43;184;84;4;190;10;177;54;48;160;34;146;22;18;108;69;159;181;42;5;41;193;139,2137390467910446969,0.000000
greedy_intra:edges_start:greedy,199,72263,23490,48773,1,0,199;139;68;46;115;59;118;51;0;117;143;183;89;186;23;137;176;80;79;63;94;124;152;97;1;101;2;120;82;129;57;92;55;52;49;102;148;9;62;144;14;138;178;106;185;165;40;90;81;196;179;145;78;31;56;113;175;171;16;25;44;75;86;26;100;121;53;180;154;70;135;133;151;162;127;123;149;65;116;43;184;84;190;10;177;54;48;160;34;181;42;5;41;193;159;146;22;18;108;69,6078580578374769439,0.000000
