method,run,objective,tour_length,selected_costs,evaluations,improvements,final_selected,seed,duration_ms
steepest_intra:nodes_start:random,0,85552,37378,48174,2063100,137,127;135;154;152;57;92;129;26;53;180;133;151;118;59;65;116;115;139;68;108;69;18;22;42;43;131;149;70;16;171;175;81;90;119;40;176;193;159;34;177;10;190;4;112;123;162;51;0;93;117;143;183;89;186;9;62;106;196;31;56;113;44;75;86;101;97;1;2;120;25;78;145;179;185;165;138;3;178;52;55;167;80;79;63;94;124;148;102;49;14;144;137;46;41;181;160;48;30;54;184,8738961374528292186,0.061942
steepest_intra:nodes_start:random,1,88131,39380,48751,2242500,149,152;26;100;135;70;127;123;149;131;65;43;160;42;116;162;179;196;81;90;144;117;108;18;22;159;139;68;46;115;118;59;184;177;10;190;4;112;54;34;193;41;15;14;138;165;40;185;167;124;94;122;79;133;151;51;183;89;23;186;180;154;53;86;92;57;55;52;145;78;25;16;171;175;113;31;157;106;3;178;129;2;1;97;121;63;80;176;0;143;137;101;75;120;44;49;102;62;9;37;148,7313039608888360279,0.067078
steepest_intra:nodes_start:random,2,90295,41515,48780,2347150,156,41;42;43;116;23;186;15;9;62;92;16;171;175;81;106;178;167;115;193;18;108;140;68;46;176;148;14;164;27;90;185;52;55;179;196;145;101;53;154;123;149;47;65;59;51;80;122;63;79;131;160;34;22;159;118;94;100;26;97;1;120;82;78;31;56;113;25;44;75;86;180;133;151;162;135;70;127;112;4;177;54;184;183;89;144;102;49;138;165;119;40;57;129;2;152;124;137;143;0;139,249668062026051051,0.068772
steepest_intra:nodes_start:random,3,88842,39513,49329,2332200,155,27;90;81;78;120;2;135;112;177;54;48;184;149;162;180;154;158;53;121;97;1;101;75;86;100;26;189;94;124;55;52;167;193;22;18;108;93;143;183;89;176;80;151;133;79;122;152;129;92;179;57;62;9;186;23;137;51;118;115;139;117;0;46;116;65;47;35;84;4;131;59;148;106;178;49;144;14;185;145;82;63;160;34;181;41;42;43;123;127;70;44;25;16;171;175;113;31;196;40;165,151700163153032845,0.067011
steepest_intra:nodes_start:random,4,88093,35324,52769,2735850,182,178;106;185;40;90;165;138;14;144;129;25;44;120;2;121;180;135;112;4;10;190;84;35;127;70;154;158;100;26;1;97;63;79;151;72;65;47;131;149;123;162;75;16;78;145;92;137;93;140;116;43;184;177;30;54;160;34;41;115;139;68;108;69;18;199;193;159;195;22;146;181;42;59;51;176;80;9;62;186;89;183;143;117;0;46;118;133;53;86;101;49;102;37;148;124;94;152;57;55;52,7423946930599076697,0.079833
steepest_intra:nodes_start:random,5,85979,36723,49256,2302300,153,148;124;94;63;79;127;70;135;154;180;133;151;118;115;22;146;103;34;54;184;131;149;84;4;112;123;162;59;139;69;108;18;159;193;41;5;181;160;42;43;51;137;15;62;9;176;65;47;116;117;143;183;89;120;44;25;78;145;23;0;68;46;80;53;121;100;26;178;106;40;119;165;39;27;90;81;196;101;86;75;16;171;175;113;31;185;138;14;144;49;52;55;57;92;129;2;1;97;152;167,637299247920669484,0.067884
steepest_intra:nodes_start:random,6,84698,35231,49467,2631200,175,3;178;145;78;82;148;186;137;176;80;122;94;97;1;101;75;86;53;158;180;154;112;184;177;54;48;160;43;131;149;162;121;100;26;124;167;106;52;55;57;179;185;165;119;40;31;56;113;175;171;16;25;44;120;151;46;68;139;18;22;146;34;181;42;193;41;115;118;15;62;9;51;59;116;65;123;127;70;135;133;79;63;152;2;129;92;196;81;90;21;89;183;143;0;23;114;144;14;102;49,7393942808370288786,0.077000
steepest_intra:nodes_start:random,7,90754,41447,49307,2466750,164,108;18;22;146;195;181;129;92;179;49;183;143;117;0;176;80;51;116;42;5;41;193;159;139;68;46;198;115;137;9;62;16;171;175;113;81;90;165;40;145;120;162;35;184;43;47;65;59;118;151;133;79;63;94;124;189;97;2;57;55;52;106;178;3;167;121;180;135;127;123;149;131;160;48;54;177;70;44;78;31;196;185;14;144;186;89;23;148;152;1;101;75;86;26;100;53;154;112;84;34,247801803272343309,0.071511
steepest_intra:nodes_start:random,8,91785,42133,49652,2347150,156,148;124;94;122;80;79;63;121;97;1;101;154;135;162;133;151;118;115;46;68;198;139;41;193;93;117;143;0;137;92;31;157;185;3;49;183;108;18;22;146;184;35;113;175;171;16;2;51;59;65;116;43;149;123;86;75;120;82;44;25;78;145;179;196;81;90;39;138;14;144;186;23;176;180;158;53;100;26;167;178;106;165;119;40;57;129;42;181;34;160;54;177;112;127;70;152;55;52;62;9,7074489151105843606,0.069998
steepest_intra:nodes_start:random,9,88460,40017,48443,2392000,159,18;68;46;198;139;115;42;54;177;184;112;127;123;65;41;193;159;195;181;120;25;113;31;144;62;9;176;51;116;43;160;34;103;146;22;140;117;143;0;118;59;131;149;162;151;133;101;44;171;175;16;75;70;135;154;180;129;40;119;185;55;52;106;178;3;14;49;57;92;78;145;179;196;81;165;90;27;164;95;39;2;1;97;152;94;148;186;23;137;80;79;53;86;26;100;63;89;183;93;108,4220860164541800825,0.068506
steepest_intra:nodes_start:random,10,89933,40631,49302,2406950,160,94;124;148;102;62;9;15;137;181;160;54;177;89;183;143;108;18;68;51;79;122;152;2;120;25;157;81;90;196;179;57;92;129;167;23;186;49;3;178;106;43;42;41;139;144;14;165;119;40;185;52;55;145;78;31;113;175;171;16;44;75;86;63;184;34;22;159;193;115;118;59;162;151;133;80;176;0;117;46;116;65;149;131;112;123;127;70;26;97;1;101;158;154;135;180;53;136;121;100;189,2917224922081982218,0.073001
steepest_intra:nodes_start:random,11,93869,43288,50581,2705950,180,162;47;65;151;133;79;180;154;123;131;43;193;159;18;22;34;48;54;184;49;165;40;185;52;55;57;92;129;2;1;101;100;53;35;84;127;70;135;176;137;23;186;89;183;143;170;117;93;68;198;46;51;94;78;31;113;175;171;16;145;179;62;9;148;152;97;26;121;63;80;59;116;42;5;115;118;109;15;114;0;139;41;181;160;149;124;167;106;178;14;144;177;10;4;112;120;25;44;75;86,9192278566265788120,0.079000
steepest_intra:nodes_start:random,12,91627,42754,48873,1928550,128,137;121;53;63;46;139;18;22;146;159;115;118;80;79;133;151;162;149;131;116;65;86;16;171;175;113;56;31;1;35;184;84;112;70;97;165;90;27;164;21;138;144;15;114;89;183;143;0;193;41;5;42;43;123;127;135;9;102;14;49;148;176;51;181;34;54;177;160;59;106;185;40;196;179;145;78;92;167;124;94;180;154;100;26;101;75;44;25;120;2;152;129;57;55;52;178;3;62;186;23,136128142677273317,0.056001
steepest_intra:nodes_start:random,13,91969,43790,48179,2197650,146,177;54;42;43;116;118;59;65;47;133;121;100;26;101;86;53;123;131;149;162;152;129;120;2;1;97;94;176;51;46;68;137;62;102;49;3;185;196;113;31;78;89;183;143;0;23;15;165;119;40;179;145;92;57;106;178;9;117;108;18;22;146;34;160;184;112;127;75;44;25;16;171;175;81;90;164;21;14;144;114;186;80;79;122;63;135;70;154;180;151;115;41;193;139;148;52;55;4;190;10,8626194717402489398,0.062999
steepest_intra:nodes_start:random,14,90549,40567,49982,2481700,165,160;184;84;35;123;127;70;53;86;75;78;145;81;90;165;143;108;18;46;23;186;185;40;179;92;101;1;97;152;106;178;3;167;94;63;162;149;131;47;59;118;109;51;137;183;89;15;144;14;148;124;121;100;26;120;44;16;171;175;113;41;193;159;22;181;42;5;9;62;102;49;52;55;57;129;2;80;176;0;117;93;140;68;139;115;43;105;116;65;151;133;79;180;154;135;112;4;177;54;34,5777050616227291219,0.073626
steepest_intra:nodes_start:random,15,87241,37686,49555,2705950,180,55;185;119;40;145;25;44;120;2;152;135;70;127;123;79;9;62;181;34;160;59;118;51;176;80;122;189;26;97;1;101;100;121;133;162;149;131;112;84;184;177;54;115;46;0;117;68;139;193;41;137;52;196;81;90;165;14;144;102;148;12;63;180;154;158;53;86;75;16;171;78;92;167;124;94;151;65;116;43;42;159;22;18;143;183;89;23;186;15;49;178;106;179;31;56;113;175;82;129;57,3152012332700454712,0.102973
steepest_intra:nodes_start:random,16,87103,37532,49571,2780700,185,179;145;92;57;55;52;94;63;122;12;148;138;165;90;164;21;114;89;183;143;0;117;18;22;146;181;43;149;100;26;121;59;115;41;193;159;116;65;129;113;175;171;16;44;2;53;158;154;180;133;79;80;176;51;118;46;68;198;139;42;184;177;54;48;34;160;84;112;127;70;75;120;78;31;40;119;185;106;178;167;124;152;97;1;101;86;135;123;162;151;137;23;186;15;144;14;49;102;62;9,2728634607100571615,0.091997
steepest_intra:nodes_start:random,17,90415,40917,49498,2526550,168,106;40;185;55;57;179;92;129;2;86;177;54;34;146;22;181;42;43;75;31;113;175;171;16;137;0;68;139;193;41;123;127;70;135;133;151;65;47;131;149;162;97;152;124;89;183;143;117;93;140;108;18;120;44;25;78;145;52;49;102;9;62;144;14;165;39;27;90;81;196;94;63;79;180;154;158;53;121;100;26;101;1;178;3;148;186;23;46;115;5;160;184;116;59;118;109;51;176;80;167,6190541944071738516,0.076000
steepest_intra:nodes_start:random,18,90540,41185,49355,2272400,151,151;59;47;77;184;177;10;190;35;154;53;86;31;113;175;171;16;75;180;162;149;131;127;70;135;65;116;43;42;160;34;48;54;84;4;112;123;133;148;14;165;90;164;21;144;62;9;102;49;178;106;52;185;119;40;55;167;124;94;176;137;0;143;183;89;23;97;1;101;2;145;81;196;179;57;152;80;118;115;46;186;15;37;129;120;44;25;78;92;51;41;193;22;18;139;79;63;26;100;121,7443876067139431086,0.068909
steepest_intra:nodes_start:random,19,90293,41084,49209,2003300,133,165;40;185;49;102;167;123;84;35;65;116;42;181;41;115;152;120;25;113;56;31;145;57;55;100;53;180;162;133;121;86;75;16;175;171;44;101;1;2;82;78;38;157;179;52;62;9;15;137;176;80;79;63;154;135;70;127;112;177;54;22;159;193;139;68;0;89;23;148;124;94;51;118;46;18;108;93;117;143;183;144;14;106;178;149;131;184;160;34;43;59;72;151;26;97;129;92;196;81;90,7920639125694847118,0.060901
steepest_intra:nodes_start:random,20,91897,44009,47888,2197650,146,80;55;196;31;56;113;175;171;16;78;23;89;183;118;43;184;54;177;10;4;112;44;25;145;179;52;49;102;62;9;79;42;22;146;34;160;185;40;81;90;164;7;21;148;63;180;158;53;121;100;26;97;94;137;0;170;143;117;46;115;116;65;149;162;133;123;127;70;135;154;86;101;2;129;57;92;120;75;1;152;167;178;106;165;14;144;41;193;159;18;108;69;139;59;151;51;68;140;93;176,315890259838480445,0.065874
steepest_intra:nodes_start:random,21,88728,39842,48886,2406950,160,78;31;175;113;90;27;165;106;167;94;53;158;180;154;135;133;176;137;14;164;7;21;144;89;183;143;117;0;46;51;151;162;59;118;115;146;103;34;54;177;10;190;43;42;181;160;48;184;112;127;70;86;26;100;121;189;97;1;120;145;179;92;129;82;2;152;55;52;148;80;79;63;101;44;25;171;16;75;123;65;116;41;159;22;18;193;139;68;119;40;185;178;9;23;186;15;62;102;49;57,1933490051674316303,0.069359
steepest_intra:nodes_start:random,22,89027,39084,49943,2421900,161,49;138;14;102;62;9;15;148;124;94;53;26;185;165;90;40;2;101;86;75;44;25;92;55;52;137;140;93;117;143;0;46;198;115;139;68;183;89;23;186;114;73;144;178;106;79;133;35;184;43;116;65;131;149;118;109;51;176;57;179;196;31;113;175;171;16;63;151;42;181;160;127;135;154;180;162;123;112;4;177;54;34;22;18;108;159;193;41;5;59;72;80;129;145;78;120;1;97;152;167,378679573616021563,0.083998
steepest_intra:nodes_start:random,23,93212,45139,48073,2018250,134,119;40;185;106;3;178;52;152;94;124;167;148;176;59;65;149;131;84;4;112;154;86;101;75;57;55;145;175;171;16;35;184;48;54;177;10;180;53;100;26;97;15;186;23;137;80;79;133;162;123;127;70;135;116;41;193;159;22;18;108;117;14;165;90;81;113;31;78;25;44;120;92;129;2;1;63;151;43;42;160;34;181;115;51;9;62;89;143;183;21;7;164;95;144;46;198;139;68;0;49,8996386136155083281,0.064000
steepest_intra:nodes_start:random,24,87598,38777,48821,2287350,152,124;148;49;178;106;79;133;35;184;177;4;112;70;158;53;180;154;135;123;54;48;43;116;65;47;131;149;162;86;75;44;25;120;2;152;167;102;144;21;164;27;90;138;14;62;9;115;41;5;42;118;51;176;80;63;179;145;78;31;113;175;171;16;101;1;97;26;100;151;59;159;22;18;69;108;140;93;117;143;0;137;23;186;89;183;46;139;193;181;34;160;52;165;40;185;55;57;92;129;94,7097884934834188679,0.064971
steepest_intra:nodes_start:random,25,85856,38387,47469,2975050,198,112;4;10;177;84;80;21;7;164;27;31;56;113;175;171;16;14;144;49;102;62;9;148;124;152;1;101;97;186;89;183;143;117;18;34;160;48;54;184;51;176;137;23;0;118;59;65;116;42;43;149;123;70;154;167;178;106;52;55;57;92;44;25;78;145;129;2;26;100;63;79;94;185;40;119;165;90;81;196;120;75;86;53;180;162;41;193;159;22;146;181;5;115;139;68;46;151;133;135;127,5268227213682065881,0.083423
steepest_intra:nodes_start:random,26,94613,43962,50651,2392000,159,62;15;114;89;186;1;101;75;120;129;57;185;40;90;165;42;181;146;22;46;14;138;3;152;97;26;100;121;49;102;144;183;143;0;184;54;30;177;10;190;4;112;127;135;133;79;23;137;176;80;151;162;149;131;123;25;31;113;175;171;16;44;70;84;35;47;65;115;139;41;193;159;34;160;43;116;59;78;145;179;92;2;86;53;158;154;180;63;94;167;178;106;52;55;124;122;118;51;148;9,6723560493271298316,0.068349
steepest_intra:nodes_start:random,27,83695,34250,49445,2152800,143,159;22;146;195;139;93;117;0;143;183;176;80;63;97;26;100;79;151;43;160;34;54;184;35;131;149;162;133;180;53;86;101;1;152;148;144;21;164;90;81;113;175;171;55;52;106;185;40;119;165;39;138;14;178;57;129;2;167;49;102;62;9;15;137;59;115;198;69;18;108;68;46;118;51;94;92;179;145;44;25;78;196;157;31;16;120;75;154;135;123;112;4;84;65;116;5;42;181;41;193,8463214734936147017,0.064099
steepest_intra:nodes_start:random,28,90382,42058,48324,2362100,157,139;159;193;41;115;118;51;80;120;44;25;145;179;52;55;57;129;2;162;149;59;151;133;79;63;182;121;100;53;180;123;184;160;34;181;68;117;0;46;116;43;42;146;22;18;108;140;93;143;183;31;113;175;171;16;78;92;23;89;186;15;178;3;138;14;144;148;124;94;97;1;101;75;70;127;135;154;86;26;152;167;49;102;62;9;112;177;54;48;65;176;165;90;81;196;40;119;185;106;137,8014693282866546134,0.066087
steepest_intra:nodes_start:random,29,88581,40069,48512,2227550,148,75;86;117;93;108;18;22;34;48;160;181;159;115;116;59;118;51;176;137;46;139;193;41;42;43;65;149;127;70;135;154;158;53;100;26;23;183;89;186;152;129;92;57;55;52;106;178;3;15;143;0;54;177;184;84;4;112;35;123;180;31;113;175;171;16;121;133;162;151;80;79;122;63;185;165;40;179;145;2;1;97;101;120;44;25;78;138;14;49;102;167;124;94;148;9;62;144;90;81;196,5435742547066115373,0.064514
steepest_intra:nodes_start:random,30,93929,46243,47686,2631200,175,165;106;167;124;94;51;46;139;18;108;117;0;143;183;137;176;80;122;79;162;84;10;177;54;184;123;180;53;121;63;59;41;193;159;42;43;131;149;151;148;9;62;49;52;179;145;92;129;26;100;154;135;127;112;4;70;75;44;25;120;133;181;146;22;115;57;196;81;164;7;21;144;114;89;23;186;15;14;3;178;55;152;97;1;101;2;78;31;113;175;171;16;86;160;34;116;65;185;40;90,8912488064922828325,0.075125
steepest_intra:nodes_start:random,31,89964,41030,48934,2481700,165,185;148;159;22;18;108;183;89;57;92;145;31;56;113;175;171;16;129;137;0;117;143;15;102;49;3;178;106;152;1;101;97;189;94;80;59;65;160;34;54;184;112;70;158;86;75;120;2;46;115;116;43;42;181;193;41;139;68;23;186;9;52;55;167;124;176;51;118;151;79;63;121;26;100;53;180;154;135;127;123;131;149;162;133;62;144;14;164;27;90;165;119;40;81;78;25;44;82;179;196,1205153378572102143,0.071893
steepest_intra:nodes_start:random,32,92199,43737,48462,2451800,163,118;72;162;135;70;127;112;123;154;86;75;44;120;101;35;34;146;159;193;124;57;92;25;16;171;175;113;31;78;145;94;115;41;139;46;0;14;165;90;27;164;21;144;62;151;184;160;48;54;177;10;190;4;180;53;1;2;129;179;40;119;185;106;178;49;9;137;59;65;116;5;42;43;131;149;133;79;63;100;26;97;152;186;23;89;183;143;117;108;18;22;181;47;80;167;55;52;148;176;51,1535503790673711067,0.073484
steepest_intra:nodes_start:random,33,92469,43951,48518,2063100,137,9;15;114;186;23;167;57;31;113;175;171;16;44;176;93;108;18;69;139;198;46;137;148;52;55;129;97;26;100;53;63;79;184;160;181;42;43;47;102;49;178;145;78;25;75;86;101;1;152;124;183;143;0;117;68;115;116;65;162;151;118;193;159;22;146;80;94;2;120;82;92;90;164;7;21;144;62;51;59;149;131;127;70;135;154;180;133;123;112;177;54;34;41;89;14;138;165;40;185;106,8781156361766999248,0.057944
steepest_intra:nodes_start:random,34,91446,42340,49106,2063100,137,25;78;179;49;102;46;68;117;143;0;31;113;175;171;16;92;89;183;176;80;122;137;23;186;152;1;97;63;159;22;34;30;54;177;48;160;184;165;90;27;164;7;21;14;144;15;51;118;59;135;154;158;180;162;65;116;131;149;127;70;53;100;26;121;151;43;42;41;193;139;115;84;4;112;123;133;79;94;124;148;9;62;178;106;52;55;129;75;86;101;2;57;185;119;40;81;196;145;120;44,8506716778601729720,0.058752
steepest_intra:nodes_start:random,35,84474,35301,49173,2466750,164,117;143;183;89;186;23;137;63;26;100;180;54;177;10;4;112;123;162;59;46;68;139;193;41;115;118;31;16;171;175;113;56;81;196;179;57;92;129;82;120;44;25;78;145;185;40;90;27;165;138;148;80;151;133;79;122;94;124;12;176;51;65;116;43;42;181;34;160;184;127;70;135;154;53;121;167;14;144;62;9;102;49;3;178;106;152;97;1;101;86;75;2;55;52;15;114;0;159;22;18,2558482803090995513,0.075758
steepest_intra:nodes_start:random,36,90356,36530,53826,2616250,174,44;185;40;119;165;139;159;22;18;108;140;153;183;89;23;186;49;3;106;178;137;115;160;34;181;193;41;42;43;77;162;127;123;149;131;47;65;116;59;51;167;52;55;57;2;75;86;101;152;124;94;189;19;97;1;26;100;121;53;180;133;151;118;46;0;143;117;93;68;184;84;112;135;154;148;37;15;114;9;62;102;144;14;138;39;27;90;175;171;16;78;145;92;129;122;176;80;79;63;120,8232630591041340360,0.074676
steepest_intra:nodes_start:random,37,87782,38788,48994,2227550,148,1;101;86;53;162;65;116;43;42;160;34;18;69;108;117;144;21;7;164;95;154;135;123;131;149;152;129;92;179;145;78;2;26;100;94;124;167;106;178;49;102;14;138;165;27;90;40;185;52;55;148;0;143;183;89;137;176;51;118;59;151;133;79;122;63;180;127;112;4;177;54;48;184;35;84;70;75;120;44;16;171;175;113;56;31;57;62;9;46;139;193;159;22;146;181;5;41;115;80;97,2880855418473354957,0.062970
steepest_intra:nodes_start:random,38,86092,35189,50903,2137850,142,72;51;115;139;68;46;118;59;181;146;22;18;159;193;41;42;116;43;54;177;184;131;133;79;63;158;53;121;94;55;165;27;90;81;82;120;75;86;101;1;152;97;26;100;180;162;149;35;84;4;112;127;70;154;44;25;16;171;175;78;57;167;124;80;65;160;34;48;123;194;135;2;129;92;179;145;31;113;56;157;196;49;102;9;62;144;14;178;106;119;40;185;52;148;23;89;183;137;176;151,1856144587271684511,0.062087
steepest_intra:nodes_start:random,39,82892,34249,48643,2197650,146,62;52;55;145;78;31;157;196;81;90;27;165;1;101;2;129;57;92;25;16;171;175;113;56;40;119;185;49;102;144;14;3;178;106;152;26;100;53;154;135;127;123;65;116;115;46;68;139;193;69;108;18;22;159;41;42;133;79;122;80;181;34;30;54;184;180;63;97;120;44;75;86;70;112;4;177;48;160;43;131;149;162;151;59;118;51;176;94;124;148;0;117;143;183;89;23;137;186;15;9,6610139452239915311,0.062831
steepest_intra:nodes_start:random,40,83168,32839,50329,2347150,156,78;82;63;79;51;118;72;151;133;94;57;55;52;185;40;165;144;89;183;46;68;139;115;59;162;123;127;70;135;154;86;26;100;121;53;158;180;41;193;159;22;146;103;34;54;177;48;42;43;116;65;149;131;184;160;181;18;69;108;93;117;23;186;15;148;9;62;49;14;178;106;129;2;1;97;152;189;122;80;176;0;143;137;124;101;75;120;44;25;92;179;145;31;113;56;196;81;175;171;16,2377869211802457746,0.068589
steepest_intra:nodes_start:random,41,86050,37900,48150,2421900,161,14;178;106;52;55;57;179;145;78;196;185;49;102;62;9;167;129;44;120;75;63;79;133;151;162;149;65;116;43;5;41;159;195;181;118;51;176;148;40;119;39;165;101;86;100;26;1;92;7;164;27;90;81;157;31;113;175;171;16;25;2;139;193;18;22;146;34;48;160;42;115;46;68;117;0;143;183;89;23;186;124;152;97;94;80;123;4;112;127;135;180;53;154;70;177;54;184;59;137;144,7800864562748199658,0.071004
steepest_intra:nodes_start:random,42,88687,38477,50210,2152800,143,124;12;94;121;100;26;86;101;1;97;137;89;183;143;0;23;186;62;9;148;176;116;43;42;181;34;103;146;159;193;115;151;133;135;70;127;177;54;48;41;139;165;27;90;119;40;185;106;178;46;68;108;18;22;160;184;123;162;149;131;112;84;35;65;59;118;51;80;120;44;16;171;175;78;145;92;57;55;52;31;113;81;196;129;2;75;53;158;154;180;152;49;14;144;102;167;79;63;189;19,8451333239774408029,0.064799
steepest_intra:nodes_start:random,43,93386,44067,49319,2093000,139,176;179;196;81;106;15;186;23;0;46;51;86;75;120;78;31;157;90;39;167;124;94;80;148;9;62;137;118;181;34;160;180;113;175;171;16;44;25;145;92;82;2;133;162;151;79;63;121;100;26;97;129;57;55;178;3;49;102;14;95;164;7;21;183;143;117;108;18;89;144;165;119;40;185;52;152;1;101;53;154;135;70;43;22;193;41;139;68;115;5;42;184;112;127;123;149;131;65;116;59,5133916497794862827,0.059004
steepest_intra:nodes_start:random,44,88654,39040,49614,2302300,153,186;89;183;143;0;23;178;106;52;185;40;196;81;90;27;165;14;144;117;108;18;22;193;148;37;137;46;139;41;5;43;131;149;123;127;135;180;63;79;133;151;162;47;42;181;34;160;54;177;184;124;167;57;92;145;78;129;82;120;44;16;171;175;25;2;1;152;94;80;51;118;59;65;116;96;115;15;62;9;176;84;4;112;70;154;53;121;100;26;97;101;86;75;113;56;31;157;179;55;49,7826536219193125445,0.066587
steepest_intra:nodes_start:random,45,90469,40659,49810,2122900,141,113;175;171;75;101;86;53;162;123;4;112;127;135;180;165;90;81;196;55;23;0;68;139;193;41;43;105;116;65;47;131;149;59;151;100;26;19;189;124;94;122;79;133;184;48;160;42;137;15;144;62;9;148;167;152;2;129;92;40;119;185;121;154;70;177;54;34;146;22;159;115;118;176;102;49;14;178;106;52;179;145;78;16;25;44;120;1;97;63;80;51;46;18;108;117;143;183;89;57;31,7917813420153368762,0.084997
steepest_intra:nodes_start:random,46,89263,41197,48066,2511600,167,176;137;15;148;124;94;86;75;120;31;113;81;90;165;40;185;65;47;131;149;123;112;184;177;10;4;127;70;135;154;53;100;26;101;1;97;152;55;52;106;178;49;14;164;7;21;144;51;160;54;34;181;93;117;23;186;114;89;183;143;0;80;79;63;122;167;62;9;68;159;22;18;108;57;175;171;16;44;25;78;145;92;129;2;180;162;116;43;42;5;41;193;139;198;46;115;118;59;151;133,4919781050653290223,0.070034
steepest_intra:nodes_start:random,47,85993,35049,50944,2945150,196,118;46;198;139;115;116;65;131;149;123;101;1;2;129;57;49;15;186;23;89;183;153;0;96;5;42;41;199;69;108;18;22;159;193;181;34;160;54;177;4;112;84;184;43;59;92;31;113;175;171;16;44;63;122;79;133;80;94;124;152;97;26;100;121;53;158;180;154;135;70;127;162;151;176;148;167;55;52;106;178;14;144;62;9;137;143;117;93;140;68;120;25;78;145;40;165;185;75;86;51,8491114168818696026,0.082544
steepest_intra:nodes_start:random,48,93277,43076,50201,2122900,141,185;57;92;129;120;2;1;97;80;51;46;115;42;54;177;10;190;184;112;162;133;14;164;27;90;81;31;25;75;86;100;63;79;18;22;159;193;41;143;183;89;114;186;23;0;139;5;43;116;15;9;37;148;137;176;94;124;152;113;175;171;16;44;101;26;19;189;136;135;70;127;123;149;59;118;151;180;154;158;53;121;167;62;144;102;49;78;145;179;52;55;65;160;34;181;178;106;165;119;40,1728647600681702708,0.061040
steepest_intra:nodes_start:random,49,86479,38035,48444,2018250,134,3;178;152;1;97;26;100;101;75;86;53;176;0;143;137;94;2;120;16;171;175;113;31;25;44;129;92;179;57;117;93;108;18;139;115;116;112;4;10;177;54;160;184;35;131;43;42;181;34;146;22;193;41;68;46;106;40;185;52;55;78;145;14;144;62;9;37;148;15;186;23;89;183;114;102;49;51;118;59;65;47;149;154;180;63;79;80;133;135;70;127;123;162;151;165;90;27;164;21;138,6258497765507663647,0.060140
steepest_intra:nodes_start:random,50,89994,40047,49947,2481700,165,102;148;152;97;180;154;135;162;46;0;179;145;78;25;120;101;86;158;53;1;2;31;113;175;171;16;44;75;70;127;5;41;193;159;139;198;115;65;47;131;149;59;118;51;79;63;121;100;26;129;92;57;133;184;54;160;34;181;42;116;80;94;167;106;165;40;185;55;52;178;62;9;15;195;146;22;18;108;93;89;186;23;137;176;151;123;112;4;177;84;35;43;68;117;143;183;114;144;14;49,581310995857296010,0.072125
steepest_intra:nodes_start:random,51,83547,34891,48656,2003300,133,152;129;52;185;39;95;21;7;164;90;165;40;81;196;145;78;2;1;101;120;25;92;57;55;9;15;148;124;121;53;180;79;80;0;117;68;46;115;116;65;47;131;149;162;133;63;26;97;167;49;14;144;62;102;178;106;179;31;113;175;171;16;44;75;86;100;154;193;159;22;146;181;42;59;151;51;118;139;41;34;160;54;177;112;127;70;135;123;35;84;184;43;143;183;89;186;23;137;176;94,3795740608611738272,0.058831
steepest_intra:nodes_start:random,52,84065,33681,50384,2436850,162,148;15;9;62;49;178;106;52;55;57;129;2;120;92;185;40;165;14;144;102;152;97;26;53;133;151;72;118;115;139;46;68;108;18;116;65;47;149;131;195;146;22;117;0;143;183;145;31;56;113;175;171;16;78;25;44;70;127;123;112;184;181;159;193;41;5;42;43;23;137;51;59;35;84;4;190;10;177;30;54;48;34;160;162;135;154;180;79;122;63;121;100;86;75;101;1;124;94;80;176,6636067673920410758,0.073003
steepest_intra:nodes_start:random,53,82879,34652,48227,3289000,219,138;106;178;167;148;137;51;118;46;68;139;115;116;65;59;151;133;79;63;97;1;152;92;179;185;40;119;165;90;81;196;145;82;158;135;127;70;86;101;2;129;57;55;52;49;102;62;186;23;0;117;93;108;18;143;183;89;78;31;113;175;171;16;25;44;120;75;26;100;121;53;35;184;160;34;54;177;4;112;123;80;176;42;181;146;22;159;193;41;43;131;149;162;154;180;94;124;9;144;14,7796020243287683465,0.093016
steepest_intra:nodes_start:random,54,87180,37535,49645,2362100,157,80;122;63;180;154;135;133;151;162;123;149;65;115;46;15;14;138;106;178;167;124;94;100;26;97;2;31;56;113;175;171;16;53;79;41;193;18;108;93;143;183;89;23;186;114;144;21;165;185;179;145;78;92;148;137;51;59;116;160;34;22;139;68;117;0;9;62;102;49;129;25;44;120;75;86;101;1;152;57;55;52;40;90;81;196;70;127;112;84;184;35;131;47;43;42;181;5;96;118;176,5502647102466199368,0.070511
steepest_intra:nodes_start:random,55,85239,35620,49619,2347150,156,135;127;112;4;190;10;177;184;54;34;160;43;131;123;162;133;63;129;92;57;55;52;167;148;176;72;59;65;105;47;149;151;79;75;44;120;2;1;97;26;100;121;53;86;101;152;3;178;106;185;196;31;113;175;171;16;78;145;179;62;9;15;186;89;23;137;116;42;5;68;117;0;46;139;193;18;69;108;93;143;183;144;14;165;90;40;49;181;146;22;159;41;115;118;51;80;124;94;180;154,1015786608836951952,0.067538
steepest_intra:nodes_start:random,56,96715,47080,49635,2182700,145,162;65;59;151;79;26;97;2;57;55;9;89;117;18;34;184;123;127;135;154;100;129;92;179;145;78;25;44;86;53;180;133;46;139;22;159;193;41;115;118;51;176;90;27;164;7;183;143;0;137;82;16;171;175;81;138;49;102;62;148;122;63;94;52;40;119;165;39;21;14;155;144;15;114;186;23;124;152;1;101;75;120;196;185;106;178;3;167;80;116;43;42;181;160;48;54;177;112;113;31,6550386823526158606,0.063512
steepest_intra:nodes_start:random,57,81919,32110,49809,2496650,166,183;89;186;15;9;148;94;180;154;135;70;127;43;42;22;159;193;41;115;139;69;18;108;68;46;151;133;79;63;97;1;75;2;152;80;176;51;59;118;137;62;178;106;40;119;90;27;164;39;165;14;144;49;129;120;44;25;16;171;175;113;56;31;157;78;145;179;196;81;185;52;55;57;92;167;124;189;121;53;100;26;101;86;158;162;123;65;116;47;35;112;149;131;184;10;177;54;34;160;0,6972115807356732702,0.073002
steepest_intra:nodes_start:random,58,88659,40288,48371,2078050,138,34;103;146;195;22;159;193;41;181;184;84;4;112;35;5;96;115;46;117;0;176;80;94;179;196;81;90;40;165;138;14;144;167;152;101;75;120;44;25;78;31;145;129;2;1;162;149;131;43;42;116;65;59;118;51;148;49;178;106;52;55;57;92;89;183;143;139;54;177;10;70;86;16;171;175;113;185;102;62;9;186;23;137;151;133;180;154;135;127;123;18;108;68;79;63;97;26;100;53;160,5830150351960803288,0.059705
steepest_intra:nodes_start:random,59,90156,41567,48589,2212600,147,164;7;21;43;160;34;30;54;177;48;65;51;9;144;14;165;27;90;119;55;123;184;10;190;4;112;84;35;131;149;133;79;94;52;185;40;81;113;175;171;16;31;78;44;120;2;152;97;151;72;59;118;115;41;193;139;0;117;93;140;68;46;162;135;70;154;180;158;53;86;75;101;1;26;63;80;176;137;148;129;92;145;196;179;57;186;23;108;18;22;42;116;143;183;89;62;49;178;106;95,8754735167563963194,0.065779
steepest_intra:nodes_start:random,60,87211,37067,50144,2122900,141,18;22;159;193;46;0;183;143;117;68;139;41;5;42;154;101;1;97;53;180;151;118;109;51;80;79;135;127;4;10;177;54;48;160;34;181;94;152;55;52;167;148;176;59;65;116;43;115;137;15;49;178;106;129;82;44;25;78;145;157;38;31;113;56;85;81;90;165;14;144;62;9;57;92;179;185;119;40;196;175;171;16;120;2;75;86;63;133;149;131;184;84;112;123;162;23;186;89;93;108,7713568686604217045,0.063085
steepest_intra:nodes_start:random,61,85119,36848,48271,2526550,168,129;152;97;26;70;112;4;84;127;135;154;53;100;1;2;120;25;44;75;101;121;63;133;151;118;59;116;43;42;5;115;46;183;89;23;148;167;57;92;78;145;179;185;40;90;165;15;137;159;22;18;108;68;51;176;80;79;94;124;49;3;178;106;52;55;9;62;144;14;138;102;162;149;184;10;177;54;48;160;34;181;0;143;117;139;193;41;65;123;180;86;16;171;175;113;56;31;157;81;196,3450377341744576257,0.072689
steepest_intra:nodes_start:random,62,84853,35227,49626,2003300,133,131;65;116;43;42;41;193;160;177;54;34;22;18;108;140;68;139;184;35;84;4;112;123;127;44;16;171;175;113;56;25;82;92;57;55;185;165;40;81;90;21;183;143;117;0;89;144;3;178;106;52;179;145;78;31;157;196;91;129;152;154;135;70;86;101;1;75;120;2;97;26;100;63;151;59;162;133;79;80;176;137;148;167;49;14;102;62;9;23;46;115;118;51;124;94;189;121;53;180;149,212011463024810897,0.058587
steepest_intra:nodes_start:random,63,93017,43655,49362,2406950,160,89;186;23;42;159;193;41;137;148;167;106;178;3;138;14;49;102;131;84;112;86;25;31;113;175;171;16;151;65;47;149;162;100;101;75;44;120;2;1;97;26;53;154;180;63;121;152;92;185;40;90;165;144;0;108;69;18;22;34;160;127;70;135;79;80;51;115;139;198;176;124;55;52;62;114;15;9;57;179;145;78;129;94;133;123;35;184;190;10;177;54;43;116;59;118;46;68;117;143;183,484430475467838868,0.068626
steepest_intra:nodes_start:random,64,91485,39695,51790,2242500,149,81;90;165;57;129;152;133;151;46;68;117;143;183;89;106;119;40;185;59;160;34;193;41;139;115;118;167;52;55;53;154;135;70;127;112;84;184;43;116;65;162;180;86;101;82;92;179;91;196;157;31;182;136;63;122;79;80;176;51;137;23;186;15;145;78;25;75;123;42;181;22;18;108;140;93;0;49;178;14;144;62;9;148;124;94;189;121;100;26;97;1;2;120;44;16;171;175;113;56;85,7929125255748264262,0.063586
steepest_intra:nodes_start:random,65,85339,37175,48164,2571400,171,164;90;40;165;62;9;15;186;23;137;51;72;35;84;184;160;193;41;118;59;47;43;42;181;34;146;22;18;108;139;115;116;65;46;68;117;0;143;183;144;49;52;55;179;57;80;176;151;133;79;53;121;94;122;63;180;154;135;127;123;131;149;162;100;26;101;75;120;25;78;171;16;44;112;4;10;177;54;70;86;2;129;92;145;31;175;113;81;196;185;106;178;152;1;97;124;148;102;14;21,6734571199666872970,0.073508
steepest_intra:nodes_start:random,66,92823,43145,49678,2063100,137,41;139;115;47;131;149;137;15;62;144;49;102;9;80;122;63;121;1;97;189;79;133;162;112;160;34;22;18;108;93;117;143;0;46;123;127;70;75;44;78;145;179;185;57;92;129;51;109;118;59;116;65;176;14;165;40;167;111;124;94;180;135;154;158;53;100;26;86;101;120;81;90;164;7;21;23;68;42;43;151;152;2;55;52;178;106;31;113;175;171;16;148;186;89;183;184;177;54;181;193,7415139916288802579,0.059000
steepest_intra:nodes_start:random,67,83141,34238,48903,2676050,178,112;4;10;177;184;5;96;139;41;193;195;146;22;18;108;159;181;34;54;160;42;43;116;118;51;148;185;40;165;14;144;49;55;57;196;81;90;164;7;21;178;106;52;167;152;97;189;94;124;0;117;143;183;89;62;31;113;175;171;16;25;44;120;78;145;92;129;2;1;26;180;133;79;122;80;151;59;149;131;35;123;154;53;100;101;75;86;121;63;176;137;23;46;115;65;47;162;135;70;127,6611277701013602786,0.075442
steepest_intra:nodes_start:random,68,84574,35780,48794,2661100,177,183;0;68;139;193;41;115;59;118;46;140;93;117;143;144;14;165;90;27;164;21;137;176;80;122;94;152;2;120;44;25;145;78;16;171;175;113;56;31;196;40;119;185;49;9;37;148;167;124;121;53;100;26;52;55;57;92;129;70;112;177;54;48;34;160;184;123;127;135;162;149;131;43;116;65;151;133;180;154;86;75;101;1;97;63;79;108;18;22;146;181;42;5;51;106;178;62;15;186;89,5151489855936917071,0.078406
steepest_intra:nodes_start:random,69,92579,44349,48230,2436850,162,79;133;162;151;72;59;65;47;131;149;165;90;81;196;57;152;121;53;158;180;154;135;70;86;75;101;148;186;23;46;115;116;43;42;181;146;22;159;193;68;15;62;49;9;41;34;160;54;184;123;2;78;145;179;92;129;1;100;26;97;55;52;185;119;40;25;44;16;171;175;113;31;120;127;84;177;10;4;112;167;106;178;14;144;89;183;108;18;139;118;51;80;176;0;93;117;143;137;94;63,4618303754384862943,0.070760
steepest_intra:nodes_start:random,70,85025,35822,49203,2377050,158,59;118;80;129;57;179;52;185;40;119;90;27;165;14;144;186;89;183;23;152;97;1;120;16;171;175;113;56;31;44;25;78;157;81;196;145;92;2;121;63;51;46;68;139;115;5;42;181;159;108;18;22;146;34;160;54;177;184;123;167;178;106;55;26;100;176;137;0;143;117;93;193;41;96;43;116;65;149;162;79;122;94;124;49;102;62;9;148;180;154;135;127;70;158;86;75;101;53;133;151,7382799680077806278,0.067871
steepest_intra:nodes_start:random,71,86759,39378,47381,2137850,142,68;139;41;5;43;127;135;154;53;97;1;101;86;26;100;121;63;79;193;159;23;186;144;14;21;164;27;90;81;196;80;51;118;59;65;116;115;46;89;183;108;18;22;146;181;42;106;165;119;40;185;57;92;145;78;25;31;56;113;175;171;16;44;120;75;184;160;34;48;54;177;10;70;180;94;124;152;2;129;55;52;178;49;62;9;148;133;162;123;112;4;84;35;149;151;176;137;0;143;117,4545570505359321355,0.065999
steepest_intra:nodes_start:random,72,93844,43967,49877,2302300,153,118;59;42;43;131;25;175;171;16;44;86;180;162;47;116;65;151;79;63;53;121;100;26;97;52;55;57;92;82;120;75;101;1;2;129;145;179;40;119;185;112;4;133;94;49;102;144;62;9;15;114;14;138;165;27;90;81;196;106;178;35;184;160;34;181;41;143;183;89;23;137;109;51;176;124;167;148;193;159;22;18;108;139;68;117;0;46;115;149;123;127;70;135;154;113;56;31;78;152;80,7315595005407854793,0.065548
steepest_intra:nodes_start:random,73,82031,33406,48625,2556450,170,124;167;148;9;62;102;49;3;178;40;165;27;90;81;196;185;52;55;114;186;23;89;183;143;117;0;46;54;177;112;135;154;2;92;179;145;120;44;25;78;31;56;113;175;171;16;70;127;123;149;131;115;139;159;146;34;160;184;43;47;151;133;63;152;129;57;106;138;14;144;15;137;176;80;79;180;53;100;26;97;1;101;75;86;162;42;181;22;18;108;69;193;41;5;116;65;59;118;51;94,9177263796945303807,0.072547
steepest_intra:nodes_start:random,74,86091,36842,49249,2242500,149,185;106;152;154;135;70;127;123;47;65;59;51;151;133;79;178;3;49;14;144;186;89;183;18;22;146;195;159;139;198;115;193;41;5;116;118;46;68;93;117;143;0;176;2;120;44;16;171;78;57;55;52;167;80;43;42;181;34;160;184;177;4;112;35;131;149;162;180;53;100;26;75;86;121;63;94;124;97;101;1;148;9;62;21;7;164;27;90;81;113;175;31;145;92;129;137;23;15;165;40,5308846443933074592,0.064223
steepest_intra:nodes_start:random,75,91823,41100,50723,2511600,167,75;101;2;82;31;113;175;171;16;86;133;59;46;68;117;93;140;139;181;34;160;43;106;185;119;40;179;158;154;70;135;180;53;189;124;148;37;49;102;62;9;114;89;23;186;15;144;14;3;178;1;97;26;100;121;63;122;79;149;184;112;127;123;162;151;80;176;167;52;55;57;51;118;115;41;193;159;18;22;42;116;65;21;164;90;165;183;143;170;0;137;94;152;129;92;145;78;25;44;120,3386625184760678601,0.072766
steepest_intra:nodes_start:random,76,83519,34520,48999,2317250,154,46;139;41;193;159;18;22;34;30;54;177;48;160;42;43;116;115;0;117;143;183;89;148;129;82;44;120;101;97;122;80;176;51;118;59;65;123;127;70;135;63;94;52;185;40;119;165;14;49;62;9;26;100;53;112;4;84;184;131;149;162;180;154;158;16;171;175;113;56;31;157;179;145;78;25;75;86;121;133;151;79;124;167;178;106;55;57;152;1;2;92;196;81;90;164;21;144;186;23;137,3794708601388335925,0.067839
steepest_intra:nodes_start:random,77,92998,45575,47423,2152800,143,68;139;159;193;41;115;46;144;21;7;164;148;80;162;123;35;84;184;131;149;44;16;171;175;113;31;81;90;165;106;178;180;135;154;53;86;100;94;176;51;118;59;65;116;0;143;183;89;102;49;14;40;185;179;145;78;120;75;101;1;97;26;63;79;151;43;48;54;177;10;4;112;127;70;152;55;52;124;160;34;146;22;42;133;2;129;92;57;137;93;140;108;18;69;117;186;15;62;9;23,6966904629725305125,0.062019
steepest_intra:nodes_start:random,78,87846,39011,48835,2122900,141,2;1;101;51;0;143;117;18;22;34;54;177;10;190;48;160;43;65;116;42;5;59;118;44;25;16;171;175;113;56;40;119;90;81;196;120;75;84;4;112;70;86;26;100;53;154;123;181;159;193;41;139;115;46;183;144;102;178;106;185;165;138;14;49;152;97;162;149;131;47;184;35;127;135;180;63;122;80;151;133;79;94;124;148;9;62;186;89;23;137;176;129;78;31;145;179;92;57;52;55,8899869203950121267,0.066000
steepest_intra:nodes_start:random,79,85603,36090,49513,2526550,168,106;14;144;15;118;59;51;176;80;124;94;154;135;70;26;101;97;63;79;133;84;177;48;18;108;140;68;139;159;22;146;30;54;35;162;180;53;86;75;120;44;78;92;151;72;149;131;123;127;112;184;160;34;181;42;116;65;47;77;43;5;41;193;115;46;137;55;145;31;16;171;175;113;90;165;40;185;196;179;57;129;2;1;152;148;186;23;0;117;143;183;89;114;9;62;102;49;3;178;52,707278200581500509,0.070503
steepest_intra:nodes_start:random,80,85082,35699,49383,2511600,167,86;158;127;112;4;190;10;177;54;184;68;0;89;183;143;117;181;160;48;34;22;18;159;193;41;115;151;94;189;152;2;129;57;178;3;106;145;78;92;49;102;62;9;59;116;43;42;139;46;118;162;135;70;154;180;53;121;100;26;101;75;120;44;16;171;175;113;31;40;119;185;52;55;167;148;137;176;80;122;63;79;133;123;149;131;47;65;51;21;164;90;165;14;144;15;186;23;124;97;1,2001677856823331370,0.071524
steepest_intra:nodes_start:random,81,92530,43622,48908,2093000,139,97;55;52;178;106;179;145;92;129;152;94;42;181;22;159;68;117;0;46;139;115;131;149;123;194;135;154;180;158;53;101;2;81;90;165;138;14;148;80;184;84;112;162;176;137;15;9;62;102;49;57;25;44;120;75;86;121;63;122;79;51;118;59;43;160;48;54;34;23;144;119;40;185;1;70;127;177;10;4;16;171;175;113;31;78;186;89;183;143;108;69;18;193;41;116;65;151;133;100;26,2119519036295441959,0.060000
steepest_intra:nodes_start:random,82,87600,37531,50069,2362100,157,12;148;9;62;102;49;14;138;165;106;178;37;137;116;42;43;47;65;59;118;109;51;176;80;79;133;123;112;177;54;34;22;18;139;68;46;57;92;129;2;101;75;120;44;16;171;175;113;31;78;151;115;41;193;159;181;160;184;127;70;135;154;152;55;185;40;90;81;196;179;145;86;180;131;149;162;97;1;26;100;121;53;158;63;94;15;186;23;89;183;143;117;93;0;114;144;3;52;167;124,6697459639530983674,0.066002
steepest_intra:nodes_start:random,83,87770,35839,51931,2526550,168,179;57;148;89;0;143;183;144;14;138;3;178;49;62;9;15;186;23;137;118;59;72;151;133;44;25;16;171;175;78;176;46;139;115;43;131;162;55;52;185;119;40;157;85;56;113;31;145;92;129;184;34;22;159;193;41;5;42;181;160;48;54;177;112;127;194;135;70;154;180;158;53;121;100;26;86;97;1;101;75;120;82;2;152;123;149;65;116;51;80;79;63;94;124;167;106;165;90;81;196,8409402153247499982,0.073015
steepest_intra:nodes_start:random,84,84873,33977,50896,2406950,160,94;189;100;86;75;16;171;175;113;31;196;185;40;165;106;178;57;129;82;25;44;120;2;152;97;1;101;26;121;53;158;133;151;159;22;18;69;108;117;92;78;145;179;55;52;167;124;176;65;116;118;137;15;62;9;148;63;180;154;135;127;123;112;84;184;5;96;41;193;146;34;54;177;160;181;42;43;162;79;80;51;109;46;68;93;140;139;115;47;131;149;59;0;143;183;89;186;144;14;49,5390204561200261986,0.068043
steepest_intra:nodes_start:random,85,88388,38522,49866,2377050,158,135;154;86;75;101;1;23;117;108;18;22;159;193;139;143;183;89;21;90;81;196;31;113;175;171;16;82;129;186;114;15;9;62;144;165;119;40;185;179;92;97;121;63;79;133;80;122;94;124;106;178;3;49;167;148;37;102;14;138;52;55;162;35;184;112;70;100;26;53;180;151;118;46;68;0;137;189;152;2;120;44;25;78;145;57;176;51;59;116;43;42;160;34;181;41;115;65;149;123;127,2955840787824463038,0.071351
steepest_intra:nodes_start:random,86,87902,39326,48576,2720900,181,106;167;148;15;186;23;34;48;160;43;116;65;59;176;51;118;115;139;18;108;143;183;89;0;68;41;193;22;146;181;42;5;131;149;123;162;151;133;79;152;179;196;81;90;165;138;62;9;92;78;113;31;145;137;117;93;140;46;80;63;100;26;97;1;120;44;25;129;57;55;52;178;49;102;144;14;40;175;171;16;75;112;177;54;184;127;70;135;154;180;94;124;189;121;53;158;86;101;2;185,6578107398286493911,0.077505
steepest_intra:nodes_start:random,87,86718,37617,49101,2436850,162,175;113;31;196;40;185;52;148;117;93;108;18;22;159;193;9;62;102;49;3;178;106;167;124;94;180;53;26;97;1;101;2;57;55;179;145;78;81;90;27;165;138;14;144;15;114;186;137;51;118;115;59;133;86;75;120;44;25;92;129;152;151;65;116;181;34;160;43;47;149;131;35;184;42;5;41;139;46;176;80;79;63;122;23;89;183;143;0;162;194;135;154;70;127;112;177;54;123;16;171,112907458007559450,0.071910
steepest_intra:nodes_start:random,88,85895,36330,49565,2182700,145,79;63;152;129;57;49;15;186;23;0;140;93;117;143;183;89;114;37;148;124;94;80;151;118;139;18;159;116;65;47;43;42;193;41;115;59;123;135;154;53;100;26;97;1;2;75;101;86;121;133;162;149;184;181;22;146;34;160;177;112;70;180;189;167;9;62;102;144;14;3;178;106;185;165;164;7;21;137;68;46;51;176;55;52;40;119;90;81;145;78;120;44;25;16;171;175;113;31;92;122,8484124147735346807,0.063998
steepest_intra:nodes_start:random,89,84858,36126,48732,2078050,138,139;68;117;0;46;115;96;5;42;118;51;62;9;148;124;94;122;151;65;116;43;177;54;160;34;181;143;183;89;186;144;49;14;165;185;78;16;171;175;113;31;81;90;119;40;196;145;57;55;178;106;52;92;25;44;75;86;70;127;35;184;22;18;108;69;159;193;41;59;79;63;133;162;149;131;123;180;53;101;1;26;100;80;176;137;23;15;102;167;129;82;120;2;152;97;154;135;112;4;84,8794642908265883114,0.060155
steepest_intra:nodes_start:random,90,85906,37363,48543,2421900,161,97;129;92;179;113;175;171;16;44;120;152;41;193;159;22;18;108;68;139;116;65;131;149;162;151;148;9;62;102;14;144;186;23;15;49;178;106;52;167;59;118;51;176;137;89;183;46;115;5;42;43;184;35;123;135;154;86;75;25;56;31;78;145;82;101;53;180;133;79;80;122;63;121;100;1;2;57;196;81;90;165;119;40;185;55;70;127;112;4;177;54;48;160;34;181;117;143;0;94;26,9106002641881112330,0.069032
steepest_intra:nodes_start:random,91,85201,36445,48756,2556450,170,4;112;127;70;135;121;100;26;86;75;44;25;120;152;94;51;46;139;41;42;43;123;16;171;175;113;124;59;116;65;149;162;63;180;154;158;53;101;57;92;129;2;1;97;167;178;106;52;55;185;40;119;138;49;62;9;148;137;176;80;79;133;151;118;193;159;22;18;108;144;14;165;90;81;196;31;78;145;179;15;114;186;23;89;183;143;0;117;93;140;68;115;96;5;181;34;160;184;177;10,3009247340177338150,0.074293
steepest_intra:nodes_start:random,92,88115,39126,48989,2212600,147,68;23;186;15;9;62;49;178;106;179;145;196;81;90;164;21;14;152;1;97;100;158;180;53;167;102;144;89;183;143;117;0;118;51;176;124;78;31;113;175;171;16;75;86;79;65;116;115;139;46;137;148;25;44;120;94;193;159;22;34;181;59;80;63;121;26;101;2;129;92;40;119;165;185;52;55;57;154;135;70;127;112;4;123;162;133;151;149;131;47;5;42;43;35;184;177;54;48;160;41,1992846053009864569,0.069025
steepest_intra:nodes_start:random,93,85626,35094,50532,2227550,148,52;55;145;113;175;171;16;129;167;148;15;37;57;92;78;25;44;75;133;151;162;65;116;59;72;149;131;47;43;160;54;184;94;97;152;82;120;2;1;101;86;26;100;121;53;136;63;79;80;51;118;115;41;193;159;139;46;176;137;0;18;22;146;34;177;112;70;154;158;180;135;127;123;42;5;68;117;143;183;144;185;119;40;196;31;56;157;81;90;27;164;39;165;14;49;102;62;9;178;106,5748789167775333102,0.063077
steepest_intra:nodes_start:random,94,91195,41673,49522,2795650,186,57;75;101;4;177;54;184;162;136;121;182;133;151;65;116;46;0;143;183;89;186;15;62;9;167;120;44;25;78;92;129;124;94;176;51;118;115;193;41;59;80;122;63;79;149;131;43;139;68;140;108;18;22;159;16;171;175;113;31;145;196;165;138;14;3;106;178;49;102;137;42;181;34;160;84;112;123;154;53;100;26;86;158;70;127;135;180;148;144;21;90;81;2;1;97;152;55;52;185;40,4253863444235186018,0.080027
steepest_intra:nodes_start:random,95,91155,42772,48383,2676050,178,23;137;51;118;59;65;47;131;149;123;127;135;154;86;101;2;57;55;52;106;178;184;84;112;70;75;145;78;16;171;175;90;164;21;167;152;1;97;124;148;9;62;15;183;143;117;0;176;80;94;129;92;179;196;31;113;25;44;120;26;79;115;198;68;140;108;18;34;54;177;48;160;181;22;159;144;14;165;119;40;185;49;102;46;139;193;41;5;162;180;53;121;63;133;151;116;43;42;89;186,4651005363537828740,0.074578
steepest_intra:nodes_start:random,96,91813,42612,49201,2362100,157,127;135;113;56;31;78;94;122;80;176;148;106;179;145;196;81;90;40;185;165;144;23;193;159;22;18;108;139;116;65;43;42;181;34;160;54;177;10;190;184;35;123;100;101;26;51;118;46;0;117;170;143;183;89;175;171;16;86;53;154;180;79;63;189;152;129;92;57;55;52;167;124;133;162;151;9;49;178;3;14;102;62;137;59;115;41;5;131;149;121;97;1;2;120;25;44;75;70;4;112,6750102172143060814,0.068532
steepest_intra:nodes_start:random,97,85855,38492,47363,2616250,174,131;149;162;133;79;80;176;148;49;178;179;92;120;44;25;78;145;196;40;119;165;90;27;164;21;144;14;106;185;81;31;113;175;171;16;75;118;115;46;0;143;23;186;114;89;183;68;139;41;193;181;184;35;127;70;86;101;53;180;123;160;34;146;22;18;108;159;42;43;116;47;65;151;63;94;152;2;129;57;167;137;117;93;140;54;177;4;112;135;154;26;97;1;55;52;102;62;9;51;59,7162478188764997293,0.075255
steepest_intra:nodes_start:random,98,93679,44409,49270,2332200,155,145;78;92;176;51;118;42;160;34;54;177;184;44;16;171;175;113;31;89;183;117;68;159;22;146;181;151;79;1;97;80;108;18;69;139;149;123;127;131;116;115;198;46;0;143;137;152;2;129;57;55;185;165;39;164;27;90;40;120;75;86;133;72;59;65;47;43;5;193;41;162;135;154;180;63;94;124;62;144;14;138;106;52;178;49;9;148;26;100;121;53;158;70;112;4;84;101;179;196;81,3045780292180241370,0.069565
steepest_intra:nodes_start:random,99,88776,39523,49253,1898650,126,1;97;26;101;2;129;57;55;9;93;140;108;18;69;139;46;124;16;171;175;113;81;90;21;144;183;143;117;0;162;135;123;116;115;89;186;23;137;118;59;65;131;149;148;49;178;52;106;3;138;14;62;160;48;54;34;181;41;193;159;22;146;195;42;43;184;177;4;112;154;180;53;100;86;75;120;44;25;82;92;185;165;119;40;196;179;145;31;78;121;63;133;151;51;176;80;79;122;94;152,5085188000403512921,0.056918
steepest_intra:nodes_start:random,100,85594,37495,48099,2332200,155,0;117;93;68;46;115;139;41;193;18;22;159;5;149;131;35;84;177;4;112;127;123;162;184;54;48;160;151;133;92;145;78;25;44;180;34;181;42;43;116;65;59;118;86;75;120;179;196;52;55;57;129;2;152;97;1;101;53;154;135;70;16;171;175;113;31;167;186;23;153;143;183;89;137;176;80;15;144;21;7;164;27;90;165;40;185;106;178;14;49;102;62;9;148;94;26;100;63;79;51,3808711056431185573,0.066267
steepest_intra:nodes_start:random,101,88965,39231,49734,2167750,144,116;131;149;65;115;0;170;143;117;18;193;159;22;146;34;181;96;5;42;43;184;112;123;127;70;154;165;90;40;185;129;180;177;54;160;23;114;7;164;21;89;183;109;72;151;133;75;16;171;175;113;31;14;144;102;49;178;106;52;55;57;92;179;145;78;25;44;120;2;101;86;53;63;79;80;137;186;15;62;9;148;167;152;1;97;26;94;176;51;118;59;162;194;135;46;93;140;68;139;41,1761825315037516447,0.062448
steepest_intra:nodes_start:random,102,89943,40585,49358,2212600,147,101;1;97;152;167;14;21;164;27;90;81;129;2;121;63;122;79;133;151;162;123;112;4;10;177;54;34;181;41;68;117;143;183;89;144;49;102;62;9;148;137;51;109;0;46;42;160;184;180;25;78;92;57;185;40;165;138;149;131;127;70;75;44;120;53;158;154;135;47;43;116;65;59;80;124;178;106;52;55;145;31;113;175;171;16;118;115;198;139;108;18;22;159;193;176;94;189;26;100;86,5967177041037190817,0.062630
steepest_intra:nodes_start:random,103,87518,39246,48272,2661100,177,122;80;115;41;193;139;176;92;145;78;31;113;175;171;16;25;44;120;129;57;49;102;62;9;114;0;93;117;143;183;89;94;124;148;186;23;137;51;46;68;108;69;18;22;159;5;43;131;149;162;180;154;135;42;181;34;160;54;177;184;116;65;3;178;106;2;75;101;1;97;152;167;14;144;15;118;59;151;133;79;55;52;185;40;165;90;81;196;86;123;35;84;4;112;127;70;53;100;26;63,1919294155020765268,0.081021
steepest_intra:nodes_start:random,104,86850,37927,48923,2018250,134,144;164;27;90;81;196;92;129;101;177;54;34;181;41;139;68;117;0;46;115;94;152;57;55;52;176;51;118;59;151;133;86;75;120;44;25;185;40;119;165;14;49;167;148;37;9;62;102;178;106;145;78;31;56;113;175;171;16;2;1;97;121;123;184;160;42;5;43;162;63;189;26;100;53;70;127;159;22;18;193;96;116;65;149;35;84;4;112;135;154;180;79;80;137;23;143;183;89;186;15,6430546520957956447,0.058276
steepest_intra:nodes_start:random,105,82736,33833,48903,2227550,148,160;34;103;146;181;43;65;162;133;57;55;52;106;185;165;119;40;145;92;148;15;9;62;144;102;49;14;178;39;90;81;196;78;25;44;120;152;80;176;51;72;151;79;16;171;175;113;31;129;2;1;97;26;100;121;63;180;154;53;86;75;101;94;137;23;115;193;159;18;22;195;5;116;135;70;127;123;112;4;84;35;131;149;59;118;46;68;93;117;143;183;89;0;139;41;42;184;10;177;54,3622937213391880728,0.062189
steepest_intra:nodes_start:random,106,81321,32653,48668,2451800,163,54;48;34;160;184;65;116;43;42;193;41;115;118;51;165;39;138;15;186;23;89;183;143;117;0;137;167;57;92;120;44;25;16;171;175;113;31;78;129;124;176;80;122;63;180;154;53;100;26;1;101;86;75;2;55;40;90;164;21;144;102;49;14;3;178;106;185;196;145;179;52;62;9;37;148;152;97;94;79;133;151;162;135;70;127;123;149;181;159;195;146;22;18;139;46;59;112;4;10;177,1850589204632436591,0.075292
steepest_intra:nodes_start:random,107,85372,35446,49926,2197650,146,149;59;118;46;139;68;140;93;117;143;183;89;186;23;137;135;70;154;152;52;55;57;82;120;78;145;179;102;49;178;106;92;44;25;31;113;175;171;16;75;80;0;18;34;54;177;10;190;4;112;123;94;124;148;167;129;2;1;97;26;100;53;158;180;136;182;63;133;162;184;48;160;193;41;115;72;151;79;121;86;101;185;40;90;165;14;144;62;9;176;51;65;116;159;22;146;181;42;43;131,6094921816746173159,0.066878
steepest_intra:nodes_start:random,108,88621,39268,49353,2272400,151,143;170;0;117;68;46;115;137;15;144;14;148;180;154;53;86;75;101;100;26;97;1;44;25;16;171;175;113;31;123;112;35;43;42;5;96;41;193;159;181;195;146;22;18;108;69;139;116;65;162;133;178;106;52;55;57;92;129;2;152;167;49;102;62;9;80;184;177;54;34;160;131;149;145;78;120;70;135;63;94;124;186;23;176;51;109;118;59;151;79;179;196;81;90;165;40;185;114;89;183,7592675010866960247,0.068001
steepest_intra:nodes_start:random,109,89572,39020,50552,2122900,141,127;135;154;75;25;16;171;175;113;78;145;52;106;178;167;180;112;84;35;181;159;18;22;146;103;34;48;160;42;59;118;109;51;176;137;23;186;144;102;49;55;57;92;129;2;101;86;53;158;70;4;10;177;54;184;43;65;94;124;189;121;100;26;97;1;152;37;9;62;15;46;139;193;41;115;185;40;90;165;14;89;183;80;79;63;120;44;82;148;0;143;117;68;116;131;149;151;133;162;123,7244893527569204714,0.060516
steepest_intra:nodes_start:random,110,86175,38178,47997,2347150,156,152;167;49;14;144;102;124;94;176;137;23;186;9;62;3;106;185;165;119;40;157;31;92;129;80;51;59;65;47;131;149;123;127;70;135;154;180;63;79;112;4;177;184;116;118;0;143;117;68;139;115;43;42;41;193;159;22;146;181;34;54;48;160;53;86;101;57;179;196;145;78;25;44;120;2;75;16;171;175;113;81;90;164;7;21;183;108;18;69;46;148;178;52;55;151;162;133;26;97;1,158962812617275756,0.069031
steepest_intra:nodes_start:random,111,81841,32562,49279,2451800,163,146;22;181;42;5;59;80;63;121;1;2;78;145;92;129;57;49;3;178;106;52;55;185;179;25;120;75;86;53;180;154;70;135;194;162;151;176;137;89;183;143;117;93;108;18;159;139;46;118;51;124;94;122;79;133;123;131;149;15;144;14;21;164;90;165;119;40;81;196;31;56;113;175;171;16;44;101;100;26;97;152;167;102;62;9;148;127;112;177;54;184;43;47;65;116;115;41;193;160;34,7903869624216824048,0.070793
steepest_intra:nodes_start:random,112,86223,36505,49718,2272400,151,112;70;53;180;154;135;194;127;123;59;118;139;108;18;22;159;193;5;43;116;65;151;2;82;120;1;101;86;75;44;25;78;196;40;119;90;27;165;14;144;114;15;9;62;31;16;171;175;113;56;81;185;23;143;0;115;42;160;54;184;131;149;162;133;148;3;178;106;129;97;26;100;152;167;102;49;138;179;145;92;57;55;52;124;94;63;122;79;80;176;51;137;89;183;46;41;181;34;177;4,1810870955736374906,0.066461
steepest_intra:nodes_start:random,113,85325,35882,49443,2048150,136,149;123;70;75;16;171;92;129;120;2;26;100;121;162;160;48;54;34;181;193;41;5;42;43;116;115;46;51;176;80;86;101;1;97;152;102;62;9;137;118;59;65;184;177;4;112;127;135;154;158;53;180;133;151;68;117;0;143;183;89;23;186;15;148;12;122;79;63;94;124;167;52;185;40;165;138;14;144;49;178;106;55;57;31;175;113;56;157;81;90;196;145;78;25;44;139;18;22;159;131,1895105459366642113,0.058601
steepest_intra:nodes_start:random,114,86560,36756,49804,2332200,155,158;154;180;80;176;137;186;15;9;62;14;138;39;90;185;57;97;26;100;135;190;10;177;54;184;123;162;152;92;129;2;1;121;133;151;79;63;122;148;37;167;55;52;106;178;51;181;160;34;146;22;18;117;143;23;179;145;78;31;113;175;171;16;44;120;75;101;86;70;127;112;4;84;35;149;65;43;42;116;59;118;46;115;41;193;139;68;0;183;89;114;144;165;119;40;49;102;124;94;53,4390713656911823555,0.065880
steepest_intra:nodes_start:random,115,91280,43098,48182,2496650,166,42;181;22;159;0;23;186;15;62;9;148;167;124;51;115;41;193;139;68;117;143;183;89;165;90;81;40;185;52;160;34;48;54;123;180;53;94;63;79;151;176;80;152;120;25;44;112;190;10;177;16;171;175;113;31;78;145;92;57;55;129;2;1;101;75;86;97;26;100;158;70;127;135;154;133;162;149;131;47;35;84;4;184;43;116;65;59;118;46;18;108;93;102;49;178;106;138;14;144;137,1772099815979303179,0.069997
steepest_intra:nodes_start:random,116,84908,35463,49445,2182700,145,4;112;123;127;70;135;154;158;53;180;65;43;160;34;54;184;59;137;21;164;27;90;40;81;196;145;78;92;179;185;165;138;14;144;49;102;62;9;148;176;51;118;139;68;46;80;79;63;121;100;86;75;2;178;106;52;55;57;129;152;1;101;97;26;19;189;133;151;116;42;181;22;18;108;0;89;183;143;117;93;193;41;115;31;56;113;175;171;16;25;44;120;82;167;124;94;162;149;35;84,7870887925576634796,0.063514
steepest_intra:nodes_start:random,117,88635,38135,50500,2063100,137,2;1;86;53;158;154;180;106;165;27;90;81;175;171;16;44;120;75;101;26;100;70;135;151;72;51;109;118;115;41;193;22;18;139;46;0;117;143;183;89;186;23;59;65;131;149;123;127;162;133;79;63;182;121;189;148;37;49;178;55;57;97;112;4;10;177;54;34;176;102;14;144;137;116;43;42;160;184;35;80;15;9;62;179;31;113;196;40;119;185;52;167;124;94;152;129;92;145;78;25,8526398376542990748,0.058624
steepest_intra:nodes_start:random,118,82965,33015,49950,2122900,141,148;167;124;94;152;1;2;120;179;196;81;157;38;31;56;113;175;171;16;78;145;92;57;129;79;133;151;51;118;115;159;22;146;195;139;46;68;117;0;143;183;89;23;44;25;55;52;106;178;3;49;62;144;14;165;40;185;9;108;18;34;184;43;123;135;154;180;53;100;121;63;162;59;65;116;42;41;193;181;160;48;54;177;10;4;112;127;70;158;86;75;101;97;26;122;80;176;137;186;15,8359374004489215590,0.062559
steepest_intra:nodes_start:random,119,88257,36993,51264,2392000,159,146;22;181;42;72;80;165;40;185;179;92;2;1;101;26;100;86;75;120;44;16;171;175;113;31;78;145;97;118;193;159;18;108;68;79;63;136;182;121;53;180;154;162;123;135;70;127;112;35;131;149;47;115;139;198;46;137;23;89;183;143;117;0;114;144;14;49;62;9;148;124;152;129;57;167;15;186;93;140;41;5;116;65;151;133;94;55;52;106;178;176;51;109;59;43;160;184;177;54;34,5928335676473544157,0.068240
steepest_intra:nodes_start:random,120,86273,37993,48280,2122900,141,123;35;184;84;112;127;44;16;171;175;113;31;145;78;120;75;101;1;2;129;92;196;81;90;27;165;40;185;106;178;138;164;7;21;144;89;183;117;93;108;18;34;54;177;160;181;41;115;59;116;42;43;65;131;149;158;53;133;51;0;143;124;94;189;121;100;26;86;97;152;57;55;52;46;139;159;22;146;193;68;15;14;49;62;9;148;122;63;135;70;154;180;79;80;176;186;23;137;151;162,3966734222942991233,0.060537
steepest_intra:nodes_start:random,121,85366,35575,49791,2332200,155,115;198;46;23;144;14;138;90;81;175;171;16;44;53;158;154;180;63;79;80;176;51;41;193;139;68;108;69;195;146;22;18;199;159;116;59;151;133;100;26;97;1;101;86;75;120;2;124;0;117;143;102;49;178;106;167;94;162;123;149;131;65;43;42;181;34;160;54;184;84;112;127;70;135;121;152;129;57;92;145;78;31;113;56;196;40;119;165;185;52;55;148;186;89;183;15;62;9;137;118,8647085998171015071,0.071507
steepest_intra:nodes_start:random,122,86943,38348,48595,2003300,133,95;14;178;106;52;55;118;5;42;43;59;51;79;94;148;37;102;49;185;196;81;40;165;39;27;90;113;175;171;16;31;0;46;198;115;116;65;133;180;154;135;70;53;86;75;101;1;2;129;92;57;179;145;78;25;44;120;63;41;193;159;139;68;108;69;18;34;54;177;184;112;97;152;167;9;62;15;186;23;89;183;143;117;22;146;195;181;160;131;149;123;162;151;80;176;137;144;21;7;164,6244003196589194864,0.057508
steepest_intra:nodes_start:random,123,86587,37433,49154,2048150,136,133;63;121;100;26;86;101;14;138;196;31;113;175;171;16;44;120;75;53;154;135;180;94;124;148;9;62;167;25;78;145;165;39;21;7;164;95;27;90;81;169;40;119;185;79;160;34;42;59;80;176;51;118;115;159;22;18;0;143;183;89;186;23;46;68;139;193;41;43;35;184;54;177;112;162;151;137;15;144;102;49;178;106;152;97;1;57;55;52;179;92;129;2;70;127;123;149;131;116;65,4937407011116148962,0.059832
steepest_intra:nodes_start:random,124,86540,36458,50082,2676050,178,47;149;162;53;86;75;44;120;2;1;97;137;23;89;186;114;15;62;9;148;112;177;54;34;146;181;59;118;51;151;121;26;101;25;16;171;175;113;31;196;179;100;154;135;180;167;49;14;144;102;37;124;94;70;127;123;131;65;116;115;193;41;5;42;160;184;43;139;68;93;117;0;143;183;165;40;185;106;3;178;52;55;57;129;92;145;78;152;189;63;122;79;133;80;176;46;108;18;22;159,2607075773868507688,0.075981
steepest_intra:nodes_start:random,125,85710,36391,49319,2018250,134,16;78;145;179;80;176;51;118;46;139;115;5;42;116;47;77;43;160;34;146;22;159;181;162;180;86;101;26;100;121;53;154;135;127;112;4;84;123;52;185;40;196;81;90;165;138;14;144;137;0;68;41;193;18;108;117;143;183;89;49;178;106;152;189;63;94;124;167;9;62;15;148;122;79;133;151;59;65;149;131;184;54;177;70;75;120;44;25;92;57;55;129;97;1;2;31;56;113;175;171,2662031722940106436,0.058951
steepest_intra:nodes_start:random,126,89598,38101,51497,2421900,161,144;62;9;0;117;143;183;89;186;23;137;149;131;184;160;34;181;42;43;116;65;80;49;32;3;167;94;63;123;84;4;112;70;82;31;56;113;175;171;16;75;101;86;100;26;1;2;120;44;25;78;145;179;57;55;52;106;178;152;122;115;41;193;22;139;68;46;118;180;154;135;127;54;177;10;190;35;162;133;79;151;72;59;51;176;185;40;92;129;97;53;121;189;124;148;102;14;138;165;90,3528874827921977679,0.072206
steepest_intra:nodes_start:random,127,88081,39493,48588,2451800,163,81;196;145;92;167;137;118;59;84;112;70;158;154;135;127;77;43;42;41;193;139;46;78;31;113;175;171;16;25;97;26;100;0;117;93;108;69;18;159;22;146;181;34;160;184;47;65;116;115;51;80;122;79;133;180;63;94;152;57;55;52;106;178;49;14;144;89;183;143;151;162;123;35;131;149;176;148;9;62;15;186;23;54;177;10;190;4;53;86;75;44;120;101;1;2;129;185;40;165;90,6259526452864198415,0.070985
steepest_intra:nodes_start:random,128,93107,43625,49482,2197650,146,158;53;100;26;97;1;101;2;55;185;40;90;27;165;14;183;89;23;186;16;171;78;145;179;92;123;131;149;162;79;122;80;115;139;96;5;42;181;146;22;63;121;189;94;176;0;143;117;93;108;18;68;46;137;144;49;102;62;9;184;84;112;127;152;52;106;178;148;65;43;116;59;118;51;124;167;57;129;120;44;25;31;56;113;175;75;86;70;177;54;160;34;159;193;41;151;133;135;154;180,1118527718427086874,0.066098
steepest_intra:nodes_start:random,129,87917,40402,47515,2003300,133,93;140;108;18;22;181;115;118;79;63;121;26;97;1;75;120;44;25;31;113;175;171;16;70;127;112;4;84;160;34;42;43;149;162;100;101;86;135;177;54;184;123;154;180;53;189;94;124;57;81;90;27;52;55;62;9;148;133;151;65;116;59;51;137;15;102;49;178;106;14;144;23;46;139;41;193;159;68;117;143;0;176;80;152;2;129;185;165;119;40;196;145;78;92;179;164;7;21;89;183,1942750171472244185,0.055999
steepest_intra:nodes_start:random,130,85249,34926,50323,2392000,159,16;44;127;112;4;177;54;184;43;105;65;47;131;149;162;151;80;122;120;25;78;145;179;55;167;124;94;121;100;26;97;148;23;89;183;143;0;117;108;18;22;159;193;9;62;137;46;139;41;42;116;59;118;51;176;86;75;101;1;2;52;106;178;3;49;14;144;115;181;34;160;123;180;53;154;70;135;133;79;63;152;129;92;57;185;40;119;165;39;27;90;81;196;157;31;85;56;113;175;171,4031253257361232855,0.067959
steepest_intra:nodes_start:random,131,85714,36656,49058,2436850,162,70;100;26;1;101;154;135;127;123;51;0;143;117;18;22;181;42;115;118;59;116;43;160;54;34;193;41;139;68;46;137;176;80;94;171;175;113;90;27;164;39;165;40;185;196;179;55;57;92;129;97;121;162;149;131;35;84;184;47;65;72;151;133;79;63;180;53;86;75;44;25;16;31;145;78;120;2;152;148;9;62;102;49;3;138;14;144;186;23;89;183;15;178;106;52;124;177;10;4;112,7753702817765901547,0.069005
steepest_intra:nodes_start:random,132,94003,45761,48242,2317250,154,178;117;93;140;68;137;120;44;25;78;92;89;183;143;0;46;198;115;116;47;149;131;184;84;35;123;70;127;112;4;177;54;160;43;185;40;165;14;144;186;23;139;193;41;154;86;101;2;129;55;52;26;100;53;180;63;9;62;21;7;164;90;81;145;57;167;124;94;152;1;97;133;162;65;42;159;18;22;146;34;181;135;16;171;175;113;31;75;151;59;118;51;176;80;79;122;148;102;49;106,4446573955938938578,0.067039
steepest_intra:nodes_start:random,133,87465,39604,47861,2078050,138,25;57;52;106;178;89;183;143;0;46;68;93;117;186;62;9;137;198;115;116;65;149;43;184;54;177;10;4;112;123;127;70;135;154;152;55;185;165;40;196;31;175;113;56;157;81;90;27;164;21;144;23;139;159;193;41;59;151;80;26;100;53;180;79;63;86;75;101;1;97;133;162;42;181;69;108;18;22;146;34;160;118;102;14;138;49;148;176;109;51;94;16;171;78;145;92;129;2;120;44,4057642945624658348,0.060969
steepest_intra:nodes_start:random,134,89329,40068,49261,2227550,148,81;31;113;175;171;16;53;180;154;149;131;47;43;42;5;116;65;44;25;78;145;179;178;49;62;9;167;152;97;26;100;101;1;57;55;52;124;162;123;35;184;84;112;127;70;135;63;79;122;129;92;40;185;106;114;89;183;143;117;0;121;86;75;120;82;2;94;176;51;118;59;151;133;80;148;144;21;7;14;102;15;186;23;115;160;177;10;54;34;22;18;159;193;41;139;46;137;138;165;90,7554399929044306586,0.065937
steepest_intra:nodes_start:random,135,89533,41260,48273,2392000,159,92;57;55;52;18;108;140;93;15;9;62;102;144;14;3;178;106;167;122;79;63;78;145;179;40;119;185;49;148;176;51;59;43;160;34;146;22;159;53;100;26;97;101;1;152;2;120;16;171;175;113;31;186;23;89;114;165;90;81;196;25;44;75;86;135;123;184;54;177;112;127;70;154;180;162;65;116;47;149;131;42;181;193;41;139;143;183;80;133;151;118;115;46;68;117;0;137;94;124;129,2491732360099637578,0.069221
steepest_intra:nodes_start:random,136,90000,40071,49929,2033200,135,18;22;159;193;139;115;41;181;42;43;51;137;183;89;114;40;81;196;157;145;179;185;52;55;57;129;152;176;0;170;143;117;46;162;135;127;123;160;34;54;184;14;165;90;27;164;21;144;62;9;15;148;167;92;78;31;113;175;171;16;70;154;180;158;53;121;100;26;97;1;86;101;2;106;178;3;49;102;80;133;151;65;116;59;118;23;186;12;124;94;122;79;63;75;120;44;25;82;68;108,1019915710875008308,0.059269
steepest_intra:nodes_start:random,137,91084,40096,50988,2825550,188,193;159;146;22;18;139;117;143;137;176;135;127;123;184;160;34;54;177;4;112;70;175;113;31;78;25;120;116;42;43;131;149;162;133;79;122;80;12;124;94;136;180;154;158;53;100;26;97;152;167;9;62;102;49;14;138;119;40;185;2;101;1;178;106;52;179;145;171;16;44;75;86;121;151;72;59;46;0;183;89;55;57;92;129;189;63;47;65;15;144;21;164;90;165;3;148;51;118;115;41,1934503741770987407,0.084246
steepest_intra:nodes_start:random,138,90072,40004,50068,2421900,161,185;40;138;14;144;137;118;109;51;79;63;121;100;26;97;1;152;52;55;57;92;145;78;127;112;4;70;75;120;44;129;2;101;86;53;89;183;153;143;117;0;176;80;151;184;48;54;177;133;167;165;90;31;113;175;171;16;25;162;149;65;115;198;46;23;186;62;9;148;180;154;135;123;131;47;139;68;140;108;18;22;146;159;193;41;5;42;181;34;160;43;116;59;122;94;124;102;49;178;106,5904365972663033659,0.071752
steepest_intra:nodes_start:random,139,88797,40281,48516,1973400,131,26;101;75;120;82;129;2;152;124;167;55;179;113;175;171;16;92;57;40;119;49;9;115;41;193;159;18;22;146;34;54;177;112;162;72;51;62;144;21;7;164;14;178;106;145;78;25;44;86;53;154;135;180;121;52;185;165;90;81;56;31;157;196;148;93;140;68;139;97;1;94;23;89;183;176;80;122;63;79;133;151;70;127;123;149;184;160;181;42;43;116;65;59;118;46;0;117;143;137;100,7098840185970794806,0.057189
steepest_intra:nodes_start:random,140,85941,35697,50244,2631200,175,44;25;120;101;1;152;2;129;57;55;185;40;165;49;148;176;80;79;122;94;124;97;26;100;121;63;41;193;159;139;68;0;183;89;186;16;171;175;113;31;52;106;178;3;14;144;62;9;137;22;146;34;181;5;116;47;65;72;151;133;180;53;78;145;92;167;23;143;117;93;108;18;46;51;109;42;160;54;177;10;190;84;35;131;149;59;118;115;43;184;4;112;123;162;127;70;135;154;86;75,4426699349717123606,0.077792
steepest_intra:nodes_start:random,141,90860,42580,48280,2257450,150,180;154;42;22;146;103;34;160;43;116;135;70;127;123;149;47;65;59;118;109;51;176;80;63;26;97;178;106;185;119;165;49;62;9;15;148;55;52;138;14;183;143;117;108;18;159;193;152;129;92;179;40;90;21;144;23;46;139;115;151;101;44;25;16;171;175;113;31;81;196;2;1;79;133;162;131;35;84;177;10;190;4;112;137;89;0;68;41;181;54;184;94;124;57;145;78;120;75;86;53,5431233576550802621,0.065000
steepest_intra:nodes_start:random,142,83248,34391,48857,3049800,203,185;129;2;101;86;75;145;90;27;164;21;183;143;0;117;93;68;46;51;176;80;79;122;63;121;100;26;97;1;120;44;25;92;57;55;52;167;124;94;109;118;115;159;18;22;42;43;184;84;112;123;127;70;135;154;53;180;133;151;59;116;65;162;152;78;31;113;175;171;16;148;186;23;89;139;41;193;181;34;160;54;177;10;190;35;131;149;137;9;62;102;144;14;49;3;178;106;165;119;40,3606504556522617047,0.089496
steepest_intra:nodes_start:random,143,83113,34158,48955,2466750,164,9;62;144;14;3;178;106;16;171;175;113;31;179;57;167;124;94;79;80;137;186;23;0;108;18;68;46;148;49;52;55;82;120;44;25;78;145;92;129;152;63;123;4;190;10;177;54;34;160;184;84;112;127;70;135;154;86;75;101;1;2;185;40;90;165;176;51;59;65;116;43;42;5;41;193;139;198;115;118;151;133;180;53;100;26;97;121;162;149;131;181;195;146;22;159;93;117;143;183;89,4448872733546267679,0.074155
steepest_intra:nodes_start:random,144,93642,43145,50497,2048150,136,196;157;38;78;152;79;133;80;122;124;148;102;49;3;106;179;145;92;57;129;82;44;120;75;101;86;53;180;162;43;42;181;34;160;184;59;118;51;176;100;26;97;1;25;113;175;171;16;2;115;139;46;23;14;138;40;185;94;63;127;112;4;123;137;15;62;9;121;154;70;135;0;143;117;93;140;108;18;22;193;41;116;65;131;149;151;167;165;27;90;56;31;55;52;178;186;89;183;144;81,6828010730347975924,0.059094
steepest_intra:nodes_start:random,145,79308,30918,48390,2825550,188,100;26;101;75;120;44;78;145;179;52;55;57;92;129;2;1;86;135;70;127;149;131;65;43;184;35;84;112;123;162;137;23;89;183;143;117;68;46;198;139;115;151;133;63;121;97;152;94;124;167;148;15;186;0;108;18;22;146;181;42;5;41;193;159;195;34;54;177;48;160;116;59;118;51;176;144;14;21;164;27;90;165;40;16;171;175;113;31;196;185;106;178;49;62;9;80;79;180;154;53,5186789701229932184,0.077032
steepest_intra:nodes_start:random,146,88296,38468,49828,2840500,189,146;181;42;43;47;131;149;127;70;135;154;180;158;53;100;26;86;101;1;2;129;40;119;102;186;23;0;143;183;165;27;90;81;196;179;92;152;51;118;115;46;145;31;56;78;25;44;120;97;121;63;79;151;72;59;162;123;112;177;54;34;160;184;84;35;80;148;9;62;49;106;185;113;175;171;16;75;133;65;116;137;15;144;14;178;52;55;57;167;124;94;176;117;93;68;139;41;193;159;22,7478303688729645791,0.081000
steepest_intra:nodes_start:random,147,86624,34862,51762,2571400,171,23;137;65;43;42;184;84;112;131;149;72;151;133;180;53;86;101;2;120;25;56;113;175;171;16;44;75;154;59;118;115;198;46;68;108;18;159;22;34;160;181;5;116;80;148;9;179;91;196;157;38;85;31;78;145;1;100;26;97;152;124;94;63;122;79;162;123;127;70;135;178;106;52;55;129;82;92;57;167;176;51;41;193;139;117;0;143;183;89;15;62;49;185;40;81;90;165;14;144;186,412660465065686264,0.073001
steepest_intra:nodes_start:random,148,91407,42781,48626,2137850,142,70;100;26;121;63;79;133;65;43;42;193;41;116;101;120;145;78;25;44;75;86;122;80;137;23;186;165;81;196;179;124;94;152;31;113;175;171;16;46;93;117;143;183;90;27;164;21;167;97;53;158;154;135;180;1;2;129;92;57;55;52;185;40;119;118;59;115;139;68;0;89;114;15;9;62;102;144;14;106;178;3;49;148;176;51;72;151;162;123;184;160;34;181;159;18;22;54;177;112;127,401107484451187533,0.061511
steepest_intra:nodes_start:random,149,85821,36990,48831,2586350,172,120;75;86;53;162;149;184;160;42;139;68;117;0;143;183;89;137;80;79;63;94;9;62;102;49;56;113;175;171;16;31;157;145;179;40;119;165;39;27;90;81;196;176;41;159;22;18;108;148;55;52;185;106;178;3;167;70;127;123;112;4;177;54;34;181;193;140;93;46;115;43;116;65;59;118;51;151;133;100;26;97;1;101;2;82;92;57;129;152;121;154;135;180;124;144;14;138;78;25;44,6371073645741134897,0.073002
steepest_intra:nodes_start:random,150,93419,44739,48680,2182700,145,160;184;43;116;65;46;68;117;143;183;15;102;49;122;79;151;118;139;69;18;108;63;121;100;26;97;94;124;167;52;185;40;55;101;86;53;180;123;112;4;84;35;59;51;176;178;106;78;31;16;44;120;75;177;54;34;159;0;89;186;23;137;135;70;154;1;2;129;92;57;179;145;196;81;90;27;165;138;14;144;62;9;148;80;133;162;149;131;41;193;115;113;175;171;152;42;181;195;22;146,4948955008011684492,0.062520
steepest_intra:nodes_start:random,151,86374,37163,49211,2317250,154,77;47;118;137;144;14;165;27;90;81;40;185;49;23;108;18;22;181;127;70;16;171;175;113;31;106;178;52;55;57;129;2;101;86;26;63;176;0;139;159;193;41;115;198;46;68;93;117;143;183;89;186;15;62;9;148;79;162;149;65;59;51;80;122;94;124;152;1;75;120;44;25;78;145;92;97;53;160;48;54;34;42;116;151;133;180;154;135;194;123;131;35;84;112;4;190;10;177;184;43,3506116615614288523,0.066029
steepest_intra:nodes_start:random,152,85673,36799,48874,2227550,148,139;159;146;22;18;108;68;46;0;117;143;183;92;78;25;44;75;86;151;72;59;65;149;123;70;154;180;94;124;167;106;165;90;40;185;52;55;57;101;53;35;184;177;10;4;112;127;135;133;176;137;23;89;186;15;49;178;3;14;138;95;164;7;21;144;102;62;9;148;51;118;116;43;42;160;34;181;193;41;115;162;100;26;121;63;79;122;97;1;129;145;31;113;175;171;16;120;2;152;80,237443140258965471,0.065533
steepest_intra:nodes_start:random,153,90519,40603,49916,2302300,153,16;1;133;162;135;154;180;53;63;79;151;72;59;118;115;193;159;195;146;54;177;10;190;84;35;42;5;41;139;198;137;144;14;106;178;49;102;62;176;51;96;181;34;48;160;43;80;167;165;90;81;196;40;119;185;52;55;152;70;127;149;131;47;65;116;46;117;143;0;2;129;92;145;57;23;183;89;186;15;9;148;123;112;184;22;18;108;140;68;94;97;101;86;75;120;44;78;113;175;171,1273139373679791581,0.065540
steepest_intra:nodes_start:random,154,90958,41582,49376,2227550,148,175;171;16;44;180;149;160;34;54;177;184;43;42;181;146;22;159;46;21;164;90;165;40;185;106;167;124;65;116;139;140;93;117;143;183;114;62;102;14;144;15;137;115;41;193;18;108;68;94;97;152;52;55;57;92;127;112;84;35;123;162;148;37;186;23;118;59;51;176;80;79;122;63;26;1;2;129;178;3;49;9;89;153;0;151;133;135;70;154;158;53;100;86;101;75;120;25;78;145;113,6536330751766108273,0.065205
steepest_intra:nodes_start:random,155,80444,31837,48607,2676050,178,5;42;43;10;177;54;34;146;181;160;184;35;131;149;47;65;116;198;46;68;139;159;22;59;162;151;176;80;133;180;53;121;94;124;148;186;23;0;18;108;93;117;143;183;89;114;9;62;102;49;178;106;185;179;31;56;113;175;171;16;25;44;120;75;101;26;63;79;152;52;55;57;92;129;2;1;97;100;154;70;127;123;135;86;78;145;196;81;90;40;165;14;144;15;137;51;118;115;193;41,4280413586281968559,0.077438
steepest_intra:nodes_start:random,156,91208,40095,51113,2063100,137,115;131;149;123;127;70;135;154;158;53;136;121;97;1;2;120;44;25;171;16;75;86;26;101;145;196;81;90;179;100;180;139;41;193;18;69;108;117;137;3;178;106;176;5;42;160;43;116;65;162;133;79;122;94;124;148;9;62;167;152;189;63;151;59;118;51;80;129;92;78;31;113;175;112;184;34;22;159;23;186;15;57;55;52;185;40;119;165;39;138;14;49;102;144;89;183;153;143;0;46,2442604910180362923,0.059259
steepest_intra:nodes_start:random,157,87995,39108,48887,2182700,145,112;70;135;154;102;144;21;7;164;39;165;40;185;196;157;56;113;175;16;120;97;121;133;162;127;123;149;131;47;65;41;193;139;59;151;180;53;178;106;52;55;152;1;101;86;75;44;25;145;179;3;49;137;46;115;116;105;43;181;22;18;117;143;183;89;0;68;159;34;160;42;23;186;15;62;9;148;124;94;176;80;79;63;100;26;2;129;57;92;78;171;31;81;90;14;51;184;48;54;177,2539985256556279213,0.062010
steepest_intra:nodes_start:random,158,89878,39392,50486,2227550,148,7;21;65;184;160;34;146;159;193;41;109;51;176;178;106;52;55;57;26;100;121;162;149;131;101;2;31;113;175;171;16;86;53;158;154;180;97;152;167;148;137;108;18;22;181;151;1;129;92;145;78;25;44;120;75;70;135;133;79;80;9;62;186;23;89;183;153;143;0;118;59;116;139;140;93;117;68;46;198;115;5;42;43;123;127;63;94;124;49;102;144;14;138;185;40;119;165;90;27;164,2374850794128568579,0.062910
steepest_intra:nodes_start:random,159,84231,35734,48497,2661100,177,10;177;54;34;146;22;159;183;89;186;23;137;46;198;139;69;18;108;118;51;176;80;97;1;101;2;129;81;90;40;106;178;52;55;57;185;165;164;7;21;14;144;62;9;79;123;35;84;4;112;127;70;75;16;175;171;44;120;86;26;100;158;53;121;152;78;113;31;145;92;49;148;124;94;63;180;154;135;162;133;151;72;59;43;48;160;181;41;193;68;93;117;143;0;115;65;116;5;42;184,662000230900083249,0.075940
steepest_intra:nodes_start:random,160,89158,39022,50136,2003300,133,131;184;84;35;86;75;78;145;185;14;21;164;165;40;90;81;196;52;55;167;148;80;176;0;143;117;68;139;193;41;115;175;171;16;44;120;129;92;57;106;178;49;144;51;42;181;30;54;177;104;48;160;43;100;26;97;1;101;2;152;63;79;133;151;118;59;65;116;105;47;162;180;154;158;53;121;94;137;23;183;89;186;62;9;46;108;18;159;22;146;34;10;190;4;112;127;70;135;123;149,5388236803801265153,0.056000
steepest_intra:nodes_start:random,161,86603,38090,48513,2392000,159,143;0;117;93;108;18;22;146;34;181;159;139;68;46;23;137;124;94;97;101;75;171;175;113;81;40;119;165;185;196;179;145;92;129;80;115;41;193;42;116;65;47;135;70;127;123;162;79;49;3;178;1;86;53;158;154;180;133;151;72;118;59;131;149;51;176;148;9;62;144;14;106;52;57;120;44;16;31;78;2;121;63;43;160;48;54;177;184;84;112;100;26;152;55;90;27;164;21;89;183,74556271560047769,0.071509
steepest_intra:nodes_start:random,162,87352,38033,49319,2571400,171,116;129;92;51;118;115;41;193;159;139;68;117;46;5;160;34;54;177;184;127;70;158;86;101;100;26;97;1;2;120;25;78;81;90;165;138;102;62;186;89;183;153;143;0;137;15;144;14;40;185;106;49;176;80;133;194;135;154;180;53;148;9;167;152;121;63;151;59;108;18;22;146;181;42;43;149;35;84;4;112;123;162;79;122;94;124;178;52;55;57;179;145;31;113;175;171;16;44;75;65,5671543245841985210,0.074033
steepest_intra:nodes_start:random,163,86699,38461,48238,2631200,175,178;165;90;27;164;21;93;108;69;18;22;181;42;5;193;41;162;133;180;53;158;154;135;70;86;101;1;97;26;100;63;79;152;2;106;185;119;40;81;196;179;145;31;113;78;92;57;52;55;129;44;16;171;175;120;75;112;4;177;54;184;123;62;9;80;151;176;137;23;186;15;144;14;49;148;51;59;65;116;115;46;68;139;159;146;34;160;43;131;149;118;0;117;170;143;183;89;94;124;167,7250852543841131817,0.075463
steepest_intra:nodes_start:random,164,91710,41769,49941,2332200,155,102;144;186;23;137;66;176;122;121;75;16;171;175;113;31;179;52;55;129;70;177;54;34;146;22;159;193;41;139;115;51;80;94;124;57;196;81;40;119;185;165;90;164;21;14;49;167;152;97;26;154;135;127;112;160;181;5;151;79;63;53;158;180;0;117;143;2;120;44;25;78;145;92;133;43;42;184;35;123;162;148;9;62;15;149;131;47;65;116;59;118;46;183;89;100;86;101;1;106;178,3695436623256803346,0.064511
steepest_intra:nodes_start:random,165,86545,38241,48304,2377050,158,145;78;16;171;175;113;31;90;164;21;143;108;18;159;193;137;148;37;9;62;102;49;144;14;138;39;165;185;52;55;124;94;79;80;51;118;59;65;116;43;184;54;48;160;42;46;0;117;139;41;115;176;97;101;75;86;53;154;70;135;194;127;112;4;84;149;162;180;100;26;121;133;151;63;152;2;120;44;25;92;57;106;178;15;186;23;89;183;22;146;34;30;177;10;123;1;129;40;81;196,2138738335875111650,0.072003
steepest_intra:nodes_start:random,166,91434,43012,48422,2347150,156,148;127;112;4;10;177;54;48;181;68;140;108;18;41;42;59;106;185;165;119;40;81;196;52;55;57;152;97;63;176;0;117;46;115;116;149;123;135;120;25;78;145;92;129;101;86;75;16;171;175;90;39;138;178;51;118;139;193;159;195;22;146;34;160;43;65;162;151;133;26;1;2;31;113;44;70;84;35;184;143;183;89;144;14;49;167;124;94;121;53;158;154;180;79;80;137;15;9;62;102,7716851968752681328,0.069018
steepest_intra:nodes_start:random,167,80920,31430,49490,2227550,148,63;94;189;100;26;101;75;86;121;53;158;154;180;133;151;51;183;89;186;23;137;135;127;123;65;116;43;139;68;117;143;0;46;5;42;181;146;34;48;54;30;177;10;4;112;149;59;176;124;178;106;52;185;40;165;27;90;81;196;145;78;31;113;175;171;16;44;120;2;1;97;152;49;14;144;62;9;15;148;167;55;57;92;129;118;115;96;41;193;199;69;108;18;22;159;160;184;162;80;79,1065034499430056429,0.063001
steepest_intra:nodes_start:random,168,83864,34598,49266,2122900,141,151;133;63;94;124;26;86;101;1;2;120;75;53;154;180;79;80;176;137;186;15;9;62;102;138;14;144;114;23;117;108;69;18;193;41;159;22;146;34;160;177;10;54;48;184;112;123;135;44;196;81;90;27;164;39;165;185;92;145;78;16;171;175;113;31;40;119;106;178;97;100;162;149;131;47;65;115;139;68;143;183;89;153;0;46;5;42;43;116;59;152;129;57;55;52;49;167;148;51;118,4053047850760298187,0.105511
steepest_intra:nodes_start:random,169,87307,38357,48950,2152800,143,49;102;62;9;57;179;145;92;82;25;78;31;56;16;171;175;113;196;185;106;178;167;152;1;2;129;40;90;165;14;144;15;51;118;59;133;121;97;26;100;154;135;123;184;177;10;4;112;127;70;86;75;44;120;101;53;180;149;131;41;193;115;122;94;124;189;63;79;80;46;68;69;18;108;117;0;139;34;54;160;42;43;65;162;151;176;137;23;89;183;143;159;195;22;146;181;116;148;55;52,2316134661943868175,0.068996
steepest_intra:nodes_start:random,170,88685,39992,48693,2481700,165,177;10;190;4;112;75;78;145;129;152;97;1;101;2;120;44;92;57;185;165;119;40;81;196;157;179;55;52;167;63;123;35;131;133;79;94;124;137;143;0;46;139;115;118;59;127;70;154;135;194;162;151;80;176;148;178;106;31;56;113;175;171;16;90;164;21;144;15;186;23;51;65;47;149;180;100;26;86;53;116;43;42;184;48;160;181;193;41;9;49;14;62;89;183;117;18;22;146;34;54,8849641172424672131,0.082511
steepest_intra:nodes_start:random,171,89211,37797,51414,2317250,154,22;146;34;184;127;135;133;51;109;118;59;162;123;112;4;190;10;177;42;5;46;0;183;89;23;186;97;101;25;16;171;175;78;145;92;129;44;120;75;86;53;116;43;181;160;48;54;84;70;154;180;176;137;143;117;68;139;41;115;148;49;138;165;27;90;40;14;144;62;9;152;1;2;178;3;106;185;179;57;55;52;167;65;47;131;149;80;12;124;94;63;122;79;151;193;159;199;69;108;18,1185438446331499993,0.075510
steepest_intra:nodes_start:random,172,91102,40962,50140,2152800,143,78;120;116;42;159;193;41;46;167;178;106;152;97;189;121;53;63;94;129;31;113;175;171;16;44;75;151;72;109;51;148;9;62;102;49;52;2;1;26;100;86;101;185;90;27;165;70;177;54;34;146;22;18;108;68;139;115;65;131;149;123;135;154;180;179;196;81;40;138;14;144;186;23;118;59;43;160;184;84;4;112;162;133;79;80;176;137;153;0;117;170;143;183;89;114;15;55;57;92;145,2163663952278377582,0.066002
steepest_intra:nodes_start:random,173,87149,38871,48278,2152800,143,79;122;63;94;124;55;185;165;138;14;9;137;51;133;180;154;135;112;4;84;190;10;177;54;68;117;23;186;152;1;101;86;59;115;198;46;144;21;7;164;90;40;57;2;75;70;127;123;184;42;43;65;116;139;69;108;18;193;41;159;22;146;181;34;160;162;120;16;171;175;113;56;31;44;25;78;145;92;129;97;26;100;53;151;118;0;143;183;89;114;15;62;102;49;178;106;52;148;176;80,4166821670008673422,0.062774
steepest_intra:nodes_start:random,174,92094,43511,48583,2078050,138,193;159;18;108;117;178;106;52;152;127;4;177;54;48;43;62;102;49;14;144;143;0;186;9;57;113;175;171;16;25;44;120;75;101;2;78;56;31;145;179;92;129;1;131;160;34;146;22;139;68;46;122;63;53;180;154;135;70;86;97;26;100;133;151;65;47;149;94;124;167;185;40;165;90;81;196;55;148;115;96;5;42;116;59;118;51;79;80;176;137;23;89;183;162;123;112;84;184;181;41,5742906409532999056,0.064298
steepest_intra:nodes_start:random,175,84938,36035,48903,2227550,148,16;171;175;113;31;145;78;120;75;184;160;34;54;177;112;127;123;162;72;51;80;122;79;133;151;176;148;9;62;15;114;186;89;117;93;140;108;18;139;94;97;86;26;100;63;118;46;0;143;183;144;106;81;196;179;167;124;137;23;68;198;115;116;65;43;42;181;146;22;159;193;41;59;180;154;135;70;158;53;152;178;3;49;102;14;138;165;90;40;185;52;55;57;92;129;2;1;101;44;25,2147427493314383104,0.072513
steepest_intra:nodes_start:random,176,87261,38398,48863,2302300,153,115;46;143;183;89;57;129;2;154;135;123;127;70;75;120;44;16;171;175;78;145;92;151;65;47;35;84;4;184;43;5;139;68;117;0;51;118;59;116;146;22;18;108;69;159;193;41;42;181;34;54;177;10;112;133;63;94;9;62;176;80;79;49;14;178;106;165;119;40;185;52;55;196;81;90;164;21;144;102;167;152;1;101;86;100;26;137;23;186;15;148;124;97;53;180;162;149;131;48;160,973914791554335345,0.072517
steepest_intra:nodes_start:random,177,89232,39942,49290,2272400,151,102;49;55;57;92;179;52;138;14;144;62;9;148;12;79;151;133;180;53;100;121;63;122;189;97;145;196;81;90;27;165;118;42;159;193;41;139;117;0;46;115;116;65;59;51;21;7;164;40;185;106;178;15;186;23;137;176;80;129;78;31;56;113;175;171;16;154;135;123;35;184;54;177;112;70;86;75;101;1;26;162;149;43;160;34;146;22;18;143;183;89;167;82;25;44;120;2;152;94;124,7762965614004172409,0.071026
steepest_intra:nodes_start:random,178,87417,37624,49793,2212600,147,53;86;75;44;120;101;162;116;5;42;181;139;137;186;15;144;49;102;62;9;167;25;16;171;175;113;31;23;89;153;0;46;115;59;151;133;180;154;135;123;149;65;43;160;34;22;159;41;193;18;108;93;117;143;183;114;14;138;3;178;106;52;55;179;196;81;185;176;51;118;109;148;165;27;90;119;40;145;78;92;57;129;2;152;1;97;26;63;79;122;94;124;12;80;184;54;177;4;112;70,2000131466474712908,0.067038
steepest_intra:nodes_start:random,179,86954,36208,50746,2571400,171,53;124;148;178;106;165;14;144;137;118;149;131;123;92;179;40;185;70;112;4;127;135;154;75;44;120;94;176;46;0;143;117;93;68;139;115;181;34;160;48;54;177;184;43;47;162;133;151;72;51;80;122;189;152;2;129;57;55;52;3;49;102;62;9;15;186;89;183;108;18;22;146;159;193;41;5;42;116;65;59;79;63;180;121;82;145;78;31;113;175;171;16;25;1;97;26;100;101;86;158,5335333259275286675,0.079971
steepest_intra:nodes_start:random,180,87556,38559,48997,2272400,151,131;51;176;80;178;106;185;196;31;16;44;108;18;22;159;123;127;112;184;48;160;34;181;193;41;139;46;89;23;186;9;62;183;143;0;117;68;115;5;116;65;59;118;137;15;144;14;49;52;55;79;151;43;42;54;177;70;135;154;180;53;26;152;167;148;124;94;189;97;1;2;57;40;90;27;58;164;7;21;95;39;165;145;78;56;113;175;171;92;129;120;75;101;86;100;121;63;133;162;149,2029607825744924618,0.072000
steepest_intra:nodes_start:random,181,88487,38183,50304,2317250,154,1;97;189;94;122;79;133;180;154;184;160;34;22;159;42;162;135;70;127;123;149;43;115;118;51;59;116;65;151;165;39;164;27;90;81;196;8;138;102;62;9;176;80;63;53;121;2;82;129;92;57;55;167;137;0;46;139;41;86;75;120;44;25;31;113;175;171;16;78;145;179;40;119;185;52;152;112;177;54;181;193;117;143;183;89;23;186;49;3;178;106;14;144;114;15;148;124;100;26;101,4504258435311738630,0.077997
steepest_intra:nodes_start:random,182,85168,35319,49849,2197650,146,178;3;14;102;49;145;78;25;44;120;1;97;26;53;180;133;72;59;116;65;47;190;10;177;54;34;160;123;75;16;171;175;113;31;138;144;62;9;176;151;162;149;131;43;42;181;22;18;0;23;137;122;63;79;51;46;68;117;143;183;89;186;15;165;90;81;196;40;119;185;52;55;148;167;57;129;152;94;80;118;115;139;159;193;41;96;5;184;35;84;4;112;135;154;86;101;2;92;179;106,8484923272993989869,0.067154
steepest_intra:nodes_start:random,183,86285,37944,48341,2167750,144,41;116;47;149;131;84;4;112;70;26;100;53;180;154;35;184;177;54;43;65;151;124;55;52;90;164;7;21;14;57;129;2;75;120;44;25;16;171;175;113;31;89;183;0;46;137;186;15;148;94;133;162;123;127;135;158;86;101;1;167;49;102;144;62;9;23;143;117;68;139;115;59;118;51;176;80;79;122;63;97;152;178;106;185;165;40;145;78;92;42;181;160;34;146;22;18;108;69;159;193,7690219140400704684,0.069539
steepest_intra:nodes_start:random,184,89837,39968,49869,2272400,151,9;62;144;102;49;178;57;129;2;152;97;26;53;158;180;189;55;52;167;80;149;131;35;84;112;123;70;86;101;100;136;182;121;1;44;25;145;40;164;7;21;15;137;118;59;151;79;94;78;31;113;175;171;16;63;133;162;65;116;42;181;146;159;193;41;139;68;117;143;183;89;23;135;154;75;120;92;185;106;14;138;165;27;90;81;196;179;124;176;51;46;18;22;34;160;184;43;115;0;148,1744355633006505401,0.072010
steepest_intra:nodes_start:random,185,90028,39833,50195,2392000,159,108;117;143;137;167;57;92;129;1;112;4;177;54;184;84;35;55;52;151;160;34;181;42;118;176;49;3;178;106;189;180;154;70;135;194;127;123;47;65;116;59;51;144;14;102;62;9;148;124;94;80;115;193;159;22;41;5;43;77;131;149;162;133;79;63;152;2;120;25;44;75;101;86;158;53;121;100;26;97;185;40;165;90;31;113;175;171;16;78;145;15;186;23;89;183;0;46;68;139;18,7655745055128251206,0.076269
steepest_intra:nodes_start:random,186,85794,33970,51824,2122900,141,1;97;63;79;151;59;193;41;116;65;149;123;127;194;135;70;106;185;179;92;129;44;120;75;86;133;162;184;177;54;34;160;42;115;198;139;68;46;118;109;80;122;148;37;9;62;144;14;3;178;167;176;51;43;181;22;18;108;69;159;152;2;57;55;52;78;16;171;175;113;56;31;145;196;40;165;49;102;15;114;186;23;89;183;143;117;93;0;137;124;94;121;136;180;154;158;53;100;26;101,1499844928791886506,0.063091
steepest_intra:nodes_start:random,187,82341,33756,48585,2421900,161,70;112;4;190;84;35;43;116;65;59;118;115;46;139;41;193;34;160;48;54;177;184;149;123;162;51;183;89;15;196;81;31;56;113;175;171;16;135;42;22;18;108;117;143;0;176;80;151;133;79;63;94;124;9;62;144;14;138;185;40;119;165;90;27;164;21;178;106;52;179;145;78;25;44;129;92;57;55;49;102;186;23;137;148;167;152;53;180;154;158;86;101;100;26;97;1;2;82;120;75,5716227340821639579,0.072693
steepest_intra:nodes_start:random,188,88836,38705,50131,2347150,156,100;53;48;54;177;10;190;4;84;131;149;176;9;62;15;115;159;22;146;34;160;43;116;65;151;121;120;25;44;75;86;101;1;97;124;148;186;23;117;69;18;108;140;93;68;139;42;184;35;123;162;133;79;63;122;137;89;183;143;0;46;118;51;80;94;152;129;55;52;49;178;106;145;16;171;175;113;78;59;41;193;181;112;29;127;70;135;154;180;167;102;144;14;165;40;185;57;92;2;26,5031014408703184602,0.068153
steepest_intra:nodes_start:random,189,94529,44833,49696,2436850,162,129;92;78;31;145;179;57;167;68;108;18;69;139;59;118;51;176;148;102;49;138;14;144;15;149;131;35;84;4;112;123;162;133;79;9;62;65;116;43;160;34;195;159;193;41;42;5;96;115;46;117;143;0;80;94;124;178;106;152;121;180;135;70;154;53;1;2;120;44;75;86;101;55;52;185;40;165;127;10;177;54;48;184;151;63;97;113;175;171;16;25;26;100;137;23;89;183;22;146;181,452918569685567166,0.077916
steepest_intra:nodes_start:random,190,93579,44337,49242,1883700,125,183;144;14;138;165;40;185;106;178;94;63;79;151;72;115;41;193;18;69;108;93;78;175;171;16;42;160;34;54;184;123;121;97;57;55;52;49;21;164;90;81;92;129;26;100;80;46;139;181;146;22;159;68;0;23;145;31;56;113;25;101;86;75;44;120;2;1;152;148;9;62;15;137;176;162;194;135;154;133;51;118;59;65;131;149;180;53;158;70;127;112;4;10;177;43;77;47;116;117;143,7083929152813193728,0.068130
steepest_intra:nodes_start:random,191,86843,37349,49494,2272400,151,148;9;62;52;55;162;35;84;184;43;5;41;193;181;160;177;112;70;86;101;129;40;90;165;138;14;3;178;106;185;113;175;171;16;2;51;118;115;42;48;54;30;34;22;159;139;46;186;114;15;57;92;145;179;196;31;78;44;120;75;53;133;151;180;154;135;127;123;149;131;65;116;59;137;23;89;183;143;170;117;93;108;18;69;68;0;153;144;102;49;152;1;97;26;100;94;63;79;80;176,2049417499651716008,0.076430
steepest_intra:nodes_start:random,192,80791,33524,47267,2377050,158,127;112;4;123;135;154;180;53;152;2;129;179;196;81;90;40;165;164;21;144;62;9;102;14;49;167;148;51;118;198;46;0;143;117;93;68;139;193;41;115;59;151;133;79;63;94;55;52;185;31;113;175;171;16;25;78;145;57;186;23;137;176;80;162;84;190;10;177;54;48;160;34;181;42;43;184;131;149;65;116;159;22;18;69;108;140;183;89;15;178;106;92;44;120;75;1;97;101;86;70,8272683023271259909,0.072032
steepest_intra:nodes_start:random,193,88597,38859,49738,2556450,170,148;102;49;52;55;57;179;92;129;152;162;177;54;34;160;131;149;59;118;0;143;117;68;139;46;176;80;167;178;106;185;40;165;14;137;193;22;146;181;42;41;115;23;186;15;9;62;144;114;89;183;93;140;108;18;26;97;1;2;78;31;113;175;171;16;81;196;145;101;100;135;127;70;75;44;25;120;86;154;123;112;4;84;184;43;77;47;116;65;72;109;51;151;133;79;63;180;53;94;124,6915088406208702580,0.076604
steepest_intra:nodes_start:random,194,89019,40381,48638,2421900,161,167;40;119;90;81;196;157;78;25;75;86;53;180;121;100;26;101;44;16;171;175;113;56;31;145;79;133;162;149;123;127;70;135;63;148;9;62;176;51;118;42;34;22;159;18;68;46;115;116;43;184;177;54;160;41;193;139;80;122;94;152;129;92;120;2;124;23;186;114;15;52;55;57;1;97;151;59;65;35;84;112;154;179;185;165;138;14;49;102;144;21;7;164;106;178;183;143;117;0;137,922644031249408019,0.071094
steepest_intra:nodes_start:random,195,88958,39240,49718,2257450,150,53;86;75;44;113;56;31;78;101;154;135;127;123;131;77;43;96;41;139;117;143;0;148;167;57;175;171;16;25;120;1;152;2;145;81;196;179;92;129;46;115;42;160;184;84;112;70;55;52;185;40;90;165;14;144;108;18;22;146;195;159;193;151;100;26;97;94;137;23;183;89;186;9;62;49;3;178;106;124;80;176;51;109;118;59;5;181;34;54;177;35;47;116;65;149;162;133;79;63;180,2546841108237401546,0.081522
steepest_intra:nodes_start:random,196,88137,38634,49503,2526550,168,5;59;51;176;80;121;100;86;101;1;97;26;53;70;135;194;127;35;84;4;112;123;162;151;118;46;115;160;184;177;54;34;181;41;137;196;81;119;165;138;14;144;186;89;183;0;139;193;159;22;18;143;21;7;164;90;40;185;92;44;120;2;63;133;79;148;9;62;102;49;3;106;179;145;78;25;75;158;154;180;16;171;175;113;31;124;94;189;152;129;57;55;52;178;167;149;65;116;43;42,8004655903200713321,0.089227
steepest_intra:nodes_start:random,197,85764,36594,49170,2421900,161,165;14;144;23;89;183;108;18;193;41;115;118;51;148;49;178;106;97;26;121;53;136;63;80;186;15;185;113;175;171;16;120;152;124;167;52;55;57;25;44;75;101;86;70;127;123;181;22;34;160;184;131;149;116;65;162;151;176;137;0;143;117;68;46;139;42;84;112;4;190;10;177;54;48;43;59;9;62;94;122;79;133;194;135;154;180;158;100;1;2;129;92;145;78;31;196;81;90;40;119,7203896054576245002,0.081000
steepest_intra:nodes_start:random,198,92544,41467,51077,2093000,139,75;86;70;135;154;158;53;23;183;89;186;114;15;62;9;37;148;12;176;46;139;41;193;159;146;22;18;0;137;78;31;113;175;171;16;25;129;43;181;34;54;177;112;167;178;106;119;40;196;55;57;92;145;81;90;27;39;165;185;52;184;160;42;5;115;118;151;80;122;94;124;121;180;194;149;65;116;59;51;102;144;14;49;152;26;100;101;1;97;63;79;133;162;131;35;123;127;2;120;44,238207477510914922,0.067002
steepest_intra:nodes_start:random,199,95747,46012,49735,2436850,162,158;53;100;26;97;101;86;75;16;175;171;44;160;34;146;22;181;42;43;162;167;52;185;119;40;196;81;165;183;89;23;31;56;113;90;27;164;7;21;137;184;54;177;4;112;35;65;51;176;92;145;179;57;94;63;122;79;80;9;62;37;148;124;180;154;133;143;0;46;118;59;116;41;193;159;139;115;151;121;120;25;78;178;49;102;152;1;2;129;55;106;14;144;15;149;131;123;127;70;135,8439877590790406134,0.074002
