method,run,objective,tour_length,selected_costs,evaluations,improvements,final_selected,seed
steepest_intra:nodes_start:random,0,116602,57960,58642,1495014950,100001,148;15;114;183;49;138;178;55;77;54;30;47;115;116;198;139;22;195;65;14;7;39;165;73;186;162;160;192;103;69;93;153;51;72;109;0;143;170;80;57;92;137;191;193;199;18;46;41;42;79;26;86;101;94;124;62;37;106;40;185;81;31;85;16;175;78;44;113;171;52;145;17;196;2;152;1;63;133;53;176;59;149;151;135;180;97;154;10;177;84;34;184;131;127;70;123;75;120;82;144,8171909883322433427
steepest_intra:nodes_start:random,1,114171,56723,57448,1495014950,100001,90;81;185;8;40;133;154;94;12;176;93;36;139;123;1;86;53;180;72;68;193;41;34;124;52;178;21;73;9;167;148;149;77;43;122;14;144;102;63;80;62;3;92;78;145;57;59;118;184;160;177;190;112;151;74;152;101;97;135;127;6;70;136;26;100;182;42;47;162;79;137;89;186;23;183;0;46;115;35;131;116;65;51;138;164;7;49;106;55;129;2;75;175;16;113;171;44;120;27;165,3045710288500910680
steepest_intra:nodes_start:random,2,108378,55560,52818,1495014950,100001,180;102;9;59;160;48;43;41;146;22;42;116;53;100;2;145;16;171;120;152;129;92;78;113;31;44;75;86;26;101;1;97;137;93;18;193;159;96;65;176;189;19;94;124;148;49;165;8;185;122;80;51;72;131;35;112;4;70;135;127;5;115;37;106;27;90;14;114;186;23;62;178;52;40;119;143;0;68;139;46;118;149;123;151;183;89;177;54;30;34;184;162;63;167;55;57;79;133;154;144,6820675058032075218
steepest_intra:nodes_start:random,3,94187,44015,50172,1495014950,100001,63;94;145;78;1;133;162;151;59;46;198;146;103;34;181;160;42;193;41;115;68;140;117;180;53;75;2;129;52;106;49;102;144;186;23;124;120;44;16;171;175;113;86;100;62;15;176;80;79;131;149;65;116;77;43;143;183;0;139;159;22;48;54;177;184;35;112;127;70;154;135;123;118;51;137;9;14;185;119;40;165;39;90;164;58;7;89;93;108;18;148;178;55;57;92;152;97;101;26;121,6462461484834340413
steepest_intra:nodes_start:random,4,188372,95007,93365,1495014950,100001,117;84;105;198;4;47;59;125;186;140;68;152;107;178;49;41;42;151;128;8;167;74;111;114;64;176;123;10;131;67;163;115;46;133;141;183;76;116;43;5;191;122;106;88;175;157;168;73;21;119;98;27;58;38;142;28;120;179;165;3;32;9;75;146;181;86;63;94;188;129;160;193;130;79;80;148;48;20;53;101;37;150;121;23;83;55;78;92;16;154;25;12;19;6;99;100;97;30;156;127,6643505760242639543
steepest_intra:nodes_start:random,5,94051,44465,49586,1495014950,100001,63;180;162;149;184;48;34;115;0;117;22;146;181;42;2;129;25;120;70;127;123;135;154;158;53;26;100;86;75;44;16;171;175;113;1;97;152;80;51;46;139;18;159;193;41;5;116;65;47;131;59;118;62;9;102;90;81;185;106;178;94;43;160;54;177;190;4;112;101;57;55;52;49;114;183;89;167;92;78;145;40;119;165;14;144;15;186;23;137;176;151;133;124;37;148;143;93;140;68;79,4736997692943078706
steepest_intra:nodes_start:random,6,132114,74547,57567,1495014950,100001,0;119;56;175;171;133;79;23;186;94;130;182;26;101;86;16;88;50;113;157;145;97;162;139;109;196;40;138;128;4;35;151;176;9;62;148;144;49;185;91;78;55;57;2;19;124;63;80;47;184;149;92;25;44;75;123;65;59;180;194;53;179;52;178;106;1;131;34;54;22;18;152;120;82;154;160;193;42;116;68;41;153;183;143;115;177;48;105;43;135;70;137;14;81;31;90;165;39;93;164,8862318326009016015
steepest_intra:nodes_start:random,7,119640,62059,57581,1495014950,100001,69;94;55;49;178;97;2;120;44;62;148;136;70;133;149;65;166;181;116;109;51;79;152;12;124;23;143;153;117;0;137;89;114;64;52;106;122;72;118;34;160;43;42;193;198;115;68;140;110;93;183;186;15;9;144;101;86;123;184;177;54;135;154;100;57;185;40;1;194;127;112;176;63;53;129;92;179;8;14;74;26;80;146;103;108;18;22;162;75;16;31;171;145;78;151;59;139;41;159;180,5510361195747988603
steepest_intra:nodes_start:random,8,112890,54924,57966,1495014950,100001,124;145;17;119;106;129;57;55;52;49;116;5;43;133;63;180;100;86;135;131;193;41;18;22;34;59;109;60;68;0;94;152;1;101;26;182;53;158;154;184;160;42;46;15;144;196;188;31;56;171;3;95;165;90;40;92;2;25;175;113;78;97;189;120;157;81;13;16;44;178;102;14;185;169;38;179;70;112;123;194;127;79;9;62;148;186;151;77;65;118;51;176;162;137;183;93;139;115;80;75,4925839271803134934
steepest_intra:nodes_start:random,9,105029,54541,50488,1495014950,100001,92;120;53;133;123;35;84;112;51;176;0;143;18;193;41;42;34;181;43;65;178;39;31;157;55;148;189;94;124;16;113;1;154;151;162;177;184;59;137;23;183;144;9;167;100;101;86;97;62;164;90;27;81;91;145;129;52;106;3;14;49;135;70;139;159;146;103;195;22;108;68;46;160;48;54;10;4;116;149;131;180;171;175;179;57;185;119;165;40;196;78;25;2;152;80;115;118;79;63;44,3630663317682889907
steepest_intra:nodes_start:random,10,93049,40936,52113,1495014950,100001,86;122;79;151;59;159;22;18;108;93;143;89;23;186;114;51;65;184;160;34;181;43;42;41;193;137;37;14;138;185;40;119;165;3;148;124;94;80;72;118;115;139;46;117;0;183;73;21;90;196;25;120;131;35;112;127;70;135;53;26;1;97;152;121;63;162;47;105;116;149;123;44;16;175;113;31;106;178;49;9;62;167;2;129;57;92;145;78;52;55;102;144;15;176;133;154;180;75;101;100,558463840005115725
steepest_intra:nodes_start:random,11,104551,51297,53254,1495014950,100001,149;93;140;193;41;79;122;158;26;49;14;62;178;106;129;78;145;39;95;164;90;27;40;176;80;94;124;37;148;52;185;92;120;2;65;177;160;43;25;175;171;16;86;53;111;3;165;8;138;144;183;143;18;22;146;181;116;42;5;139;108;163;68;46;118;123;127;112;35;184;34;48;51;137;186;55;57;167;101;97;100;182;133;180;154;152;179;113;31;44;75;1;136;63;135;70;162;151;59;115,517159406340470019
steepest_intra:nodes_start:random,12,112816,56928,55888,1495014950,100001,176;167;14;102;9;0;18;199;146;41;118;57;55;52;119;40;81;16;44;120;101;94;133;154;180;178;106;165;185;49;124;151;131;184;166;43;24;162;129;78;145;62;89;183;137;80;79;75;1;53;127;135;86;95;27;90;25;2;92;196;169;157;113;175;31;179;59;160;22;103;34;193;139;115;148;61;37;3;138;144;15;122;189;63;51;46;100;97;26;136;65;116;42;54;30;177;112;123;149;152,2440606275653297773
steepest_intra:nodes_start:random,13,126248,66149,60099,1495014950,100001,160;177;53;44;120;101;1;176;51;59;173;180;158;94;137;89;72;162;43;109;167;78;175;171;97;62;95;165;185;39;40;178;37;30;54;65;116;47;148;144;186;198;46;149;131;184;179;145;14;32;3;106;92;16;157;81;90;8;49;96;115;118;136;154;135;70;0;153;183;114;197;105;42;123;133;79;26;121;63;151;80;93;143;139;193;41;68;108;4;84;103;18;140;117;2;152;182;127;34;22,4600067624453992181
steepest_intra:nodes_start:random,14,93106,39021,54085,1495014950,100001,129;40;123;35;84;112;127;70;136;121;53;158;180;162;131;149;135;86;75;101;97;41;193;42;160;34;54;184;43;77;65;72;118;59;116;47;194;154;100;26;148;9;62;179;145;78;92;57;106;14;144;186;23;137;12;124;94;176;89;183;143;0;117;46;139;115;51;151;133;80;79;63;122;15;102;49;52;55;185;196;31;113;175;171;16;44;120;178;138;21;164;27;90;165;167;111;152;1;2;119,1119589296818520984
steepest_intra:nodes_start:random,15,91688,40811,50877,1495014950,100001,137;144;14;129;92;82;2;152;133;4;112;123;127;180;154;100;86;101;75;1;143;0;183;148;124;122;80;118;116;184;160;54;30;34;181;195;146;22;46;186;9;62;102;49;21;164;90;165;106;178;55;52;40;185;196;56;113;31;157;81;167;176;51;149;131;151;162;65;43;42;115;139;18;159;193;41;59;70;135;158;53;26;189;63;79;121;44;16;88;171;175;179;57;145;78;25;120;97;94;23,1178642158743202762
steepest_intra:nodes_start:random,16,103388,49061,54327,1495014950,100001,184;42;43;115;193;139;46;162;161;154;158;53;44;16;78;92;106;167;80;79;122;51;109;151;133;15;14;144;148;124;189;129;57;2;123;116;65;152;120;171;175;31;56;13;113;75;86;47;131;149;127;70;135;173;136;63;94;97;100;176;59;118;0;143;49;52;55;178;3;89;23;183;117;41;181;160;34;22;186;165;40;179;145;185;90;81;196;119;102;62;9;137;121;26;1;101;180;177;54;190,711212537599511347
steepest_intra:nodes_start:random,17,126962,62458,64504,1495014950,100001,178;62;9;102;155;144;32;129;120;86;154;10;184;198;0;23;64;78;145;92;25;94;183;143;137;59;41;96;65;115;193;139;101;97;53;75;16;31;171;196;176;80;52;165;40;57;44;182;79;51;123;136;180;99;189;121;100;55;187;169;49;14;138;81;90;106;111;148;83;89;186;151;133;63;185;3;1;135;22;18;199;160;34;192;42;161;74;152;179;2;48;177;43;105;35;166;72;162;116;24,6036436542572057619
steepest_intra:nodes_start:random,18,96529,46138,50391,1495014950,100001,43;5;41;139;115;118;23;89;183;144;90;165;14;49;167;80;68;140;108;22;146;34;54;48;160;181;42;149;135;158;53;86;44;120;101;121;180;154;63;176;186;15;148;31;56;113;59;193;159;199;18;69;36;93;117;143;9;62;52;145;78;129;1;97;100;26;171;175;16;25;137;0;46;51;124;106;178;3;152;94;151;162;133;79;55;119;40;185;57;92;2;75;70;127;123;112;184;131;65;116,1356601680873645589
steepest_intra:nodes_start:random,19,94144,44767,49377,1495014950,100001,106;160;54;48;195;22;146;116;47;131;149;123;135;63;137;23;143;117;0;46;93;140;68;43;184;4;112;127;70;97;152;167;148;49;52;55;179;145;78;25;75;86;53;154;79;122;80;15;9;62;124;94;42;5;181;41;193;183;89;186;57;92;129;2;176;51;59;65;35;84;177;34;159;18;139;115;118;151;133;180;100;26;101;1;120;44;16;175;171;31;165;7;164;90;40;185;144;14;178;162,108037988917369079
steepest_intra:nodes_start:random,20,94745,42715,52030,1495014950,100001,53;97;123;35;184;34;103;146;159;198;68;140;117;143;153;183;89;186;23;160;54;177;112;127;135;26;2;120;25;44;92;57;55;40;165;90;185;14;144;15;46;115;41;193;69;108;139;86;101;100;189;152;145;78;171;175;16;75;154;70;180;124;94;151;65;47;59;118;51;109;176;167;52;106;178;49;102;9;62;148;137;0;93;18;22;43;116;131;162;122;63;79;80;133;5;181;195;42;149;1,1824326410059941099
steepest_intra:nodes_start:random,21,115647,62273,53374,1495014950,100001,97;92;31;175;113;78;2;140;18;146;103;42;43;41;159;22;63;100;26;180;89;183;120;82;135;112;190;177;149;53;75;44;25;52;165;164;39;178;34;54;160;94;152;62;9;137;133;162;65;84;35;154;145;81;196;90;102;144;15;79;72;59;51;151;127;70;123;184;48;30;116;118;0;117;143;55;57;49;32;106;46;139;110;191;193;115;101;86;1;122;80;176;128;185;40;138;14;148;167;129,1876762537100634220
steepest_intra:nodes_start:random,22,102941,53691,49250,1495014950,100001,177;10;84;116;0;143;21;7;90;175;171;159;146;22;137;148;167;154;158;75;152;94;124;15;62;9;185;40;119;196;81;157;145;179;55;51;43;193;41;42;5;115;46;139;151;63;57;129;135;127;123;149;59;118;133;97;1;101;86;180;122;79;53;100;26;121;176;23;183;89;144;14;102;49;52;92;78;25;120;2;44;16;56;113;31;65;184;160;54;34;18;117;186;165;39;106;178;80;162;112,1803562214436309062
steepest_intra:nodes_start:random,23,96866,48426,48440,1495014950,100001,108;146;159;46;62;9;94;154;180;26;100;121;63;133;184;177;54;181;41;139;143;183;144;14;102;49;106;145;179;57;129;1;101;53;127;116;5;42;43;148;138;21;164;90;165;119;40;185;178;151;162;59;115;68;140;93;117;0;118;123;70;135;55;52;92;78;25;152;176;51;137;89;23;186;15;75;86;97;122;80;79;120;44;31;113;171;175;16;2;160;34;35;112;131;149;65;47;193;18;22,9057922047590761560
steepest_intra:nodes_start:random,24,157520,76279,81241,1495014950,100001,66;183;13;56;87;42;22;20;146;139;46;69;117;0;115;197;32;106;52;3;187;17;91;120;16;171;62;49;130;35;192;159;184;160;48;177;105;5;47;65;84;59;1;121;37;33;9;55;23;182;2;97;19;194;173;53;12;137;89;60;176;90;185;138;14;178;38;179;31;175;113;78;145;144;21;167;169;98;125;180;127;131;58;7;123;34;143;158;100;142;181;193;124;63;151;24;116;96;148;155,76585838145277357
steepest_intra:nodes_start:random,25,129360,70465,58895,1495014950,100001,138;115;18;159;42;48;190;54;180;52;106;32;165;92;1;101;120;82;129;170;117;122;123;177;30;160;118;78;16;175;171;44;108;67;133;121;186;114;15;40;119;113;56;100;86;131;116;46;191;41;193;181;51;176;80;26;136;59;34;22;146;96;140;183;23;137;79;182;94;178;57;55;0;143;179;145;152;158;154;135;53;162;43;65;60;109;151;62;155;95;185;2;97;63;148;144;102;14;49;139,2437230628235469936
steepest_intra:nodes_start:random,26,107212,54614,52598,1495014950,100001,193;117;89;12;135;127;0;143;46;177;10;54;184;30;160;65;15;37;9;49;3;106;14;73;132;102;124;148;55;196;81;157;16;44;25;75;1;86;100;121;92;52;178;185;145;78;31;113;175;171;120;97;152;133;79;70;34;22;108;140;118;53;57;129;2;101;154;112;190;43;115;139;62;144;40;169;179;90;165;167;94;151;176;51;137;183;23;5;42;162;180;136;63;80;66;59;123;116;41;18,5884756707747838923
steepest_intra:nodes_start:random,27,97905,48763,49142,1495014950,100001,176;120;44;75;86;158;154;59;116;43;42;65;149;123;70;121;165;39;8;119;40;185;138;14;114;89;183;143;117;51;151;162;135;180;53;97;2;178;106;179;78;145;63;133;127;112;84;4;79;94;129;92;7;164;21;144;49;102;62;9;15;139;115;41;193;22;18;108;68;46;80;152;25;16;56;81;90;27;196;171;175;113;31;57;52;55;167;148;118;34;54;160;184;26;1;186;23;0;137;101,1453092108626266469
steepest_intra:nodes_start:random,28,93437,44248,49189,1495014950,100001,123;186;15;9;144;62;148;46;115;96;41;193;198;139;68;117;0;23;137;176;80;124;167;52;165;90;81;92;152;51;59;116;47;35;84;190;10;177;54;34;181;22;18;108;159;42;65;158;53;86;75;101;1;26;63;79;43;160;184;70;135;180;154;127;131;149;162;151;133;121;97;2;31;113;175;171;16;44;25;120;93;140;143;183;185;119;40;196;145;78;178;14;49;106;55;57;94;112;4;118,4616710141794261172
steepest_intra:nodes_start:random,29,94165,44449,49716,1495014950,100001,70;112;84;35;131;149;75;16;171;175;113;177;54;48;34;181;160;184;123;127;194;135;154;53;97;55;52;124;94;63;121;1;2;185;40;90;165;49;80;151;162;133;79;92;145;179;186;23;89;183;59;65;47;43;116;0;143;117;46;118;51;176;144;14;138;3;178;106;57;129;101;86;100;26;152;167;102;62;9;148;137;68;108;18;193;41;5;96;115;139;159;22;146;42;180;120;78;31;25;44,8845246226205468244
steepest_intra:nodes_start:random,30,106843,53034,53809,1495014950,100001,52;167;178;14;8;81;196;145;92;135;154;53;158;180;72;59;149;151;79;63;176;43;160;34;137;23;40;185;31;16;78;129;152;123;10;177;54;133;122;19;189;100;101;97;26;124;94;51;193;41;159;22;139;0;170;89;15;62;9;143;117;118;162;86;1;179;90;165;55;80;184;84;127;70;75;44;120;57;102;49;144;183;93;140;68;46;115;65;35;112;131;47;116;77;42;146;181;148;106;2,830946222645396326
steepest_intra:nodes_start:random,31,93818,45435,48383,1495014950,100001,22;108;18;177;10;4;112;149;151;133;154;180;63;79;80;162;123;127;70;135;26;97;1;52;40;185;167;176;109;51;23;137;118;59;152;129;92;57;89;183;0;143;117;68;139;46;2;44;25;145;78;31;113;179;14;144;148;94;124;55;165;39;164;27;90;81;196;106;178;49;102;62;9;184;54;34;146;181;75;171;175;16;120;101;189;182;121;100;86;53;115;41;159;193;42;116;65;43;48;160,3083798638354116547
steepest_intra:nodes_start:random,32,129010,71626,57384,1495014950,100001,62;79;63;100;52;178;49;106;91;167;198;115;43;117;0;153;9;55;148;139;42;48;160;11;53;44;78;175;171;129;34;35;184;194;120;113;56;158;180;51;80;176;76;89;143;193;199;163;86;145;90;40;119;165;122;151;46;41;118;59;133;154;152;94;15;155;7;164;137;65;116;162;135;123;149;105;96;24;121;2;92;75;16;25;101;112;177;22;18;108;73;14;185;57;1;97;183;23;144;21,7564243015628196381
steepest_intra:nodes_start:random,33,206017,111737,94280,1495014950,100001,20;173;154;141;63;6;28;101;79;196;178;180;86;158;174;107;147;177;93;67;198;146;184;199;5;105;165;87;191;139;37;111;62;186;70;182;94;148;0;123;74;97;194;133;189;188;12;109;31;17;195;134;193;115;152;57;120;16;129;78;75;179;114;176;99;49;172;95;52;45;53;84;4;167;82;135;181;33;23;27;171;7;71;81;56;88;112;124;170;14;91;72;116;156;126;10;11;76;59;9,7677029663057380570
steepest_intra:nodes_start:random,34,92985,43216,49769,1495014950,100001,165;65;116;41;193;22;181;43;79;63;121;1;101;86;53;154;135;70;180;75;120;78;56;113;31;145;179;167;37;148;152;97;26;100;189;94;124;62;9;102;144;14;138;119;40;185;178;106;55;57;92;129;2;59;42;34;30;54;184;162;151;131;160;48;177;10;4;112;44;25;16;171;175;196;49;15;186;23;89;183;143;0;176;133;127;123;149;115;139;46;68;93;117;118;51;80;52;81;90;137,8880335336008443611
steepest_intra:nodes_start:random,35,101736,51059,50677,1495014950,100001,124;15;114;186;176;80;51;59;65;116;118;137;90;165;52;97;63;79;194;70;180;9;62;185;119;2;1;86;144;102;106;57;92;100;154;135;127;18;69;108;22;34;43;42;159;195;181;5;96;149;131;123;136;75;25;44;120;82;101;26;53;162;151;152;129;55;49;148;133;112;160;54;184;78;16;171;175;31;145;179;196;56;113;40;138;14;183;143;117;68;193;41;139;115;46;93;140;0;94;178,1448538796373085709
steepest_intra:nodes_start:random,36,110564,57914,52650,1495014950,100001,152;129;120;92;167;151;59;118;51;109;53;182;75;39;90;119;40;3;178;2;101;86;1;97;12;124;14;144;123;35;127;133;136;189;94;160;34;146;22;159;193;41;57;196;165;138;63;180;154;115;68;46;116;65;62;9;175;171;145;179;185;55;52;183;0;143;139;42;184;112;70;135;100;26;131;149;137;148;102;106;49;164;81;113;16;44;79;80;66;176;177;30;54;43;162;157;31;78;25;82,77788757636608105
steepest_intra:nodes_start:random,37,146198,78366,67832,1495014950,100001,30;138;49;152;92;55;82;179;133;42;43;5;121;1;26;101;87;185;119;3;106;182;123;126;135;180;176;143;65;159;197;189;97;167;137;4;54;48;28;184;158;111;144;132;14;154;63;124;53;40;196;169;18;22;96;194;78;171;175;88;16;113;31;17;145;2;94;41;146;103;115;166;116;149;139;193;195;108;0;12;62;114;198;142;34;112;23;148;151;79;15;183;130;80;162;59;10;160;181;120,3730614892565265302
steepest_intra:nodes_start:random,38,99143,45719,53424,1495014950,100001,70;135;154;158;75;129;57;193;181;146;34;159;22;18;139;86;1;167;62;102;144;15;9;80;176;51;66;122;133;180;53;52;185;40;81;31;175;56;113;171;196;49;183;143;46;118;43;116;42;54;177;160;184;123;162;151;79;94;124;186;23;137;97;101;189;63;127;112;35;149;59;115;41;96;5;77;65;105;131;121;100;111;37;148;178;179;145;92;78;16;25;120;44;2;26;152;14;165;106;55,204182609938996717
steepest_intra:nodes_start:random,39,135764,68211,67553,1495014950,100001,129;145;92;94;199;108;153;49;155;21;32;78;167;55;14;132;144;26;80;118;162;65;5;42;115;39;185;106;138;102;27;58;128;53;154;135;161;180;189;15;93;68;105;34;116;59;72;183;62;40;196;19;136;75;101;43;166;184;139;176;186;89;79;158;152;1;149;77;131;63;148;151;123;11;28;48;54;70;120;25;175;171;113;81;2;97;100;99;133;104;160;22;193;41;191;23;137;165;90;56,8337100658008786996
steepest_intra:nodes_start:random,40,101937,49018,52919,1495014950,100001,189;95;164;90;27;185;52;167;53;86;1;2;75;152;63;79;109;118;59;68;139;0;143;14;3;106;133;22;193;41;198;51;176;94;101;97;80;151;46;140;93;117;183;44;120;57;196;119;40;8;165;81;56;113;31;78;82;179;144;49;137;54;177;84;35;131;43;5;115;47;149;4;112;184;116;65;42;34;160;181;180;158;154;6;70;135;127;123;162;15;62;148;55;92;145;16;175;171;129;178,6415129280859764912
steepest_intra:nodes_start:random,41,96601,43355,53246,1495014950,100001,86;57;40;165;138;14;49;152;1;101;102;144;114;186;23;148;52;55;145;113;175;81;185;196;31;171;16;25;44;2;124;15;64;83;89;137;51;118;43;184;4;112;133;122;94;106;178;62;9;37;151;59;131;149;162;154;180;158;53;136;176;46;139;110;159;146;22;18;183;143;117;68;42;160;34;195;181;79;63;100;26;97;129;92;78;120;75;135;123;177;54;193;41;115;116;65;0;153;80;121,1804748014735284117
steepest_intra:nodes_start:random,42,104336,52275,52061,1495014950,100001,196;175;171;2;80;65;131;123;75;16;56;113;157;179;43;41;159;195;193;115;0;129;92;57;31;78;152;101;189;122;79;63;180;86;1;26;100;121;53;162;133;15;9;49;178;3;155;144;148;94;124;62;102;119;185;23;183;89;114;14;138;21;164;95;186;137;176;151;118;59;51;46;139;18;22;34;116;149;70;55;52;39;106;97;112;184;42;160;84;4;135;154;120;44;25;145;40;90;165;81,8127847432153408906
steepest_intra:nodes_start:random,43,101550,51464,50086,1495014950,100001,86;101;97;136;79;133;162;160;34;54;177;135;75;120;44;165;90;40;118;5;42;65;47;116;59;80;176;63;70;194;149;43;115;139;22;159;46;9;49;138;106;178;124;94;131;41;193;18;69;68;62;144;14;1;26;137;89;183;186;15;129;78;145;25;16;179;57;55;3;52;31;175;171;113;100;53;127;112;84;184;123;154;180;152;167;21;7;164;95;185;92;2;151;51;153;143;117;0;23;148,7174441128586074208
steepest_intra:nodes_start:random,44,100448,51791,48657,1495014950,100001,15;186;51;118;151;63;100;26;97;94;122;79;133;59;115;139;108;18;159;193;41;80;124;49;102;137;46;5;42;43;184;160;34;22;181;116;175;113;31;152;121;53;180;158;86;165;39;90;40;119;65;54;177;112;123;55;52;178;106;138;7;164;21;176;131;149;162;101;120;44;25;23;0;143;183;89;179;145;78;92;167;148;9;62;57;129;2;1;154;135;127;70;75;16;171;81;196;185;14;144,6743910602422276823
steepest_intra:nodes_start:random,45,98849,49361,49488,1495014950,100001,175;171;70;65;41;22;146;181;34;43;47;149;131;186;164;58;7;144;154;180;53;100;121;79;133;151;42;48;54;160;184;84;112;148;37;55;52;124;94;176;162;123;127;135;120;44;25;179;145;196;81;90;40;165;185;57;129;82;2;97;1;86;101;152;167;14;49;102;51;59;116;115;118;92;78;31;157;75;26;183;89;143;139;193;159;18;108;46;0;15;106;178;62;9;23;137;80;63;16;113,426819661932469127
steepest_intra:nodes_start:random,46,106856,55514,51342,1495014950,100001,48;54;34;193;159;68;0;89;129;78;145;16;113;44;100;79;59;143;117;18;22;42;135;53;121;101;120;31;157;171;175;9;62;185;165;138;144;183;139;65;47;90;27;164;21;37;131;149;162;86;75;119;40;57;94;133;51;151;80;176;180;154;158;26;97;1;152;124;198;115;116;112;123;2;92;179;81;196;178;106;55;52;63;136;122;137;114;49;14;148;23;118;46;41;5;105;43;184;160;177,829940126720139555
steepest_intra:nodes_start:random,47,89128,36885,52243,1495014950,100001,2;158;154;180;94;124;15;186;23;89;183;143;46;139;115;138;165;119;40;185;145;78;44;75;86;127;112;177;30;54;184;149;123;162;133;63;152;16;171;175;113;56;31;167;148;62;9;144;90;81;157;196;91;179;106;3;32;14;49;176;80;79;135;70;53;182;121;100;97;1;101;26;136;151;41;193;18;108;117;0;118;116;43;160;34;42;65;59;51;137;102;178;52;55;57;92;129;82;25;120,1152309509892720109
steepest_intra:nodes_start:random,48,103945,51067,52878,1495014950,100001,5;47;118;51;109;122;79;57;106;138;178;148;152;129;179;165;39;119;31;16;113;101;53;133;93;108;18;139;151;63;80;62;49;102;144;23;46;198;4;112;154;136;182;86;94;59;115;193;160;48;43;35;84;123;180;55;52;185;90;58;164;14;40;145;120;44;25;2;75;1;26;97;78;92;143;117;68;22;34;30;54;184;42;159;41;181;162;70;135;127;149;131;65;116;176;137;183;0;69;146,4666578801975074263
steepest_intra:nodes_start:random,49,103038,52893,50145,1495014950,100001,112;184;35;149;151;152;97;51;46;41;159;22;34;123;194;55;52;14;144;9;80;176;133;79;63;124;94;2;16;171;175;113;31;92;118;47;65;131;127;154;165;164;21;62;137;116;43;108;18;115;162;161;180;121;26;90;27;40;196;78;82;120;86;75;44;185;3;106;178;49;148;167;129;57;179;145;25;158;53;100;1;101;54;48;160;23;186;89;183;143;42;181;193;139;117;0;68;59;135;70,3474573431967337947
steepest_intra:nodes_start:random,50,124121,64174,59947,1495014950,100001,21;37;19;97;75;158;136;80;116;34;30;160;65;197;51;141;94;185;196;178;137;118;151;41;46;198;63;100;3;106;62;152;176;131;166;117;143;183;0;115;123;162;154;86;53;135;127;180;177;139;193;159;186;31;78;92;18;22;96;42;5;59;95;71;49;55;145;57;82;87;133;161;184;28;48;79;121;26;124;2;120;129;14;138;90;39;7;164;144;1;101;44;113;175;16;171;157;169;165;40,5365996982018888818
steepest_intra:nodes_start:random,51,115778,61138,54640,1495014950,100001,34;160;184;123;154;23;137;63;53;152;97;47;116;149;112;70;1;75;101;86;176;80;122;94;189;133;79;16;171;145;57;179;113;31;78;100;151;68;193;159;5;65;183;89;144;185;55;102;15;199;18;69;20;108;139;140;93;46;115;59;105;162;62;9;148;0;117;153;143;60;118;51;128;49;138;180;135;4;166;43;124;129;2;44;120;92;106;14;42;195;22;41;3;164;90;165;40;178;52;54,7960110976392345112
steepest_intra:nodes_start:random,52,93530,44553,48977,1495014950,100001,137;35;184;190;10;177;54;48;160;34;181;42;116;16;171;175;113;31;92;143;117;139;193;41;5;43;131;123;127;70;135;53;152;57;106;178;144;186;0;46;198;115;118;51;94;55;52;49;9;62;185;40;145;78;25;44;120;129;2;75;101;86;100;133;59;159;22;18;108;68;176;196;81;90;165;138;14;102;148;124;79;151;65;47;149;162;121;26;1;97;158;154;180;63;122;80;89;183;23;112,4392729678743241679
steepest_intra:nodes_start:random,53,106830,54108,52722,1495014950,100001,62;22;146;159;41;140;93;193;34;54;123;162;151;133;182;57;92;44;112;84;43;176;9;21;95;40;101;86;70;135;79;94;52;164;58;90;81;179;145;2;97;75;120;78;171;16;175;31;113;196;165;8;49;117;68;115;184;48;160;183;89;170;46;139;42;116;65;59;63;26;111;14;138;185;106;102;37;12;124;189;152;167;148;23;186;178;55;1;53;180;154;80;137;143;0;51;100;129;3;144,401559937011315029
steepest_intra:nodes_start:random,54,101340,49952,51388,1495014950,100001,52;55;165;119;40;160;34;146;22;193;159;18;46;23;183;89;112;35;123;162;117;143;0;115;43;118;109;51;178;196;179;57;124;94;122;63;77;5;96;41;116;65;49;14;138;106;185;145;171;175;16;44;2;70;127;4;177;184;139;68;137;62;9;102;144;21;7;90;81;31;78;80;42;181;47;59;72;176;148;92;120;75;86;101;97;121;53;26;100;1;79;133;151;149;131;135;154;180;152;129,1677633749426893350
steepest_intra:nodes_start:random,55,117500,59373,58127,1495014950,100001,54;160;152;57;31;78;129;97;121;26;53;180;135;154;44;82;2;1;75;120;145;92;138;7;164;52;55;102;148;124;80;79;101;86;158;162;109;176;141;60;65;115;137;15;114;94;149;112;35;68;183;62;14;21;40;185;195;22;41;116;77;72;151;19;100;9;144;49;106;178;10;184;131;123;133;122;63;23;89;143;0;42;43;34;181;18;108;140;186;73;39;95;165;118;139;59;51;46;193;190,1127749861967316862
steepest_intra:nodes_start:random,56,106779,56855,49924,1495014950,100001,68;23;9;62;106;196;40;185;178;144;65;48;34;160;4;112;118;137;129;52;57;25;44;171;78;75;86;100;145;31;16;113;175;55;148;79;133;122;63;167;37;0;117;143;183;89;186;151;47;116;59;97;101;176;193;41;139;115;51;80;94;53;158;180;195;146;103;22;159;43;131;127;154;2;92;120;123;184;177;54;181;108;18;46;49;14;58;164;165;90;124;189;135;70;26;152;1;162;5;42,2322616391552326865
steepest_intra:nodes_start:random,57,102391,52473,49918,1495014950,100001,177;84;135;86;57;55;52;106;178;143;117;159;195;41;115;27;90;165;94;42;160;181;43;65;59;118;136;121;102;138;40;119;185;101;53;180;154;123;35;112;127;133;151;122;79;63;97;75;44;25;120;1;26;100;129;92;145;31;78;51;139;69;18;0;183;148;111;167;9;49;144;114;89;176;162;149;184;10;54;34;22;193;46;80;152;2;16;175;113;171;81;164;7;21;14;62;186;137;116;190,504052398420858989
steepest_intra:nodes_start:random,58,94488,45712,48776,1495014950,100001,154;131;146;22;18;108;139;53;100;57;179;92;2;75;101;97;1;4;177;190;112;162;80;62;144;14;165;90;27;196;31;56;175;113;120;79;133;151;63;16;171;25;44;78;145;129;167;37;148;152;94;176;59;47;116;72;51;137;23;89;183;186;15;119;81;40;185;106;178;52;55;49;102;9;118;43;160;34;181;159;193;41;115;46;117;143;0;26;86;70;127;184;54;48;42;65;149;135;180;123,2052326255694128371
steepest_intra:nodes_start:random,59,135225,68700,66525,1495014950,100001,90;17;196;154;161;149;180;86;157;145;92;49;32;179;127;135;72;118;51;115;116;65;139;143;43;197;137;102;52;55;31;16;171;99;151;162;130;189;15;124;152;44;175;198;46;68;0;41;42;59;126;112;184;123;84;54;69;18;108;199;36;191;60;158;101;120;160;146;94;80;12;63;53;182;25;56;113;78;97;1;185;7;3;178;14;95;58;165;106;91;40;144;62;176;34;181;5;193;28;82,9008415348466030902
steepest_intra:nodes_start:random,60,90378,40525,49853,1495014950,100001,31;196;179;92;23;183;89;15;144;21;95;39;57;152;112;35;162;79;185;40;52;55;145;78;25;44;75;101;124;148;49;3;106;178;2;1;97;94;80;176;51;151;133;63;100;26;86;53;180;154;135;70;127;123;149;131;65;116;68;117;143;62;9;14;165;90;27;164;0;46;5;43;184;177;54;48;34;146;22;181;160;42;139;198;118;72;59;115;41;159;193;137;167;129;120;16;171;175;113;56,499326862438777726
steepest_intra:nodes_start:random,61,100625,48526,52099,1495014950,100001,162;131;123;127;4;112;35;149;105;96;193;22;195;181;77;43;72;145;25;2;176;137;144;14;9;49;185;78;175;113;31;171;16;57;55;178;106;52;135;177;184;84;180;75;92;40;119;165;63;65;5;42;159;34;48;54;160;139;41;18;108;68;94;120;44;82;129;152;26;100;86;97;101;1;122;151;133;79;80;51;118;59;170;143;153;0;183;89;186;148;62;23;115;46;117;140;53;154;70;116,8104064127338562340
steepest_intra:nodes_start:random,62,90365,40546,49819,1495014950,100001,106;178;52;55;152;121;127;112;4;177;184;160;34;181;43;47;116;42;5;46;137;14;138;165;185;101;26;100;80;51;109;118;59;151;63;78;145;196;119;40;167;148;124;94;189;97;1;81;90;27;164;21;144;15;23;186;9;62;102;49;176;149;131;65;115;139;159;22;18;108;193;41;123;70;75;120;44;25;16;171;175;113;31;89;183;143;0;79;180;154;135;194;162;133;53;86;2;129;92;57,6694109706333883257
steepest_intra:nodes_start:random,63,105772,52571,53201,1495014950,100001,198;118;51;137;23;176;65;184;177;54;149;133;121;97;1;94;124;63;122;53;154;136;148;3;178;185;106;72;59;116;162;2;120;175;113;31;145;78;44;135;70;144;49;14;102;89;140;93;117;186;114;62;9;40;119;81;90;165;52;57;92;86;26;100;79;151;139;22;146;181;160;4;123;55;138;164;95;21;183;170;153;143;0;80;158;180;127;112;10;34;42;43;115;41;193;101;75;152;46;68,3971373591731215767
steepest_intra:nodes_start:random,64,106084,54007,52077,1495014950,100001,39;71;164;21;117;115;105;151;80;100;75;121;53;70;123;194;135;19;152;78;92;129;43;65;72;186;114;23;15;137;124;55;52;178;106;49;62;9;101;97;26;180;63;46;41;42;184;4;112;154;16;157;56;171;175;113;31;116;193;22;146;34;181;160;118;51;0;143;183;89;176;79;86;57;179;145;139;69;18;59;44;120;25;82;2;1;127;149;162;133;122;94;167;148;144;14;185;40;165;90,3056173185330142282
steepest_intra:nodes_start:random,65,100364,49919,50445,1495014950,100001,137;22;18;108;139;26;97;1;152;167;148;124;35;177;54;160;34;181;41;193;118;133;79;80;51;59;116;43;42;113;175;171;16;25;44;112;84;184;115;0;89;23;15;9;185;40;138;49;102;62;176;66;109;151;162;123;127;70;135;154;180;63;122;94;55;165;90;196;101;100;149;131;53;2;129;92;52;178;3;106;14;144;183;143;117;93;140;68;46;65;47;121;86;75;120;78;145;57;186;159,2626882685084625495
steepest_intra:nodes_start:random,66,138999,70614,68385,1495014950,100001,167;63;158;153;163;108;18;54;112;173;49;81;78;92;129;183;141;105;35;10;4;123;97;101;189;79;53;152;74;157;174;40;90;119;178;109;160;193;41;118;94;16;56;31;106;89;0;68;28;166;180;136;120;145;57;55;46;159;29;154;176;23;137;148;61;15;186;144;102;113;175;185;128;51;59;143;170;99;26;122;65;84;80;133;116;42;181;48;184;43;72;151;139;115;135;1;87;111;62;162,4771162806038895846
steepest_intra:nodes_start:random,67,110740,57598,53142,1495014950,100001,123;135;154;53;182;80;176;151;133;1;92;55;180;70;5;96;115;16;81;90;27;165;144;15;65;42;184;4;127;24;143;0;153;183;140;93;181;160;48;84;75;120;56;113;157;179;145;78;196;185;40;148;37;62;102;9;63;122;137;51;118;79;152;2;167;68;139;193;34;22;117;46;116;43;59;100;101;149;77;41;18;159;162;31;175;171;44;86;26;97;14;32;138;106;49;178;52;57;129;94,2867900548864608464
steepest_intra:nodes_start:random,68,133607,71261,62346,1495014950,100001,52;179;49;144;102;111;176;59;151;57;31;92;55;148;89;183;143;117;46;121;99;158;180;68;140;163;22;10;4;97;78;44;53;63;94;9;62;5;42;43;80;79;19;51;161;123;109;115;139;14;39;81;196;100;162;65;195;18;69;36;101;152;149;47;84;154;86;25;113;16;135;122;186;23;193;159;108;41;133;194;173;182;120;171;175;56;106;178;118;116;0;15;165;185;145;1;137;153;170;82,4920367281462254271
steepest_intra:nodes_start:random,69,92583,41653,50930,1495014950,100001,40;119;185;129;152;94;80;118;139;68;46;137;138;165;90;145;78;92;57;55;52;106;3;178;122;133;112;4;10;177;54;160;34;181;42;43;116;65;59;151;79;63;136;121;100;101;75;86;154;123;149;131;184;35;127;70;135;162;115;41;193;159;18;22;146;180;53;44;175;171;16;25;120;2;1;140;93;117;102;14;144;183;143;0;109;51;176;148;9;167;97;26;124;15;114;89;23;186;62;49,7552501091742809023
steepest_intra:nodes_start:random,70,100274,50410,49864,1495014950,100001,165;106;127;112;4;84;22;69;108;18;115;51;137;23;148;152;25;16;175;171;44;129;55;178;14;102;167;101;86;70;42;5;80;94;124;59;43;160;34;139;46;68;193;159;41;9;62;52;185;179;92;154;194;123;149;105;116;151;133;97;2;57;164;7;27;90;81;113;31;78;145;120;75;1;180;79;162;65;131;48;181;118;176;122;63;121;53;135;54;177;184;0;170;117;143;183;49;144;138;40,7468275499218041019
steepest_intra:nodes_start:random,71,131620,68503,63117,1495014950,100001,39;174;90;7;106;129;44;113;144;33;148;114;42;198;176;137;183;163;159;41;108;18;0;62;155;164;95;52;124;133;184;30;35;135;180;189;94;2;145;171;55;19;152;57;92;97;63;24;77;192;22;195;193;59;151;162;149;123;154;16;56;140;139;109;12;38;81;40;75;82;120;14;178;165;25;101;65;160;177;48;54;104;84;43;34;116;80;23;186;86;53;136;47;105;197;115;49;185;78;31,4747792415985093583
steepest_intra:nodes_start:random,72,87473,35310,52163,1495014950,100001,152;2;16;171;175;113;56;31;157;169;119;40;185;91;145;82;120;44;25;78;196;81;90;39;165;106;178;1;101;86;97;167;148;137;143;93;108;18;22;34;160;193;41;139;46;183;89;23;186;15;14;138;3;179;92;75;53;154;180;9;62;144;102;49;52;55;57;129;124;176;118;115;68;117;0;94;189;26;100;121;63;65;116;149;123;135;127;112;184;42;43;162;133;79;80;151;72;59;51;122,3057141174686118714
steepest_intra:nodes_start:random,73,117151,62038,55113,1495014950,100001,114;175;31;81;92;144;151;162;160;197;109;51;59;118;176;148;23;137;2;120;44;25;3;49;124;94;189;123;177;184;35;154;180;136;105;116;131;135;129;82;75;79;65;115;42;41;43;122;86;101;1;97;80;193;22;68;62;52;185;119;32;14;9;55;165;89;186;178;40;7;58;27;90;145;78;16;113;171;196;39;106;152;133;112;54;146;139;170;117;0;46;48;34;181;195;63;182;53;183;143,8442850523544388390
steepest_intra:nodes_start:random,74,115855,63980,51875,1495014950,100001,154;195;5;65;77;59;106;178;14;144;102;49;185;165;119;40;139;193;115;51;97;152;1;63;133;79;116;42;160;177;184;70;135;123;127;100;75;25;56;31;78;117;143;183;57;145;113;175;148;37;62;15;137;43;35;84;112;4;53;189;19;80;176;94;9;23;0;108;18;179;196;92;121;180;158;162;41;159;22;181;149;26;2;120;44;82;52;55;129;16;88;171;90;164;46;118;151;101;86;34,6902703447345148732
steepest_intra:nodes_start:random,75,125703,70128,55575,1495014950,100001,34;90;165;119;92;42;41;181;48;160;184;194;63;49;14;62;52;129;167;144;9;116;22;110;93;140;108;18;0;21;132;170;143;176;135;180;154;53;86;44;16;175;171;120;101;1;122;193;159;123;151;59;118;51;133;100;75;25;78;185;40;80;115;139;68;153;117;46;96;43;47;65;57;145;2;26;162;149;131;89;183;148;97;152;79;94;12;111;23;186;102;138;55;106;178;137;109;190;30;164,1774830996758235471
steepest_intra:nodes_start:random,76,111368,56932,54436,1495014950,100001,149;47;176;106;178;152;154;65;42;59;121;97;1;40;185;81;175;171;44;101;86;53;180;112;4;5;43;109;51;148;94;79;80;137;14;102;179;31;56;145;49;21;73;15;9;62;63;133;151;162;194;122;120;2;117;143;183;144;95;165;52;92;129;25;135;24;123;105;139;108;163;69;22;48;70;75;16;113;78;57;124;46;140;68;18;193;41;160;35;84;184;116;115;195;103;34;177;54;131;127,8090898514007251875
steepest_intra:nodes_start:random,77,205836,110937,94899,1495014950,100001,180;23;108;192;182;71;7;86;45;149;184;30;10;47;104;162;120;168;196;110;18;93;198;160;28;90;61;102;42;67;131;78;145;111;14;3;16;25;37;63;89;155;64;98;88;179;170;183;139;123;153;178;44;50;130;33;82;186;144;74;121;142;105;83;52;148;152;49;43;161;117;0;193;103;146;22;94;59;40;91;31;13;185;132;39;128;167;11;166;197;92;188;58;189;15;199;127;151;124;95,1325525195966358457
steepest_intra:nodes_start:random,78,141396,79939,61457,1495014950,100001,52;82;136;79;53;6;135;133;137;9;14;160;43;7;21;191;139;78;196;157;185;178;184;54;177;112;156;94;3;128;89;176;51;26;75;101;120;57;129;121;158;41;22;103;146;151;80;123;70;16;175;145;2;97;152;74;64;83;65;35;161;86;40;90;46;115;5;116;63;1;106;165;144;183;23;114;102;148;197;42;195;193;62;49;55;180;154;194;162;72;0;117;186;92;44;171;118;198;59;31,4996630048648464974
steepest_intra:nodes_start:random,79,106432,54652,51780,1495014950,100001,154;120;25;40;165;102;114;15;52;8;27;90;2;101;180;63;182;97;92;39;95;7;21;183;117;140;18;159;184;35;112;149;116;41;181;42;34;54;30;177;48;160;162;79;94;124;148;49;62;167;121;26;1;196;119;185;189;123;65;43;137;138;14;81;31;171;175;78;178;106;144;9;176;51;59;5;195;22;115;118;135;127;151;133;86;75;44;145;113;16;46;193;139;80;55;57;179;129;152;53,6250208487075582943
steepest_intra:nodes_start:random,80,100767,49604,51163,1495014950,100001,46;118;51;176;80;148;106;178;167;101;1;189;63;79;94;49;102;3;185;40;138;144;14;57;92;53;180;133;151;96;42;116;145;78;196;157;85;31;113;56;175;171;16;120;26;68;18;69;159;193;160;10;177;54;184;115;139;198;59;97;100;152;2;75;86;70;127;135;158;179;81;90;165;15;41;22;34;181;43;65;183;89;129;44;25;55;52;137;72;131;149;123;162;154;121;9;62;143;117;0,7988936884711824188
steepest_intra:nodes_start:random,81,92649,41956,50693,1495014950,100001,9;102;94;79;80;117;93;68;43;42;160;34;181;51;176;186;183;89;114;144;62;15;46;139;115;116;149;65;41;193;159;22;54;30;177;184;123;162;122;189;44;25;16;171;175;78;75;101;97;81;90;164;7;165;119;40;185;180;154;53;152;2;120;55;52;3;106;32;138;14;178;26;100;1;86;70;135;127;0;143;23;137;118;59;151;133;63;82;113;56;31;145;179;92;129;57;167;124;148;49,6119638932455927715
steepest_intra:nodes_start:random,82,96492,45945,50547,1495014950,100001,123;127;135;154;180;122;63;75;44;145;179;185;106;178;57;171;16;120;101;100;1;86;26;121;149;131;65;46;117;143;93;18;199;108;69;80;79;97;2;129;78;175;113;31;196;3;137;23;22;160;34;181;5;42;47;59;118;115;139;51;176;102;49;165;119;40;52;55;167;9;62;15;148;124;94;158;53;152;144;14;7;164;90;92;116;48;54;184;43;0;89;186;183;68;159;41;193;162;133;151,1250878855998991458
steepest_intra:nodes_start:random,83,106216,54328,51888,1495014950,100001,78;92;82;1;97;26;154;70;127;123;148;62;9;185;40;196;167;23;183;0;151;79;194;135;158;182;133;59;47;5;159;22;193;41;180;53;101;2;57;138;14;49;178;129;152;121;72;139;191;68;96;43;118;80;176;51;46;115;116;149;162;75;120;145;55;52;89;143;117;18;34;160;184;35;137;144;7;164;165;94;65;181;42;25;16;171;175;113;31;179;3;106;63;84;190;54;177;112;86;44,3489860913107400565
steepest_intra:nodes_start:random,84,117932,63889,54043,1495014950,100001,112;70;31;113;175;120;124;133;80;115;198;162;97;26;56;171;106;102;9;55;44;78;16;25;1;101;75;100;86;160;181;41;149;47;59;151;137;148;144;0;139;46;62;165;40;39;51;193;18;69;49;14;135;84;190;177;10;48;42;154;180;152;167;3;57;185;178;52;2;53;136;94;122;63;92;129;19;12;176;116;65;131;123;145;179;79;118;5;184;30;54;34;103;195;22;183;114;186;23;43,5481144274475130474
steepest_intra:nodes_start:random,85,94731,44441,50290,1495014950,100001,158;70;135;52;164;7;21;144;51;35;184;41;193;159;18;139;148;165;27;90;40;185;55;57;92;129;2;152;100;26;97;1;86;53;180;63;79;176;80;122;94;120;44;16;171;175;113;31;25;75;131;43;42;5;181;160;177;54;34;146;22;116;162;151;124;167;106;178;14;49;133;127;123;149;59;118;183;89;186;23;65;47;77;105;115;46;0;114;62;9;15;143;117;137;179;145;78;82;101;154,2025829933876703550
steepest_intra:nodes_start:random,86,105854,55782,50072,1495014950,100001,22;118;115;117;143;137;122;79;63;151;51;68;108;18;139;62;9;14;144;49;189;154;180;43;5;89;23;114;186;15;148;176;80;116;105;65;159;193;94;90;39;40;165;3;52;185;196;81;57;129;55;167;41;181;42;2;179;106;178;58;164;100;53;182;1;75;78;113;175;31;44;25;120;92;145;171;16;70;4;112;123;133;162;72;46;0;183;152;97;101;86;26;135;127;184;54;160;34;146;59,7916915353518555963
steepest_intra:nodes_start:random,87,175594,93019,82575,1495014950,100001,135;115;116;96;5;177;4;34;146;151;123;127;184;43;15;58;17;150;68;153;182;161;156;103;160;195;193;119;188;38;95;32;57;44;125;118;149;9;145;52;133;66;183;61;90;82;136;45;137;198;143;144;128;16;113;106;176;24;70;8;175;91;120;1;180;63;65;30;117;46;14;187;56;13;155;108;93;140;164;55;178;49;64;148;130;121;158;79;21;185;78;25;92;74;171;167;109;51;139;190,4059323271389662254
steepest_intra:nodes_start:random,88,105359,53287,52072,1495014950,100001,79;133;151;118;68;46;0;124;121;70;54;34;160;181;22;20;18;117;165;40;92;49;62;183;143;59;162;127;154;180;63;176;186;3;106;185;8;178;9;80;72;41;193;139;52;55;57;78;145;56;113;175;171;16;25;44;75;120;129;157;31;196;81;90;144;89;137;53;136;158;65;115;5;116;131;47;146;159;42;105;43;109;94;152;97;1;2;101;86;135;149;35;112;148;14;102;51;184;84;123,1700125136613827398
steepest_intra:nodes_start:random,89,97362,47869,49493,1495014950,100001,72;65;116;59;63;189;82;120;79;41;193;159;22;18;183;102;40;119;25;44;101;131;184;160;42;43;149;53;100;26;86;97;1;2;129;179;185;178;152;154;180;123;112;177;54;34;181;115;89;23;113;175;171;16;75;51;118;139;140;68;46;127;70;135;162;151;133;80;176;153;143;117;0;94;124;167;165;90;81;196;31;56;78;145;92;148;186;114;15;9;62;49;55;57;52;106;3;14;144;137,7647358463811097895
steepest_intra:nodes_start:random,90,226290,127251,99039,1495014950,100001,50;33;131;95;119;155;178;32;195;30;177;46;26;108;20;54;4;62;174;59;83;67;198;162;199;172;132;7;70;64;44;88;187;38;106;24;65;28;35;112;127;82;109;137;196;150;120;157;2;194;25;85;165;40;87;189;145;61;89;123;118;141;197;185;56;1;92;158;152;154;111;21;72;115;81;144;186;12;69;160;163;79;121;149;66;98;23;29;74;179;133;94;126;97;148;41;166;129;76;48,4787567980190238877
steepest_intra:nodes_start:random,91,108641,55222,53419,1495014950,100001,180;100;120;113;175;178;144;49;14;55;52;8;165;185;39;106;133;118;115;149;35;123;151;63;152;9;62;176;72;34;181;146;65;59;46;68;137;162;184;54;160;190;112;101;92;78;31;40;27;90;114;153;0;22;103;195;42;77;116;41;193;110;51;80;53;1;124;94;183;93;117;163;108;18;140;143;89;148;158;154;131;43;105;5;159;139;79;26;2;16;171;44;75;86;97;57;145;179;129;135,6816179059161741382
steepest_intra:nodes_start:random,92,101270,47240,54030,1495014950,100001,75;2;16;175;25;44;121;137;183;23;153;170;0;139;22;159;96;115;47;116;43;123;135;70;184;30;54;18;108;140;143;186;148;167;165;90;27;138;32;102;144;40;185;106;114;46;193;41;34;160;42;101;120;129;152;133;79;127;162;59;65;149;131;92;57;31;78;145;179;55;49;62;9;15;14;178;52;97;1;26;86;100;124;94;12;80;151;72;63;53;180;154;158;182;122;51;176;171;113;56,6945386075037875534
steepest_intra:nodes_start:random,93,105287,54786,50501,1495014950,100001,34;195;159;46;143;0;15;144;14;49;26;53;186;183;89;23;124;92;171;16;44;9;102;62;59;41;115;65;154;1;179;185;106;178;3;80;42;22;193;18;108;139;68;117;137;148;12;121;136;135;70;97;2;129;55;119;40;52;167;63;116;43;118;133;123;35;184;51;151;162;161;180;101;25;78;145;81;31;175;113;56;120;75;86;160;177;190;4;127;79;94;152;57;165;90;164;21;176;149;131,5107654485418768489
steepest_intra:nodes_start:random,94,93771,42161,51610,1495014950,100001,22;65;149;131;162;16;56;157;31;113;175;171;78;145;14;144;9;62;148;167;152;124;176;151;70;135;158;53;136;122;94;121;26;100;86;101;57;106;178;3;49;137;68;140;139;41;34;48;184;84;112;123;194;154;75;120;44;40;165;185;102;15;143;117;93;0;183;89;46;160;54;177;127;180;63;79;80;51;59;116;43;5;96;42;115;118;1;2;129;92;52;55;97;133;193;159;108;69;18;181,3625300694607997774
steepest_intra:nodes_start:random,95,85235,36069,49166,1495014950,100001,56;175;171;16;31;129;2;1;101;75;86;53;158;180;154;135;70;127;162;133;79;63;52;55;57;179;145;92;152;80;51;115;193;159;41;96;5;42;181;160;48;30;54;184;43;139;69;108;18;34;177;4;112;123;65;59;118;46;68;22;146;116;151;40;119;185;106;178;49;62;9;148;23;137;176;121;100;26;97;189;94;124;102;14;144;89;183;143;117;0;120;44;25;78;196;165;27;90;81;113,1404279877563895832
steepest_intra:nodes_start:random,96,108930,55403,53527,1495014950,100001,63;80;198;46;118;176;153;143;0;51;151;86;75;120;44;92;178;102;144;122;154;180;109;42;184;54;30;22;18;69;185;39;90;40;119;183;68;139;96;41;159;193;34;35;72;137;15;31;113;175;16;171;145;129;78;81;196;165;95;58;164;52;152;53;189;97;100;123;127;135;70;24;59;89;49;106;14;62;115;43;116;65;149;131;77;181;160;121;101;1;57;55;94;133;162;190;177;84;79;148,7556528934198911843
steepest_intra:nodes_start:random,97,107710,56219,51491,1495014950,100001,31;25;180;70;158;53;86;92;57;129;44;120;106;102;15;18;22;48;177;54;160;118;80;189;94;51;115;42;41;68;46;139;116;65;43;77;148;185;119;40;145;75;100;135;127;4;112;84;35;184;79;2;152;193;146;34;165;95;90;81;178;55;124;122;63;121;196;113;16;171;78;1;97;183;143;0;59;131;149;47;123;24;194;154;101;26;176;137;23;186;49;14;144;62;9;162;151;133;52;175,7937878780937348134
steepest_intra:nodes_start:random,98,100452,48881,51571,1495014950,100001,8;3;55;57;92;31;171;16;25;59;43;42;5;65;180;53;121;100;1;97;101;26;118;115;41;159;181;193;108;18;22;34;160;184;84;123;162;133;106;165;90;113;175;129;89;183;143;176;80;37;14;21;114;116;4;112;70;2;179;196;81;40;119;138;178;63;194;127;135;154;86;75;120;44;82;78;145;152;182;151;51;15;144;49;102;137;46;139;0;186;9;62;148;122;79;94;124;167;52;185,3705786182971376795
steepest_intra:nodes_start:random,99,102027,51780,50247,1495014950,100001,49;62;14;90;165;144;114;199;18;108;69;117;143;0;183;148;97;2;129;57;196;81;145;55;52;178;106;15;89;23;186;185;40;179;92;78;157;31;133;123;65;47;84;112;120;25;82;101;176;115;159;22;193;139;198;59;151;180;100;86;154;162;46;68;80;63;182;53;136;135;127;70;121;26;79;51;118;43;42;41;140;93;137;94;152;1;75;44;175;113;171;16;184;54;34;181;160;116;167;9,128762642971749124
steepest_intra:nodes_start:random,100,183880,83578,100302,1495014950,100001,131;60;170;55;8;154;180;158;128;136;19;130;31;113;119;167;183;125;62;9;15;109;141;66;194;193;159;166;77;177;147;4;42;74;152;92;153;76;63;50;175;56;13;185;49;148;68;67;151;87;25;182;80;117;114;72;5;160;30;162;59;20;108;134;191;33;38;91;150;84;126;123;146;47;45;122;23;178;187;165;102;132;155;189;53;75;171;52;27;71;95;88;82;70;192;142;184;176;79;186,6826382892199911960
steepest_intra:nodes_start:random,101,97036,45126,51910,1495014950,100001,18;22;34;160;184;127;70;154;158;136;152;145;196;40;9;114;183;117;170;0;68;46;198;118;80;63;94;55;179;78;120;135;151;116;131;44;25;82;101;26;167;52;81;56;113;31;175;171;16;75;86;100;189;121;97;1;2;106;178;3;138;49;14;144;62;102;39;165;90;185;129;53;123;112;4;42;5;43;65;59;51;109;137;23;186;143;139;159;193;115;180;57;92;148;176;79;133;162;41;108,1716217263360305154
steepest_intra:nodes_start:random,102,89808,42020,47788,1495014950,100001,44;120;75;86;180;133;151;162;53;101;2;55;178;106;152;97;1;100;26;94;124;14;21;7;164;39;165;40;185;63;127;112;4;123;62;9;89;183;143;0;23;186;15;148;137;176;80;79;129;78;145;92;57;49;144;46;115;65;116;5;159;69;108;18;22;146;34;48;54;177;84;135;154;70;184;160;181;42;43;131;149;51;118;59;96;41;193;139;68;93;117;52;31;113;196;90;81;175;171;16,652363173101845264
steepest_intra:nodes_start:random,103,101408,53089,48319,1495014950,100001,25;75;158;162;123;127;70;63;94;129;57;124;79;80;176;137;183;89;14;49;151;118;116;30;54;112;53;121;100;97;152;26;86;101;1;2;165;40;119;185;179;31;113;175;171;159;22;18;108;193;139;115;44;120;145;92;178;15;23;186;51;59;42;41;68;0;164;90;81;196;154;180;135;184;177;10;48;34;160;43;47;65;148;144;102;9;62;3;106;52;55;167;133;149;131;46;117;143;78;16,140099850614699646
steepest_intra:nodes_start:random,104,149161,77983,71178,1495014950,100001,14;132;143;112;184;160;59;158;97;94;80;148;183;167;7;119;40;137;41;5;116;191;139;66;133;176;63;182;100;1;87;85;31;16;78;92;128;55;179;150;75;125;2;185;171;88;172;115;142;193;79;25;145;62;37;82;101;136;154;178;91;44;120;121;54;195;89;186;180;177;104;28;46;114;49;129;124;64;23;51;127;106;57;10;181;22;20;151;161;123;135;131;65;84;53;152;118;162;144;196,7213072101057818692
steepest_intra:nodes_start:random,105,102394,49412,52982,1495014950,100001,120;175;16;171;113;56;31;78;139;68;46;0;143;114;119;185;115;41;193;149;79;63;53;158;189;144;14;138;167;180;154;135;70;127;123;112;84;184;160;43;131;100;101;26;37;102;49;178;129;1;86;75;44;25;92;152;151;162;133;176;186;23;89;183;15;9;33;148;137;12;124;40;165;117;140;108;18;69;65;116;159;22;146;34;42;80;94;2;57;52;55;106;62;51;118;59;182;121;97;145,4592784922655238241
steepest_intra:nodes_start:random,106,111839,53371,58468,1495014950,100001,159;47;116;77;65;151;133;79;1;2;92;157;145;179;185;55;52;106;138;14;155;62;9;148;94;154;109;176;51;129;57;78;40;71;95;58;164;31;16;53;180;158;19;167;37;102;89;117;42;48;160;34;184;177;190;127;135;70;86;101;137;115;139;63;122;162;123;112;43;195;41;193;59;182;97;44;113;56;186;0;143;80;26;120;75;189;128;178;3;144;49;124;152;119;90;39;165;183;46;118,856989163004860811
steepest_intra:nodes_start:random,107,110428,59148,51280,1495014950,100001,144;14;123;4;184;42;18;108;159;41;96;151;133;80;122;63;79;51;193;146;22;115;15;40;196;57;72;59;65;43;116;124;52;185;119;165;167;54;160;34;112;149;137;114;23;186;189;86;26;97;152;55;145;113;31;78;53;154;135;180;182;25;44;92;90;21;102;62;49;178;106;94;162;127;70;75;171;16;175;0;117;68;139;46;111;129;120;2;37;9;148;12;176;118;143;183;89;1;101;100,541328218144434906
steepest_intra:nodes_start:random,108,89469,40156,49313,1495014950,100001,121;46;0;178;106;31;56;113;81;90;164;21;144;14;196;175;171;16;75;154;135;47;65;59;118;109;51;94;92;145;78;25;44;120;101;180;133;151;162;149;131;116;115;139;117;143;183;89;79;194;127;123;41;193;181;42;43;35;184;48;160;34;103;146;22;18;159;54;177;10;4;112;70;53;1;2;129;57;55;52;152;97;189;124;148;9;49;185;40;165;102;62;15;137;176;80;100;26;86;63,6742491256674331657
steepest_intra:nodes_start:random,109,88499,39169,49330,1495014950,100001,16;171;175;113;52;14;144;186;89;183;115;54;177;184;43;42;41;193;159;146;34;160;65;151;80;122;79;63;180;53;26;97;101;1;92;57;55;185;40;165;90;31;56;78;145;75;70;123;149;131;47;35;84;190;4;112;127;44;25;129;2;94;124;167;178;106;3;152;121;154;135;133;162;116;181;22;18;69;108;68;46;23;9;62;49;148;176;51;118;59;139;93;117;0;143;137;189;100;86;120,1683730550480557608
steepest_intra:nodes_start:random,110,99518,49042,50476,1495014950,100001,90;27;81;196;92;180;158;79;63;80;122;113;175;16;44;75;101;86;124;94;72;131;47;115;0;89;23;179;78;171;31;145;15;186;183;143;108;18;22;34;181;42;43;116;149;123;162;151;133;135;70;154;100;129;52;55;184;160;54;177;120;25;2;53;127;112;118;51;176;37;62;148;152;1;167;9;144;21;39;165;185;106;57;97;26;59;65;96;193;159;41;139;137;49;102;3;178;138;14;40,7093978414929115453
steepest_intra:nodes_start:random,111,105270,52079,53191,1495014950,100001,193;68;46;60;176;154;158;136;137;186;23;49;196;157;31;171;113;175;16;129;152;94;109;72;65;116;195;159;70;86;2;101;75;63;184;160;34;22;180;26;1;90;7;164;58;185;145;179;57;55;52;106;178;138;39;165;40;148;0;143;170;9;62;124;80;51;115;5;43;162;133;79;114;144;102;14;15;151;149;127;123;54;42;41;139;183;89;92;78;25;44;120;97;100;53;135;59;118;181;140,2292573253978160683
steepest_intra:nodes_start:random,112,116733,60105,56628,1495014950,100001,81;85;175;75;51;115;22;84;4;190;72;137;186;114;49;178;106;31;113;91;179;145;55;176;162;59;47;65;96;43;42;5;116;97;26;180;154;167;52;8;165;12;151;112;160;34;54;184;152;92;144;164;7;21;14;23;183;0;159;142;139;131;123;63;136;53;122;124;37;111;121;133;118;41;18;193;80;79;135;101;120;90;40;102;143;117;68;44;16;171;78;185;57;2;1;19;94;9;62;148,3269860777645018215
steepest_intra:nodes_start:random,113,122096,58782,63314,1495014950,100001,14;39;52;183;0;141;79;19;85;50;175;145;82;137;51;151;194;135;63;158;53;97;37;148;62;178;49;102;185;174;81;57;129;120;16;171;25;154;133;116;160;41;198;12;2;94;130;59;149;123;4;177;54;34;48;136;75;86;180;42;43;65;115;46;193;1;92;44;5;163;140;68;143;117;139;197;162;127;80;152;189;26;101;106;144;21;40;119;118;109;176;66;55;78;113;31;187;196;169;165,8487818903951875491
steepest_intra:nodes_start:random,114,88415,40340,48075,1495014950,100001,112;10;177;54;149;62;9;178;106;57;129;92;145;81;90;164;21;144;148;124;94;101;75;120;44;25;179;52;49;15;186;23;137;65;47;116;43;42;5;115;59;72;162;123;127;135;152;55;185;119;40;196;113;175;171;16;31;78;2;1;97;63;133;151;46;68;117;143;0;118;51;80;26;86;53;154;184;160;34;146;22;159;18;69;108;193;41;139;176;167;165;39;138;14;102;89;183;79;180;70,8367642855420993112
steepest_intra:nodes_start:random,115,97313,46423,50890,1495014950,100001,100;82;129;145;78;25;44;120;92;57;52;55;124;122;118;42;160;34;54;184;112;123;127;70;75;171;175;113;196;81;90;119;167;65;116;43;47;2;179;157;31;16;152;94;63;151;162;131;149;59;51;137;89;183;0;117;143;23;186;15;182;53;158;121;189;148;9;37;79;133;80;138;165;40;185;97;26;176;193;18;22;159;41;135;154;180;115;139;68;46;102;106;178;14;49;144;62;101;86;1,1229930722332985278
steepest_intra:nodes_start:random,116,98800,49110,49690,1495014950,100001,109;68;140;108;18;69;41;35;112;184;177;30;54;48;160;43;148;14;138;21;144;183;89;137;9;62;55;57;101;86;53;180;154;63;79;94;3;178;106;52;91;179;92;129;2;152;115;139;198;118;59;26;75;44;16;175;171;25;97;133;162;131;149;123;135;70;1;145;196;81;90;165;143;117;0;51;151;80;124;167;102;49;78;113;31;120;193;159;22;146;34;181;42;116;65;119;40;185;176;46,5552439192719476788
steepest_intra:nodes_start:random,117,93273,42479,50794,1495014950,100001,148;165;40;185;113;175;171;16;129;183;143;117;68;47;131;149;65;116;59;51;176;57;92;145;78;31;25;44;120;2;75;101;86;53;180;135;194;123;162;151;133;63;97;26;184;54;30;177;10;9;62;186;23;89;198;139;5;43;35;84;190;4;112;127;70;154;1;152;49;102;14;144;94;79;118;115;41;193;69;18;108;163;36;140;93;0;178;106;52;55;137;46;159;22;146;34;160;181;42;80,6534828289218546737
steepest_intra:nodes_start:random,118,104423,53225,51198,1495014950,100001,79;2;100;26;97;49;62;9;52;179;196;185;165;40;112;4;177;54;34;160;184;106;55;120;44;137;93;69;18;108;140;89;124;94;78;145;31;113;175;171;16;92;57;167;128;178;3;15;80;181;195;159;53;75;86;154;151;143;117;0;51;118;131;65;47;116;42;115;46;59;162;133;176;14;21;164;138;102;144;23;183;148;111;121;101;1;189;180;70;135;123;149;43;193;139;68;22;41;63;152,5874642444964810651
steepest_intra:nodes_start:random,119,103133,53002,50131,1495014950,100001,57;92;121;154;160;34;30;54;177;10;190;112;77;198;46;68;51;78;113;56;81;27;95;9;62;94;122;115;139;159;193;41;14;138;165;39;90;40;178;137;0;18;22;117;143;183;144;185;196;31;171;175;16;44;25;176;80;65;43;116;63;101;86;53;180;42;181;184;149;131;84;35;162;133;148;37;124;79;118;59;151;129;145;179;106;49;26;135;70;123;127;75;120;55;52;167;1;97;152;2,8962575810099687947
steepest_intra:nodes_start:random,120,108207,58206,50001,1495014950,100001,49;95;58;90;27;165;119;40;185;2;44;56;31;16;120;53;194;162;63;26;75;101;133;79;100;121;86;25;78;179;143;117;18;22;181;184;35;123;180;94;148;124;154;70;135;115;34;177;160;43;106;178;136;127;149;151;118;59;65;42;116;112;54;48;51;176;3;55;129;145;81;52;114;89;183;0;68;139;46;137;80;97;175;171;113;92;57;198;41;159;193;9;144;14;62;102;21;164;152;1,3044637963979329760
steepest_intra:nodes_start:random,121,90384,39618,50766,1495014950,100001,78;55;167;94;79;133;116;5;41;193;139;46;68;140;108;18;22;159;115;137;15;144;21;164;27;90;57;2;101;1;97;152;129;92;145;120;75;86;26;53;180;154;70;135;162;151;9;62;102;148;127;4;177;54;48;184;35;84;112;123;131;149;59;118;51;72;65;43;42;181;146;34;160;63;106;3;185;40;165;14;183;143;0;176;80;122;124;49;178;52;189;182;121;100;44;16;175;113;171;179,8176369520321496901
steepest_intra:nodes_start:random,122,95371,47090,48281,1495014950,100001,37;52;55;106;165;90;119;40;185;9;62;15;186;23;149;112;4;177;54;160;43;144;14;3;57;129;2;97;65;116;115;68;117;0;176;133;180;86;75;25;78;92;82;120;44;175;113;56;31;145;152;80;51;118;59;162;154;53;1;196;81;164;21;138;178;179;171;16;101;100;26;70;127;184;34;22;18;108;123;135;124;167;49;102;137;46;139;193;159;41;42;151;79;63;94;148;114;183;143;89,838483809438781170
steepest_intra:nodes_start:random,123,124286,63808,60478,1495014950,100001,90;169;56;16;2;176;194;135;75;38;31;120;44;157;85;78;116;18;93;68;183;37;62;137;118;151;1;25;52;55;57;26;121;79;63;72;149;54;177;184;30;139;115;106;165;40;196;185;178;144;49;167;152;180;181;160;42;43;51;148;14;9;193;41;197;162;154;39;187;81;179;92;189;133;24;123;59;77;65;127;97;175;113;171;145;100;158;80;109;60;47;4;112;192;34;105;94;53;86;101,4943424587216507432
steepest_intra:nodes_start:random,124,101643,48639,53004,1495014950,100001,148;12;26;121;158;154;133;151;160;54;177;112;123;149;116;47;77;65;162;135;97;145;31;78;178;106;144;183;0;93;41;193;117;143;14;49;9;15;23;139;115;68;46;100;53;22;181;5;42;43;118;137;111;152;44;16;81;90;165;169;113;175;171;25;120;129;185;21;7;138;62;37;94;124;52;55;92;2;75;86;1;101;196;119;40;179;57;122;176;80;79;51;59;184;4;127;70;180;63;167,6332615742707180620
steepest_intra:nodes_start:random,125,103475,54020,49455,1495014950,100001,106;31;16;171;175;154;70;4;112;79;144;119;40;138;14;49;62;23;153;108;18;34;181;101;75;78;145;44;120;2;152;97;94;148;15;9;95;90;165;185;129;177;10;54;160;118;51;176;80;182;1;86;92;196;81;57;63;133;151;59;65;116;115;46;68;100;26;121;162;149;47;42;41;193;159;22;139;183;89;43;84;35;184;131;123;127;135;180;53;136;137;93;140;143;117;0;55;52;178;113,254291495511907030
steepest_intra:nodes_start:random,126,108412,56631,51781,1495014950,100001,52;94;136;133;162;43;177;54;84;123;135;44;120;2;1;86;70;131;42;5;193;181;146;160;184;35;166;149;100;75;152;129;167;26;180;154;80;79;151;59;51;137;62;185;40;165;90;106;23;89;0;108;18;179;57;101;53;116;41;22;159;122;97;16;175;56;85;171;113;81;92;63;176;12;102;14;144;49;178;145;78;157;31;127;112;34;103;139;68;143;117;47;77;65;115;46;183;148;55;9,7851028508893210779
steepest_intra:nodes_start:random,127,105163,54647,50516,1495014950,100001,65;48;34;160;123;44;25;120;127;112;4;190;177;41;198;46;80;122;53;154;180;101;78;175;113;16;63;79;151;84;184;42;68;140;93;117;0;143;186;15;49;3;52;55;40;90;81;31;145;97;152;26;100;1;185;165;183;89;114;144;7;21;138;178;2;75;86;133;109;72;116;139;18;22;159;51;176;102;14;62;9;149;131;162;167;106;57;92;129;118;59;115;193;43;70;135;94;148;137;54,8171906539632513135
steepest_intra:nodes_start:random,128,93173,42602,50571,1495014950,100001,46;114;144;164;21;183;143;117;118;180;182;121;26;100;63;133;65;47;116;42;43;55;52;92;57;185;40;165;14;178;106;31;113;175;171;16;44;25;129;115;193;41;139;68;0;89;15;9;49;102;62;37;148;12;122;94;124;1;97;101;75;86;53;158;154;70;135;127;123;112;84;35;131;149;162;151;137;186;23;181;160;54;177;10;2;120;78;145;152;79;80;176;51;59;184;48;34;22;159;18,5585817689327197294
steepest_intra:nodes_start:random,129,86960,38268,48692,1495014950,100001,51;152;2;120;44;25;129;49;62;9;144;14;138;178;106;57;92;148;15;114;89;183;143;117;93;0;94;26;100;53;158;180;154;162;149;131;47;43;5;42;160;181;146;22;18;108;193;159;34;54;177;184;35;151;185;40;81;90;165;52;55;167;124;80;59;116;65;123;135;70;127;112;4;84;137;23;186;179;145;78;16;171;175;113;31;63;79;133;121;86;75;101;1;97;176;46;139;41;115;118,145798693186228264
steepest_intra:nodes_start:random,130,103134,50687,52447,1495014950,100001,180;86;44;171;175;31;92;57;52;185;40;129;120;75;154;194;47;43;160;34;42;131;149;72;176;80;143;0;139;68;79;53;121;189;2;16;56;113;145;55;41;193;22;18;117;183;51;151;65;116;9;14;3;106;138;62;59;77;123;70;135;127;112;4;84;94;49;178;148;137;46;118;133;162;35;10;177;184;115;89;186;144;21;27;90;58;164;165;81;78;82;97;100;101;1;74;152;136;63;26,6130463588010017690
steepest_intra:nodes_start:random,131,95603,43461,52142,1495014950,100001,124;53;70;127;112;160;34;54;177;4;123;185;40;81;196;31;56;25;120;100;26;86;101;74;152;106;3;49;133;194;135;121;94;137;0;143;183;89;114;144;14;138;165;90;27;164;7;21;186;23;115;41;193;42;116;65;2;57;129;63;79;154;180;149;184;43;5;139;68;46;59;118;51;176;92;145;78;44;1;97;75;16;171;175;113;179;55;189;162;151;80;167;52;178;102;62;9;15;148;37,1678157145907097216
steepest_intra:nodes_start:random,132,91020,40876,50144,1495014950,100001,52;49;102;167;111;148;15;114;183;143;59;149;123;127;112;84;184;177;10;54;48;160;34;181;193;46;118;51;97;129;57;55;185;165;14;144;73;153;0;92;113;31;78;145;179;101;1;152;2;44;16;171;175;25;120;75;86;70;135;154;53;180;176;137;23;89;186;94;100;26;63;79;151;162;133;80;124;37;9;62;68;139;159;22;18;69;115;65;116;43;42;41;108;140;93;117;178;40;196;106,2298759290085900204
steepest_intra:nodes_start:random,133,99442,47929,51513,1495014950,100001,114;102;138;14;62;72;59;116;65;143;183;145;31;175;171;16;25;44;120;75;86;70;127;184;34;160;42;115;176;80;158;154;53;121;100;180;112;84;177;54;148;178;8;40;185;55;52;57;179;92;133;151;162;123;135;152;2;78;81;90;3;106;49;15;51;46;68;93;117;0;118;149;47;43;139;193;41;22;18;26;82;129;196;119;165;9;94;122;79;63;1;101;97;124;12;137;89;23;186;144,2779860510952216614
steepest_intra:nodes_start:random,134,109272,54834,54438,1495014950,100001,162;51;183;144;119;40;27;90;185;52;62;118;149;100;25;44;175;171;16;91;55;57;1;99;97;106;14;15;186;137;0;117;143;133;101;86;154;53;151;181;42;34;195;22;160;184;84;158;26;136;121;122;80;176;79;46;139;115;198;5;4;112;127;123;59;72;180;135;70;131;43;63;31;113;78;74;94;152;129;165;164;49;178;9;148;140;18;159;41;193;110;116;65;189;75;2;120;92;145;179,7020313156091270219
steepest_intra:nodes_start:random,135,90991,41763,49228,1495014950,100001,37;52;55;119;40;185;179;75;127;84;112;162;133;180;53;26;100;2;120;44;25;78;145;81;196;31;113;16;171;175;90;165;39;106;178;51;41;193;159;22;181;160;42;43;65;47;116;149;94;102;144;0;143;153;183;89;23;152;97;135;123;35;177;184;115;139;46;117;93;140;108;69;18;146;34;54;70;154;101;129;92;57;49;14;9;137;176;80;63;79;72;59;118;151;86;1;124;148;62;167,8056066673436479887
steepest_intra:nodes_start:random,136,87069,37332,49737,1495014950,100001,16;151;65;47;116;59;137;23;89;183;143;0;51;194;70;135;133;79;122;57;55;52;106;185;119;40;90;81;196;25;44;120;75;154;180;53;100;26;86;101;167;49;178;179;145;92;2;160;34;22;159;42;43;35;84;4;112;127;123;176;186;15;9;62;102;144;21;7;164;95;165;14;148;124;152;1;97;63;162;149;131;184;177;54;48;181;193;41;139;46;115;118;80;94;129;78;31;113;175;171,6070557681124865744
steepest_intra:nodes_start:random,137,104273,54810,49463,1495014950,100001,145;78;112;4;35;43;59;151;162;123;127;135;154;55;90;165;106;139;18;108;93;140;160;54;10;177;184;149;70;75;44;16;171;175;113;31;25;86;133;109;51;115;96;5;41;22;193;80;79;180;121;49;62;148;124;94;63;53;97;152;52;178;14;89;183;117;170;143;186;57;129;120;2;176;46;0;23;15;144;102;9;137;116;42;34;181;21;164;7;114;118;65;47;26;100;1;101;92;185;40,7970426468690349626
steepest_intra:nodes_start:random,138,118500,56692,61808,1495014950,100001,106;91;78;44;16;175;138;144;185;92;82;63;12;124;111;94;121;97;2;152;130;66;163;108;18;51;176;133;182;55;3;165;95;90;57;135;194;177;112;4;190;23;40;169;81;178;62;15;37;148;74;1;86;101;120;75;100;79;5;43;59;118;53;52;119;49;14;9;151;123;35;184;42;146;159;139;170;143;183;0;46;72;116;65;197;105;115;60;137;80;154;180;193;103;22;41;145;31;171;113,1095308535727610306
steepest_intra:nodes_start:random,139,95047,43545,51502,1495014950,100001,41;139;198;115;167;106;185;40;165;186;89;183;46;159;22;18;108;144;14;138;178;55;52;152;180;72;118;5;160;184;42;65;59;57;31;56;113;16;75;86;51;109;0;143;117;140;93;68;84;112;123;127;70;194;135;129;92;145;78;25;44;120;82;179;196;171;175;2;101;1;122;151;162;133;80;23;137;176;79;63;94;9;62;49;102;15;148;97;26;100;53;154;149;116;105;43;54;34;181;193,399053767820455241
steepest_intra:nodes_start:random,140,109011,58607,50404,1495014950,100001,120;193;146;22;159;65;56;113;171;44;101;86;75;97;186;23;114;138;39;185;100;121;123;127;135;119;165;90;81;196;92;57;167;79;162;115;139;198;84;112;26;1;53;180;70;80;176;178;55;52;111;124;137;183;140;68;59;151;154;94;15;89;0;46;42;30;54;34;18;93;117;143;144;14;16;175;145;40;102;9;62;148;51;160;184;5;41;43;116;133;63;152;106;3;49;2;129;78;25;31,4463242634481394580
steepest_intra:nodes_start:random,141,100688,51253,49435,1495014950,100001,165;55;179;31;171;16;135;123;198;68;108;18;146;34;160;175;113;75;86;59;159;22;193;41;162;154;53;121;9;62;49;3;178;25;44;78;145;57;52;40;119;185;149;35;84;112;127;70;180;14;144;102;15;148;37;167;124;151;184;177;54;48;129;92;120;2;79;51;118;46;115;5;42;116;65;133;63;101;1;97;152;100;26;131;43;139;0;143;183;89;23;137;176;80;94;196;81;90;27;106,9022608937384607341
steepest_intra:nodes_start:random,142,98540,47315,51225,1495014950,100001,148;72;65;184;160;54;34;146;181;5;139;198;68;93;117;0;63;26;101;75;44;25;92;129;57;52;55;94;189;152;40;185;127;4;112;149;59;118;108;69;18;199;22;162;53;180;154;135;123;131;116;96;193;159;41;115;51;80;178;3;138;106;124;176;137;89;183;23;144;14;165;27;90;186;143;46;42;43;86;120;31;145;78;1;97;2;16;171;175;113;70;194;151;133;79;122;62;9;102;49,6388809713211224520
steepest_intra:nodes_start:random,143,213971,120692,93279,1495014950,100001,153;158;105;112;118;135;35;104;76;178;3;129;4;195;199;63;137;183;91;128;106;175;38;16;9;36;186;143;67;77;127;194;123;134;48;147;190;87;196;157;174;95;2;78;94;92;25;115;11;84;47;148;23;73;119;154;120;75;55;141;197;101;39;187;125;198;121;193;181;189;72;24;1;150;145;152;20;177;140;180;21;74;166;93;144;70;59;22;34;10;82;111;176;165;13;114;103;60;19;98,6507982673250315757
steepest_intra:nodes_start:random,144,101065,50218,50847,1495014950,100001,75;175;171;92;57;2;152;80;59;41;159;22;68;143;23;44;31;196;179;78;113;81;40;49;137;51;72;131;149;65;42;181;34;48;160;115;43;190;10;177;54;4;184;84;53;121;94;167;55;165;71;58;164;90;14;79;63;133;123;135;180;154;89;183;186;62;148;124;26;86;101;97;1;144;21;119;185;106;178;52;145;16;25;120;122;151;162;116;105;47;193;18;139;46;117;140;93;0;176;56,4655430344170564559
steepest_intra:nodes_start:random,145,120432,59150,61282,1495014950,100001,155;80;135;133;136;196;175;171;78;56;16;44;120;74;94;60;153;137;15;9;102;14;138;185;119;165;82;100;86;154;124;145;31;113;85;63;194;41;139;115;0;46;51;176;106;144;193;159;22;43;65;42;34;181;184;167;152;150;26;121;109;143;183;186;23;114;89;101;75;123;35;59;72;79;180;53;125;129;2;62;49;178;92;162;105;77;48;160;116;151;182;148;55;57;1;19;97;25;40;164,3700598698440473960
steepest_intra:nodes_start:random,146,93248,44375,48873,1495014950,100001,62;102;49;124;63;79;115;41;159;193;139;68;93;117;143;57;145;78;25;44;75;154;70;127;47;116;65;162;53;26;152;52;40;119;178;106;167;80;46;69;108;18;199;22;146;34;181;42;151;94;55;185;165;81;196;92;129;2;1;135;123;131;149;133;120;31;16;171;175;113;90;27;164;14;144;9;37;148;176;43;184;112;4;10;177;54;48;160;180;86;101;97;183;0;59;118;109;51;137;15,4404001050548141388
steepest_intra:nodes_start:random,147,120466,62336,58130,1495014950,100001,115;133;94;167;102;9;80;79;121;19;57;55;62;144;49;14;183;143;7;71;21;164;40;185;3;106;178;52;89;59;109;51;173;182;181;22;108;20;159;5;42;179;31;175;16;171;86;100;154;135;194;180;53;45;162;65;46;41;191;18;193;48;123;149;112;4;177;34;170;0;23;186;137;176;184;166;105;43;151;152;78;145;196;54;160;1;97;101;120;113;44;92;148;63;116;77;118;68;139;70,1497717445075124954
steepest_intra:nodes_start:random,148,102108,47151,54957,1495014950,100001,159;193;140;46;137;133;162;35;84;105;43;49;9;62;144;14;44;16;31;145;86;26;25;129;92;196;175;113;171;78;179;40;185;165;57;97;121;124;111;167;172;152;189;151;51;68;0;89;183;186;148;130;154;180;63;197;115;116;123;70;53;1;2;120;75;176;118;65;149;127;4;54;160;190;10;177;42;181;34;18;108;139;191;59;80;178;106;52;55;101;100;19;94;79;135;156;112;184;41;22,5744329866544141521
steepest_intra:nodes_start:random,149,106187,54507,51680,1495014950,100001,78;120;101;1;53;70;35;48;160;115;198;0;170;117;89;137;79;133;112;184;28;43;65;149;159;195;116;162;45;151;80;86;75;97;26;106;14;167;123;127;135;180;124;94;63;154;158;109;51;59;118;176;23;9;178;119;90;95;183;108;18;22;146;41;139;46;193;42;5;2;145;179;57;152;148;49;144;181;34;54;177;190;175;171;31;92;52;62;143;93;140;68;55;185;40;165;196;113;16;44,7069544372760923667
steepest_intra:nodes_start:random,150,213641,115987,97654,1495014950,100001,177;139;198;91;157;98;16;115;137;169;27;145;87;171;128;156;36;119;25;113;92;26;135;154;3;120;176;127;109;6;118;131;147;112;19;166;110;60;100;21;165;78;32;89;46;24;192;84;43;129;44;124;37;185;56;94;121;189;186;148;153;22;134;159;161;90;55;39;155;14;144;97;33;199;142;181;2;13;29;4;45;38;58;17;174;126;116;59;57;164;138;74;197;167;149;191;104;15;136;178,5747366751799194126
steepest_intra:nodes_start:random,151,107884,57432,50452,1495014950,100001,117;89;57;129;92;79;151;80;122;63;136;158;53;86;82;120;152;94;176;137;15;102;40;185;78;25;44;70;184;30;177;54;160;51;171;113;145;124;193;22;34;10;190;112;135;100;26;52;106;165;90;81;55;14;144;148;133;123;131;149;47;65;31;16;175;178;49;62;9;167;2;75;180;43;181;42;162;182;1;101;97;189;121;154;116;96;41;18;108;164;7;21;118;59;115;139;46;0;143;183,3132635287442350001
steepest_intra:nodes_start:random,152,111192,58600,52592,1495014950,100001,40;106;178;165;52;55;185;31;157;25;44;75;1;26;56;113;27;21;73;23;46;5;116;65;120;78;179;145;196;57;154;158;70;135;127;131;47;86;16;175;171;101;97;124;148;9;62;14;144;183;143;0;18;43;105;42;149;63;136;53;180;162;166;35;123;100;152;151;160;54;177;49;138;95;90;164;8;92;2;133;112;4;59;51;80;79;176;193;159;22;146;181;184;186;137;115;41;139;94;129,5229621982548905124
steepest_intra:nodes_start:random,153,158548,79299,79249,1495014950,100001,114;87;68;193;8;119;175;197;65;199;110;195;34;126;84;48;10;147;77;22;162;180;63;151;116;25;82;120;171;27;98;40;106;167;129;136;158;29;191;139;60;160;18;112;123;53;44;172;194;0;198;135;57;55;9;62;186;141;59;47;41;132;144;183;163;93;143;64;130;66;176;80;79;118;43;42;5;131;122;2;26;7;71;164;185;49;58;39;21;95;94;75;100;101;97;152;12;89;124;86,2520858788703680019
steepest_intra:nodes_start:random,154,104126,53906,50220,1495014950,100001,178;143;9;57;92;145;185;40;55;52;167;1;86;53;158;154;149;43;42;5;116;59;186;23;89;183;160;34;48;10;177;30;54;127;180;75;120;82;129;2;124;117;108;18;22;159;41;47;65;193;110;68;46;176;148;102;14;144;15;137;51;118;72;80;79;63;152;44;175;171;16;101;100;26;25;113;31;78;97;133;162;123;131;139;198;115;62;21;90;165;49;94;135;70;112;35;184;151;106;0,3793820244661414205
steepest_intra:nodes_start:random,155,95415,45132,50283,1495014950,100001,42;5;139;115;137;167;57;179;91;27;90;81;157;145;25;120;75;86;101;26;53;180;154;151;51;109;59;118;46;117;0;15;52;55;102;144;14;138;119;196;31;56;175;113;178;49;186;23;89;143;183;21;164;39;165;152;1;97;2;129;92;78;16;171;44;70;112;190;10;177;4;123;94;124;62;9;148;135;127;35;184;65;176;185;40;106;41;193;159;22;146;34;160;162;133;63;79;80;116;43,7037018461093015174
steepest_intra:nodes_start:random,156,96517,45359,51158,1495014950,100001,105;47;59;72;133;180;53;86;101;92;145;78;75;154;135;127;112;177;54;184;35;167;106;179;25;44;120;82;57;52;55;129;2;1;97;63;79;118;68;140;108;18;69;41;51;80;176;115;139;46;23;49;178;16;175;113;31;185;40;165;181;34;160;94;124;137;0;117;143;122;121;100;26;152;148;186;89;183;114;15;9;62;144;21;7;164;14;102;193;159;22;42;43;149;151;162;123;131;65;116,669206232802423709
steepest_intra:nodes_start:random,157,90444,39539,50905,1495014950,100001,42;133;100;26;152;57;185;40;138;14;144;102;49;178;2;75;86;121;63;72;59;46;115;116;77;149;145;78;44;120;162;131;184;112;135;180;53;154;70;127;123;151;176;80;124;94;122;79;51;68;139;193;41;159;181;43;47;118;109;12;148;62;15;186;23;9;3;106;196;81;90;39;165;52;55;101;1;97;129;92;179;31;113;175;171;16;25;137;89;183;143;0;117;93;108;18;22;34;160;65,955278220632736852
steepest_intra:nodes_start:random,158,93406,44003,49403,1495014950,100001,146;195;5;65;59;144;40;90;27;165;185;52;55;167;80;176;51;72;149;35;84;112;4;177;54;34;160;181;42;137;15;14;138;49;9;62;124;97;101;75;120;92;106;178;57;145;113;56;31;44;127;123;184;41;139;23;148;37;100;26;46;68;93;140;118;162;180;53;86;129;78;16;171;175;25;2;70;135;154;121;1;152;94;63;79;133;151;116;43;108;18;143;89;183;0;117;115;193;159;22,4593372735571206225
steepest_intra:nodes_start:random,159,101230,51452,49778,1495014950,100001,81;117;93;108;18;22;115;113;175;171;16;25;65;184;160;34;42;118;59;151;80;79;63;152;129;57;179;157;196;185;138;14;102;167;124;94;176;9;178;165;39;40;119;52;106;15;23;89;183;143;51;70;135;154;53;75;2;78;31;145;116;43;5;193;41;139;68;46;0;137;55;92;120;44;90;164;21;144;149;131;84;4;112;123;127;162;133;180;26;97;101;86;1;148;37;62;49;3;8;186,8779957365494606173
steepest_intra:nodes_start:random,160,127951,67537,60414,1495014950,100001,177;61;155;21;144;15;167;3;91;40;90;27;196;145;120;44;152;195;34;154;86;101;123;131;115;139;140;68;67;108;18;199;69;191;59;197;181;35;63;79;171;113;151;51;89;183;46;65;135;136;180;122;30;48;54;160;184;42;96;26;71;164;14;178;57;106;185;31;175;52;9;62;148;111;53;97;1;78;2;176;137;76;23;165;95;0;193;41;47;149;116;118;186;49;92;16;94;80;133;143,3849489899811435021
steepest_intra:nodes_start:random,161,91060,40624,50436,1495014950,100001,80;124;52;55;185;165;40;81;196;86;101;75;44;16;31;78;120;2;152;122;65;43;160;184;84;4;112;90;27;164;21;144;49;121;53;154;180;162;151;51;46;139;41;193;115;96;5;42;149;123;127;70;135;158;63;137;186;89;183;143;117;93;68;0;23;178;106;175;171;113;14;62;9;37;148;92;145;179;57;129;1;26;100;97;94;176;118;59;47;131;35;177;54;34;22;159;116;72;133;79,1278614853241066830
steepest_intra:nodes_start:random,162,90066,40191,49875,1495014950,100001,101;49;62;9;148;124;127;4;112;14;7;164;90;165;40;119;185;55;180;135;70;154;86;1;97;79;151;133;53;75;120;44;25;94;63;162;123;131;149;43;42;5;118;59;65;184;34;22;193;51;176;122;80;137;23;89;183;0;143;117;160;54;30;177;190;10;84;35;77;116;47;115;68;46;198;139;41;159;18;108;186;15;144;196;81;145;31;113;171;16;78;92;52;178;3;106;57;129;2;152,1431030064475221319
steepest_intra:nodes_start:random,163,110882,59959,50923,1495014950,100001,135;127;70;154;1;152;133;41;68;46;143;0;117;89;178;14;144;137;65;195;34;160;115;63;26;100;176;59;162;151;79;92;165;40;81;157;145;97;86;57;196;175;31;80;42;181;43;116;105;118;148;49;106;138;164;95;7;21;180;123;159;18;22;193;96;139;198;183;114;9;62;52;185;85;56;171;78;179;55;119;27;90;25;2;75;149;54;48;177;184;51;129;44;120;101;94;136;53;16;113,8532311246958204693
steepest_intra:nodes_start:random,164,115835,59918,55917,1495014950,100001,40;165;164;90;144;181;48;34;103;131;116;51;2;120;92;129;32;14;62;86;97;1;137;0;143;109;53;135;194;133;180;182;26;136;151;115;184;54;43;46;193;108;18;75;44;25;57;148;183;139;198;149;112;158;122;185;106;138;3;178;55;52;175;16;101;160;22;159;199;69;195;41;96;47;65;5;42;123;162;79;154;80;59;118;189;19;176;63;94;152;56;171;113;91;49;102;31;145;81;78,2987375930527070945
steepest_intra:nodes_start:random,165,119449,65387,54062,1495014950,100001,185;9;186;183;23;90;40;101;75;25;129;152;80;63;135;84;184;139;110;46;68;198;197;115;16;113;175;94;89;170;0;143;117;4;112;123;159;146;22;149;45;133;15;49;106;32;148;62;97;86;59;116;51;2;145;78;81;196;102;14;137;72;127;180;70;154;121;65;77;42;30;54;47;55;52;57;79;151;162;53;44;171;120;144;21;164;165;92;1;131;5;34;160;41;193;43;118;176;178;179,6439125308080496526
steepest_intra:nodes_start:random,166,89153,40396,48757,1495014950,100001,97;1;78;145;92;129;152;181;159;22;18;139;117;143;183;0;46;115;118;51;59;149;112;84;35;65;116;43;42;5;41;193;176;80;63;100;101;113;175;171;16;75;86;123;54;34;160;184;131;162;151;133;79;94;55;185;165;119;40;179;57;52;106;178;49;102;9;62;15;137;148;2;120;44;25;3;14;138;196;157;31;81;90;27;95;164;7;21;144;26;53;158;154;70;177;10;4;127;135;180,1543708557153603015
steepest_intra:nodes_start:random,167,171122,88543,82579,1495014950,100001,99;84;55;25;120;148;162;112;31;7;170;181;146;116;12;165;39;179;184;47;96;89;83;68;117;0;109;190;149;11;144;21;56;175;38;78;151;53;94;49;65;195;105;115;176;62;95;58;138;106;72;59;197;45;136;97;19;182;125;101;44;196;27;40;91;157;6;166;48;41;103;34;160;192;198;137;15;32;178;183;140;14;185;8;129;92;57;63;51;124;23;128;171;17;145;119;81;188;85;22,4307245726710135334
steepest_intra:nodes_start:random,168,145986,80683,65303,1495014950,100001,63;137;119;27;21;1;101;77;5;48;96;65;4;121;171;82;49;148;144;68;108;20;18;42;130;40;32;111;41;193;191;79;73;7;58;164;122;176;59;105;115;116;47;162;180;100;185;179;16;75;97;86;133;53;152;55;178;106;145;189;151;34;146;159;198;25;120;173;22;199;23;62;155;14;52;92;186;183;76;80;46;140;139;160;196;113;56;135;154;31;38;78;44;94;118;143;0;124;12;123,2883454259307862028
steepest_intra:nodes_start:random,169,98102,49899,48203,1495014950,100001,148;117;68;139;43;116;25;113;175;171;16;82;2;94;133;162;151;79;80;0;143;183;23;62;9;149;160;34;181;159;41;115;46;51;154;135;127;70;180;63;176;137;15;144;138;165;81;40;119;185;97;53;65;69;108;18;22;193;118;59;100;26;145;31;78;44;120;75;