method,run,objective,tour_length,selected_costs,evaluations,improvements,final_selected,seed,duration_ms
steepest_intra:nodes_start:random,0,87693,38892,48801,2332200,155,92;120;44;16;171;175;113;31;179;62;9;137;46;139;193;41;116;65;47;43;42;159;22;18;0;144;14;40;185;106;178;186;23;89;183;143;117;68;177;10;190;84;151;80;176;51;118;115;181;34;160;48;54;184;35;131;149;59;148;102;49;145;78;1;97;121;63;122;94;152;26;100;180;4;112;70;101;2;129;57;167;124;79;133;162;123;127;135;154;158;53;86;75;196;81;90;27;165;52;55,4800949928744839851,0.070759
steepest_intra:nodes_start:random,1,85646,37091,48555,2122900,141,63;26;100;35;184;160;34;181;68;93;117;0;139;48;54;177;10;4;53;86;75;101;1;97;151;59;118;51;176;137;23;183;89;186;124;152;129;92;145;78;31;113;175;171;16;44;120;2;149;43;42;5;41;193;159;195;103;146;22;18;108;143;114;144;3;178;138;14;49;102;62;9;15;148;106;185;165;90;81;40;179;57;55;52;94;123;112;127;70;135;154;180;79;80;46;115;116;65;162;133,8132654027494232249,0.062295
steepest_intra:nodes_start:random,2,84087,35899,48188,2511600,167,81;90;40;165;14;144;183;143;117;68;139;41;193;69;108;18;22;34;177;10;4;75;16;171;175;113;31;185;138;102;49;178;106;167;124;94;63;121;100;26;101;1;97;80;176;9;62;186;89;93;140;159;181;54;84;112;127;70;135;162;133;151;51;118;59;116;43;5;42;160;184;123;149;131;65;115;46;0;137;148;129;92;57;55;52;145;78;25;44;120;2;86;53;154;180;79;122;152;179;196,320066088705899106,0.085999
steepest_intra:nodes_start:random,3,87845,37018,50827,2257450,150,97;189;0;93;117;143;124;152;16;171;175;113;56;31;78;92;129;53;180;158;101;2;57;179;185;40;165;90;81;196;145;70;127;112;4;123;133;80;137;89;183;176;151;5;42;181;41;193;159;146;22;18;139;115;118;109;51;59;116;65;47;43;131;149;162;154;86;75;44;25;120;135;184;160;34;46;23;186;15;49;55;52;106;178;3;14;144;102;62;9;37;148;94;122;79;63;121;100;26;1,2037372810169102958,0.072999
steepest_intra:nodes_start:random,4,90722,41762,48960,2063100,137,117;143;183;113;175;171;154;135;127;190;10;177;34;146;22;159;193;41;79;129;92;57;186;23;137;176;80;51;59;65;116;42;139;115;118;180;53;86;75;16;31;185;40;90;165;138;14;144;102;37;148;9;62;15;151;35;84;123;100;26;97;94;124;152;2;120;44;25;78;145;55;52;106;178;3;49;167;162;149;131;184;160;43;133;63;1;101;158;70;112;4;54;48;181;18;108;140;68;46;0,4780968325775759612,0.061591
steepest_intra:nodes_start:random,5,85943,36814,49129,2332200,155,101;1;100;26;97;152;94;0;143;117;46;193;159;22;146;176;124;148;9;62;102;49;3;178;106;53;135;70;75;120;44;25;129;92;57;185;165;138;14;144;183;93;108;18;69;68;139;41;181;34;54;160;162;154;180;79;80;137;23;89;186;114;15;31;113;175;171;16;78;145;179;55;52;40;90;81;196;2;51;109;115;116;42;43;123;127;112;84;184;131;149;65;59;118;72;151;133;63;121;86,4562095574339694888,0.069997
steepest_intra:nodes_start:random,6,90428,42900,47528,2227550,148,92;129;2;1;152;167;55;31;113;175;171;16;52;178;49;148;94;53;180;135;194;84;177;54;48;34;146;117;0;68;139;115;43;10;190;4;112;123;127;70;154;57;196;81;90;164;21;14;102;63;133;149;131;151;176;9;62;137;46;193;41;42;181;160;184;35;162;79;122;80;51;118;159;22;18;108;144;165;40;185;106;59;65;116;143;183;89;23;186;124;97;26;86;101;75;120;44;25;78;145,6487398630032584800,0.070016
steepest_intra:nodes_start:random,7,83831,35237,48594,2048150,136,159;193;41;139;115;59;149;131;35;84;112;75;44;120;2;167;124;152;1;101;97;63;184;160;43;79;122;94;26;100;86;53;180;154;135;70;127;123;162;65;116;5;42;181;34;54;177;25;16;171;175;113;31;78;145;179;106;178;3;49;102;9;62;144;14;138;165;92;129;57;55;52;185;40;196;81;90;164;21;148;0;46;118;151;133;80;176;51;137;23;186;89;183;143;117;18;22;146;103;195,3472305565869694611,0.063982
steepest_intra:nodes_start:random,8,84848,36650,48198,2167750,144,16;171;175;113;31;81;90;165;55;57;2;1;101;26;63;79;133;151;59;118;115;46;0;117;93;140;68;65;149;131;160;34;181;42;43;116;5;159;146;22;18;108;176;94;129;92;40;119;185;106;178;148;80;162;123;184;54;177;10;190;4;112;78;145;52;3;102;144;62;9;15;89;183;143;139;193;41;109;51;137;23;186;114;21;7;164;14;49;167;152;97;180;135;70;154;53;86;75;120;44,3742532720832370084,0.072004
steepest_intra:nodes_start:random,9,90082,40697,49385,2152800,143,154;180;97;2;129;92;57;186;23;0;117;143;183;89;178;175;171;16;75;86;101;1;152;167;49;14;144;62;9;148;151;162;133;79;122;63;121;26;100;53;118;139;41;193;159;54;177;184;112;94;106;185;119;40;179;145;78;25;44;120;82;196;81;165;137;68;108;18;22;34;48;160;181;42;43;47;65;116;59;51;21;7;164;58;95;27;90;113;31;52;55;124;80;176;46;198;115;149;123;135,3549518904602294444,0.073310
steepest_intra:nodes_start:random,10,90373,38758,51615,2048150,136,127;112;4;190;10;177;84;123;162;180;53;121;94;124;186;23;176;80;133;151;51;47;43;5;41;18;108;69;96;116;65;115;198;46;68;117;143;183;89;0;118;59;131;149;79;122;63;100;26;97;1;2;129;57;49;102;15;137;42;181;160;48;30;54;184;165;40;185;92;75;101;86;70;35;34;146;22;159;193;139;148;167;120;44;16;171;175;78;145;9;62;144;14;178;106;52;55;152;154;135,2136006667012314151,0.065996
steepest_intra:nodes_start:random,11,91538,43285,48253,2152800,143,159;140;93;68;193;34;160;54;184;185;165;40;196;25;44;120;2;69;18;108;183;21;164;90;81;31;113;175;171;16;78;145;179;106;178;3;49;15;89;143;117;0;94;152;1;101;97;115;41;139;46;144;14;52;55;57;92;129;75;127;112;4;84;123;162;151;65;59;118;51;133;79;63;100;26;86;53;158;154;70;135;180;121;167;102;62;9;148;124;122;80;176;137;186;23;116;43;42;181;22,7621188452321910719,0.071114
steepest_intra:nodes_start:random,12,88973,40266,48707,2646150,176,34;160;54;184;135;154;180;80;137;23;186;15;138;14;183;108;69;18;193;159;22;146;41;116;65;43;5;115;139;68;46;51;176;148;49;178;106;52;185;119;40;81;90;27;165;55;57;92;129;9;62;144;102;167;1;101;86;100;26;89;143;117;93;0;118;59;151;158;53;75;120;44;25;16;78;145;2;63;79;94;124;152;97;121;133;162;123;35;84;112;127;70;171;175;113;31;196;179;42;181,5783591068337989317,0.080001
steepest_intra:nodes_start:random,13,85924,36605,49319,2048150,136,93;68;139;46;51;176;80;102;14;138;165;90;119;40;185;57;129;92;179;196;81;113;31;145;78;25;2;152;124;94;180;154;158;86;75;16;175;171;44;120;101;160;34;181;195;146;22;18;108;140;23;186;15;62;9;148;137;118;59;151;133;79;63;100;26;97;167;49;3;178;106;52;55;1;53;135;127;123;65;116;115;193;159;41;5;42;43;184;131;149;162;164;7;21;144;89;183;143;0;117,8427393269717871124,0.058324
steepest_intra:nodes_start:random,14,84378,35245,49133,2421900,161,53;180;154;70;135;194;162;59;115;96;5;159;18;108;140;93;117;14;90;81;31;113;175;171;16;44;2;152;189;94;124;148;9;62;102;144;15;114;186;23;137;176;80;133;151;22;146;42;43;116;65;184;131;149;118;51;89;183;143;0;46;68;139;41;193;181;34;160;54;177;10;4;79;49;178;106;165;119;40;185;52;63;123;112;127;75;120;78;145;92;57;55;129;1;97;101;86;26;100;121,7164747877275611892,0.067558
steepest_intra:nodes_start:random,15,86154,36984,49170,2496650,166,148;37;102;49;178;3;14;138;106;52;55;2;1;101;75;44;25;78;145;92;179;196;81;90;165;62;9;15;114;183;89;57;129;97;135;70;127;112;4;177;54;48;184;16;171;175;113;31;120;152;94;176;51;118;59;41;193;159;181;42;43;131;149;162;133;180;154;53;86;26;100;121;63;79;80;137;23;186;144;40;185;123;35;160;34;22;18;108;117;143;0;46;139;115;116;65;151;124;111;167,5507191143051978300,0.090967
steepest_intra:nodes_start:random,16,89664,40567,49097,2302300,153,106;52;55;149;131;65;116;59;72;151;162;194;133;80;137;23;186;79;180;154;44;16;171;2;1;97;152;129;92;57;185;40;165;49;0;93;117;143;183;89;124;94;122;63;53;121;100;26;86;101;75;120;78;145;31;175;113;90;164;21;14;144;15;46;139;193;159;34;181;42;5;43;135;70;127;123;112;4;190;10;177;54;160;184;35;148;102;62;9;176;51;118;115;41;195;146;22;18;108;178,5975631968673485601,0.114026
steepest_intra:nodes_start:random,17,87361,36550,50811,2182700,145,113;31;78;145;179;52;55;57;1;101;86;158;154;149;131;65;162;194;135;70;127;123;112;84;184;43;115;46;117;170;0;118;59;51;151;133;79;122;148;62;49;178;106;152;97;26;100;121;53;180;177;54;160;41;193;159;22;146;195;139;198;68;93;143;183;89;186;144;14;185;40;165;90;81;175;171;16;75;63;80;176;94;124;92;129;2;189;116;5;42;181;34;103;18;69;108;140;137;120;44,5795742735971471901,0.104024
steepest_intra:nodes_start:random,18,88880,40522,48358,2541500,169,80;79;122;63;135;70;127;112;123;162;133;151;149;131;43;116;65;121;189;94;59;193;159;108;18;22;34;160;181;42;152;92;78;25;44;75;86;154;180;53;101;2;120;82;129;167;15;186;89;183;23;137;124;100;26;97;1;57;165;39;164;27;90;81;196;184;177;54;41;139;115;46;68;117;143;0;148;31;56;113;175;171;16;145;179;55;9;62;144;14;102;49;178;106;40;185;52;176;51;118,5142929231197427537,0.142000
steepest_intra:nodes_start:random,19,91711,42694,49017,1988350,132,15;102;167;152;1;101;86;75;120;44;16;78;145;2;97;26;100;131;160;34;42;5;181;146;22;18;159;43;149;129;92;57;179;185;40;31;171;175;113;90;165;124;59;65;116;68;140;93;117;143;183;89;94;63;180;135;154;158;53;79;80;133;127;123;162;151;51;109;115;41;193;139;46;0;23;186;114;144;14;49;178;106;52;55;70;112;4;190;10;177;84;148;9;62;176;184;54;48;118;137,4720392596199805635,0.068515
steepest_intra:nodes_start:random,20,89320,38937,50383,2197650,146,79;117;93;140;108;18;193;139;0;143;120;44;16;171;175;113;31;25;75;86;158;154;70;135;47;65;59;118;51;176;80;148;9;102;49;179;145;78;92;129;152;124;137;89;183;46;41;159;22;146;181;34;177;4;127;194;162;72;115;160;54;184;116;94;167;55;52;106;178;3;165;90;40;185;57;2;1;101;26;100;121;136;133;151;149;131;123;112;84;35;43;42;5;180;53;97;14;144;62;63,5719558147088697890,0.121518
steepest_intra:nodes_start:random,21,89571,40042,49529,2302300,153,65;162;123;127;70;135;158;53;152;52;55;57;129;2;80;151;133;79;63;120;78;145;92;167;193;159;59;154;180;94;124;148;62;144;14;40;185;97;26;112;4;84;184;190;10;177;54;181;195;22;146;103;34;48;160;25;31;113;175;171;16;44;75;86;101;1;196;81;90;165;106;178;49;102;9;118;115;46;170;143;183;89;0;68;140;93;117;23;186;137;176;51;139;41;5;42;43;131;149;116,4391438322236371534,0.132090
steepest_intra:nodes_start:random,22,89252,38988,50264,2048150,136,5;96;41;193;159;22;146;34;181;139;183;89;23;186;78;145;179;106;14;102;49;3;178;52;92;75;86;135;70;127;123;112;35;59;51;97;1;26;116;65;162;53;100;101;40;119;185;55;57;129;152;63;149;131;47;77;184;84;4;190;10;177;54;18;117;143;0;46;115;118;151;133;154;180;79;80;176;137;94;124;148;9;62;167;2;120;44;25;16;171;175;113;90;27;165;144;15;43;160;42,4716557567619631380,0.091999
steepest_intra:nodes_start:random,23,83804,33122,50682,2646150,176,160;34;54;177;10;190;184;181;22;18;108;143;153;183;144;14;102;148;124;53;154;180;63;122;79;80;137;0;117;68;139;46;176;94;152;2;129;92;57;49;62;9;15;186;23;89;114;138;165;90;81;196;55;52;185;40;119;106;178;167;97;26;100;86;101;1;121;133;151;72;51;109;118;59;115;41;193;159;5;42;65;162;120;44;16;171;175;113;78;145;75;135;70;127;123;149;131;47;116;43,4623609965454037984,0.077998
steepest_intra:nodes_start:random,24,89252,39893,49359,2526550,168,9;167;152;63;79;162;149;131;35;184;160;34;181;42;59;176;124;94;80;65;116;43;5;96;139;41;193;159;18;69;108;137;97;101;86;70;112;4;177;54;146;22;183;89;148;129;92;57;52;55;2;1;135;127;123;115;46;0;143;117;93;140;68;118;133;53;158;154;180;23;186;15;49;178;106;165;90;81;145;78;25;44;120;51;109;72;151;75;16;171;175;113;31;40;185;138;14;144;102;62,3937411975001242599,0.082001
steepest_intra:nodes_start:random,25,87099,38642,48457,2720900,181,41;193;159;181;42;116;65;86;120;44;25;78;196;81;90;119;40;57;1;97;152;106;178;3;102;62;9;148;123;112;4;162;151;133;180;53;101;2;129;92;167;137;117;93;108;18;22;146;139;68;46;0;143;183;89;23;186;15;144;49;55;145;31;113;175;171;16;75;70;127;135;94;124;52;185;165;138;14;118;160;34;54;177;184;59;51;176;80;79;63;121;26;100;154;149;131;43;5;96;115,4798000611985367107,0.100000
steepest_intra:nodes_start:random,26,87835,36471,51364,2661100,177,90;165;185;55;57;92;129;2;1;26;100;86;101;106;138;14;144;94;79;133;151;162;149;131;77;43;42;5;96;115;116;65;47;181;146;22;159;193;41;139;15;62;9;148;124;121;53;154;70;127;135;80;176;0;140;93;117;143;183;89;23;186;178;52;179;145;78;25;82;152;63;123;184;177;54;160;34;18;69;108;68;46;59;72;180;158;75;16;175;171;44;120;97;51;118;137;102;49;40;81,6204997870418358296,0.094186
steepest_intra:nodes_start:random,27,91685,42358,49327,2317250,154,180;154;53;63;94;124;167;178;106;52;55;176;115;5;42;59;51;148;37;49;102;62;9;80;149;131;123;127;70;135;151;118;46;198;139;68;93;117;0;143;15;144;14;133;162;112;84;184;190;10;177;54;65;185;40;119;116;43;160;34;22;193;41;21;7;164;27;90;165;179;145;31;113;175;171;16;75;86;120;44;25;78;157;81;196;57;92;129;2;1;101;26;97;152;186;23;89;183;137;79,7485409606519612388,0.071342
steepest_intra:nodes_start:random,28,88855,39799,49056,2122900,141,68;140;108;18;159;154;53;86;101;1;97;162;181;22;34;48;160;21;7;164;27;90;165;40;185;106;14;144;102;49;3;178;167;124;176;137;89;183;118;116;47;65;59;51;151;133;79;94;148;9;62;37;152;2;129;92;16;171;175;113;31;196;179;55;52;15;186;23;57;145;78;44;120;75;135;70;127;123;149;131;43;184;177;54;42;5;115;0;117;143;80;63;121;26;100;180;41;193;139;46,3126398931990907943,0.117003
steepest_intra:nodes_start:random,29,86894,37291,49603,2885350,192,59;115;41;193;69;108;18;159;42;43;149;123;135;154;70;127;112;184;160;34;22;140;93;117;143;144;138;179;145;78;2;1;101;86;26;94;124;129;92;57;55;52;185;165;39;119;40;15;89;183;0;68;139;116;65;162;151;176;137;23;186;80;79;63;180;53;100;97;152;106;178;3;49;148;46;198;118;109;51;121;75;120;44;25;167;9;62;102;14;164;27;90;81;196;31;113;175;171;16;133,4836736607655875140,0.117029
steepest_intra:nodes_start:random,30,85193,35800,49393,2810600,187,75;86;53;154;180;133;176;137;23;186;62;102;49;92;129;82;120;44;25;78;196;81;40;185;148;51;59;65;116;43;159;22;18;68;46;152;2;31;56;113;175;171;16;145;179;57;178;3;106;52;55;167;124;151;149;131;184;48;160;42;5;96;115;198;139;41;193;181;34;54;177;112;9;144;14;21;7;164;27;90;165;183;143;0;118;162;123;127;70;135;100;26;94;80;79;63;121;97;1;101,6037044959409703513,0.092543
steepest_intra:nodes_start:random,31,85747,35610,50137,2257450,150,31;56;113;25;63;51;118;137;23;186;14;138;106;178;148;176;80;79;133;135;70;154;180;158;53;86;75;44;16;171;175;81;196;52;62;9;124;94;122;151;184;160;34;54;177;112;127;121;100;26;101;120;82;145;179;92;57;55;185;40;119;90;165;144;89;183;143;0;46;68;139;41;193;159;181;42;43;65;116;22;18;108;69;115;59;149;123;162;136;182;189;102;49;167;152;97;1;2;129;78,6862979942841309215,0.086002
steepest_intra:nodes_start:random,32,88969,39214,49755,2107950,140,79;26;101;1;152;97;100;53;180;154;162;133;37;102;49;178;106;179;145;78;120;75;86;63;80;176;137;89;183;143;117;0;23;9;62;15;186;68;139;193;41;167;129;92;57;55;52;185;40;25;44;2;43;42;181;159;69;108;18;22;34;160;48;177;10;30;54;184;35;123;127;70;135;94;124;122;151;72;149;131;84;190;4;112;16;171;175;113;31;165;14;144;148;59;65;116;115;46;118;51,2624088532639886333,0.070522
steepest_intra:nodes_start:random,33,88267,39496,48771,2466750,164,79;122;167;52;185;40;119;90;165;14;183;143;117;68;139;42;160;54;177;184;16;171;175;113;31;81;196;179;92;154;135;127;123;35;84;4;112;70;120;44;25;78;145;108;18;22;146;34;181;159;193;41;115;59;72;121;26;100;53;180;131;149;162;133;151;65;116;43;158;86;75;101;1;97;152;2;129;57;55;106;178;3;49;144;186;23;89;0;46;118;51;80;176;137;62;9;148;124;94;63,8143806292204663485,0.089000
steepest_intra:nodes_start:random,34,92539,43880,48659,2377050,158,80;193;22;18;108;118;151;180;154;135;127;4;112;70;101;52;106;178;3;49;148;137;15;144;14;55;57;129;152;63;149;131;47;43;184;123;158;53;86;75;120;2;1;121;162;35;84;190;10;177;54;41;117;143;23;186;89;183;0;59;65;116;115;139;68;46;51;176;124;145;196;81;90;165;40;185;94;79;160;48;34;181;42;5;133;100;26;97;167;9;62;92;25;44;16;171;175;113;31;78,46067469708164092,0.074516
steepest_intra:nodes_start:random,35,93261,43294,49967,2302300,153,22;117;143;170;0;46;65;47;131;149;123;127;70;135;162;59;139;18;108;93;183;21;7;164;90;129;2;101;53;116;5;41;115;15;62;9;148;63;180;154;158;86;75;16;171;25;44;120;82;92;185;40;165;138;14;144;80;151;133;79;52;55;57;179;145;78;31;113;175;112;184;181;159;193;68;89;23;137;94;97;1;152;167;49;102;124;121;100;26;106;178;3;176;51;118;43;42;160;34;146,9102186025329431262,0.078233
steepest_intra:nodes_start:random,36,91710,43028,48682,1988350,132,183;89;115;193;41;5;116;51;49;178;106;167;162;123;112;127;70;75;120;78;145;179;196;81;90;165;40;185;14;144;117;18;22;159;139;140;93;68;46;57;175;171;16;63;79;122;148;9;62;15;131;35;184;190;10;177;54;160;34;181;42;43;47;65;149;59;118;72;135;154;86;129;92;25;44;2;1;97;152;94;124;55;52;31;56;113;101;26;100;53;180;80;186;23;137;176;133;151;0;143,488427502773326134,0.057969
steepest_intra:nodes_start:random,37,89353,41052,48301,2406950,160,143;117;93;140;0;23;186;167;129;25;31;56;16;44;120;75;101;86;53;180;123;184;34;22;159;193;21;7;164;90;165;52;55;57;92;179;145;78;171;175;113;196;40;119;185;106;178;49;15;68;139;46;63;97;26;162;149;131;35;112;4;177;54;160;181;41;79;152;2;1;154;70;135;133;151;72;115;69;18;108;89;144;14;62;9;148;124;94;65;43;42;5;116;59;118;51;80;176;137;183,1368925983723431838,0.085001
steepest_intra:nodes_start:random,38,85359,36737,48622,2481700,165,178;106;148;137;139;193;41;115;116;65;131;149;162;180;86;16;171;175;113;165;39;164;27;90;40;185;167;124;122;80;176;46;68;108;69;18;159;22;146;34;181;151;133;79;189;152;129;92;145;78;31;25;44;120;75;101;2;57;55;52;196;179;1;97;26;100;121;53;154;70;112;184;190;10;177;54;48;160;42;43;59;118;51;144;14;138;49;94;63;135;127;123;0;117;143;183;89;9;62;102,2286155382825904405,0.082686
steepest_intra:nodes_start:random,39,91044,42913,48131,2107950,140,5;42;41;193;159;18;108;183;21;7;164;145;78;25;44;16;171;92;143;117;22;34;181;89;144;39;90;165;138;14;102;186;23;51;149;131;123;162;101;120;175;113;31;55;52;49;178;106;185;40;196;179;57;94;80;65;116;59;176;148;9;62;15;137;43;160;48;54;177;10;184;84;112;127;70;135;154;26;97;1;152;2;129;82;75;86;100;53;180;63;79;133;151;118;46;0;68;139;115;96,2343668736223849498,0.066001
steepest_intra:nodes_start:random,40,88369,38239,50130,2421900,161,2;129;92;145;78;31;56;157;196;89;183;46;115;139;68;117;143;0;176;80;40;165;90;81;82;53;180;162;65;116;149;131;35;184;10;177;54;48;160;34;146;22;159;193;41;118;137;15;62;9;37;148;167;49;102;144;14;3;178;152;1;101;120;44;75;86;100;26;97;25;16;171;175;113;179;55;57;121;154;135;70;127;123;112;4;84;133;124;106;185;52;94;122;151;43;42;59;51;79;63,5267603207285398511,0.072722
steepest_intra:nodes_start:random,41,92536,42079,50457,1988350,132,1;101;75;120;44;25;16;171;175;113;31;62;9;54;177;10;123;127;112;4;84;35;184;160;34;42;43;47;162;136;182;63;122;94;124;137;118;59;131;149;79;178;106;52;55;57;92;179;196;145;78;129;2;86;70;135;154;158;53;180;133;151;51;176;80;97;152;148;186;183;143;117;93;68;139;115;121;26;100;5;41;193;159;18;22;146;181;144;14;165;40;185;3;49;65;116;46;0;89;23,6191792047148324588,0.076998
steepest_intra:nodes_start:random,42,88293,38296,49997,2466750,164,162;100;44;16;171;175;113;75;86;101;1;2;129;138;14;49;148;176;80;79;63;92;145;179;57;89;143;170;0;139;159;22;181;115;59;118;51;137;23;186;15;102;62;9;43;160;34;54;177;123;135;158;53;26;97;120;25;78;31;196;81;40;52;55;152;94;124;167;3;178;106;185;165;144;183;117;108;18;69;68;46;151;133;180;154;70;127;112;84;184;42;5;193;41;96;116;65;47;131;149,3301161772295320939,0.084004
steepest_intra:nodes_start:random,43,87302,39088,48214,2137850,142,72;151;162;133;176;137;23;89;183;80;79;122;63;26;100;53;154;135;70;86;97;9;62;14;138;106;185;165;90;119;40;55;52;178;49;102;57;129;92;179;145;25;44;75;101;1;2;120;16;171;175;113;56;31;78;152;116;43;54;177;10;4;112;127;123;149;65;59;51;148;196;81;144;15;186;46;42;181;193;41;139;68;0;117;93;34;160;184;180;94;124;143;108;18;22;146;195;159;115;118,3932678786627466666,0.083999
steepest_intra:nodes_start:random,44,81893,32530,49363,2421900,161,9;148;102;49;165;39;27;90;81;175;171;16;44;75;162;184;177;160;42;5;43;116;65;131;149;123;127;135;154;180;53;26;97;1;2;129;57;55;15;114;0;117;93;68;139;46;176;80;151;133;79;63;152;145;78;31;113;25;120;82;92;179;40;185;52;101;86;100;51;118;59;115;41;193;159;181;48;54;30;34;22;18;108;140;143;183;89;186;23;137;94;124;167;106;178;3;138;14;144;62,4157497300372240781,0.086512
steepest_intra:nodes_start:random,45,91909,42331,49578,2048150,136,92;159;146;181;160;54;177;184;42;5;43;116;51;176;80;79;133;112;34;103;22;18;139;46;137;9;62;15;186;23;118;59;72;94;167;106;178;49;14;165;185;57;129;101;86;53;63;122;151;65;47;149;162;180;154;135;127;123;131;96;41;193;115;75;44;120;2;152;68;93;117;143;0;153;183;89;175;171;16;25;1;97;26;100;124;148;102;144;21;164;90;81;40;52;55;179;145;31;113;78,591460217165653375,0.058514
steepest_intra:nodes_start:random,46,81968,33934,48034,2212600,147,82;129;94;80;139;41;193;159;42;116;43;160;48;54;34;181;146;22;18;108;68;46;9;62;49;55;57;92;145;179;52;185;40;119;90;27;164;21;183;143;117;0;89;23;137;51;118;115;65;35;184;177;4;112;123;127;70;135;133;79;63;152;120;44;113;175;171;16;25;78;31;157;196;81;39;165;106;178;3;138;14;144;148;176;59;131;149;162;151;26;101;75;86;154;180;53;100;97;1;2,8042314658037971395,0.066999
steepest_intra:nodes_start:random,47,86563,36759,49804,2511600,167,179;185;40;90;27;39;165;123;112;4;84;35;149;162;133;79;63;121;26;100;53;180;154;135;70;158;75;2;120;44;31;113;175;171;16;25;92;57;55;52;106;178;148;124;94;151;184;177;54;160;34;22;18;143;183;89;153;0;139;5;42;43;116;65;59;137;9;62;102;49;167;152;97;1;101;86;80;51;46;68;93;117;170;186;114;144;14;15;23;181;146;159;193;41;115;118;176;129;78;145,2399669957637277962,0.098360
steepest_intra:nodes_start:random,48,87448,37561,49887,2601300,173,40;90;165;167;124;122;131;184;112;70;158;53;100;121;63;79;151;65;47;116;42;41;193;139;115;46;68;108;18;22;146;181;34;54;160;43;149;154;86;120;44;25;31;113;175;171;16;133;162;123;127;135;180;94;102;49;3;55;57;129;75;101;26;189;137;23;186;114;15;9;62;144;14;81;196;157;78;82;2;80;176;51;59;118;0;117;143;183;89;148;92;145;179;52;106;178;152;97;1;185,4743673035112082301,0.081593
steepest_intra:nodes_start:random,49,84596,34826,49770,2347150,156,4;10;177;84;59;137;9;62;102;37;148;26;86;101;97;1;44;113;175;171;16;75;53;70;123;149;43;42;5;159;193;41;115;118;151;133;79;122;63;180;154;135;162;51;0;143;183;89;186;114;15;49;178;106;52;167;80;48;54;30;34;103;146;22;18;108;140;93;117;23;144;14;165;90;81;40;119;185;55;57;92;145;78;25;120;2;152;94;176;46;68;139;181;160;184;35;116;65;131;112,2396315489682594872,0.066999
steepest_intra:nodes_start:random,50,89277,41273,48004,2406950,160,42;181;34;160;48;54;177;184;35;133;9;62;186;159;22;112;127;123;149;115;68;140;93;0;176;94;152;97;26;121;79;69;18;108;117;143;183;89;23;100;86;75;44;16;171;175;78;92;57;3;14;49;102;144;21;164;90;165;119;40;185;179;145;25;120;101;1;2;55;52;148;137;46;139;193;41;116;65;180;53;154;70;135;63;124;167;178;106;196;113;31;129;80;51;118;59;151;162;131;43,6033538338565571141,0.068997
steepest_intra:nodes_start:random,51,83556,34276,49280,2392000,159,119;40;179;145;157;196;81;90;165;185;178;3;14;138;106;52;57;25;44;120;2;152;124;148;15;62;9;167;16;171;175;113;56;31;78;92;129;82;75;180;47;65;116;42;181;159;193;41;139;115;51;176;80;151;133;79;63;53;158;154;135;70;112;177;34;146;22;18;108;183;144;49;102;137;59;184;54;160;43;131;149;123;127;162;118;46;68;93;117;143;0;94;121;100;26;86;101;1;97;55,5467881547044047341,0.071284
steepest_intra:nodes_start:random,52,94746,46106,48640,2107950,140,184;160;43;65;151;152;145;179;185;62;15;89;183;143;0;23;137;80;133;127;123;149;59;118;115;46;51;176;49;178;106;52;55;57;92;129;167;37;148;124;94;79;63;121;100;86;101;78;31;56;113;175;171;16;75;42;181;34;54;177;135;154;180;53;26;97;1;120;44;25;2;193;159;41;116;47;131;162;196;81;40;165;117;108;18;22;139;186;144;14;21;7;164;27;90;39;138;102;9;112,987538581130600933,0.062076
steepest_intra:nodes_start:random,53,84446,35796,48650,2466750,164,160;48;54;177;10;190;84;35;131;123;135;154;180;116;41;193;159;18;108;183;89;23;186;94;121;53;86;101;75;31;113;175;171;16;129;167;9;62;15;148;124;100;26;97;1;2;185;40;179;92;152;63;79;80;176;137;144;52;55;57;82;120;44;25;78;145;90;165;14;49;178;106;70;127;112;184;146;22;68;93;117;143;0;139;42;43;65;149;162;133;151;51;59;118;46;115;96;5;181;34,1180757735310573922,0.072013
steepest_intra:nodes_start:random,54,85272,35352,49920,2586350,172,117;108;18;22;146;159;193;41;115;116;65;43;184;35;123;135;53;100;26;86;75;25;78;16;171;175;113;31;145;179;106;52;55;57;92;129;2;1;97;80;46;68;139;59;133;180;154;70;127;112;160;34;42;131;149;162;63;101;120;44;82;152;79;151;118;109;51;148;102;49;167;124;94;176;137;0;153;183;89;114;15;144;164;27;90;81;196;178;3;9;62;14;165;119;40;185;186;23;143;170,5067984161813775740,0.078001
steepest_intra:nodes_start:random,55,87826,39416,48410,2093000,139,93;117;143;0;80;94;97;1;152;167;9;62;102;49;178;106;52;55;157;196;40;165;164;7;21;144;15;137;116;160;54;34;146;22;159;181;184;112;127;123;149;43;42;5;18;69;108;79;121;100;26;57;179;145;92;101;86;53;180;115;41;193;183;89;23;186;148;129;82;25;44;120;75;154;135;162;65;59;118;51;176;14;185;119;27;90;81;113;175;171;16;31;78;2;63;133;151;46;139;68,6667841166328267413,0.060999
steepest_intra:nodes_start:random,56,89876,40141,49735,2152800,143,138;144;183;143;0;89;186;62;9;80;122;79;133;151;162;123;112;4;10;177;54;184;63;121;75;120;44;113;56;31;196;179;92;124;94;137;23;148;129;16;171;175;78;145;55;52;106;176;116;42;181;34;160;180;53;100;26;101;86;154;135;149;47;65;59;118;109;51;102;49;14;178;152;1;97;189;46;115;41;139;68;93;140;108;18;22;146;159;193;5;43;131;127;70;2;57;185;40;90;165,2480525687957848355,0.058536
steepest_intra:nodes_start:random,57,83579,33695,49884,2676050,178,120;2;1;84;4;112;135;154;180;162;65;116;149;123;127;70;86;101;75;44;16;171;175;113;57;55;52;106;178;3;14;144;114;15;148;37;9;62;102;49;167;152;97;26;100;94;124;186;89;183;23;137;176;80;51;42;34;146;22;159;193;41;139;115;198;46;68;117;143;0;79;63;121;53;158;133;151;118;59;43;184;160;48;54;177;10;129;92;40;90;165;185;179;145;196;81;157;31;78;25,5804522432344683587,0.079274
steepest_intra:nodes_start:random,58,87556,38287,49269,2780700,185,25;78;145;92;129;152;123;112;4;10;177;184;65;9;62;102;144;14;164;27;90;39;165;40;81;157;31;196;185;137;46;139;193;41;59;151;26;101;86;53;63;79;80;176;51;118;115;68;93;117;170;143;153;0;116;43;160;48;54;30;34;146;22;181;42;131;149;162;133;148;49;178;106;52;16;171;175;113;179;167;94;180;135;127;70;154;75;2;57;55;15;183;89;23;186;124;97;1;120;44,6132586191938001338,0.080003
steepest_intra:nodes_start:random,59,85473,35995,49478,2347150,156,75;86;101;1;97;152;167;178;106;55;57;2;26;100;121;63;137;183;89;23;186;148;37;3;165;119;40;185;52;124;94;79;80;0;117;68;46;118;51;176;9;62;102;49;14;138;157;31;113;175;171;16;25;44;120;180;162;149;123;127;70;135;154;158;53;179;196;81;90;144;143;18;22;34;160;181;42;5;116;65;47;43;48;54;177;4;112;184;159;193;41;139;115;59;151;133;78;145;92;129,8510964047784548797,0.070996
steepest_intra:nodes_start:random,60,85833,36644,49189,2347150,156,65;47;149;131;43;42;41;193;181;34;54;177;112;127;70;154;53;121;100;26;101;145;78;25;44;75;86;162;159;22;18;139;51;80;97;120;82;92;57;148;137;0;143;183;89;186;15;138;119;40;16;171;175;113;56;31;157;196;81;90;165;14;144;62;9;79;63;94;124;167;3;178;52;55;152;1;2;129;179;185;106;49;102;176;59;116;160;184;35;123;135;180;133;151;118;46;117;93;68;115,8622363047103379261,0.067366
steepest_intra:nodes_start:random,61,85836,36639,49197,2137850,142,54;160;181;193;139;68;117;0;143;183;15;55;52;178;49;102;62;9;148;79;135;154;158;86;101;75;70;127;112;4;84;48;34;18;108;140;93;46;151;133;180;53;100;26;97;1;152;124;94;63;122;186;89;23;137;118;59;109;51;176;80;162;123;43;22;159;16;171;175;113;31;196;106;144;14;138;165;90;40;185;57;92;120;44;25;78;145;129;2;115;41;5;42;116;65;47;149;131;184;177,4841704058109830613,0.062878
steepest_intra:nodes_start:random,62,82748,32636,50112,2392000,159,115;118;59;149;162;133;79;122;63;180;158;53;121;94;124;148;9;62;144;15;186;23;89;183;0;46;42;160;48;177;54;34;146;22;159;193;41;51;176;151;123;127;135;154;86;16;171;175;113;56;31;52;49;102;14;178;106;167;100;26;97;1;2;129;92;179;57;55;185;40;119;165;27;90;81;196;157;145;78;101;65;116;43;184;112;70;75;120;44;25;82;152;80;137;143;117;93;68;139;198,8298881131122245165,0.073898
steepest_intra:nodes_start:random,63,93684,44541,49143,2122900,141,167;124;133;35;84;112;123;79;122;63;189;97;101;44;16;171;175;113;25;75;86;184;48;160;181;42;43;116;65;78;31;157;55;52;15;186;89;183;0;118;59;51;176;129;92;120;2;1;152;57;179;145;196;81;40;119;165;185;180;154;53;100;26;121;162;149;131;151;80;9;62;148;94;135;70;127;177;54;34;22;159;193;41;139;115;137;90;27;164;21;14;144;143;117;68;46;23;49;178;106,4956469896070201265,0.064175
steepest_intra:nodes_start:random,64,87475,39371,48104,2317250,154,49;102;62;15;137;51;118;59;151;162;135;123;149;116;115;0;117;159;22;146;193;41;176;80;179;81;90;138;14;144;9;148;167;92;25;44;120;75;86;26;100;53;158;154;177;54;34;181;42;139;46;68;18;108;140;93;143;183;89;23;186;114;124;94;97;1;78;113;31;145;152;63;79;180;101;2;129;57;55;52;178;133;65;43;160;184;35;84;4;112;70;16;171;175;196;40;165;185;106;3,3196588367511950978,0.066009
steepest_intra:nodes_start:random,65,85772,35772,50000,2421900,161,149;135;154;180;122;80;46;139;41;193;159;18;108;144;14;52;129;1;97;26;100;63;79;133;151;109;51;176;148;9;62;55;57;92;145;179;106;178;49;23;117;93;140;68;2;25;78;185;165;40;31;113;175;171;16;44;120;152;94;124;137;89;183;143;0;118;59;72;162;53;101;75;86;70;127;123;184;160;34;146;22;195;181;42;5;115;116;65;43;35;84;112;4;190;10;177;30;54;48;131,4314825205173119400,0.067900
steepest_intra:nodes_start:random,66,94837,44631,50206,1719250,114,120;101;1;52;106;7;164;90;179;92;152;133;162;123;112;177;54;160;42;43;149;131;184;34;22;159;193;144;102;62;9;148;46;139;115;118;151;180;53;100;185;165;138;14;49;178;40;81;196;171;16;75;86;154;70;135;79;186;89;183;23;137;109;59;116;47;65;122;94;124;12;80;176;153;0;143;117;93;140;36;68;63;26;97;2;57;55;167;51;41;18;69;108;129;175;113;31;145;78;44,1928561242049343296,0.049272
steepest_intra:nodes_start:random,67,88857,40249,48608,2571400,171,55;57;129;2;101;53;154;135;180;63;94;124;167;106;185;119;40;81;196;157;145;152;80;79;100;26;1;92;179;178;49;137;46;139;108;18;159;22;146;103;34;160;181;42;43;116;41;193;115;62;102;9;176;59;65;184;54;177;127;70;16;171;175;113;56;31;78;97;121;162;123;112;35;131;149;118;0;143;51;151;133;86;75;44;25;120;148;15;186;23;89;183;144;14;165;39;164;27;90;52,4632542730653729483,0.075244
steepest_intra:nodes_start:random,68,90963,42481,48482,2197650,146,149;124;55;52;62;9;148;35;184;34;22;159;80;94;2;120;44;82;92;57;49;102;144;14;138;185;40;165;90;27;164;21;0;46;68;139;115;176;31;113;175;171;16;101;121;162;65;43;116;59;151;133;79;63;180;53;100;26;97;152;106;178;3;15;41;193;18;117;143;183;89;23;137;51;118;42;160;54;177;10;190;4;112;127;70;86;75;25;78;145;81;196;179;129;1;154;135;194;123;131,7700713868614035612,0.063836
steepest_intra:nodes_start:random,69,90645,42293,48352,2272400,151,25;120;2;94;151;59;118;51;148;14;138;165;81;196;145;78;92;57;55;52;106;178;49;62;9;0;46;198;5;42;43;123;127;70;135;154;53;86;101;1;180;133;162;65;116;137;23;89;183;143;108;18;69;139;115;149;131;160;34;181;41;193;68;117;93;140;163;159;22;146;171;175;113;31;129;124;176;80;79;63;100;26;97;152;102;144;21;164;90;119;40;185;184;48;54;177;112;75;44;16,2965315989296686892,0.063837
steepest_intra:nodes_start:random,70,88770,36803,51967,2272400,151,112;84;184;48;54;177;10;4;70;78;31;113;56;85;157;145;82;129;57;102;62;9;148;80;176;137;23;89;183;143;117;0;65;116;115;46;68;139;22;34;160;123;86;44;16;171;175;25;120;75;101;26;100;121;53;158;154;180;162;151;94;14;144;15;186;59;149;131;43;42;193;41;118;51;92;179;196;81;40;165;185;106;167;152;97;1;2;55;52;178;49;124;189;182;63;122;79;133;135;127,7853978451905101388,0.064651
steepest_intra:nodes_start:random,71,91461,41611,49850,2212600,147,186;137;118;51;176;171;175;113;106;49;102;148;124;189;152;2;55;52;178;3;167;94;63;53;121;100;26;86;75;101;1;97;122;79;133;180;158;120;44;16;31;157;145;179;92;78;25;129;57;196;81;90;165;154;70;135;162;151;80;185;40;119;138;14;144;193;159;22;181;42;116;59;15;62;9;35;84;112;127;123;149;65;43;160;34;54;177;10;184;41;0;183;89;46;115;139;68;117;143;23,7143516161002385982,0.063555
steepest_intra:nodes_start:random,72,88085,38747,49338,3049800,203,55;119;40;196;81;90;27;165;185;52;106;178;14;144;15;46;139;159;193;41;148;49;102;62;9;186;23;59;42;184;123;135;154;158;101;82;175;171;16;75;86;53;180;63;122;79;80;176;137;89;183;143;117;0;94;189;100;26;1;2;120;44;25;31;113;56;157;78;70;127;112;177;54;160;34;146;22;18;108;115;118;51;151;133;121;97;152;129;92;145;179;57;124;65;116;43;131;149;162;167,5799101520081827224,0.085867
steepest_intra:nodes_start:random,73,88078,38191,49887,2242500,149,90;81;40;185;120;75;86;162;65;116;131;149;123;127;70;135;133;151;153;143;117;0;115;43;184;177;54;160;34;181;193;41;5;42;84;4;112;154;180;158;53;100;101;97;26;121;63;122;79;46;68;140;93;183;89;62;52;55;57;129;2;1;152;118;198;108;69;18;199;139;137;92;145;78;25;44;16;171;175;113;31;106;178;49;148;94;80;176;51;59;159;22;146;195;23;186;144;14;165;27,4947791717276354135,0.066246
steepest_intra:nodes_start:random,74,86118,36553,49565,2347150,156,159;22;180;53;121;100;26;97;152;55;52;106;178;167;124;94;51;72;151;133;79;63;122;80;176;0;143;117;68;115;43;35;84;4;112;127;70;135;123;177;54;48;184;160;34;181;42;116;65;47;131;149;59;118;137;15;144;21;164;165;14;62;183;89;186;9;49;185;40;90;81;196;78;145;179;57;148;46;139;41;5;162;154;158;86;75;120;44;25;16;171;175;113;31;92;129;2;1;101;193,5372207872526876547,0.066642
steepest_intra:nodes_start:random,75,90352,42450,47902,2093000,139,78;31;56;113;175;49;62;183;89;23;92;171;16;75;86;70;127;112;34;146;22;18;108;68;46;51;176;178;106;81;196;145;25;44;120;129;57;21;7;164;90;40;185;94;63;180;53;124;9;144;14;138;39;165;52;55;154;135;123;149;65;116;43;160;184;35;131;59;118;0;143;117;193;159;195;41;5;42;181;48;54;177;84;162;151;133;79;100;26;97;152;167;148;137;139;115;80;101;1;2,8776389404388222493,0.090000
steepest_intra:nodes_start:random,76,85347,36234,49113,2242500,149,144;14;138;21;164;90;152;70;112;4;10;190;84;35;149;131;184;177;54;48;160;0;183;143;117;93;140;137;148;129;145;78;25;44;120;75;101;2;52;106;178;80;176;51;118;59;116;115;46;68;139;69;108;18;193;41;159;22;146;34;181;5;151;79;122;63;94;97;1;26;180;133;162;65;47;42;43;123;127;135;154;53;86;16;171;175;113;40;119;165;185;179;92;57;55;9;15;62;102;49,4823029399394249108,0.068519
steepest_intra:nodes_start:random,77,92562,43928,48634,2317250,154,55;52;106;152;63;133;123;112;177;54;34;0;183;89;114;102;49;167;124;94;80;176;15;62;9;148;122;79;151;46;68;139;160;184;35;116;65;178;3;144;143;117;93;108;18;22;146;195;43;97;1;145;78;16;171;175;113;31;81;196;92;129;2;101;86;26;53;158;154;135;70;127;162;137;186;23;115;5;42;181;159;193;41;118;185;40;90;165;138;14;51;59;131;149;180;75;120;44;25;57,2404687217196951021,0.066507
steepest_intra:nodes_start:random,78,85266,36666,48600,2646150,176,151;59;42;5;139;68;117;143;183;89;148;57;92;78;145;179;55;52;185;40;90;27;39;165;2;1;100;26;97;152;178;14;49;102;144;62;9;186;23;137;176;80;94;129;31;56;113;25;101;53;162;65;116;47;131;149;123;135;70;127;112;4;190;10;177;84;35;184;43;115;140;93;0;51;86;75;120;44;16;171;175;157;81;196;106;46;41;193;159;18;22;146;34;160;54;154;180;63;79;133,7618415154767453394,0.075508
steepest_intra:nodes_start:random,79,86448,35387,51061,2720900,181,43;65;116;5;41;193;14;165;90;40;185;52;176;80;162;123;84;4;112;70;158;53;100;26;86;75;120;44;25;16;171;175;78;145;92;15;186;23;137;51;151;133;79;121;97;101;1;152;2;129;57;55;49;102;62;9;148;135;127;177;54;160;184;35;47;131;149;154;180;63;94;124;111;167;106;178;144;114;89;183;140;108;18;69;139;198;115;59;118;46;68;0;143;117;93;159;22;34;181;42,4102663078469477982,0.076425
steepest_intra:nodes_start:random,80,85102,36310,48792,2167750,144,185;3;49;102;9;62;144;14;138;81;196;31;113;175;171;16;25;137;23;0;46;139;193;159;18;22;181;160;184;43;116;59;51;176;80;63;97;26;100;53;154;135;70;44;120;180;149;131;47;65;151;86;75;101;1;118;115;41;42;34;54;177;112;123;162;133;79;94;124;148;15;186;89;117;143;183;114;21;7;164;95;167;152;2;82;78;145;179;92;129;57;55;52;178;106;165;27;90;119;40,7300770074935128434,0.059998
steepest_intra:nodes_start:random,81,86587,37705,48882,2765750,184,54;177;165;90;81;196;145;78;25;44;120;129;9;62;144;14;49;3;178;106;167;124;94;63;180;158;53;100;26;1;97;137;23;143;117;108;18;22;159;193;139;198;59;162;123;127;112;4;84;184;43;116;65;131;149;151;133;79;152;92;57;55;52;185;40;148;176;51;118;115;41;5;42;70;135;154;101;2;31;113;175;171;16;75;86;121;122;80;46;68;140;93;186;114;89;183;0;181;34;160,151429925113534620,0.079583
steepest_intra:nodes_start:random,82,90463,41164,49299,2257450,150,167;122;79;133;151;149;131;123;70;127;112;4;84;35;135;154;53;100;26;101;86;180;162;65;116;5;115;118;51;80;94;124;148;186;89;183;143;153;23;9;49;178;106;55;57;145;78;120;92;129;2;152;1;97;121;184;160;181;146;159;198;46;176;75;44;16;171;175;113;31;196;52;137;68;139;193;41;42;43;47;59;144;14;102;62;15;0;117;108;18;22;34;54;177;10;63;165;90;40;185,6712712586110662395,0.062999
steepest_intra:nodes_start:random,83,89354,40645,48709,2646150,176,154;116;5;41;193;159;22;18;108;68;46;80;26;75;16;171;175;113;31;2;43;42;181;34;160;54;177;184;112;70;135;63;79;133;162;123;127;122;124;167;3;178;106;52;145;78;25;44;120;152;176;140;93;117;137;94;97;1;101;86;53;149;131;47;65;59;51;148;9;15;114;89;183;143;0;23;186;144;21;7;164;55;57;129;92;185;40;90;27;165;14;49;102;62;139;115;118;151;180;158,3246210932937828289,0.073998
steepest_intra:nodes_start:random,84,84460,34902,49558,2631200,175,159;146;181;160;43;42;5;41;193;139;68;46;118;59;109;51;151;133;100;26;101;75;78;113;56;31;145;179;57;92;129;120;44;16;171;175;196;40;185;106;52;55;2;1;86;158;154;180;53;97;152;189;121;63;122;79;80;176;0;143;183;89;137;135;70;127;123;149;131;112;84;184;177;54;34;22;18;108;117;9;62;144;14;49;102;148;116;65;47;162;94;167;178;165;90;21;15;186;23;115,8401423048599417165,0.074788
steepest_intra:nodes_start:random,85,93759,44977,48782,1943500,129,143;117;68;198;115;116;149;123;135;154;53;23;186;114;15;124;100;26;97;106;178;148;176;51;41;193;181;42;151;80;167;179;31;113;175;171;16;78;145;120;101;159;199;69;18;22;146;34;54;160;86;75;44;25;92;57;14;144;62;137;46;139;108;140;93;0;52;55;152;1;2;129;40;90;165;185;49;9;94;127;112;4;190;10;177;70;180;63;79;133;162;35;184;43;47;65;59;118;89;183,6444139981794919352,0.054648
steepest_intra:nodes_start:random,86,89942,41779,48163,2212600,147,34;160;70;154;180;53;86;26;63;79;46;139;18;108;117;143;0;68;198;115;116;149;123;127;135;133;162;35;184;131;151;167;106;185;40;138;14;102;148;176;51;118;59;5;42;43;47;65;152;179;196;81;78;25;44;82;129;92;145;31;113;175;171;16;57;55;52;15;186;89;183;23;94;97;1;2;120;75;101;41;146;22;159;193;137;49;178;165;90;164;21;144;62;9;80;112;4;177;54;48,8062496687414905975,0.061999
steepest_intra:nodes_start:random,87,90345,40308,50037,2332200,155,41;193;139;198;115;47;65;59;176;9;62;102;49;167;26;100;121;53;180;133;151;43;160;184;84;112;127;70;101;1;120;25;78;145;31;113;175;171;16;44;75;86;158;154;135;123;177;54;48;34;146;159;68;15;144;14;138;106;152;97;2;179;40;165;185;52;80;51;46;0;183;89;23;118;116;5;42;181;22;18;108;93;117;143;186;55;57;92;129;124;94;79;149;131;162;63;178;3;148;137,836690195536531187,0.065278
steepest_intra:nodes_start:random,88,83578,35244,48334,2332200,155,75;86;100;26;1;97;94;124;152;2;120;44;25;78;145;92;129;63;133;151;162;154;180;79;80;176;51;109;118;139;108;18;22;34;160;54;177;184;84;112;131;149;65;116;41;193;159;146;181;42;43;115;46;68;117;143;0;137;9;49;178;106;16;171;175;113;31;57;167;23;183;89;186;62;102;14;81;196;179;59;123;127;135;53;55;52;185;40;119;165;90;27;164;21;144;73;114;15;148;101,4992358999968517763,0.065475
steepest_intra:nodes_start:random,89,87042,38335,48707,2541500,169,70;127;112;4;177;54;123;135;86;75;120;44;82;124;137;0;117;143;92;145;179;52;15;114;186;23;89;183;144;14;1;101;26;97;152;9;62;3;106;178;148;176;51;46;68;140;108;18;159;193;41;139;198;115;43;184;160;34;22;181;42;151;133;162;149;131;65;116;59;118;80;102;49;55;57;129;2;100;121;53;154;180;63;79;122;94;167;185;40;165;90;81;196;16;171;175;113;31;78;25,3707834238024708952,0.073533
steepest_intra:nodes_start:random,90,90789,42158,48631,2571400,171,184;54;177;4;75;16;171;78;145;106;49;102;52;55;120;44;25;175;113;56;31;157;81;90;196;179;92;180;154;135;127;70;158;53;86;101;2;129;57;167;148;93;108;18;22;193;43;35;84;112;123;162;133;63;79;151;149;160;34;181;42;116;65;59;9;62;138;165;40;185;152;94;80;176;137;23;186;114;89;183;0;139;41;115;118;100;26;1;97;51;46;68;117;143;144;14;3;178;124;131,3122089072756882788,0.074295
steepest_intra:nodes_start:random,91,85089,34427,50662,2242500,149,178;106;52;49;15;89;183;143;46;42;5;139;198;115;118;59;184;177;54;34;103;146;199;69;108;18;20;22;195;159;68;0;23;186;137;51;72;151;162;133;100;26;97;1;101;86;75;44;25;16;171;175;113;90;165;119;40;185;55;57;124;94;135;123;149;131;65;116;43;41;193;181;160;112;70;154;180;53;63;79;80;176;152;2;78;31;145;92;82;120;129;167;148;140;93;117;9;62;144;14,6149908885018179560,0.063637
steepest_intra:nodes_start:random,92,92298,43822,48476,2107950,140,123;154;86;75;178;106;52;55;57;167;148;9;62;179;145;31;56;78;183;143;117;93;51;26;101;100;121;65;43;160;48;54;34;181;193;41;139;115;59;180;53;120;113;175;171;16;44;25;196;40;185;112;4;177;184;35;127;70;135;72;118;46;0;89;23;137;80;122;63;94;124;176;68;108;18;22;159;42;116;151;97;1;2;129;92;49;14;138;165;90;27;164;21;144;152;79;133;162;149;131,8654793260861883389,0.059250
steepest_intra:nodes_start:random,93,87191,36781,50410,2362100,157,185;137;139;41;193;181;34;160;135;154;180;162;43;42;159;22;18;108;117;143;0;46;115;184;84;112;131;149;59;72;158;53;82;31;56;75;70;127;123;47;65;116;118;51;151;133;63;100;26;86;120;44;25;196;81;157;113;175;171;16;78;145;179;106;3;178;52;55;57;2;101;1;97;189;94;152;129;92;167;148;23;183;89;186;15;62;102;49;14;144;9;176;80;79;124;165;27;90;119;40,3688821933590695008,0.066239
steepest_intra:nodes_start:random,94,88557,39846,48711,2571400,171,175;171;162;65;116;46;0;143;117;68;159;22;181;42;43;123;127;135;154;180;167;138;14;102;51;118;115;69;18;108;93;183;89;37;57;44;25;16;78;145;179;92;129;26;100;121;53;63;122;94;124;114;186;23;139;193;41;137;15;62;49;3;178;106;185;165;90;164;21;144;9;148;176;80;79;133;151;59;160;34;54;184;112;70;86;75;120;2;101;1;97;152;55;52;40;81;196;31;56;113,8333584616182721108,0.070341
steepest_intra:nodes_start:random,95,87494,38527,48967,2541500,169,35;112;123;127;135;154;180;162;47;43;184;54;34;160;131;133;63;53;100;26;86;75;120;44;129;106;178;49;15;186;0;68;139;198;59;118;51;23;89;183;143;117;108;18;193;41;42;181;146;22;159;102;14;138;3;167;65;116;115;46;137;148;196;81;113;31;179;57;92;145;78;175;171;16;25;101;121;122;80;176;9;62;144;21;7;164;90;165;40;185;52;55;2;1;97;152;94;79;151;149,2588325474030261203,0.072513
steepest_intra:nodes_start:random,96,85541,34187,51354,2018250,134,137;0;93;117;143;183;89;114;62;9;15;186;23;80;135;70;154;180;63;136;182;121;189;94;124;167;52;55;57;145;78;31;113;175;171;16;25;44;65;116;59;51;176;185;40;119;138;14;144;3;106;178;49;102;148;26;100;122;79;133;151;162;123;184;160;34;193;41;139;68;46;115;149;131;43;42;181;22;146;54;177;112;127;194;158;53;86;101;75;120;2;1;97;152;165;90;81;196;92;129,8238802667941129658,0.056001
steepest_intra:nodes_start:random,97,86816,36949,49867,2272400,151,68;139;5;42;22;146;34;160;184;177;4;112;127;144;14;3;178;106;185;52;152;26;100;121;63;122;79;180;53;101;75;86;154;135;70;149;43;41;193;159;18;108;143;183;89;55;57;92;145;179;196;157;31;78;129;133;123;162;151;80;167;49;102;62;9;15;148;124;94;97;1;2;120;44;25;16;171;90;27;39;165;119;40;81;113;175;46;115;116;47;65;59;118;109;51;176;137;0;117;93,4160563683379366990,0.084010
steepest_intra:nodes_start:random,98,84257,35025,49232,2750800,183,43;5;42;160;34;146;195;181;41;193;159;22;18;117;0;143;144;178;106;185;145;78;113;175;171;16;97;26;53;158;180;133;79;63;94;124;49;14;138;40;119;165;39;90;27;164;7;21;59;116;65;131;149;162;151;80;148;102;62;9;15;186;89;183;137;167;129;92;57;52;55;2;1;152;176;51;118;46;68;139;115;123;135;154;86;75;44;25;120;101;70;127;112;4;10;177;54;184;84;35,5710250589683745440,0.093992
steepest_intra:nodes_start:random,99,89893,40259,49634,2421900,161,152;129;78;145;40;185;137;118;131;149;162;135;154;180;53;86;158;70;127;123;115;68;117;143;183;89;44;25;16;171;175;113;62;9;124;26;100;121;133;151;59;116;65;35;112;4;10;177;54;160;181;42;5;41;193;139;93;140;108;69;18;159;22;34;184;43;186;15;148;37;167;55;57;92;120;75;101;102;49;178;106;52;2;1;97;63;79;51;46;0;23;144;14;39;90;165;138;176;80;94,1283814020780384178,0.086517
steepest_intra:nodes_start:random,100,87796,38448,49348,2063100,137,86;1;49;138;95;164;7;21;186;41;193;139;68;46;151;133;162;112;84;184;160;34;181;42;43;115;118;51;176;148;37;9;62;57;129;2;101;75;120;78;145;179;52;106;3;178;55;92;25;44;16;171;175;113;31;124;94;79;65;116;47;135;154;180;22;18;108;117;0;143;183;89;23;80;63;53;100;26;97;152;167;102;144;14;185;196;81;40;119;165;90;39;15;137;59;149;131;123;127;70,7496566236426457127,0.076995
steepest_intra:nodes_start:random,101,84406,35068,49338,2317250,154,40;119;185;179;92;145;78;31;25;44;120;2;152;124;94;189;121;180;135;154;158;53;86;75;101;100;26;97;1;129;57;55;89;183;143;0;118;59;65;116;43;5;42;181;41;193;159;22;18;108;46;176;80;79;133;194;127;112;184;177;54;34;160;148;14;138;49;167;63;151;162;72;51;137;186;15;144;102;62;9;23;117;68;139;115;131;149;123;70;16;171;175;113;196;52;178;106;165;90;81,6039549702094875526,0.072001
steepest_intra:nodes_start:random,102,89645,40148,49497,2466750,164,179;92;129;152;97;26;100;86;75;101;1;189;63;184;177;54;34;146;22;18;108;0;49;119;40;185;106;167;151;65;116;115;139;46;51;176;55;52;183;143;117;68;41;193;159;181;160;42;43;133;79;122;94;25;78;31;113;175;171;16;145;178;14;144;114;23;186;15;102;62;9;137;118;59;149;131;112;70;154;135;127;123;162;80;148;165;90;81;196;44;120;2;121;53;158;180;136;182;124;57,475552201157204664,0.076577
steepest_intra:nodes_start:random,103,91938,42726,49212,2601300,173,152;97;121;136;133;59;18;22;146;195;159;193;41;115;51;78;145;81;90;165;14;144;23;68;139;46;118;151;79;122;94;124;148;9;62;15;162;112;4;10;177;54;84;70;16;171;175;113;31;89;183;143;0;117;93;116;149;123;127;135;86;75;44;25;120;65;43;5;42;181;34;160;48;184;35;154;101;129;92;57;106;178;49;137;176;80;63;180;158;53;100;26;1;2;82;179;40;185;52;55,4245069570008058332,0.075121
steepest_intra:nodes_start:random,104,87048,37548,49500,2377050,158,109;51;80;121;97;1;2;129;92;57;94;63;122;79;151;159;22;146;34;54;177;101;75;120;16;171;175;113;31;44;25;78;145;179;185;40;165;90;81;196;176;59;118;137;15;3;178;106;14;144;49;102;62;9;148;133;162;149;131;77;47;65;116;43;42;115;139;68;108;18;193;41;181;160;184;127;135;180;152;55;52;123;35;84;112;154;53;86;100;26;124;114;186;23;89;183;143;117;0;46,5347406024473912864,0.066988
steepest_intra:nodes_start:random,105,93835,44637,49198,2212600,147,75;101;97;80;46;68;0;129;175;171;16;44;2;152;79;133;180;154;135;127;123;177;54;34;146;22;18;108;69;159;181;51;176;148;9;144;14;138;102;62;15;186;23;116;42;5;115;183;89;118;59;96;41;193;139;137;179;196;81;90;165;119;40;185;106;178;167;124;94;122;63;100;26;1;57;55;52;151;149;184;160;43;65;162;120;25;113;56;31;78;145;92;49;114;140;93;117;143;53;86,2246657400910066575,0.060878
steepest_intra:nodes_start:random,106,83859,35239,48620,2048150,136,41;193;159;181;34;146;22;18;108;143;183;89;21;7;164;52;167;124;94;189;152;1;97;26;121;63;79;80;133;151;162;149;131;123;127;70;135;154;180;53;100;86;101;16;171;175;81;90;40;55;57;92;145;31;113;78;2;75;120;44;25;129;148;9;62;144;14;138;39;165;185;114;186;23;137;115;116;43;42;160;54;177;184;65;176;106;178;49;102;15;118;59;109;51;0;117;93;68;46;139,6282741814616267173,0.058294
steepest_intra:nodes_start:random,107,91781,42325,49456,2287350,152,89;144;49;178;106;167;80;149;131;123;127;135;154;26;97;1;129;92;145;78;152;160;34;43;51;55;52;102;23;46;68;139;41;42;84;112;4;177;54;184;70;86;101;2;185;90;27;164;14;138;165;119;40;81;196;25;44;120;62;9;137;176;151;162;72;59;118;115;193;159;22;181;116;65;47;133;94;57;179;157;31;113;175;171;16;75;100;63;122;79;180;53;124;148;15;186;0;117;143;183,2982205740331311167,0.062333
steepest_intra:nodes_start:random,108,84074,34417,49657,2272400,151,26;100;86;92;179;145;78;82;120;44;16;171;175;113;124;41;193;42;43;123;127;135;180;63;122;176;80;79;133;151;59;118;109;51;94;121;136;162;149;131;65;116;139;68;0;89;183;143;117;108;18;22;46;23;186;114;15;137;115;181;34;160;54;177;184;112;70;154;158;53;75;25;31;196;81;90;27;165;40;185;106;178;3;14;144;49;102;62;9;148;167;152;1;101;2;129;57;55;52;97,5625581745504730121,0.062520
steepest_intra:nodes_start:random,109,87060,36501,50559,2018250,134,184;160;34;59;118;137;23;186;15;148;124;122;79;180;53;158;154;135;70;127;149;65;116;47;131;35;84;4;112;115;68;93;117;143;183;89;144;14;138;40;185;179;92;31;56;157;81;196;145;78;16;171;175;113;90;165;106;94;63;136;182;121;100;26;80;176;51;46;139;159;193;41;97;1;101;129;57;55;52;178;49;62;0;18;22;146;181;42;43;162;151;133;152;2;120;25;44;75;86;123,7602510417367003034,0.057589
steepest_intra:nodes_start:random,110,95342,44303,51039,2063100,137,190;10;177;84;35;184;160;34;22;18;69;108;93;176;122;100;26;1;2;129;145;78;175;171;16;44;101;133;5;42;127;70;135;154;180;121;55;185;40;90;165;89;183;143;181;48;30;54;131;149;151;80;167;178;49;102;116;43;47;65;148;9;62;137;193;159;41;53;86;75;120;92;57;52;106;14;144;186;23;51;109;198;139;115;118;79;63;97;152;124;94;0;117;68;46;59;162;123;112;4,1817929634883556046,0.056410
steepest_intra:nodes_start:random,111,86357,37729,48628,2182700,145,184;160;42;59;80;94;124;57;179;145;78;92;129;2;1;101;100;26;97;49;102;144;14;178;52;55;70;10;177;54;48;34;181;180;16;171;175;113;31;196;81;90;165;119;40;185;106;167;63;79;133;51;46;68;117;0;143;183;89;162;123;24;84;190;4;112;127;135;154;53;86;75;44;25;120;152;139;69;108;18;22;159;193;41;115;118;137;15;62;9;148;176;151;149;131;47;65;116;43;35,2859731185664330330,0.060998
steepest_intra:nodes_start:random,112,89674,40715,48959,2332200,155,117;0;176;121;26;100;53;180;154;135;123;149;131;47;105;116;65;59;118;109;51;80;152;2;120;78;145;92;129;143;93;108;18;22;146;159;167;57;55;52;106;178;21;7;164;90;165;40;185;31;113;175;171;16;44;112;4;10;177;54;48;193;46;183;89;115;42;43;127;70;86;75;101;1;97;160;34;181;137;15;9;62;144;14;49;102;148;124;94;63;79;133;151;162;35;84;184;41;139;68,8439428975867846827,0.066608
steepest_intra:nodes_start:random,113,84246,36019,48227,2720900,181,65;116;41;193;159;22;18;108;140;68;46;115;59;118;51;79;63;121;53;180;154;70;127;112;184;181;160;48;177;54;34;146;195;139;117;143;0;97;1;120;25;44;75;86;26;101;2;129;92;40;119;185;152;80;176;137;183;89;23;148;57;179;145;78;31;16;171;175;113;196;81;90;27;165;100;135;123;131;43;42;5;102;14;144;114;186;15;9;62;49;55;52;106;178;167;94;133;151;162;149,7390154691768424452,0.074816
steepest_intra:nodes_start:random,114,87820,40174,47646,2317250,154,3;178;106;52;179;145;129;2;152;53;127;112;84;131;149;65;116;42;5;41;193;159;34;160;184;35;75;120;78;196;165;39;164;21;144;62;9;148;94;80;176;51;162;180;154;135;123;43;181;146;22;59;31;175;113;56;81;90;40;185;55;57;92;82;25;171;16;44;63;79;151;133;100;26;97;1;101;86;70;4;10;177;54;46;0;143;183;89;186;23;137;118;115;139;18;108;117;15;49;14,1776039915491662945,0.065000
steepest_intra:nodes_start:random,115,83818,34485,49333,1958450,130,94;63;116;43;42;159;193;41;115;23;137;176;59;160;48;177;54;34;146;22;18;108;140;68;139;184;84;4;112;123;127;70;135;154;158;86;49;62;9;148;79;162;35;77;105;65;47;131;149;151;80;144;14;138;90;81;129;2;101;75;120;78;145;185;40;165;106;178;52;55;57;92;25;44;16;171;175;113;31;157;196;15;186;89;183;143;117;0;46;118;51;133;180;53;100;26;97;1;152;124,2565832196809262793,0.052999
steepest_intra:nodes_start:random,116,88677,38777,49900,2436850,162,179;145;157;31;78;92;57;55;178;49;167;122;80;148;102;144;14;138;3;106;52;129;124;94;63;79;133;180;154;53;86;44;25;16;171;175;113;81;90;114;186;89;93;108;18;22;34;160;43;116;65;59;137;23;15;62;9;176;151;162;194;135;70;127;123;41;193;159;139;46;68;117;0;143;183;21;7;164;152;97;26;100;101;75;120;82;2;1;121;112;184;42;115;51;185;165;39;119;40;196,98598530308217106,0.068617
steepest_intra:nodes_start:random,117,87579,38950,48629,2347150,156,75;101;1;97;63;79;133;121;100;26;55;52;185;40;106;178;51;118;59;116;43;5;115;46;198;139;22;159;193;41;148;49;102;144;62;9;15;186;23;89;183;108;69;18;34;177;10;4;112;162;176;137;0;143;117;68;42;160;54;184;35;179;196;81;90;165;138;14;167;124;152;129;92;145;78;25;86;70;127;123;135;154;158;53;180;149;131;65;151;80;94;57;31;113;175;171;16;44;120;2,6469466674181500649,0.066431
steepest_intra:nodes_start:random,118,87499,38841,48658,2661100,177,0;89;62;9;124;53;180;154;70;127;112;177;54;184;123;97;1;2;129;82;120;44;25;16;56;31;78;183;143;117;68;139;115;59;118;51;80;167;185;40;119;90;164;21;144;102;49;55;52;106;138;14;186;23;137;176;148;3;178;165;81;196;157;113;175;171;26;100;63;79;133;162;131;149;151;122;94;152;57;92;179;145;75;101;86;158;135;160;34;22;18;108;159;193;41;116;65;43;42;46,8070793130963490645,0.073957
steepest_intra:nodes_start:random,119,89760,41182,48578,2093000,139,137;5;42;129;92;179;106;178;3;14;49;62;23;0;18;108;93;117;170;143;183;89;15;9;148;152;97;1;101;86;26;53;121;94;63;122;80;79;133;151;162;123;149;184;177;10;4;112;16;171;175;113;81;90;165;40;185;52;55;57;2;75;154;180;118;59;65;47;116;43;160;48;54;84;127;135;120;44;78;31;196;145;124;176;51;115;41;193;181;34;22;159;139;68;46;186;21;7;164;144,5748383040417475548,0.059473
steepest_intra:nodes_start:random,120,88592,40412,48180,2451800,163,135;154;180;63;79;133;151;162;47;43;116;65;59;118;26;120;78;44;75;101;2;129;57;185;90;27;164;21;62;9;15;114;186;23;89;183;143;117;108;18;22;34;160;181;42;123;127;70;53;55;52;138;14;144;0;159;54;177;4;112;86;16;171;175;113;31;106;178;49;167;152;1;97;94;80;176;51;137;148;102;165;119;40;81;196;179;145;92;41;193;139;68;46;115;184;84;35;131;149;194,4058040702026754005,0.069001
steepest_intra:nodes_start:random,121,85304,35097,50207,2197650,146,120;44;25;78;145;57;3;49;102;62;9;51;118;59;115;46;153;183;89;23;137;162;149;65;116;43;42;181;159;193;41;139;68;0;186;148;167;152;97;26;86;101;1;2;129;92;40;119;185;52;55;124;94;121;100;178;106;165;14;144;15;114;143;117;93;140;184;35;123;135;70;127;112;4;177;54;48;160;34;22;18;108;151;133;79;80;176;122;63;171;175;113;56;31;16;158;154;180;53;75,7506192545601788658,0.059999
steepest_intra:nodes_start:random,122,87645,37716,49929,2586350,172,35;184;160;34;181;42;124;167;57;92;25;44;120;2;152;63;122;80;59;43;54;177;4;112;123;127;86;75;101;26;100;41;193;139;137;148;178;106;185;40;119;27;90;179;145;78;16;171;175;113;55;52;23;0;46;115;118;51;176;94;189;121;53;65;116;5;159;22;18;143;183;89;186;9;62;102;49;144;14;138;165;81;196;157;56;31;129;1;97;158;154;70;135;180;79;133;151;162;149;131,687691649531384644,0.074339
steepest_intra:nodes_start:random,123,91933,43312,48621,2481700,165,1;101;53;180;135;127;4;112;70;154;86;2;129;92;179;196;81;90;165;52;55;57;120;44;25;113;31;78;145;62;9;15;186;35;184;160;34;54;177;106;185;40;49;23;0;46;198;68;117;143;183;89;114;144;14;3;178;148;5;42;159;18;108;69;139;59;151;133;121;100;26;152;124;94;79;80;176;137;51;118;115;41;193;195;22;146;181;43;162;171;175;16;75;123;149;131;116;65;63;97,1036124784709561553,0.095998
steepest_intra:nodes_start:random,124,94014,44379,49635,2078050,138,54;177;84;53;101;120;25;31;157;78;145;92;106;178;49;102;118;181;34;160;184;123;86;75;16;175;171;44;2;151;72;51;176;9;62;179;196;56;113;70;112;4;127;135;129;57;55;52;185;165;40;81;90;27;164;7;21;152;1;97;121;79;80;137;89;183;143;170;117;0;144;14;138;167;124;94;63;180;154;162;149;131;65;116;59;133;100;26;148;186;23;46;68;139;115;43;42;41;193;22,3677960865394729392,0.075000
steepest_intra:nodes_start:random,125,91591,42872,48719,1943500,129,193;159;22;146;55;52;143;117;93;68;46;118;109;51;176;94;152;2;129;57;167;0;140;36;108;18;69;139;115;43;42;160;54;184;131;149;123;127;70;154;53;63;79;133;180;135;112;177;34;181;137;21;7;14;102;80;151;59;116;65;162;97;1;101;26;100;124;148;15;9;62;49;178;106;92;78;145;40;185;138;144;114;183;89;23;186;165;90;81;31;113;175;171;16;25;44;120;75;86;41,2071451971522773042,0.067999
steepest_intra:nodes_start:random,126,86919,38711,48208,2556450,170,146;103;34;54;177;4;154;180;100;26;139;22;159;193;41;115;124;129;92;57;179;145;31;78;1;97;152;148;9;62;167;2;120;44;25;16;171;175;113;75;101;86;53;133;162;151;176;80;79;135;70;127;123;112;84;35;68;117;143;0;46;118;59;65;116;43;42;181;18;69;108;183;89;137;122;63;94;55;52;106;178;49;15;23;186;144;185;119;40;196;81;90;165;138;14;102;51;149;184;160,6882853270750651782,0.086002
steepest_intra:nodes_start:random,127,91428,41575,49853,2063100,137,3;178;106;185;165;39;119;40;81;196;56;113;175;171;88;16;25;44;120;70;123;184;160;42;43;149;135;154;180;53;26;97;1;152;2;75;101;86;100;108;18;159;22;34;54;177;78;31;145;9;15;186;114;21;164;27;90;46;139;193;41;115;118;109;51;80;176;0;143;137;148;167;129;92;179;49;102;144;14;52;55;57;124;94;59;116;65;162;133;63;122;79;151;68;93;117;183;89;23;62,3457198953739106608,0.066000
steepest_intra:nodes_start:random,128,93815,45247,48568,2152800,143,118;1;16;171;175;113;31;70;127;184;160;43;162;53;86;44;25;78;145;120;75;101;26;100;121;122;80;176;108;69;18;22;146;159;193;92;196;81;40;165;185;57;97;63;133;151;65;116;115;198;68;117;143;0;137;2;129;167;148;23;183;89;186;52;55;152;79;51;46;139;41;96;5;42;181;34;54;177;112;106;178;49;102;62;9;15;144;21;164;90;14;124;94;136;180;154;135;123;149;59,2096970385318897845,0.076010
steepest_intra:nodes_start:random,129,88849,39885,48964,2601300,173,1;2;129;92;57;148;89;183;137;51;109;118;115;41;193;159;181;123;135;70;127;112;35;131;149;117;143;0;176;80;122;63;189;97;152;165;39;27;90;81;113;175;171;16;31;179;55;52;106;178;14;144;46;42;43;9;62;49;185;119;40;196;145;78;124;94;79;151;59;116;65;133;121;26;101;120;25;44;75;86;100;53;180;154;184;54;177;10;190;4;84;139;68;140;108;18;22;34;160;162,6725405481494721851,0.087999
steepest_intra:nodes_start:random,130,88563,38589,49974,2451800,163,93;117;0;109;51;144;14;185;40;90;27;165;138;114;143;139;41;193;159;181;160;34;22;18;69;108;68;46;63;121;100;86;75;120;78;196;81;49;102;148;80;176;15;9;62;55;57;92;129;2;133;151;72;65;43;116;59;118;122;94;124;167;178;106;52;179;145;31;113;175;171;16;25;44;162;47;131;149;180;53;26;101;1;97;152;186;89;183;23;137;79;154;135;70;127;123;112;184;42;115,3751725657392657847,0.077003
steepest_intra:nodes_start:random,131,83548,34237,49311,2197650,146,100;53;158;70;135;154;180;183;143;0;116;65;47;184;160;34;48;54;177;10;4;112;84;35;123;127;185;119;40;129;2;152;97;1;120;44;25;92;57;167;124;162;149;131;43;42;41;139;68;46;118;59;115;193;181;146;22;159;18;117;137;94;26;86;101;75;145;196;165;90;81;31;113;175;171;16;78;179;138;14;144;102;49;3;178;106;52;55;62;9;148;122;79;133;151;51;176;80;63;121,3949779130397257584,0.078023
steepest_intra:nodes_start:random,132,91060,43101,47959,2392000,159,78;31;113;175;171;16;44;120;75;86;133;151;115;41;193;159;22;139;68;114;62;9;15;186;23;89;183;117;93;108;18;102;49;3;178;106;152;1;97;137;143;0;46;118;59;65;47;116;43;42;5;51;176;80;148;14;165;119;40;185;55;57;92;129;26;100;53;180;154;135;70;127;112;184;181;34;160;48;54;177;52;90;39;167;162;149;131;123;101;145;196;81;164;21;144;94;79;63;2;25,736856451488947390,0.075628
steepest_intra:nodes_start:random,133,93139,44461,48678,2167750,144,84;112;70;16;171;175;120;1;97;55;57;92;75;101;86;80;46;68;140;93;165;40;90;81;113;31;52;106;178;49;186;23;159;22;146;181;53;121;100;26;94;137;0;117;143;183;89;124;152;2;129;82;44;25;78;145;185;138;14;144;115;193;41;5;42;116;151;180;154;135;127;123;149;131;184;48;160;43;47;65;59;118;139;108;18;34;54;177;10;51;176;62;9;148;122;63;79;133;162;35,8222940301047962316,0.065998
steepest_intra:nodes_start:random,134,86665,37654,49011,2242500,149,149;162;133;167;55;57;92;25;78;31;113;175;171;16;44;193;159;22;18;143;183;89;62;9;124;94;180;154;35;184;54;30;181;42;5;59;151;176;51;118;41;195;146;34;160;48;177;4;112;70;75;120;129;2;152;1;97;79;63;100;26;101;86;53;135;127;123;80;148;49;52;179;145;157;196;81;185;106;178;3;138;165;119;40;90;27;164;14;144;186;23;137;0;46;139;115;43;116;65;131,9140325062857501221,0.077998
steepest_intra:nodes_start:random,135,91832,41723,50109,2182700,145,189;94;186;23;137;176;80;79;133;135;194;127;123;149;131;47;43;42;68;0;183;89;122;180;154;158;53;100;26;121;151;162;65;41;193;22;18;117;143;15;52;55;124;184;54;34;160;116;59;148;3;178;106;185;40;57;2;152;167;37;9;62;144;102;49;14;165;90;81;196;179;145;78;92;129;46;139;115;118;51;63;101;120;44;75;86;70;112;84;177;10;4;16;171;175;113;31;25;1;97,7301346656442438920,0.063548
steepest_intra:nodes_start:random,136,84457,35406,49051,2018250,134,145;52;178;9;62;144;14;138;90;27;164;95;39;165;81;196;179;57;55;167;176;51;109;137;23;89;183;46;116;43;42;181;160;184;131;149;65;139;68;117;143;0;124;97;1;101;129;92;40;185;106;3;49;102;37;148;2;120;31;56;113;175;171;16;152;94;118;59;115;41;193;159;18;22;34;54;177;127;100;26;162;123;112;84;35;151;133;80;79;63;180;135;70;154;53;86;75;44;25;78,8901088215289946334,0.062080
steepest_intra:nodes_start:random,137,88042,38761,49281,2242500,149,151;79;165;39;27;90;31;113;175;171;16;44;120;75;2;129;57;167;148;80;176;93;140;108;69;18;199;159;193;41;115;59;118;51;46;139;68;0;23;9;62;49;52;145;78;101;86;100;26;55;185;40;106;178;89;183;143;117;22;146;181;42;63;189;97;1;152;124;94;53;158;154;135;127;123;112;4;84;35;131;149;162;133;180;121;92;179;196;81;14;144;137;116;160;34;54;177;184;43;65,8332643428805733538,0.064556
steepest_intra:nodes_start:random,138,85747,36055,49692,2227550,148,171;175;113;31;49;102;144;62;9;51;109;72;59;118;46;68;139;198;115;5;42;181;34;22;18;108;159;43;123;135;120;44;25;81;90;27;119;40;185;165;39;138;106;55;57;129;2;75;86;53;63;122;79;133;162;149;131;160;54;184;84;112;70;154;180;176;0;117;93;193;41;116;65;151;80;94;97;101;1;152;148;186;23;89;183;143;137;92;145;179;196;164;7;21;14;3;178;52;78;16,3039160601688799259,0.065283
steepest_intra:nodes_start:random,139,89102,40231,48871,2406950,160,51;68;117;143;183;144;21;7;164;14;102;46;198;139;115;118;137;23;153;0;59;65;116;41;193;34;54;177;10;184;160;43;162;180;86;75;78;145;179;196;81;56;113;175;31;55;52;185;40;119;49;62;9;148;94;154;135;70;53;121;124;167;178;106;165;27;90;57;92;129;2;152;1;97;26;100;101;120;25;171;16;44;123;131;149;151;80;176;15;186;89;93;140;108;18;22;42;133;63;79,4738080118400304590,0.071192
steepest_intra:nodes_start:random,140,90216,41209,49007,2541500,169,133;79;80;122;63;94;124;165;90;164;7;21;14;144;186;46;139;41;181;159;193;68;0;153;183;89;59;65;47;116;42;43;131;149;123;127;86;75;2;78;145;57;62;9;15;137;118;115;34;146;22;18;185;119;40;81;196;179;92;129;120;44;16;171;175;113;31;23;143;117;93;160;54;184;84;112;101;1;152;97;26;100;53;180;151;51;176;148;37;167;55;52;106;178;49;102;154;70;135;162,7764144335442947515,0.073534
steepest_intra:nodes_start:random,141,87699,39473,48226,2362100,157,137;183;89;23;186;15;178;106;180;135;154;53;75;120;179;40;185;129;2;121;63;162;84;177;54;184;149;151;80;9;62;167;152;97;26;100;1;101;86;70;127;112;4;123;44;25;78;145;92;57;148;0;143;117;93;108;69;18;159;42;43;65;133;79;124;49;144;14;138;165;90;81;113;175;171;16;31;196;52;55;94;116;181;195;22;146;103;34;160;5;46;68;139;193;41;115;59;118;51;176,8880679129382644336,0.065036
steepest_intra:nodes_start:random,142,94748,43742,51006,2406950,160,176;80;94;78;16;88;171;175;113;56;31;81;90;40;57;152;1;101;2;129;82;25;44;120;75;86;100;26;97;55;52;167;189;154;70;127;123;42;181;34;146;22;18;159;193;41;137;148;49;102;62;9;15;186;23;46;115;43;116;65;79;179;196;157;145;92;124;51;139;69;108;68;63;121;53;158;180;133;151;162;194;135;178;3;14;144;118;59;184;177;54;48;160;149;106;185;165;183;143;0,4949402655808968678,0.071319
steepest_intra:nodes_start:random,143,88284,40281,48003,2631200,175,81;31;78;145;179;40;90;164;7;21;138;14;49;176;118;65;116;115;46;51;80;25;56;113;175;171;16;44;120;0;93;108;18;22;146;159;181;184;123;135;70;127;112;177;54;34;160;26;97;94;137;143;117;68;139;193;41;5;42;43;149;154;180;53;63;122;124;3;178;106;185;119;165;144;183;89;23;1;101;75;86;100;121;162;59;151;133;79;148;9;62;167;152;2;129;92;57;55;52;196,2011687837825232528,0.074132
steepest_intra:nodes_start:random,144,83294,32381,50913,2616250,174,154;158;53;180;123;112;4;190;10;177;30;54;48;160;181;159;193;41;42;43;47;116;115;137;15;144;14;138;49;102;124;94;148;37;9;62;89;183;143;117;68;139;198;46;176;52;55;129;2;1;101;86;75;120;44;16;171;175;113;152;189;121;100;26;97;25;31;78;145;92;57;185;40;165;106;178;167;133;162;149;131;65;59;118;51;151;79;63;122;80;0;108;18;22;34;184;35;127;70;135,4521661210374105076,0.071582
steepest_intra:nodes_start:random,145,88600,37805,50795,2406950,160,129;78;16;171;175;113;31;25;44;120;70;127;112;84;35;131;149;47;105;65;162;122;94;26;100;121;53;158;136;63;79;151;72;51;137;9;102;14;144;23;0;18;108;93;117;143;183;89;57;92;179;196;81;145;123;184;54;160;34;181;42;43;116;59;118;176;124;152;2;75;86;101;1;97;180;154;135;133;80;186;15;62;49;3;178;106;165;40;185;52;55;148;115;41;193;159;22;139;68;46,8197851978869585022,0.067237
steepest_intra:nodes_start:random,146,83799,35913,47886,2018250,134,145;92;129;2;1;97;94;176;80;79;63;148;102;14;138;165;40;152;53;180;133;41;193;15;144;21;7;164;27;90;81;78;120;44;25;16;171;175;113;56;31;196;185;106;9;186;23;137;51;118;46;139;115;116;65;47;123;127;70;135;154;100;26;101;75;86;112;160;181;34;48;54;177;10;190;184;42;43;131;149;162;151;72;59;0;117;108;18;22;159;143;183;89;62;49;178;52;55;57;179,5554611346112565319,0.054180
steepest_intra:nodes_start:random,147,88947,39666,49281,2332200,155,54;184;149;118;80;94;189;97;101;1;106;40;119;90;27;165;138;14;144;123;112;4;84;190;10;177;34;22;181;42;127;70;135;53;100;26;124;148;102;49;178;78;25;75;86;158;154;180;63;79;151;162;133;152;145;179;52;185;81;196;31;113;175;171;16;44;120;2;41;159;193;129;92;57;55;167;176;51;68;93;117;143;137;23;186;9;62;15;89;183;0;46;198;139;115;59;65;116;43;160,1860194282818147731,0.063595
steepest_intra:nodes_start:random,148,86469,37830,48639,2436850,162,14;102;37;148;186;23;137;118;43;42;181;160;184;131;149;162;151;133;79;180;154;158;53;100;26;121;59;41;69;108;18;22;146;159;193;80;94;120;78;145;179;196;40;185;106;178;3;165;90;27;164;21;144;183;143;0;46;115;139;68;117;93;34;54;177;4;127;70;44;16;171;175;113;31;62;9;167;152;97;1;101;86;75;2;129;92;57;55;52;176;51;65;116;35;112;123;135;63;124;49,6252902995360403539,0.065628
steepest_intra:nodes_start:random,149,81322,33366,47956,2362100,157,167;106;185;81;196;145;92;129;79;151;162;149;65;116;43;34;103;146;22;195;193;41;181;160;184;177;10;4;112;59;137;89;183;143;0;46;139;115;118;51;176;80;133;135;70;127;123;131;42;159;18;108;93;117;23;186;124;94;63;180;154;53;101;179;40;119;178;62;9;148;97;26;100;86;75;120;44;25;31;56;113;175;171;16;78;49;102;144;14;21;7;164;90;165;52;55;57;2;1;152,1091358917979194752,0.073978
steepest_intra:nodes_start:random,150,86778,37494,49284,2676050,178,145;78;175;171;16;25;44;86;100;26;97;1;101;75;120;92;179;185;40;90;165;14;144;53;158;154;180;162;47;43;146;22;18;108;115;51;80;79;94;124;52;55;129;2;152;167;148;9;62;102;49;3;178;106;31;113;81;196;57;63;133;116;42;159;193;41;139;46;23;186;137;118;59;65;35;84;112;123;149;131;184;54;160;34;181;68;93;117;143;170;0;151;194;127;70;135;176;183;89;15,4273321051536885499,0.074073
steepest_intra:nodes_start:random,151,88497,39642,48855,2122900,141,131;149;151;79;122;80;176;137;23;89;0;117;170;143;183;62;102;49;52;175;171;16;63;193;159;22;34;181;41;139;115;116;65;43;160;42;59;167;185;119;40;196;81;90;165;106;94;133;162;177;54;48;184;35;123;127;135;154;180;53;100;26;97;113;56;31;145;179;57;92;78;25;44;75;121;46;68;108;18;69;118;51;124;148;9;144;14;178;55;129;120;2;152;1;101;86;70;112;4;84,771422571270564505,0.058000
steepest_intra:nodes_start:random,152,86330,37431,48899,2556450,170,108;18;22;146;46;0;89;183;143;117;93;140;68;139;42;181;34;160;184;43;116;118;51;80;122;63;121;26;100;154;135;123;131;149;59;72;176;148;178;106;52;55;57;92;129;2;1;97;133;151;79;94;167;185;40;165;39;95;7;164;90;81;145;78;120;101;70;4;177;54;84;112;127;180;53;124;9;62;102;49;14;144;15;137;65;47;162;86;75;44;16;171;175;113;31;152;115;41;193;159,7014795490925116815,0.070043
steepest_intra:nodes_start:random,153,89675,40474,49201,2078050,138,1;97;94;0;117;143;183;89;137;80;122;63;79;133;151;181;34;146;22;159;193;115;59;162;123;54;177;112;127;70;135;47;65;51;176;62;9;148;26;100;86;101;57;185;40;196;113;175;31;179;55;52;106;178;3;49;102;14;165;119;145;78;92;82;129;124;68;46;118;154;180;53;81;90;164;21;144;15;114;186;23;149;131;35;184;160;43;116;42;5;41;139;152;2;25;171;16;44;120;75,2263780821104771911,0.058438
steepest_intra:nodes_start:random,154,92066,42084,49982,2406950,160,46;68;108;69;18;22;146;159;139;137;148;124;94;152;2;129;57;55;52;178;62;9;15;115;41;193;34;160;184;112;70;154;53;78;31;56;113;175;171;16;23;183;89;186;144;21;7;164;167;97;26;100;86;75;82;145;81;90;165;51;118;59;65;47;131;149;162;151;133;180;120;25;44;135;123;43;42;181;5;116;79;63;92;179;106;3;49;102;14;138;40;185;1;101;121;122;80;176;143;0,2207485012594899889,0.065489
steepest_intra:nodes_start:random,155,81743,33378,48365,2735850,182,162;151;118;59;149;43;42;181;5;116;65;115;139;18;159;22;146;34;54;127;70;86;75;101;1;2;129;92;78;31;16;171;175;113;56;157;196;81;90;165;40;185;14;3;178;106;52;55;57;135;35;184;160;41;193;68;46;15;9;62;144;102;49;179;145;25;44;120;167;148;183;143;117;93;0;89;186;23;137;51;176;80;79;63;180;154;158;53;100;26;97;152;124;94;133;84;177;4;112;123,8377554192044521709,0.074707
steepest_intra:nodes_start:random,156,89167,40656,48511,2152800,143,165;39;164;21;159;22;18;108;117;143;170;0;153;183;89;124;94;79;151;162;123;149;65;144;14;138;49;102;2;75;120;44;16;171;175;40;185;116;43;42;193;41;115;59;148;9;62;57;78;113;56;31;55;52;106;178;167;176;51;118;46;68;139;181;177;10;54;48;34;160;184;84;112;127;70;135;133;80;137;23;186;114;15;152;1;97;63;180;154;53;100;26;86;101;129;92;145;81;90;27,991562609292340221,0.060245
steepest_intra:nodes_start:random,157,87675,38613,49062,2406950,160,193;41;5;65;123;135;154;158;86;101;1;75;2;129;152;97;26;121;151;72;162;180;53;100;55;52;196;78;145;179;57;89;183;143;59;116;160;54;177;184;35;131;149;43;42;181;22;146;103;34;112;70;16;171;175;113;63;79;133;80;176;137;21;164;90;81;31;25;44;120;92;167;148;15;114;144;14;102;62;9;49;3;178;165;119;40;185;106;124;94;51;118;115;139;46;0;117;108;18;159,2501829947511451649,0.065916
steepest_intra:nodes_start:random,158,81959,32513,49446,2960100,197,49;102;62;15;114;186;23;148;167;92;145;31;78;152;63;79;180;154;133;151;162;116;41;193;18;108;139;46;115;42;43;184;54;160;34;146;22;159;137;144;14;138;90;81;56;113;175;171;16;25;44;120;82;129;57;55;52;178;106;185;165;40;196;179;2;75;86;53;135;127;123;112;84;35;149;65;59;118;51;80;94;124;189;97;1;101;26;100;121;122;176;89;183;143;117;93;140;68;0;9,7812018980039689477,0.079994
steepest_intra:nodes_start:random,159,85829,37026,48803,2063100,137,154;135;70;127;123;149;131;5;193;41;59;72;151;120;25;44;75;162;47;43;184;10;177;54;160;42;181;34;146;22;159;139;46;0;143;117;115;116;65;118;51;137;15;102;49;167;148;9;62;144;14;21;164;27;90;55;1;97;26;100;101;86;53;79;133;176;80;122;152;2;129;185;165;40;196;179;57;92;145;31;56;113;175;171;16;78;18;108;183;89;23;186;114;178;106;52;124;94;63;180,8987580381790485678,0.058001
steepest_intra:nodes_start:random,160,92280,43907,48373,2093000,139,178;106;133;162;149;131;65;116;59;118;55;196;81;90;165;14;144;123;190;10;177;54;43;185;40;119;138;186;117;18;159;22;146;42;5;151;94;124;148;9;62;52;179;145;78;31;113;175;171;16;25;44;120;75;86;101;167;49;102;15;137;51;176;80;79;63;121;100;26;97;152;23;89;183;143;0;115;84;4;112;180;57;92;129;2;1;53;154;135;70;127;184;160;34;181;193;41;139;46;3,5255829908646420647,0.056315
steepest_intra:nodes_start:random,161,85565,35879,49686,2392000,159,181;5;41;193;68;117;0;118;59;162;151;176;137;23;186;89;183;143;18;34;48;54;177;112;70;86;101;75;120;44;25;78;145;81;90;165;14;144;49;102;62;9;148;46;139;115;116;47;65;133;180;136;182;79;80;122;63;94;124;57;179;92;129;82;2;100;53;154;135;127;123;149;43;42;160;184;35;121;26;16;171;175;113;31;196;40;185;52;55;1;97;152;106;178;3;167;51;159;22;146,2562642980961345157,0.065000
steepest_intra:nodes_start:random,162,94250,43409,50841,1943500,129,101;86;26;100;112;160;34;146;181;97;129;92;167;0;68;46;72;151;133;162;123;127;70;135;154;180;53;80;176;143;117;93;108;69;18;199;22;159;42;5;115;23;186;114;15;145;78;171;16;44;120;75;2;57;55;52;178;49;102;89;183;137;122;63;79;149;131;116;41;193;139;106;185;40;81;90;27;165;138;14;144;62;9;148;43;54;177;184;65;59;118;51;94;124;21;7;164;95;152;1,7959652838940567467,0.052000
steepest_intra:nodes_start:random,163,89631,41443,48188,2436850,162,175;113;31;120;80;115;139;41;193;159;18;108;140;93;117;143;0;46;51;100;75;44;25;78;145;157;196;40;185;14;183;89;23;186;15;144;49;102;62;9;148;137;42;160;184;43;116;65;151;133;79;63;94;57;92;129;2;1;101;86;158;70;112;4;127;135;179;81;90;165;106;178;3;124;176;118;59;149;123;154;53;121;167;52;55;152;97;26;180;162;181;22;146;34;48;54;177;84;16;171,7893520072227729479,0.065000
steepest_intra:nodes_start:random,164,88232,39048,49184,2212600,147,26;86;101;92;31;56;113;175;171;16;2;152;124;148;167;178;106;52;55;94;122;79;65;47;105;116;59;118;115;46;68;117;143;183;165;90;81;196;176;43;42;5;186;144;14;138;49;102;62;9;15;80;135;70;127;112;4;84;35;137;23;89;0;139;193;41;131;149;162;133;151;51;108;18;22;146;34;160;54;177;184;123;63;97;1;129;57;185;40;179;145;78;25;44;120;75;154;180;53;100,6419511366966739483,0.060000
steepest_intra:nodes_start:random,165,90231,40986,49245,2003300,133,52;55;57;129;167;9;62;106;185;40;165;90;27;164;144;89;0;46;117;170;143;183;14;3;178;49;102;184;177;4;112;151;176;80;100;26;101;75;44;16;171;175;25;120;1;97;2;145;179;92;152;59;116;65;47;131;149;51;137;15;148;94;63;79;133;162;123;127;135;154;180;53;86;113;56;31;78;118;41;159;22;146;34;54;160;181;42;43;115;198;108;69;18;193;139;68;140;93;23;186,5896999225917827977,0.055382
steepest_intra:nodes_start:random,166,91388,40647,50741,1898650,126,41;118;51;176;137;23;186;148;144;14;165;113;175;171;16;31;78;75;70;127;149;131;47;65;116;59;151;152;145;179;143;117;108;18;181;160;184;42;5;96;198;115;43;35;112;123;133;79;189;1;120;44;25;92;129;2;101;86;53;158;63;122;94;124;55;52;106;178;3;49;62;9;89;183;0;80;180;154;162;159;22;146;34;48;54;177;10;4;135;185;40;57;97;26;100;121;46;68;139;193,3365602675946133421,0.050001
steepest_intra:nodes_start:random,167,90437,42146,48291,2122900,141,41;115;80;2;129;92;145;179;57;167;148;9;62;15;186;23;89;183;117;108;18;22;193;139;68;46;5;43;116;1;120;25;78;31;196;90;81;113;175;171;16;44;75;70;123;149;131;47;65;137;144;95;164;7;21;14;138;165;40;185;55;152;135;127;112;4;177;54;160;184;162;133;79;122;94;124;97;26;100;121;63;51;118;151;154;180;0;143;176;53;86;101;52;106;178;49;59;42;34;181,3573721898448544646,0.055999
steepest_intra:nodes_start:random,168,86655,36948,49707,2556450,170,26;97;129;179;145;31;113;78;2;152;176;51;118;46;0;143;117;68;139;35;112;4;84;160;34;48;54;177;10;190;184;43;116;47;65;59;72;80;124;167;55;52;185;106;178;3;49;144;14;165;40;196;175;171;16;75;101;1;120;44;25;92;57;62;9;148;162;123;127;70;135;79;137;23;186;63;53;158;180;133;151;181;146;22;18;108;93;183;89;94;100;121;115;41;193;42;131;149;154;86,9218032641773594516,0.069002
steepest_intra:nodes_start:random,169,89839,39500,50339,2451800,163,181;193;41;139;46;44;16;171;175;113;31;145;78;120;75;86;79;116;5;42;43;47;65;59;51;176;167;52;185;165;164;21;14;144;137;108;18;22;159;115;118;40;119;90;81;92;101;70;127;112;4;123;194;135;154;136;63;122;94;124;152;97;121;182;162;131;149;151;133;180;158;53;100;26;1;2;129;57;55;106;178;49;102;62;186;23;0;117;143;183;89;15;9;148;80;35;184;54;160;34,1511681857631126118,0.065931
steepest_intra:nodes_start:random,170,86204,36372,49832,2257450,150,75;101;86;63;79;51;118;59;41;193;159;139;115;46;23;186;89;183;143;0;117;18;22;34;160;84;112;123;131;149;151;176;137;15;9;37;148;111;167;152;1;2;57;55;52;106;97;26;100;180;184;54;177;4;127;135;154;53;31;56;157;196;40;119;185;178;124;94;116;42;43;65;162;133;80;62;144;102;49;14;138;179;145;92;129;82;25;16;171;175;113;81;165;39;164;27;90;78;44;120,996688445535035357,0.061086
steepest_intra:nodes_start:random,171,89556,40774,48782,2377050,158,26;100;94;137;0;143;183;89;23;186;79;133;162;65;116;59;118;51;9;62;144;14;178;106;165;40;185;52;55;92;25;44;120;86;154;70;127;123;42;5;41;193;139;15;49;179;145;196;31;78;101;53;180;115;159;18;108;124;152;2;129;57;148;46;68;140;93;117;176;80;122;63;151;43;54;30;177;10;190;4;112;84;181;22;146;34;160;184;35;131;149;135;75;16;171;175;113;56;1;97,2147537367258410235,0.063999
steepest_intra:nodes_start:random,172,83397,34585,48812,2392000,159,75;86;151;59;46;68;93;140;193;41;181;184;127;194;123;149;131;43;42;5;139;115;118;51;176;80;148;102;49;138;14;144;62;9;167;152;1;2;55;185;40;165;90;81;196;157;145;179;106;3;178;52;25;16;171;175;113;31;78;92;57;129;101;180;162;159;146;22;18;108;117;0;143;183;89;137;79;63;53;121;94;124;97;26;100;154;135;70;112;4;177;54;48;34;160;116;65;133;120;44,7270281718659686673,0.065000
steepest_intra:nodes_start:random,173,87297,38889,48408,2227550,148,184;48;54;177;10;190;4;112;146;22;18;159;193;41;5;123;127;101;1;97;26;63;79;133;80;176;94;124;178;106;185;119;40;145;78;25;44;16;171;175;113;56;31;179;55;52;3;62;9;137;51;118;115;139;46;23;144;14;102;49;152;100;53;154;180;165;90;81;196;120;75;86;70;135;162;151;0;143;117;93;68;116;47;149;131;42;181;34;160;43;148;167;2;129;92;57;89;183;59;65,299784659082042650,0.061000
steepest_intra:nodes_start:random,174,89181,40696,48485,2646150,176,31;16;25;44;120;89;183;143;0;137;124;152;94;118;59;116;65;151;133;80;51;46;68;139;131;149;162;63;121;100;26;2;179;196;81;90;21;144;62;15;114;186;23;115;43;42;5;41;193;159;108;18;22;146;181;35;127;70;101;1;55;52;49;102;9;148;79;123;112;177;54;34;160;184;176;106;185;119;40;56;113;175;171;75;86;154;135;180;53;97;129;92;57;165;39;138;14;178;145;78,537110862017564552,0.071001
steepest_intra:nodes_start:random,175,81808,32962,48846,2317250,154,54;48;160;34;146;159;193;41;139;46;115;127;70;135;154;180;94;148;49;102;62;9;89;0;140;93;117;143;183;144;14;138;165;90;27;164;95;39;119;40;185;179;145;31;113;175;171;16;78;106;3;178;52;55;57;92;152;63;79;133;53;86;101;75;44;120;2;1;80;176;68;108;18;22;181;42;43;116;51;137;23;186;124;97;26;100;112;4;84;35;123;162;151;118;59;65;149;131;184;177,1459744823436848660,0.062000
steepest_intra:nodes_start:random,176,83105,32857,50248,2362100,157,145;92;129;94;80;176;137;23;186;114;15;9;62;102;49;167;152;97;1;101;86;53;158;180;135;127;123;149;131;47;65;72;162;151;109;0;117;143;153;183;89;144;14;138;165;119;40;27;90;81;56;113;175;171;16;44;120;2;75;154;70;112;4;10;177;184;160;34;181;41;193;159;146;22;18;108;68;139;198;46;118;133;79;63;78;31;196;185;106;115;42;43;116;59;51;148;178;52;55;57,3495677757168985745,0.064507
steepest_intra:nodes_start:random,177,93050,44779,48271,2466750,164,75;171;175;113;31;78;129;152;97;1;101;2;92;145;157;196;40;119;51;118;59;151;79;63;120;25;16;44;162;160;34;181;42;116;121;26;100;53;180;154;135;70;127;123;65;146;22;159;176;167;55;52;106;178;102;62;9;15;186;0;18;108;140;144;14;138;49;37;148;133;112;177;54;184;43;131;149;80;185;165;90;81;179;57;124;94;137;23;89;183;143;117;93;68;46;139;193;41;115;86,7853522471273743900,0.067114
steepest_intra:nodes_start:random,178,85682,36924,48758,2182700,145,57;167;152;53;135;70;127;194;133;79;63;94;100;26;97;1;52;185;40;119;138;14;102;49;55;129;82;78;31;113;175;171;16;59;139;18;159;193;41;115;118;51;176;137;183;143;117;0;46;42;181;160;48;43;131;149;162;154;180;148;9;62;15;114;89;23;186;144;21;90;165;178;106;81;196;145;179;124;80;151;65;116;22;146;103;34;54;177;10;184;112;123;86;101;75;2;120;44;25;92,8792311638635715486,0.058430
steepest_intra:nodes_start:random,179,86422,36667,49755,2571400,171,48;184;162;133;94;152;129;92;145;78;25;44;179;185;40;90;165;138;14;144;62;9;57;31;113;175;171;16;120;75;86;100;121;63;79;151;41;193;159;195;146;34;54;177;112;127;70;124;167;148;137;143;117;139;5;42;43;47;65;180;158;154;149;131;123;135;53;26;97;1;101;2;106;178;3;49;102;15;51;118;59;116;115;0;153;183;89;23;52;55;80;176;46;68;140;108;18;22;181;160,4614762853330362173,0.069795
steepest_intra:nodes_start:random,180,90727,41471,49256,2063100,137,78;145;92;179;40;185;52;79;133;123;112;4;84;35;131;149;65;43;42;160;181;5;59;118;51;137;23;183;89;186;80;63;121;100;124;148;9;62;167;152;97;70;127;184;177;54;34;22;159;115;178;106;1;26;154;135;162;151;15;144;102;49;14;138;21;7;164;27;90;39;165;114;139;193;41;116;180;53;86;101;2;129;55;57;25;44;120;75;46;68;117;143;0;176;94;31;113;175;171;16,5584283700421732599,0.055968
steepest_intra:nodes_start:random,181,90046,40232,49814,2466750,164,89;153;143;183;21;164;27;90;81;196;113;175;171;16;31;78;0;117;68;46;176;80;26;100;180;154;53;86;75;120;92;57;129;152;54;177;112;44;145;179;52;106;178;3;167;79;151;65;43;160;184;123;127;70;135;149;131;116;115;139;198;118;51;137;23;186;144;14;138;165;119;40;185;55;2;101;1;97;59;41;193;159;22;146;34;181;42;162;133;63;182;121;94;124;148;49;102;62;9;15,5863514861965921797,0.069074
steepest_intra:nodes_start:random,182,83591,34636,48955,2287350,152,185;40;165;90;81;113;175;171;16;124;94;152;2;101;86;70;127;135;154;180;53;75;120;44;25;92;129;186;143;0;117;68;139;115;149;123;162;151;133;79;122;63;121;97;1;26;100;112;84;184;54;34;146;22;159;41;193;199;18;69;108;140;93;5;42;43;47;65;59;51;9;62;102;49;178;167;148;80;176;137;23;89;183;46;181;160;116;118;15;144;14;106;52;55;57;179;145;78;31;196,8027437678649136926,0.063967
steepest_intra:nodes_start:random,183,85460,36653,48807,2646150,176,160;54;177;10;4;112;127;70;86;55;52;185;119;40;57;152;121;180;116;43;42;41;139;68;46;0;170;143;183;144;14;138;102;9;148;176;149;131;123;135;154;53;100;26;97;94;124;89;117;93;108;18;193;159;22;146;34;115;118;51;63;101;1;2;129;92;31;16;171;175;113;81;90;165;106;167;79;133;162;151;80;122;75;120;44;25;78;145;178;49;62;15;114;186;23;137;59;65;35;184,1122623813112653265,0.071120
steepest_intra:nodes_start:random,184,87756,38568,49188,2122900,141,53;180;63;79;59;96;41;193;159;18;108;93;23;186;21;164;27;90;165;55;152;97;1;101;86;158;154;70;135;0;117;68;46;115;118;51;80;122;121;100;26;2;16;171;175;196;40;185;57;92;129;120;78;145;52;14;144;62;9;133;162;184;160;34;54;177;127;75;44;113;56;31;106;178;49;148;176;151;123;112;35;47;116;65;149;131;43;5;42;181;195;146;22;139;143;183;89;137;124;94,5585096105954294661,0.057023
steepest_intra:nodes_start:random,185,88721,38426,50295,2392000,159,49;3;178;106;40;90;165;138;14;144;80;162;194;135;152;9;62;15;114;0;18;159;22;146;181;34;160;184;48;54;177;4;112;116;65;86;75;82;129;92;78;113;31;145;57;167;148;89;183;143;170;117;93;68;46;2;120;44;25;16;171;175;185;52;55;176;42;43;149;123;127;70;101;1;97;186;23;137;51;118;139;193;41;115;59;72;151;133;180;154;53;100;26;121;63;79;122;94;124;102,1622258328125044312,0.064017
steepest_intra:nodes_start:random,186,82644,34194,48450,2377050,158,193;41;139;115;46;0;183;89;23;137;80;63;79;116;43;42;159;22;181;184;35;131;149;65;151;133;100;26;101;86;53;180;154;135;70;127;59;118;51;176;9;49;3;178;55;57;129;92;78;31;113;175;171;16;25;145;179;52;185;40;81;90;165;106;167;37;148;162;123;112;4;177;54;48;34;160;97;1;75;44;120;2;152;94;124;186;114;15;62;102;14;138;21;144;143;117;93;140;108;18,4761770075374308872,0.064000
steepest_intra:nodes_start:random,187,83803,36068,47735,2182700,145,133;151;162;112;184;43;59;118;51;92;78;145;106;178;49;102;144;186;153;0;46;193;159;22;146;181;42;116;65;131;149;123;127;70;135;154;120;25;31;179;55;52;62;9;148;94;53;86;100;26;97;1;101;2;129;152;137;117;93;140;108;18;139;115;5;160;48;177;10;54;34;41;68;143;183;89;23;176;80;79;63;57;185;40;119;165;138;14;21;164;27;90;81;113;175;171;16;44;75;180,711248042534413084,0.059000
steepest_intra:nodes_start:random,188,92269,42491,49778,2122900,141,193;139;117;143;0;148;145;157;31;78;25;123;35;184;112;127;63;94;124;9;62;15;181;160;34;146;22;18;68;46;51;151;162;72;118;59;42;43;116;65;149;133;16;171;175;113;81;90;27;164;183;89;23;152;1;97;26;100;121;53;154;180;167;165;39;7;21;14;144;102;101;86;135;70;75;129;92;179;196;40;119;185;106;178;3;138;49;52;55;57;44;120;2;122;79;80;176;137;115;41,9014759017092081441,0.057010
steepest_intra:nodes_start:random,189,92460,42406,50054,2063100,137,31;78;145;92;129;2;152;180;42;181;34;160;75;120;44;25;57;55;52;106;178;167;65;47;149;131;43;116;0;117;68;198;115;5;184;112;123;94;124;186;23;89;183;137;176;80;133;162;72;118;140;93;51;63;26;97;1;101;86;53;158;154;135;22;159;193;41;139;46;15;144;95;164;7;21;14;138;165;185;49;102;143;108;18;69;59;151;79;148;9;62;40;119;90;81;196;16;171;175;113,3256463867989382616,0.055523
steepest_intra:nodes_start:random,190,83445,34447,48998,3004950,200,121;180;133;151;162;135;154;86;92;196;81;57;43;160;34;181;193;41;139;115;46;68;117;93;140;108;18;22;159;5;42;116;65;149;79;94;124;189;63;122;80;176;137;23;186;15;148;167;152;97;1;101;2;129;55;52;106;178;3;14;49;102;62;9;51;59;118;0;143;183;89;144;165;90;40;185;179;145;78;82;120;44;16;171;175;113;31;25;75;70;112;4;177;184;35;123;127;53;100;26,5192541177004179166,0.080515
steepest_intra:nodes_start:random,191,87962,40110,47852,2137850,142,129;2;1;97;94;63;80;0;117;143;183;89;178;52;55;57;92;82;120;75;86;53;180;154;135;70;127;123;149;43;42;41;193;139;115;181;160;34;146;22;159;116;65;59;90;27;164;14;144;186;23;137;176;51;46;68;108;18;118;25;171;16;44;101;100;26;152;196;81;157;78;145;179;40;119;39;165;185;124;151;184;48;54;177;10;4;112;162;133;79;148;9;62;49;3;106;56;113;175;31,3380710029875165906,0.058018
steepest_intra:nodes_start:random,192,86912,38460,48452,2377050,158,55;145;31;113;175;171;16;1;97;101;86;75;2;120;44;25;92;106;178;49;62;9;152;26;100;53;135;127;70;78;196;81;90;27;165;40;185;14;144;186;41;146;22;159;193;139;198;180;154;149;131;160;48;4;112;123;162;51;109;115;181;34;30;54;177;10;190;84;184;43;42;18;108;68;137;148;167;57;129;63;133;151;118;46;0;117;143;183;89;23;116;47;65;59;176;80;79;94;124;52,3964451860878417062,0.065151
steepest_intra:nodes_start:random,193,85856,37676,48180,2451800,163,131;184;177;54;48;22;18;108;159;193;41;149;133;79;63;80;65;116;43;115;139;46;137;148;55;52;3;138;14;144;62;9;26;100;86;101;2;129;57;92;78;145;179;196;81;165;49;102;180;154;158;53;75;44;120;1;97;152;82;25;31;113;175;171;16;112;160;34;146;181;42;5;59;118;51;151;162;123;127;70;135;94;124;167;178;106;185;40;119;90;164;21;89;183;143;117;0;23;186;176,6623004189667510781,0.066338
steepest_intra:nodes_start:random,194,83290,35822,47468,2601300,173,160;42;43;116;65;47;149;123;135;120;16;171;175;113;31;145;92;57;46;139;41;193;159;108;18;22;34;181;115;176;80;79;63;53;86;75;101;26;97;1;2;129;152;94;124;167;14;21;164;39;165;185;179;44;25;78;196;81;90;119;40;106;178;9;62;102;49;144;15;114;186;23;89;183;143;117;93;0;137;148;52;55;162;54;177;10;127;70;154;180;133;151;51;118;59;131;112;4;84;184,2774647396573262851,0.072968
steepest_intra:nodes_start:random,195,86036,38630,47406,2152800,143,100;26;101;1;97;152;148;114;183;143;117;93;68;139;46;186;15;9;62;129;2;75;86;53;158;180;79;63;94;21;7;164;165;185;106;14;144;49;178;145;78;25;120;133;151;162;135;70;127;123;131;43;181;160;34;69;108;18;22;146;159;193;41;115;51;80;176;137;23;89;0;118;59;5;42;116;65;44;16;171;175;113;31;92;57;40;90;81;196;179;55;52;167;124;149;184;54;177;112;154,1033156036095924390,0.057997
steepest_intra:nodes_start:random,196,85558,35615,49943,2317250,154,4;177;34;181;42;116;133;63;97;152;3;178;106;185;165;119;40;179;92;129;75;53;180;154;47;43;160;48;54;184;35;79;94;124;52;55;57;2;1;101;86;26;100;121;122;176;51;118;198;139;68;46;137;148;9;62;144;49;14;138;145;31;78;120;44;16;171;175;113;56;196;81;90;39;167;80;151;149;131;123;127;70;135;162;59;115;41;193;22;18;117;143;23;186;89;183;0;65;84;112,6435473620794446784,0.066124
steepest_intra:nodes_start:random,197,87236,38063,49173,2347150,156,149;131;47;65;118;59;35;84;4;112;127;135;180;63;148;102;14;144;183;143;0;117;108;18;69;139;198;46;115;5;181;160;48;54;184;123;26;97;152;55;52;185;40;81;90;165;178;106;31;113;175;129;124;94;100;121;80;176;137;51;41;193;42;43;116;162;154;158;53;86;101;2;120;25;78;145;179;92;57;49;62;9;186;23;68;159;22;146;34;30;177;70;75;16;171;44;1;79;133;151,8273335099008853934,0.063666
steepest_intra:nodes_start:random,198,87303,38409,48894,2078050,138,93;0;2;120;44;16;171;175;113;56;31;78;145;92;57;40;119;27;90;81;196;25;75;101;86;100;26;1;97;121;180;123;43;181;22;18;108;69;159;115;118;51;148;178;106;94;79;133;127;112;84;35;131;149;162;151;124;52;55;129;152;46;139;193;41;42;116;65;47;184;54;34;160;59;9;62;102;49;185;165;164;21;14;144;15;137;176;80;122;63;53;158;154;70;135;23;89;183;143;117,3878468517464911842,0.054999
steepest_intra:nodes_start:random,199,83758,35549,48209,2556450,170,16;44;151;65;116;41;193;159;18;108;68;46;139;115;118;59;43;184;35;70;86;75;101;1;26;100;80;176;51;0;117;143;183;89;165;27;90;81;196;179;92;129;148;9;62;144;14;106;185;119;40;57;152;124;94;63;79;133;180;154;123;131;149;162;121;97;2;78;145;55;52;178;49;186;23;137;96;5;42;160;181;22;146;34;54;177;10;190;4;112;127;135;53;120;25;31;56;113;175;171,6365346917292019086,0.069526
steepest_intra:nodes_start:greedy,0,70687,22482,48205,89700,5,0;117;143;183;89;186;23;137;176;80;79;63;94;124;152;97;1;101;2;120;82;129;92;57;55;52;49;102;148;9;62;144;14;3;178;106;185;40;165;90;81;196;179;145;78;31;56;113;175;171;16;25;44;75;86;26;100;121;53;180;154;135;70;127;123;162;133;151;51;118;59;65;116;43;184;84;112;4;190;10;177;54;48;160;34;146;22;18;108;69;159;181;42;5;41;193;115;139;68;46,5049579975047869784,0.001998
steepest_intra:nodes_start:greedy,1,71666,23477,48189,59800,3,1;101;75;86;53;154;70;135;180;63;79;133;51;118;59;115;46;0;143;117;93;140;68;139;193;41;5;42;181;159;69;108;18;22;146;34;160;48;54;177;10;184;43;116;65;149;123;127;162;151;80;176;137;23;183;89;186;114;15;9;62;144;14;138;185;40;165;90;81;196;179;145;78;31;56;113;175;171;16;25;44;120;2;129;92;57;55;52;106;178;49;102;148;124;94;121;100;26;97;152,3266205115965437193,0.001994
steepest_intra:nodes_start:greedy,2,71427,23287,48140,119600,7,2;129;92;57;55;52;49;102;148;9;62;144;14;3;178;106;185;40;165;90;81;196;179;145;78;31;56;113;175;171;16;25;44;120;75;86;152;124;94;63;79;80;176;133;151;51;118;59;115;46;0;137;23;186;89;183;143;117;93;140;68;139;193;41;5;42;181;159;69;108;18;22;146;34;160;48;54;177;10;190;84;184;43;116;65;131;149;162;123;127;70;135;154;180;53;100;26;97;1;101,6571529652523408959,0.003000
steepest_intra:nodes_start:greedy,3,71291,23229,48062,104650,6,138;14;144;62;9;148;102;49;178;106;52;55;57;92;129;2;101;1;97;26;100;53;180;154;135;70;127;123;162;149;131;65;116;43;184;84;190;10;177;54;48;160;34;146;22;18;108;69;159;181;42;5;41;193;139;68;140;93;117;143;183;89;186;23;137;0;46;115;59;118;51;151;133;176;80;79;63;94;124;152;86;75;120;44;25;16;171;175;113;56;31;78;145;179;196;81;90;165;40;185,3228991799570033119,0.003000
steepest_intra:nodes_start:greedy,4,71443,23266,48177,119600,7,4;190;10;177;54;48;34;160;42;181;146;22;18;108;69;159;193;41;139;68;46;115;118;59;65;116;43;184;35;131;149;123;162;133;151;51;0;117;143;183;89;23;137;176;80;79;63;94;124;152;97;1;101;2;120;82;129;92;57;55;52;49;102;148;9;62;144;14;3;178;106;185;40;165;90;81;196;179;145;78;31;56;113;175;171;16;25;44;75;86;26;100;121;53;180;154;135;70;127;112,8886197058034892857,0.004001
steepest_intra:nodes_start:greedy,5,71295,23172,48123,74750,4,5;43;116;65;149;123;127;162;151;133;135;70;154;180;53;121;100;26;86;75;44;25;16;171;175;113;56;31;78;145;179;196;81;90;165;40;185;106;178;3;14;144;62;9;148;102;49;52;55;57;92;129;82;120;2;101;1;97;152;124;94;63;79;80;176;137;23;186;89;183;143;117;0;51;118;59;115;46;68;139;41;193;159;69;108;18;22;146;181;34;160;48;54;177;10;190;4;112;184;42,4745538522921293357,0.002001
steepest_intra:nodes_start:greedy,6,71623,23053,48570,74750,4,70;158;53;121;100;26;86;75;101;1;97;152;94;124;148;102;49;178;106;52;55;57;92;129;2;120;44;25;16;171;175;113;56;31;78;145;179;196;81;90;165;40;185;138;14;144;62;9;15;114;186;89;183;23;137;176;80;151;162;127;123;149;65;116;43;184;177;54;48;160;34;146;22;18;108;69;159;181;42;5;41;193;139;68;140;93;117;143;0;46;115;59;118;51;133;79;63;180;154;135,4317820021186353096,0.002003
steepest_intra:nodes_start:greedy,7,72266,24301,47965,119600,7,7;21;144;62;9;148;102;49;14;178;106;52;55;185;165;40;179;145;78;92;57;129;2;101;1;97;26;100;53;180;154;135;70;127;123;162;149;65;116;43;184;177;54;48;160;34;146;22;18;108;69;159;181;42;5;41;193;139;68;140;93;117;143;183;89;23;137;0;46;115;59;118;51;151;133;176;80;79;63;94;124;152;86;75;120;44;25;16;171;175;113;56;31;157;196;81;90;27;95;164,4081131815293497405,0.003011
steepest_intra:nodes_start:greedy,8,71484,23287,48197,104650,6,39;165;185;40;90;81;196;179;145;78;31;56;113;175;171;16;25;44;120;75;86;152;124;94;63;79;80;176;133;151;51;118;59;115;46;0;137;23;186;89;183;143;117;93;140;68;139;193;41;5;42;181;159;69;108;18;22;146;34;160;48;54;177;10;190;184;43;116;65;131;149;162;123;127;70;135;154;180;53;100;26;97;1;101;2;129;92;57;55;52;106;178;49;102;148;9;62;144;14;138,5066367644261749458,0.002002
steepest_intra:nodes_start:greedy,9,71291,23229,48062,89700,5,9;148;102;49;178;106;52;55;57;92;129;2;101;1;97;26;100;53;180;154;135;70;127;123;162;149;131;65;116;43;184;84;190;10;177;54;48;160;34;146;22;18;108;69;159;181;42;5;41;193;139;68;140;93;117;143;183;89;186;23;137;0;46;115;59;118;51;151;133;176;80;79;63;94;124;152;86;75;120;44;25;16;171;175;113;56;31;78;145;179;196;81;90;165;40;185;138;14;144;62,8082611457791768569,0.002003
steepest_intra:nodes_start:greedy,10,71443,23266,48177,119600,7,10;190;4;112;127;70;135;154;180;53;121;100;26;86;75;44;25;16;171;175;113;56;31;78;145;179;196;81;90;165;40;185;106;178;3;14;144;62;9;148;102;49;52;55;57;92;129;82;120;2;101;1;97;152;124;94;63;79;80;176;137;23;89;183;143;117;0;51;151;133;162;123;149;131;35;184;43;116;65;59;118;115;46;68;139;41;193;159;69;108;18;22;146;181;42;160;34;48;54;177,529259478023104905,0.003092
steepest_intra:nodes_start:greedy,11,71882,23557,48325,74750,4,149;35;84;4;112;127;123;162;151;133;135;70;154;180;53;121;100;26;86;75;44;25;16;171;175;113;56;31;78;145;179;196;81;90;165;40;185;106;178;3;14;144;62;9;148;102;49;52;55;57;92;129;82;120;2;101;1;97;152;124;94;63;79;80;176;137;23;186;89;183;143;117;0;51;118;59;115;139;68;46;65;116;43;42;5;41;193;159;69;108;18;22;146;181;34;160;48;54;177;184,259212039190453183,0.002000
steepest_intra:nodes_start:greedy,12,72408,23441,48967,44850,2,124;94;152;97;1;101;2;120;82;129;92;57;179;145;78;31;56;113;175;171;16;25;44;75;86;26;100;121;53;158;154;70;135;180;63;79;133;51;118;59;115;46;0;143;117;93;140;68;139;193;41;5;42;181;159;69;108;18;22;146;34;160;48;54;177;184;43;116;65;149;123;162;151;80;176;137;23;183;89;186;114;15;9;62;144;14;138;165;90;81;196;40;185;55;52;106;178;49;102;148,3504138052710147094,0.001000
steepest_intra:nodes_start:greedy,13,71853,23538,48315,149500,9,31;157;78;145;92;179;196;81;90;165;40;185;106;178;3;14;144;62;9;148;102;49;52;55;57;129;2;101;1;97;26;100;53;180;154;135;70;127;123;162;149;131;65;116;43;184;190;10;177;54;48;160;34;146;22;18;108;69;159;181;42;5;41;193;139;68;140;93;117;143;183;89;186;23;137;0;46;115;59;118;51;151;133;176;80;79;63;94;124;152;86;75;120;44;25;16;171;175;113;56,835345724023026657,0.004008
steepest_intra:nodes_start:greedy,14,71291,23229,48062,89700,5,14;144;62;9;148;102;49;178;106;52;55;57;92;129;2;101;1;97;26;100;53;180;154;135;70;127;123;162;149;131;65;116;43;184;84;190;10;177;54;48;160;34;146;22;18;108;69;159;181;42;5;41;193;139;68;140;93;117;143;183;89;186;23;137;0;46;115;59;118;51;151;133;176;80;79;63;94;124;152;86;75;120;44;25;16;171;175;113;56;31;78;145;179;196;81;90;165;40;185;138,2539613302322073474,0.002999
steepest_intra:nodes_start:greedy,15,71370,23348,48022,89700,5,15;144;14;138;185;40;165;90;81;196;179;145;78;31;56;113;175;171;16;25;44;120;75;86;152;124;94;63;79;80;176;133;151;51;118;59;115;46;0;137;23;186;89;183;143;117;93;140;68;139;193;41;5;42;181;159;69;108;18;22;146;34;160;48;54;177;10;190;184;43;116;65;131;149;162;123;127;70;135;154;180;53;100;26;97;1;101;2;129;92;57;55;52;106;178;49;102;62;9;148,3871124883856017613,0.003182
steepest_intra:nodes_start:greedy,16,71624,23484,48140,119600,7,16;25;44;120;75;86;152;124;94;63;79;80;176;133;151;51;118;59;115;46;0;137;23;186;89;183;143;117;93;140;68;139;193;41;5;42;181;159;69;108;18;22;146;34;160;48;54;177;10;190;84;184;43;116;65;131;149;162;123;127;70;135;154;180;53;100;26;97;1;101;2;129;57;55;52;49;102;148;9;62;144;14;3;178;106;185;40;165;90;81;196;179;92;145;78;31;56;113;175;171,5280289192294643981,0.003031
steepest_intra:nodes_start:greedy,17,73004,24174,48830,164450,10,196;81;40;90;27;58;164;7;95;39;165;119;185;106;178;3;14;144;62;9;148;102;49;52;55;57;129;92;179;145;78;82;2;1;97;26;86;53;180;154;135;70;127;123;162;149;65;116;43;184;177;54;48;160;34;146;22;18;108;159;181;42;41;193;139;68;140;93;117;143;183;89;23;137;0;46;115;59;118;51;151;133;176;80;79;63;94;152;101;75;120;44;25;16;171;175;113;56;31;157,5669139009451833210,0.004032
steepest_intra:nodes_start:greedy,18,71475,23225,48250,89700,5,18;22;146;159;193;41;5;42;181;34;160;48;54;177;10;190;4;112;184;43;116;65;149;123;127;162;151;133;135;70;154;180;53;121;100;26;86;75;44;25;16;171;175;113;56;31;78;145;179;196;81;90;165;40;185;106;178;3;14;144;62;9;148;102;49;52;55;57;92;129;82;120;2;101;1;97;152;124;94;63;79;80;176;137;51;118;59;115;139;68;46;0;89;183;143;117;93;140;108;69,367197096803772593,0.002005
steepest_intra:nodes_start:greedy,19,71828,22768,49060,44850,2,189;94;124;148;102;49;178;106;52;55;57;92;129;2;120;44;25;16;171;175;113;56;31;78;145;179;196;81;90;165;40;185;138;14;144;62;9;15;114;186;89;183;23;137;176;80;151;162;123;149;65;116;43;184;177;54;48;160;34;146;22;18;108;69;159;181;42;5;41;193;139;68;140;93;117;143;0;46;115;59;118;51;133;79;63;180;135;70;154;158;53;121;100;26;86;75;101;1;97;152,8910657316996031583,0.001009
steepest_intra:nodes_start:greedy,20,71904,22926,48978,89700,5,199;22;146;159;193;41;5;42;181;34;160;48;54;177;10;190;84;184;43;116;65;149;123;127;162;151;133;135;70;154;180;53;121;100;26;86;75;44;25;16;171;175;113;56;31;78;145;179;196;81;90;165;40;185;106;178;3;14;144;62;9;148;102;49;52;55;57;92;129;82;120;2;101;1;97;152;124;94;63;79;80;176;137;51;118;59;115;139;68;46;0;89;183;143;117;93;140;108;69;18,5789121139557939909,0.003028
steepest_intra:nodes_start:greedy,21,71756,23851,47905,89700,5,21;14;138;185;40;165;90;81;196;179;145;78;31;56;113;175;171;16;25;44;120;75;86;152;124;94;63;79;80;176;133;151;51;118;59;115;46;0;137;23;186;89;183;143;117;93;140;68;139;193;41;5;42;181;159;69;108;18;22;146;34;160;48;54;177;10;190;184;43;116;65;131;149;162;123;127;70;135;154;180;53;100;26;97;1;101;2;129;92;57;55;52;106;178;49;102;148;9;62;144,5964465170417945474,0.002000
steepest_intra:nodes_start:greedy,22,71022,23049,47973,59800,3,22;146;181;34;160;48;54;177;10;190;4;112;84;184;42;43;116;65;149;123;127;162;151;133;135;70;154;180;53;121;100;26;86;75;44;25;16;171;175;113;56;31;78;145;179;196;81;90;165;40;185;106;178;3;14;144;62;9;148;102;49;52;55;57;92;129;82;120;2;101;1;97;152;124;94;63;79;80;176;137;23;186;89;183;143;117;0;51;118;59;115;46;68;139;41;193;159;69;108;18,4514440606589881044,0.002071
steepest_intra:nodes_start:greedy,23,70687,22482,48205,89700,5,23;137;176;80;79;63;94;124;152;97;1;101;2;120;82;129;92;57;55;52;49;102;148;9;62;144;14;3;178;106;185;40;165;90;81;196;179;145;78;31;56;113;175;171;16;25;44;75;86;26;100;121;53;180;154;135;70;127;123;162;133;151;51;118;59;65;116;43;184;84;112;4;190;10;177;54;48;160;34;146;22;18;108;69;159;181;42;5;41;193;115;139;68;46;0;117;143;183;89;186,1774614835360909317,0.003003
steepest_intra:nodes_start:greedy,24,71630,23068,48562,89700,5,149;131;65;116;43;184;84;190;10;177;54;48;160;34;146;22;18;108;69;159;181;42;5;41;193;139;68;46;115;59;118;51;0;117;143;183;89;186;23;137;176;80;79;63;94;124;152;97;1;101;2;120;82;129;92;57;55;52;49;102;148;9;62;144;14;3;178;106;185;40;165;90;81;196;179;145;78;31;56;113;175;171;16;25;44;75;86;26;100;121;53;180;154;70;135;133;151;162;127;123,6840746015748688234,0.002000
steepest_intra:nodes_start:greedy,25,71427,23287,48140,119600,7,25;44;120;75;86;152;124;94;63;79;80;176;133;151;51;118;59;115;46;0;137;23;186;89;183;143;117;93;140;68;139;193;41;5;42;181;159;69;108;18;22;146;34;160;48;54;177;10;190;84;184;43;116;65;131;149;162;123;127;70;135;154;180;53;100;26;97;1;101;2;129;92;57;55;52;49;102;148;9;62;144;14;3;178;106;185;40;165;90;81;196;179;145;78;31;56;113;175;171;16,166690517157294201,0.003002
steepest_intra:nodes_start:greedy,26,71456,23430,48026,44850,2,26;100;1;101;75;86;53;154;70;135;180;63;79;133;51;118;59;115;46;0;143;117;93;140;68;139;193;41;5;42;181;159;69;108;18;22;146;34;160;48;54;177;10;190;184;43;116;65;149;123;127;162;151;80;176;137;23;183;89;186;114;15;9;62;144;14;138;185;40;165;90;81;196;179;145;78;31;56;113;175;171;16;25;44;120;2;129;92;57;55;52;106;178;49;102;148;124;94;152;97,1581387526899876137,0.001000
steepest_intra:nodes_start:greedy,27,72157,23629,48528,29900,1,27;58;164;7;95;39;165;138;14;144;62;9;148;102;49;178;106;52;55;57;92;129;2;152;97;1;101;100;53;180;154;135;70;127;123;162;149;65;116;43;184;177;54;48;160;34;146;22;18;108;69;159;181;42;5;41;193;139;68;140;93;117;143;183;89;23;137;0;46;115;59;118;51;151;133;176;80;79;63;94;26;86;75;120;44;25;16;171;175;113;56;31;78;145;179;196;81;185;40;90,2546775234058188018,0.001000
steepest_intra:nodes_start:greedy,28,71757,23150,48607,104650,6,35;43;116;65;131;149;123;127;162;151;133;135;70;154;180;53;121;100;26;86;75;44;25;16;171;175;113;56;31;78;145;179;196;81;90;165;40;185;106;178;3;14;144;62;9;148;102;49;52;55;57;92;129;82;120;2;101;1;97;152;124;94;63;79;80;176;137;23;186;89;183;143;117;0;51;118;59;115;46;68;139;193;41;5;42;181;159;69;108;18;22;146;34;160;48;54;177;10;190;184,4175469606699117498,0.003000
steepest_intra:nodes_start:greedy,29,71710,23103,48607,104650,6,131;112;4;84;35;184;177;54;48;160;34;181;146;22;18;108;69;159;193;41;5;42;43;116;65;46;68;139;115;59;118;51;0;117;143;183;89;186;23;137;176;80;79;63;94;124;152;97;1;101;2;120;82;129;92;57;55;52;49;102;148;9;62;144;14;3;178;106;185;40;165;90;81;196;179;145;78;31;56;113;175;171;16;25;44;75;86;26;100;121;53;180;154;70;135;133;151;162;123;149,7645390101581670221,0.003000
steepest_intra:nodes_start:greedy,30,71628,23064,48564,119600,7,48;54;177;10;190;84;184;43;116;65;59;118;115;46;0;51;151;133;162;123;127;70;135;154;180;53;121;100;26;86;75;44;25;16;171;175;113;56;31;78;145;179;196;81;90;165;40;185;106;178;3;14;144;62;9;148;102;49;52;55;57;92;129;82;120;2;101;1;97;152;124;94;63;79;80;176;137;23;186;89;183;143;117;93;140;68;139;41;193;159;69;108;18;22;146;195;181;42;160;34,2456976064366263877,0.004000
steepest_intra:nodes_start:greedy,31,71624,23484,48140,119600,7,31;78;145;92;179;196;81;90;165;40;185;106;178;3;14;144;62;9;148;102;49;52;55;57;129;2;101;1;97;26;100;53;180;154;135;70;127;123;162;149;131;65;116;43;184;84;190;10;177;54;48;160;34;146;22;18;108;69;159;181;42;5;41;193;139;68;140;93;117;143;183;89;186;23;137;0;46;115;59;118;51;151;133;176;80;79;63;94;124;152;86;75;120;44;25;16;171;175;113;56,8237250962890206027,0.004003
steepest_intra:nodes_start:greedy,32,71291,23229,48062,104650,6,138;14;144;62;9;148;102;49;178;106;52;55;57;92;129;2;101;1;97;26;100;53;180;154;135;70;127;123;162;149;131;65;116;43;184;84;190;10;177;54;48;160;34;146;22;18;108;69;159;181;42;5;41;193;139;68;140;93;117;143;183;89;186;23;137;0;46;115;59;118;51;151;133;176;80;79;63;94;124;152;86;75;120;44;25;16;171;175;113;56;31;78;145;179;196;81;90;165;40;185,8955036358925742513,0.003000
steepest_intra:nodes_start:greedy,33,71447,23047,48400,104650,6,37;102;49;178;106;52;55;57;92;129;2;101;1;97;26;100;53;180;154;135;70;127;123;162;149;131;65;116;43;184;190;10;177;54;48;160;34;146;22;18;108;69;159;181;42;5;41;193;139;68;140;93;117;143;183;89;186;23;137;0;46;115;59;118;51;151;133;176;80;79;63;94;124;152;86;75;120;44;25;16;171;175;113;56;31;78;145;179;196;81;90;165;40;185;138;14;144;62;9;148,8365715312677141627,0.002506
steepest_intra:nodes_start:greedy,34,71022,23049,47973,59800,3,34;181;146;22;18;108;69;159;193;41;139;68;46;115;59;118;51;0;117;143;183;89;186;23;137;176;80;79;63;94;124;152;97;1;101;2;120;82;129;92;57;55;52;49;102;148;9;62;144;14;3;178;106;185;40;165;90;81;196;179;145;78;31;56;113;175;171;16;25;44;75;86;26;100;121;53;180;154;70;135;133;151;162;127;123;149;65;116;43;42;184;84;112;4;190;10;177;54;48;160,311959182771515106,0.001999
steepest_intra:nodes_start:greedy,35,71495,23245,48250,74750,4,35;84;4;112;127;123;162;151;133;135;70;154;180;53;121;100;26;86;75;44;25;16;171;175;113;56;31;78;145;179;196;81;90;165;40;185;106;178;3;14;144;62;9;148;102;49;52;55;57;92;129;82;120;2;101;1;97;152;124;94;63;79;80;176;137;23;186;89;183;143;117;0;51;118;59;115;139;68;46;65;116;43;42;5;41;193;159;69;108;18;22;146;181;34;160;48;54;177;10;184,2765489978223145617,0.001997
steepest_intra:nodes_start:greedy,36,72068,22900,49168,74750,4,36;108;69;18;22;146;159;193;41;5;42;181;34;160;48;54;177;10;190;84;184;43;116;65;149;123;127;162;151;133;135;70;154;180;53;121;100;26;86;75;44;25;16;171;175;113;56;31;78;145;179;196;81;90;165;40;185;106;178;3;14;144;62;9;148;102;49;52;55;57;92;129;82;120;2;101;1;97;152;124;94;63;79;80;176;137;51;118;59;115;139;68;46;0;89;183;143;117;93;140,1669870048596559189,0.002000
steepest_intra:nodes_start:greedy,37,71447,23047,48400,89700,5,37;102;49;178;106;52;55;57;92;129;2;101;1;97;26;100;53;180;154;135;70;127;123;162;149;131;65;116;43;184;190;10;177;54;48;160;34;146;22;18;108;69;159;181;42;5;41;193;139;68;140;93;117;143;183;89;186;23;137;0;46;115;59;118;51;151;133;176;80;79;63;94;124;152;86;75;120;44;25;16;171;175;113;56;31;78;145;179;196;81;90;165;40;185;138;14;144;62;9;148,7977532340656935502,0.002000
steepest_intra:nodes_start:greedy,38,71853,23538,48315,134550,8,157;78;145;92;179;196;81;90;165;40;185;106;178;3;14;144;62;9;148;102;49;52;55;57;129;2;101;1;97;26;100;53;180;154;135;70;127;123;162;149;131;65;116;43;184;190;10;177;54;48;160;34;146;22;18;108;69;159;181;42;5;41;193;139;68;140;93;117;143;183;89;186;23;137;0;46;115;59;118;51;151;133;176;80;79;63;94;124;152;86;75;120;44;25;16;171;175;113;56;31,2772843999099450791,0.004002
steepest_intra:nodes_start:greedy,39,71983,23777,48206,74750,4,39;95;7;164;27;90;40;185;81;196;179;145;78;31;56;113;175;171;16;25;44;120;75;86;152;124;94;63;79;80;176;133;151;51;118;59;115;46;0;137;23;89;183;143;117;93;140;68;139;193;41;5;42;181;159;69;108;18;22;146;34;160;48;54;177;184;43;116;65;149;162;123;127;70;135;154;180;53;100;26;97;1;101;2;129;92;57;55;52;106;178;49;102;148;9;62;144;14;138;165,5786152742865951069,0.001999
steepest_intra:nodes_start:greedy,40,71291,23229,48062,89700,5,40;185;138;14;144;62;9;148;102;49;178;106;52;55;57;92;129;2;101;1;97;26;100;53;180;154;135;70;127;123;162;149;131;65;116;43;184;84;190;10;177;54;48;160;34;146;22;18;108;69;159;181;42;5;41;193;139;68;140;93;117;143;183;89;186;23;137;0;46;115;59;118;51;151;133;176;80;79;63;94;124;152;86;75;120;44;25;16;171;175;113;56;31;78;145;179;196;81;90;165,1679353979668365325,0.002001
steepest_intra:nodes_start:greedy,41,71485,23362,48123,74750,4,41;5;42;181;159;69;108;18;22;146;34;160;48;54;177;10;190;4;112;184;43;116;65;149;123;127;162;151;133;135;70;154;180;53;121;100;26;86;75;44;25;16;171;175;113;56;31;78;145;179;196;81;90;165;40;185;106;178;3;14;144;62;9;148;102;49;52;55;57;92;129;82;120;2;101;1;97;152;124;94;63;79;80;176;137;23;186;89;183;143;117;0;51;118;59;115;46;68;139;193,3810761784514956294,0.002000
steepest_intra:nodes_start:greedy,42,71485,23362,48123,74750,4,42;5;41;193;139;68;46;115;59;118;51;0;117;143;183;89;186;23;137;176;80;79;63;94;124;152;97;1;101;2;120;82;129;92;57;55;52;49;102;148;9;62;144;14;3;178;106;185;40;165;90;81;196;179;145;78;31;56;113;175;171;16;25;44;75;86;26;100;121;53;180;154;70;135;133;151;162;127;123;149;65;116;43;184;112;4;190;10;177;54;48;160;34;146;22;18;108;69;159;181,1264183428535614760,0.002003
steepest_intra:nodes_start:greedy,43,71664,23164,48500,74750,4,43;116;65;59;118;115;46;0;51;151;133;162;123;127;70;135;154;180;53;121;100;26;86;75;44;25;16;171;175;113;56;31;78;145;179;196;81;90;165;40;185;106;178;3;14;144;62;9;148;102;49;52;55;57;92;129;82;120;2;101;1;97;152;124;94;63;79;80;176;137;23;186;89;183;143;117;93;140;68;139;193;41;5;42;181;159;69;108;18;22;146;34;160;48;54;177;10;190;84;184,4033864913482888061,0.002000
steepest_intra:nodes_start:greedy,44,71427,23287,48140,119600,7,44;25;16;171;175;113;56;31;78;145;179;196;81;90;165;40;185;106;178;3;14;144;62;9;148;102;49;52;55;57;92;129;2;101;1;97;26;100;53;180;154;135;70;127;123;162;149;131;65;116;43;184;84;190;10;177;54;48;160;34;146;22;18;108;69;159;181;42;5;41;193;139;68;140;93;117;143;183;89;186;23;137;0;46;115;59;118;51;151;133;176;80;79;63;94;124;152;86;75;120,6453393896624811736,0.004000
steepest_intra:nodes_start:greedy,45,72172,23344,48828,89700,5,72;151;133;135;70;154;180;53;121;100;26;86;75;44;25;16;171;175;113;56;31;78;145;179;196;81;90;165;40;185;106;178;3;14;144;62;9;148;102;49;52;55;57;92;129;82;120;2;101;1;97;152;124;94;63;79;80;176;137;23;186;89;183;143;117;0;51;118;59;115;46;68;139;193;41;5;42;181;159;69;108;18;22;146;34;160;48;54;177;10;190;84;184;43;116;65;149;123;127;162,2638273735626705303,0.001998
steepest_intra:nodes_start:greedy,46,71485,23362,48123,74750,4,46;115;59;118;51;0;117;143;183;89;186;23;137;176;80;79;63;94;124;152;97;1;101;2;120;82;129;92;57;55;52;49;102;148;9;62;144;14;3;178;106;185;40;165;90;81;196;179;145;78;31;56;113;175;171;16;25;44;75;86;26;100;121;53;180;154;70;135;133;151;162;127;123;149;65;116;43;184;112;4;190;10;177;54;48;160;34;146;22;18;108;69;159;181;42;5;41;193;139;68,3767141932904803449,0.002013
steepest_intra:nodes_start:greedy,47,71630,23068,48562,104650,6,65;116;43;184;84;190;10;177;54;48;160;34;146;22;18;108;69;159;181;42;5;41;193;139;68;46;115;59;118;51;0;117;143;183;89;186;23;137;176;80;79;63;94;124;152;97;1;101;2;120;82;129;92;57;55;52;49;102;148;9;62;144;14;3;178;106;185;40;165;90;81;196;179;145;78;31;56;113;175;171;16;25;44;75;86;26;100;121;53;180;154;70;135;133;151;162;127;123;149;131,2301090717702000712,0.003001
steepest_intra:nodes_start:greedy,48,71628,23064,48564,104650,6,48;34;160;42;181;195;146;22;18;108;69;159;193;41;139;68;140;93;117;143;183;89;186;23;137;176;80;79;63;94;124;152;97;1;101;2;120;82;129;92;57;55;52;49;102;148;9;62;144;14;3;178;106;185;40;165;90;81;196;179;145;78;31;56;113;175;171;16;25;44;75;86;26;100;121;53;180;154;135;70;127;123;162;133;151;51;0;46;115;118;59;65;116;43;184;84;190;10;177;54,9050122450293352714,0.003000
steepest_intra:nodes_start:greedy,49,71291,23229,48062,89700,5,49;178;106;52;55;57;92;129;2;101;1;97;26;100;53;180;154;135;70;127;123;162;149;131;65;116;43;184;84;190;10;177;54;48;160;34;146;22;18;108;69;159;181;42;5;41;193;139;68;140;93;117;143;183;89;186;23;137;0;46;115;59;118;51;151;133;176;80;79;63;94;124;152;86;75;120;44;25;16;171;175;113;56;31;78;145;179;196;81;90;165;40;185;138;14;144;62;9;148;102,4650840584363383273,0.002000
steepest_intra:nodes_start:greedy,50,71853,23538,48315,179400,11,113;175;171;16;25;44;120;75;86;152;124;94;63;79;80;176;133;151;51;118;59;115;46;0;137;23;186;89;183;143;117;93;140;68;139;193;41;5;42;181;159;69;108;18;22;146;34;160;48;54;177;10;190;184;43;116;65;131;149;162;123;127;70;135;154;180;53;100;26;97;1;101;2;129;57;55;52;49;102;148;9;62;144;14;3;178;106;185;40;165;90;81;196;179;92;145;78;157;31;56,2704233233845112983,0.005000
steepest_intra:nodes_start:greedy,51,71485,23362,48123,74750,4,51;118;59;115;46;68;139;193;41;5;42;181;159;69;108;18;22;146;34;160;48;54;177;10;190;4;112;184;43;116;65;149;123;127;162;151;133;135;70;154;180;53;121;100;26;86;75;44;25;16;171;175;113;56;31;78;145;179;196;81;90;165;40;185;106;178;3;14;144;62;9;148;102;49;52;55;57;92;129;82;120;2;101;1;97;152;124;94;63;79;80;176;137;23;186;89;183;143;117;0,5954529039911026277,0.001980
steepest_intra:nodes_start:greedy,52,71291,23229,48062,104650,6,52;106;178;49;102;148;9;62;144;14;138;185;40;165;90;81;196;179;145;78;31;56;113;175;171;16;25;44;120;75;86;152;124;94;63;79;80;176;133;151;51;118;59;115;46;0;137;23;186;89;183;143;117;93;140;68;139;193;41;5;42;181;159;69;108;18;22;146;34;160;48;54;177;10;190;84;184;43;116;65;131;149;162;123;127;70;135;154;180;53;100;26;97;1;101;2;129;92;57;55,7313548741151500247,0.003003
steepest_intra:nodes_start:greedy,53,71633,23063,48570,29900,1,53;158;154;70;135;180;63;79;133;51;118;59;115;46;0;143;117;93;140;68;139;193;41;5;42;181;159;69;108;18;22;146;34;160;48;54;177;184;43;116;65;149;123;127;162;151;80;176;137;23;183;89;186;114;15;9;62;144;14;138;185;40;165;90;81;196;179;145;78;31;56;113;175;171;16;25;44;120;2;129;92;57;55;52;106;178;49;102;148;124;94;152;97;1;101;75;86;26;100;121,5389680065614247521,0.001035
steepest_intra:nodes_start:greedy,54,71628,23064,48564,104650,6,54;48;34;160;42;181;195;146;22;18;108;69;159;193;41;139;68;140;93;117;143;183;89;186;23;137;176;80;79;63;94;124;152;97;1;101;2;120;82;129;92;57;55;52;49;102;148;9;62;144;14;3;178;106;185;40;165;90;81;196;179;145;78;31;56;113;175;171;16;25;44;75;86;26;100;121;53;180;154;135;70;127;123;162;133;151;51;0;46;115;118;59;65;116;43;184;84;190;10;177,8585487694804996930,0.003000
steepest_intra:nodes_start:greedy,55,71291,23229,48062,104650,6,55;52;106;178;49;102;148;9;62;144;14;138;185;40;165;90;81;196;179;145;78;31;56;113;175;171;16;25;44;120;75;86;152;124;94;63;79;80;176;133;151;51;118;59;115;46;0;137;23;186;89;183;143;117;93;140;68;139;193;41;5;42;181;159;69;108;18;22;146;34;160;48;54;177;10;190;84;184;43;116;65;131;149;162;123;127;70;135;154;180;53;100;26;97;1;101;2;129;92;57,8769828443016697553,0.002012
steepest_intra:nodes_start:greedy,56,71624,23484,48140,119600,7,56;31;78;145;92;179;196;81;90;165;40;185;106;178;3;14;144;62;9;148;102;49;52;55;57;129;2;101;1;97;26;100;53;180;154;135;70;127;123;162;149;131;65;116;43;184;84;190;10;177;54;48;160;34;146;22;18;108;69;159;181;42;5;41;193;139;68;140;93;117;143;183;89;186;23;137;0;46;115;59;118;51;151;133;176;80;79;63;94;124;152;86;75;120;44;25;16;171;175;113,935927833155405350,0.003999
steepest_intra:nodes_start:greedy,57,71427,23287,48140,104650,6,57;55;52;49;102;148;9;62;144;14;3;178;106;185;40;165;90;81;196;179;145;78;31;56;113;175;171;16;25;44;120;75;86;152;124;94;63;79;80;176;133;151;51;118;59;115;46;0;137;23;186;89;183;143;117;93;140;68;139;193;41;5;42;181;159;69;108;18;22;146;34;160;48;54;177;10;190;84;184;43;116;65;131;149;162;123;127;70;135;154;180;53;100;26;97;1;101;2;129;92,305894103314923128,0.002999
steepest_intra:nodes_start:greedy,58,72466,24179,48287,59800,3,58;95;27;90;81;196;157;31;56;113;175;171;16;25;44;120;75;86;26;94;63;79;80;176;133;151;51;118;59;115;46;0;137;23;89;183;143;117;93;140;68;139;193;41;5;42;181;159;69;108;18;22;146;34;160;48;54;177;184;43;116;65;149;162;123;127;70;135;154;180;53;100;101;1;97;152;2;129;57;92;78;145;179;40;165;185;55;52;106;178;14;49;102;148;9;62;144;21;7;164,3814222942621637462,0.002001
steepest_intra:nodes_start:greedy,59,71485,23362,48123,74750,4,59;115;46;68;139;193;41;5;42;181;159;69;108;18;22;146;34;160;48;54;177;10;190;4;112;184;43;116;65;149;123;127;162;151;133;135;70;154;180;53;121;100;26;86;75;44;25;16;171;175;113;56;31;78;145;179;196;81;90;165;40;185;106;178;3;14;144;62;9;148;102;49;52;55;57;92;129;82;120;2;101;1;97;152;124;94;63;79;80;176;137;23;186;89;183;143;117;0;51;118,2524102895522541275,0.002000
steepest_intra:nodes_start:greedy,60,71485,23362,48123,119600,7,115;46;68;139;193;41;5;42;181;159;69;108;18;22;146;34;160;48;54;177;10;190;4;112;184;43;116;65;149;123;127;162;151;133;135;70;154;180;53;121;100;26;86;75;44;25;16;171;175;113;56;31;78;145;179;196;81;90;165;40;185;106;178;3;14;144;62;9;148;102;49;52;55;57;92;129;82;120;2;101;1;97;152;124;94;63;79;80;176;137;23;186;89;183;143;117;0;51;118;59,5598608211222789458,0.004000
steepest_intra:nodes_start:greedy,61,71370,23348,48022,104650,6,15;144;14;138;185;40;165;90;81;196;179;145;78;31;56;113;175;171;16;25;44;120;75;86;152;124;94;63;79;80;176;133;151;51;118;59;115;46;0;137;23;186;89;183;143;117;93;140;68;139;193;41;5;42;181;159;69;108;18;22;146;34;160;48;54;177;10;190;184;43;116;65;131;149;162;123;127;70;135;154;180;53;100;26;97;1;101;2;129;92;57;55;52;106;178;49;102;62;9;148,3122627241379416343,0.003001
steepest_intra:nodes_start:greedy,62,71291,23229,48062,89700,5,62;144;14;138;185;40;165;90;81;196;179;145;78;31;56;113;175;171;16;25;44;120;75;86;152;124;94;63;79;80;176;133;151;51;118;59;115;46;0;137;23;186;89;183;143;117;93;140;68;139;193;41;5;42;181;159;69;108;18;22;146;34;160;48;54;177;10;190;84;184;43;116;65;131;149;162;123;127;70;135;154;180;53;100;26;97;1;101;2;129;92;57;55;52;106;178;49;102;148;9,1761509505149674495,0.003000
steepest_intra:nodes_start:greedy,63,71633,23063,48570,29900,1,63;180;135;70;154;158;53;121;100;26;86;75;101;1;97;152;94;124;148;102;49;178;106;52;55;57;92;129;2;120;44;25;16;171;175;113;56;31;78;145;179;196;81;90;165;40;185;138;14;144;62;9;15;114;186;89;183;23;137;176;80;151;162;127;123;149;65;116;43;184;177;54;48;160;34;146;22;18;108;69;159;181;42;5;41;193;139;68;140;93;117;143;0;46;115;59;118;51;133;79,2241177280452172795,0.001000
steepest_intra:nodes_start:greedy,64,72256,22737,49519,29900,1,64;114;186;89;183;23;137;176;80;151;162;123;149;65;116;43;184;177;54;48;160;34;146;22;18;108;69;159;181;42;5;41;193;139;68;140;93;117;143;0;46;115;59;118;51;133;79;63;180;135;70;154;158;53;121;100;26;86;75;101;1;97;152;94;124;148;9;62;102;49;178;106;52;55;57;92;129;2;120;44;25;16;171;175;113;56;31;78;145;179;196;81;90;165;40;185;138;14;144;15,2813359212603601156,0.001000
steepest_intra:nodes_start:greedy,65,71485,23362,48123,74750,4,65;149;123;127;162;151;133;135;70;154;180;53;121;100;26;86;75;44;25;16;171;175;113;56;31;78;145;179;196;81;90;165;40;185;106;178;3;14;144;62;9;148;102;49;52;55;57;92;129;82;120;2;101;1;97;152;124;94;63;79;80;176;137;23;186;89;183;143;117;0;51;118;59;115;46;68;139;193;41;5;42;181;159;69;108;18;22;146;34;160;48;54;177;10;190;4;112;184;43;116,1297374118260544377,0.002000
steepest_intra:nodes_start:greedy,66,72330,23840,48490,74750,4,23;51;118;59;115;46;0;89;183;143;117;93;140;68;139;193;41;5;42;181;159;69;108;18;22;146;34;160;48;54;177;10;190;84;184;43;116;65;149;123;127;162;151;133;135;70;154;180;53;121;100;26;86;75;44;25;16;171;175;113;56;31;78;145;179;196;81;90;165;40;185;106;178;3;14;144;62;9;148;102;49;52;55;57;92;129;82;120;2;101;1;97;152;124;94;63;79;80;176;137,7699228857282133110,0.002000
steepest_intra:nodes_start:greedy,67,72068,22900,49168,89700,5,36;108;69;18;22;146;159;193;41;5;42;181;34;160;48;54;177;10;190;84;184;43;116;65;149;123;127;162;151;133;135;70;154;180;53;121;100;26;86;75;44;25;16;171;175;113;56;31;78;145;179;196;81;90;165;40;185;106;178;3;14;144;62;9;148;102;49;52;55;57;92;129;82;120;2;101;1;97;152;124;94;63;79;80;176;137;51;118;59;115;139;68;46;0;89;183;143;117;93;140,7976468448336181493,0.002000
steepest_intra:nodes_start:greedy,68,71485,23362,48123,74750,4,68;46;115;59;118;51;0;117;143;183;89;186;23;137;176;80;79;63;94;124;152;97;1;101;2;120;82;129;92;57;55;52;49;102;148;9;62;144;14;3;178;106;185;40;165;90;81;196;179;145;78;31;56;113;175;171;16;25;44;75;86;26;100;121;53;180;154;70;135;133;151;162;127;123;149;65;116;43;184;112;4;190;10;177;54;48;160;34;146;22;18;108;69;159;181;42;5;41;193;139,1051967822927768112,0.001000
steepest_intra:nodes_start:greedy,69,71759,22908,48851,74750,4,69;108;18;199;22;146;159;193;41;5;42;181;34;160;48;54;177;10;190;84;184;43;116;65;149;123;127;162;151;133;135;70;154;180;53;121;100;26;86;75;44;25;16;171;175;113;56;31;78;145;179;196;81;90;165;40;185;106;178;3;14;144;62;9;148;102;49;52;55;57;92;129;82;120;2;101;1;97;152;124;94;63;79;80;176;137;23;186;89;183;143;117;0;51;118;59;115;46;68;139,6562660643746830188,0.002011
steepest_intra:nodes_start:greedy,70,71633,23063,48570,29900,1,70;154;158;53;121;100;26;86;75;101;1;97;152;94;124;148;102;49;178;106;52;55;57;92;129;2;120;44;25;16;171;175;113;56;31;78;145;179;196;81;90;165;40;185;138;14;144;62;9;15;114;186;89;183;23;137;176;80;151;162;127;123;149;65;116;43;184;177;54;48;160;34;146;22;18;108;69;159;181;42;5;41;193;139;68;140;93;117;143;0;46;115;59;118;51;133;79;63;180;135,8086033602384032057,0.001000
steepest_intra:nodes_start:greedy,71,72157,23629,48528,29900,1,58;164;7;95;39;165;138;14;144;62;9;148;102;49;178;106;52;55;57;92;129;2;152;97;1;101;100;53;180;154;135;70;127;123;162;149;65;116;43;184;177;54;48;160;34;146;22;18;108;69;159;181;42;5;41;193;139;68;140;93;117;143;183;89;23;137;0;46;115;59;118;51;151;133;176;80;79;63;94;26;86;75;120;44;25;16;171;175;113;56;31;78;145;179;196;81;185;40;90;27,6922303592887728943,0.001001
steepest_intra:nodes_start:greedy,72,71903,23033,48870,89700,5,109;51;0;117;143;183;89;186;23;137;176;80;79;63;94;124;152;97;1;101;2;120;82;129;92;57;55;52;49;102;148;9;62;144;14;3;178;106;185;40;165;90;81;196;179;145;78;31;56;113;175;171;16;25;44;75;86;26;100;121;53;180;154;70;135;133;151;162;127;123;149;65;116;43;184;84;190;10;177;54;48;160;34;146;22;18;108;69;159;181;42;5;41;193;139;68;46;115;59;118,1139000068757482168,0.002010
steepest_intra:nodes_start:greedy,73,71808,23695,48113,119600,7,114;15;148;9;62;102;49;178;106;52;55;57;92;129;2;101;1;97;26;100;53;180;154;135;70;127;123;162;149;131;65;116;43;184;10;177;54;48;160;34;146;22;18;108;69;159;181;42;5;41;193;139;68;140;93;117;143;183;89;186;23;137;0;46;115;59;118;51;151;133;176;80;79;63;94;124;152;86;75;120;44;25;16;171;175;113;56;31;78;145;179;196;81;90;165;40;185;138;14;144,8018808422689704233,0.003011
steepest_intra:nodes_start:greedy,74,71853,23212,48641,104650,6,152;1;101;75;86;53;154;70;135;180;63;79;133;51;118;59;115;46;0;143;117;93;140;68;139;193;41;5;42;181;159;69;108;18;22;146;34;160;48;54;177;184;43;116;65;149;123;127;162;151;80;176;137;23;183;89;186;114;15;9;62;144;14;138;185;40;165;90;81;196;179;145;78;31;56;113;175;171;16;25;44;120;2;129;92;57;55;52;106;178;49;102;148;124;94;189;121;100;26;97,3382777655232210330,0.002001
steepest_intra:nodes_start:greedy,75,71730,23388,48342,119600,7,75;44;25;16;171;175;113;56;31;78;145;179;196;81;90;165;40;185;106;178;3;14;144;62;9;148;102;49;52;55;57;92;129;82;120;2;101;1;97;26;100;53;180;154;135;70;127;123;162;149;131;65;116;43;184;190;10;177;54;48;160;34;146;22;18;108;69;159;181;42;5;41;193;139;68;140;93;117;143;183;89;186;23;137;0;46;115;59;118;51;151;133;176;80;79;63;94;124;152;86,5887460501025307826,0.003000
steepest_intra:nodes_start:greedy,76,72335,23509,48826,59800,3,153;176;80;151;162;127;123;149;65;116;43;184;10;177;54;48;160;34;146;22;18;108;69;159;181;42;5;41;193;139;68;46;115;59;118;51;133;79;63;180;135;70;154;158;53;121;100;26;86;75;101;1;97;152;94;124;148;102;49;178;106;52;55;57;92;129;2;120;44;25;16;171;175;113;56;31;78;145;179;196;81;90;165;40;185;138;14;144;62;9;15;114;186;137;23;89;183;143;117;0,5553452749944791286,0.002000
steepest_intra:nodes_start:greedy,77,71717,23299,48418,89700,5,116;43;184;190;10;177;54;48;160;34;146;22;18;108;69;159;181;42;5;41;193;139;68;140;93;117;143;183;89;186;23;137;176;80;79;63;94;124;152;97;1;101;2;120;82;129;92;57;55;52;49;102;148;9;62;144;14;3;178;106;185;40;165;90;81;196;179;145;78;31;56;113;175;171;16;25;44;75;86;26;100;121;53;180;154;135;70;127;123;162;133;151;51;0;46;115;118;59;149;65,8858731365119551464,0.002000
steepest_intra:nodes_start:greedy,78,71427,23287,48140,119600,7,78;31;56;113;175;171;16;25;44;120;75;86;152;124;94;63;79;80;176;133;151;51;118;59;115;46;0;137;23;186;89;183;143;117;93;140;68;139;193;41;5;42;181;159;69;108;18;22;146;34;160;48;54;177;10;190;84;184;43;116;65;131;149;162;123;127;70;135;154;180;53;100;26;97;1;101;2;129;92;57;55;52;49;102;148;9;62;144;14;3;178;106;185;40;165;90;81;196;179;145,3785092416504339977,0.003307
steepest_intra:nodes_start:greedy,79,71895,23009,48886,74750,4,79;80;176;133;151;51;118;59;115;46;0;137;23;186;89;183;143;117;93;140;68;139;193;41;5;42;181;159;69;108;18;22;146;34;160;48;54;177;184;43;116;65;131;149;162;123;127;70;135;154;180;158;53;121;100;26;86;75;44;25;16;171;175;113;56;31;78;145;179;196;81;90;165;40;185;106;178;3;14;144;62;9;148;102;49;52;55;57;92;129;82;120;2;101;1;97;152;124;94;63,1845339871809912550,0.001999
steepest_intra:nodes_start:greedy,80,71577,23015,48562,59800,3,80;79;63;94;124;152;97;1;101;2;120;82;129;92;57;55;52;49;102;148;9;62;144;14;3;178;106;185;40;165;90;81;196;179;145;78;31;56;113;175;171;16;25;44;75;86;26;100;121;53;180;154;135;70;127;123;162;133;151;149;131;65;116;43;184;84;190;10;177;54;48;160;34;146;22;18;108;69;159;181;42;5;41;193;139;68;46;115;59;118;51;0;117;143;183;89;186;23;137;176,6433685719346280071,0.001000
steepest_intra:nodes_start:greedy,81,71515,23453,48062,74750,4,81;196;40;185;179;145;78;31;56;113;175;171;16;25;44;120;75;86;152;124;94;63;79;80;176;133;151;51;118;59;115;46;0;137;23;186;89;183;143;117;93;140;68;139;193;41;5;42;181;159;69;108;18;22;146;34;160;48;54;177;10;190;84;184;43;116;65;131;149;162;123;127;70;135;154;180;53;100;26;97;1;101;2;129;92;57;55;52;106;178;49;102;148;9;62;144;14;138;165;90,819142574022026738,0.002000
steepest_intra:nodes_start:greedy,82,71774,23432,48342,104650,6,82;2;75;86;101;124;94;63;79;80;176;133;151;51;118;59;115;46;0;137;23;186;89;183;143;117;93;140;68;139;193;41;5;42;181;159;69;108;18;22;146;34;160;48;54;177;10;190;184;43;116;65;131;149;162;123;127;70;135;154;180;53;100;26;97;1;152;129;92;57;55;52;49;102;148;9;62;144;14;3;178;106;185;40;165;90;81;196;179;145;78;31;56;113;175;171;16;25;44;120,1571389689408886886,0.003000
steepest_intra:nodes_start:greedy,83,71058,22762,48296,119600,7,114;89;183;143;117;0;46;68;139;115;193;41;5;42;181;159;69;108;18;22;146;34;160;48;54;177;10;190;4;112;184;43;116;65;59;118;51;151;133;162;123;127;70;135;154;180;53;121;100;26;86;75;44;25;16;171;175;113;56;31;78;145;179;196;81;90;165;40;185;106;178;3;14;144;62;9;148;102;49;52;55;57;92;129;82;120;2;101;1;97;152;124;94;63;79;80;176;137;23;186,5092589915092493500,0.003274
steepest_intra:nodes_start:greedy,84,71495,23245,48250,74750,4,84;4;112;127;123;162;151;133;135;70;154;180;53;121;100;26;86;75;44;25;16;171;175;113;56;31;78;145;179;196;81;90;165;40;185;106;178;3;14;144;62;9;148;102;49;52;55;57;92;129;82;120;2;101;1;97;152;124;94;63;79;80;176;137;23;186;89;183;143;117;0;51;118;59;115;139;68;46;65;116;43;42;5;41;193;159;69;108;18;22;146;181;34;160;48;54;177;10;184;35,3986973779350544243,0.002000
steepest_intra:nodes_start:greedy,85,71972,23657,48315,134550,8,157;145;179;196;81;90;165;40;185;106;178;3;14;144;62;9;148;102;49;52;55;57;92;129;2;101;1;97;26;100;53;180;154;135;70;127;123;162;149;131;65;116;43;184;190;10;177;54;48;160;34;146;22;18;108;69;159;181;42;5;41;193;139;68;140;93;117;143;183;89;186;23;137;0;46;115;59;118;51;151;133;176;80;79;63;94;124;152;86;75;120;44;25;78;31;16;171;175;113;56,3245510872322269437,0.003000
steepest_intra:nodes_start:greedy,86,71633,23063,48570,29900,1,86;75;101;1;97;152;94;124;148;102;49;178;106;52;55;57;92;129;2;120;44;25;16;171;175;113;56;31;78;145;179;196;81;90;165;40;185;138;14;144;62;9;15;114;186;89;183;23;137;176;80;151;162;127;123;149;65;116;43;184;177;54;48;160;34;146;22;18;108;69;159;181;42;5;41;193;139;68;140;93;117;143;0;46;115;59;118;51;133;79;63;180;135;70;154;158;53;121;100;26,5023743771350231192,0.000999
steepest_intra:nodes_start:greedy,87,72450,23370,49080,134550,8,74;2;120;82;129;92;57;55;52;49;102;148;9;62;144;14;3;178;106;185;40;165;90;81;196;179;145;78;31;56;113;175;171;16;25;44;75;86;101;124;94;63;79;80;176;133;151;51;118;59;115;46;0;137;23;186;89;183;143;117;93;140;68;139;193;41;5;42;181;159;69;108;18;22;146;34;160;48;54;177;10;184;43;116;65;131;149;162;123;127;70;135;154;180;53;100;26;97;1;152,2961221248945659037,0.003972
steepest_intra:nodes_start:greedy,88,71903,23561,48342,164450,10,25;44;82;120;75;86;152;124;94;63;79;80;176;133;151;51;118;59;115;46;0;137;23;186;89;183;143;117;93;140;68;139;193;41;5;42;181;159;69;108;18;22;146;34;160;48;54;177;10;190;184;43;116;65;131;149;162;123;127;70;135;154;180;53;100;26;97;1;101;2;129;57;55;52;49;102;148;9;62;144;14;3;178;106;185;40;165;90;81;196;179;92;145;78;31;56;113;175;171;16,8125600398649183817,0.004927
steepest_intra:nodes_start:greedy,89,70715,22215,48500,104650,6,89;186;23;137;176;80;79;63;94;124;152;97;1;101;2;120;82;129;92;57;55;52;49;102;148;9;62;144;14;3;178;106;185;40;165;90;81;196;179;145;78;31;56;113;175;171;16;25;44;75;86;26;100;121;53;180;154;135;70;127;123;162;133;151;51;118;59;65;116;43;184;84;190;10;177;54;48;160;34;146;22;18;108;69;159;181;42;5;41;193;139;115;46;68;140;93;117;0;143;183,788588753450011786,0.003029
steepest_intra:nodes_start:greedy,90,71346,23284,48062,89700,5,185;40;90;81;196;179;145;78;31;56;113;175;171;16;25;44;120;75;86;152;124;94;63;79;80;176;133;151;51;118;59;115;46;0;137;23;186;89;183;143;117;93;140;68;139;193;41;5;42;181;159;69;108;18;22;146;34;160;48;54;177;10;190;84;184;43;116;65;131;149;162;123;127;70;135;154;180;53;100;26;97;1;101;2;129;92;57;55;52;106;178;49;102;148;9;62;144;14;138;165,8681744655867387418,0.001988
steepest_intra:nodes_start:greedy,91,71751,23436,48315,119600,7,157;179;145;78;31;56;113;175;171;16;25;44;120;75;86;152;124;94;63;79;80;176;133;151;51;118;59;115;46;0;137;23;186;89;183;143;117;93;140;68;139;193;41;5;42;181;159;69;108;18;22;146;34;160;48;54;177;10;190;184;43;116;65;131;149;162;123;127;70;135;154;180;53;100;26;97;1;101;2;129;92;57;55;52;49;102;148;9;62;144;14;3;178;106;185;40;165;90;81;196,2676488874227392387,0.003001
steepest_intra:nodes_start:greedy,92,71427,23287,48140,119600,7,57;55;52;49;102;148;9;62;144;14;3;178;106;185;40;165;90;81;196;179;145;78;31;56;113;175;171;16;25;44;120;75;86;152;124;94;63;79;80;176;133;151;51;118;59;115;46;0;137;23;186;89;183;143;117;93;140;68;139;193;41;5;42;181;159;69;108;18;22;146;34;160;48;54;177;10;190;84;184;43;116;65;131;149;162;123;127;70;135;154;180;53;100;26;97;1;101;2;129;92,6386755722170560223,0.004000
steepest_intra:nodes_start:greedy,93,71475,23225,48250,89700,5,93;140;108;69;18;22;146;159;193;41;5;42;181;34;160;48;54;177;10;190;4;112;184;43;116;65;149;123;127;162;151;133;135;70;154;180;53;121;100;26;86;75;44;25;16;171;175;113;56;31;78;145;179;196;81;90;165;40;185;106;178;3;14;144;62;9;148;102;49;52;55;57;92;129;82;120;2;101;1;97;152;124;94;63;79;80;176;137;51;118;59;115;139;68;46;0;89;183;143;117,1393723775171946039,0.002002
steepest_intra:nodes_start:greedy,94,71633,23063,48570,29900,1,94;152;97;1;101;75;86;26;100;121;53;158;154;70;135;180;63;79;133;51;118;59;115;46;0;143;117;93;140;68;139;193;41;5;42;181;159;69;108;18;22;146;34;160;48;54;177;184;43;116;65;149;123;127;162;151;80;176;137;23;183;89;186;114;15;9;62;144;14;138;185;40;165;90;81;196;179;145;78;31;56;113;175;171;16;25;44;120;2;129;92;57;55;52;106;178;49;102;148;124,4960408865563634171,0.001000
steepest_intra:nodes_start:greedy,95,72157,23629,48528,29900,1,95;7;164;58;27;90;40;185;81;196;179;145;78;31;56;113;175;171;16;25;44;120;75;86;26;94;63;79;80;176;133;151;51;118;59;115;46;0;137;23;89;183;143;117;93;140;68;139;193;41;5;42;181;159;69;108;18;22;146;34;160;48;54;177;184;43;116;65;149;162;123;127;70;135;154;180;53;100;101;1;97;152;2;129;92;57;55;52;106;178;49;102;148;9;62;144;14;138;165;39,5108024067634090003,0.001000
steepest_intra:nodes_start:greedy,96,71295,23172,48123,89700,5,5;43;116;65;149;123;127;162;151;133;135;70;154;180;53;121;100;26;86;75;44;25;16;171;175;113;56;31;78;145;179;196;81;90;165;40;185;106;178;3;14;144;62;9;148;102;49;52;55;57;92;129;82;120;2;101;1;97;152;124;94;63;79;80;176;137;23;186;89;183;143;117;0;51;118;59;115;46;68;139;41;193;159;69;108;18;22;146;181;34;160;48;54;177;10;190;4;112;184;42,4332654932454661580,0.003001
steepest_intra:nodes_start:greedy,97,71666,23477,48189,59800,3,97;152;1;101;75;86;53;154;70;135;180;63;79;133;51;118;59;115;46;0;143;117;93;140;68;139;193;41;5;42;181;159;69;108;18;22;146;34;160;48;54;177;10;184;43;116;65;149;123;127;162;151;80;176;137;23;183;89;186;114;15;9;62;144;14;138;185;40;165;90;81;196;179;145;78;31;56;113;175;171;16;25;44;120;2;129;92;57;55;52;106;178;49;102;148;124;94;121;100;26,111432045751934645,0.002002
steepest_intra:nodes_start:greedy,98,72707,24102,48605,74750,4,81;40;90;27;164;39;165;119;185;106;178;3;14;144;62;9;148;102;49;52;55;57;129;92;179;145;78;82;2;152;97;1;101;100;53;180;154;135;70;127;123;162;149;65;116;43;184;177;54;48;160;34;146;22;18;108;69;159;181;42;5;41;193;139;68;140;93;117;143;183;89;23;137;0;46;115;59;118;51;151;133;176;80;79;63;94;26;86;75;120;44;25;16;171;175;113;56;31;157;196,4418057340257979112,0.003011
steepest_intra:nodes_start:greedy,99,71750,23180,48570,59800,3,121;100;26;97;86;75;101;1;152;94;124;148;102;49;178;106;52;55;57;92;129;2;120;44;25;16;171;175;113;56;31;78;145;179;196;81;90;165;40;185;138;14;144;62;9;15;114;186;89;183;23;137;176;80;151;162;127;123;149;65;116;43;184;177;54;48;160;34;146;22;18;108;69;159;181;42;5;41;193;139;68;140;93;117;143;0;46;115;59;118;51;133;79;63;180;135;70;154;158;53,7537569671320729514,0.002008
steepest_intra:nodes_start:greedy,100,71633,23063,48570,29900,1,100;26;86;75;101;1;97;152;94;124;148;102;49;178;106;52;55;57;92;129;2;120;44;25;16;171;175;113;56;31;78;145;179;196;81;90;165;40;185;138;14;144;62;9;15;114;186;89;183;23;137;176;80;151;162;127;123;149;65;116;43;184;177;54;48;160;34;146;22;18;108;69;159;181;42;5;41;193;139;68;140;93;117;143;0;46;115;59;118;51;133;79;63;180;135;70;154;158;53;121,9056062344316586100,0.001008
steepest_intra:nodes_start:greedy,101,71666,23477,48189,59800,3,101;1;152;97;26;100;121;94;124;148;102;49;178;106;52;55;57;92;129;2;120;44;25;16;171;175;113;56;31;78;145;179;196;81;90;165;40;185;138;14;144;62;9;15;114;186;89;183;23;137;176;80;151;162;127;123;149;65;116;43;184;10;177;54;48;160;34;146;22;18;108;69;159;181;42;5;41;193;139;68;140;93;117;143;0;46;115;59;118;51;133;79;63;180;135;70;154;53;86;75,8901851714915588802,0.002011
steepest_intra:nodes_start:greedy,102,71291,23229,48062,89700,5,102;148;9;62;144;14;138;185;40;165;90;81;196;179;145;78;31;56;113;175;171;16;25;44;120;75;86;152;124;94;63;79;80;176;133;151;51;118;59;115;46;0;137;23;186;89;183;143;117;93;140;68;139;193;41;5;42;181;159;69;108;18;22;146;34;160;48;54;177;10;190;84;184;43;116;65;131;149;162;123;127;70;135;154;180;53;100;26;97;1;101;2;129;92;57;55;52;106;178;49,6316093785415774337,0.002998
steepest_intra:nodes_start:greedy,103,71022,23049,47973,74750,4,181;34;160;48;54;177;10;190;4;112;84;184;42;43;116;65;149;123;127;162;151;133;135;70;154;180;53;121;100;26;86;75;44;25;16;171;175;113;56;31;78;145;179;196;81;90;165;40;185;106;178;3;14;144;62;9;148;102;49;52;55;57;92;129;82;120;2;101;1;97;152;124;94;63;79;80;176;137;23;186;89;183;143;117;0;51;118;59;115;46;68;139;41;193;159;69;108;18;22;146,4450831656961215766,0.002272
steepest_intra:nodes_start:greedy,104,71640,22982,48658,134550,8,30;54;48;34;160;42;181;195;146;22;18;108;69;159;193;41;139;68;140;93;117;143;183;89;186;23;137;176;80;79;63;94;124;152;97;1;101;2;120;82;129;92;57;55;52;49;102;148;9;62;144;14;3;178;106;185;40;165;90;81;196;179;145;78;31;56;113;175;171;16;25;44;75;86;26;100;121;53;180;154;135;70;127;123;162;133;151;51;0;46;115;118;59;65;116;43;184;190;10;177,4288743604776386949,0.004011
steepest_intra:nodes_start:greedy,105,71630,23068,48562,119600,7,65;116;43;184;84;190;10;177;54;48;160;34;146;22;18;108;69;159;181;42;5;41;193;139;68;46;115;59;118;51;0;117;143;183;89;186;23;137;176;80;79;63;94;124;152;97;1;101;2;120;82;129;92;57;55;52;49;102;148;9;62;144;14;3;178;106;185;40;165;90;81;196;179;145;78;31;56;113;175;171;16;25;44;75;86;26;100;121;53;180;154;70;135;133;151;162;127;123;149;131,3014962531311244015,0.003007
steepest_intra:nodes_start:greedy,106,71291,23229,48062,89700,5,106;178;49;102;148;9;62;144;14;138;185;40;165;90;81;196;179;145;78;31;56;113;175;171;16;25;44;120;75;86;152;124;94;63;79;80;176;133;151;51;118;59;115;46;0;137;23;186;89;183;143;117;93;140;68;139;193;41;5;42;181;159;69;108;18;22;146;34;160;48;54;177;10;190;84;184;43;116;65;131;149;162;123;127;70;135;154;180;53;100;26;97;1;101;2;129;92;57;55;52,8211087914401748586,0.002000
steepest_intra:nodes_start:greedy,107,72157,23629,48528,59800,3,27;58;164;7;95;39;165;138;14;144;62;9;148;102;49;178;106;52;55;57;92;129;2;152;97;1;101;100;53;180;154;135;70;127;123;162;149;65;116;43;184;177;54;48;160;34;146;22;18;108;69;159;181;42;5;41;193;139;68;140;93;117;143;183;89;23;137;0;46;115;59;118;51;151;133;176;80;79;63;94;26;86;75;120;44;25;16;171;175;113;56;31;78;145;179;196;81;185;40;90,2842101241203855260,0.002000
steepest_intra:nodes_start:greedy,108,71759,22908,48851,74750,4,108;69;139;68;46;115;59;118;51;0;117;143;183;89;186;23;137;176;80;79;63;94;124;152;97;1;101;2;120;82;129;92;57;55;52;49;102;148;9;62;144;14;3;178;106;185;40;165;90;81;196;179;145;78;31;56;113;175;171;16;25;44;75;86;26;100;121;53;180;154;70;135;133;151;162;127;123;149;65;116;43;184;84;190;10;177;54;48;160;34;181;42;5;41;193;159;146;22;199;18,148493982200029100,0.002012
steepest_intra:nodes_start:greedy,109,71718,23118,48600,89700,5,109;118;115;46;68;139;193;41;5;42;181;159;69;108;18;22;146;34;160;48;54;177;10;190;4;112;184;43;116;65;59;151;133;162;123;127;70;135;154;180;53;121;100;26;86;75;44;25;16;171;175;113;56;31;78;145;179;196;81;90;165;40;185;106;178;3;14;144;62;9;148;102;49;52;55;57;92;129;82;120;2;101;1;97;152;124;94;63;79;80;176;137;23;186;89;183;143;117;0;51,4463670487308572193,0.003016
steepest_intra:nodes_start:greedy,110,71964,23165,48799,89700,5,139;193;41;5;42;181;159;69;108;18;22;146;34;160;48;54;177;10;190;84;184;43;116;65;149;123;127;162;151;133;135;70;154;180;53;121;100;26;86;75;44;25;16;171;175;113;56;31;78;145;179;196;81;90;165;40;185;106;178;3;14;144;62;9;148;102;49;52;55;57;92;129;82;120;2;101;1;97;152;124;94;63;79;80;176;137;23;186;89;183;143;117;0;51;118;59;115;46;68;198,5043179479862555393,0.002356
steepest_intra:nodes_start:greedy,111,72508,23912,48596,29900,1,167;148;9;62;102;144;14;49;178;106;165;39;95;164;27;90;81;196;40;185;52;55;57;129;92;179;145;78;31;56;113;175;171;16;25;44;120;2;152;97;1;101;75;86;26;100;121;53;158;154;70;135;180;63;79;133;51;118;59;115;46;0;89;183;143;117;93;140;68;139;193;41;5;42;181;159;69;108;18;22;146;34;160;48;54;177;184;43;116;65;149;123;127;162;151;80;176;137;94;124,6132414147688327804,0.000614
steepest_intra:nodes_start:greedy,112,71495,23245,48250,74750,4,112;4;84;35;184;10;177;54;48;160;34;181;146;22;18;108;69;159;193;41;5;42;43;116;65;46;68;139;115;59;118;51;0;117;143;183;89;186;23;137;176;80;79;63;94;124;152;97;1;101;2;120;82;129;92;57;55;52;49;102;148;9;62;144;14;3;178;106;185;40;165;90;81;196;179;145;78;31;56;113;175;171;16;25;44;75;86;26;100;121;53;180;154;70;135;133;151;162;123;127,2791756593477460660,0.001999
steepest_intra:nodes_start:greedy,113,71624,23484,48140,119600,7,113;56;31;78;145;92;179;196;81;90;165;40;185;106;178;3;14;144;62;9;148;102;49;52;55;57;129;2;101;1;97;26;100;53;180;154;135;70;127;123;162;149;131;65;116;43;184;84;190;10;177;54;48;160;34;146;22;18;108;69;159;181;42;5;41;193;139;68;140;93;117;143;183;89;186;23;137;0;46;115;59;118;51;151;133;176;80;79;63;94;124;152;86;75;120;44;25;16;171;175,3903033699746505650,0.003000
steepest_intra:nodes_start:greedy,114,71565,22995,48570,29900,1,114;186;89;183;23;137;176;80;151;162;127;123;149;65;116;43;184;177;54;48;160;34;146;22;18;108;69;159;181;42;5;41;193;139;68;140;93;117;143;0;46;115;59;118;51;133;79;63;180;135;70;154;158;53;121;100;26;86;75;101;1;97;152;94;124;148;9;62;102;49;178;106;52;55;57;92;129;2;120;44;25;16;171;175;113;56;31;78;145;179;196;81;90;165;40;185;138;14;144;15,293313729016691963,0.001002
steepest_intra:nodes_start:greedy,115,71485,23362,48123,74750,4,115;59;118;51;0;117;143;183;89;186;23;137;176;80;79;63;94;124;152;97;1;101;2;120;82;129;92;57;55;52;49;102;148;9;62;144;14;3;178;106;185;40;165;90;81;196;179;145;78;31;56;113;175;171;16;25;44;75;86;26;100;121;53;180;154;70;135;133;151;162;127;123;149;65;116;43;184;112;4;190;10;177;54;48;160;34;146;22;18;108;69;159;181;42;5;41;193;139;68;46,4628543649370547639,0.002011
steepest_intra:nodes_start:greedy,116,71485,23362,48123,74750,4,116;43;184;112;4;190;10;177;54;48;160;34;146;22;18;108;69;159;181;42;5;41;193;139;68;46;115;59;118;51;0;117;143;183;89;186;23;137;176;80;79;63;94;124;152;97;1;101;2;120;82;129;92;57;55;52;49;102;148;9;62;144;14;3;178;106;185;40;165;90;81;196;179;145;78;31;56;113;175;171;16;25;44;75;86;26;100;121;53;180;154;70;135;133;151;162;127;123;149;65,5605664185737027174,0.002000
steepest_intra:nodes_start:greedy,117,70687,22482,48205,89700,5,117;0;46;68;139;115;193;41;5;42;181;159;69;108;18;22;146;34;160;48;54;177;10;190;4;112;84;184;43;116;65;59;118;51;151;133;162;123;127;70;135;154;180;53;121;100;26;86;75;44;25;16;171;175;113;56;31;78;145;179;196;81;90;165;40;185;106;178;3;14;144;62;9;148;102;49;52;55;57;92;129;82;120;2;101;1;97;152;124;94;63;79;80;176;137;23;186;89;183;143,7868934503070338895,0.002011
steepest_intra:nodes_start:greedy,118,71485,23362,48123,89700,5,59;115;46;68;139;193;41;5;42;181;159;69;108;18;22;146;34;160;48;54;177;10;190;4;112;184;43;116;65;149;123;127;162;151;133;135;70;154;180;53;121;100;26;86;75;44;25;16;171;175;113;56;31;78;145;179;196;81;90;165;40;185;106;178;3;14;144;62;9;148;102;49;52;55;57;92;129;82;120;2;101;1;97;152;124;94;63;79;80;176;137;23;186;89;183;143;117;0;51;118,3043669793999315623,0.002000
steepest_intra:nodes_start:greedy,119,71240,23045,48195,104650,6,40;119;165;90;81;196;179;145;78;31;56;113;175;171;16;25;44;120;75;86;152;124;94;63;79;80;176;133;151;51;118;59;115;46;0;137;23;186;89;183;143;117;93;140;68;139;193;41;5;42;181;159;69;108;18;22;146;34;160;48;54;177;10;190;184;43;116;65;131;149;162;123;127;70;135;154;180;53;100;26;97;1;101;2;129;92;57;55;52;106;178;49;102;148;9;62;144;14;138;185,8790337065899659027,0.003001
steepest_intra:nodes_start:greedy,120,71427,23287,48140,119600,7,120;75;86;152;124;94;63;79;80;176;133;151;51;118;59;115;46;0;137;23;186;89;183;143;117;93;140;68;139;193;41;5;42;181;159;69;108;18;22;146;34;160;48;54;177;10;190;84;184;43;116;65;131;149;162;123;127;70;135;154;180;53;100;26;97;1;101;2;129;92;57;55;52;49;102;148;9;62;144;14;3;178;106;185;40;165;90;81;196;179;145;78;31;56;113;175;171;16;25;44,6098079120632295941,0.003001
steepest_intra:nodes_start:greedy,121,71750,23180,48570,29900,1,121;100;26;97;86;75;101;1;152;94;124;148;102;49;178;106;52;55;57;92;129;2;120;44;25;16;171;175;113;56;31;78;145;179;196;81;90;165;40;185;138;14;144;62;9;15;114;186;89;183;23;137;176;80;151;162;127;123;149;65;116;43;184;177;54;48;160;34;146;22;18;108;69;159;181;42;5;41;193;139;68;140;93;117;143;0;46;115;59;118;51;133;79;63;180;135;70;154;158;53,1263272843159331321,0.001002
steepest_intra:nodes_start:greedy,122,72141,22931,49210,74750,4,122;176;80;79;133;151;51;118;59;115;46;0;137;23;89;183;143;117;93;140;68;139;193;41;5;42;181;159;69;108;18;22;146;34;160;48;54;177;184;43;116;65;131;149;162;123;127;70;135;154;180;158;53;121;100;26;86;75;44;25;16;171;175;113;56;31;78;145;179;196;81;90;165;40;185;106;178;3;14;144;62;9;148;102;49;52;55;57;92;129;82;120;2;101;1;97;152;124;94;63,2955419991575831044,0.003008
steepest_intra:nodes_start:greedy,123,71577,23015,48562,59800,3,123;162;133;151;149;131;65;116;43;184;84;190;10;177;54;48;160;34;146;22;18;108;69;159;181;42;5;41;193;139;68;46;115;59;118;51;0;117;143;183;89;186;23;137;176;80;79;63;94;124;152;97;1;101;2;120;82;129;92;57;55;52;49;102;148;9;62;144;14;3;178;106;185;40;165;90;81;196;179;145;78;31;56;113;175;171;16;25;44;75;86;26;100;121;53;180;154;135;70;127,4459197011568701439,0.001000
steepest_intra:nodes_start:greedy,124,71633,23063,48570,44850,2,94;152;97;1;101;75;86;26;100;121;53;158;154;70;135;180;63;79;133;51;118;59;115;46;0;143;117;93;140;68;139;193;41;5;42;181;159;69;108;18;22;146;34;160;48;54;177;184;43;116;65;149;123;127;162;151;80;176;137;23;183;89;186;114;15;9;62;144;14;138;185;40;165;90;81;196;179;145;78;31;56;113;175;171;16;25;44;120;2;129;92;57;55;52;106;178;49;102;148;124,3896965076328339561,0.000995
steepest_intra:nodes_start:greedy,125,72950,23469,49481,74750,4,74;2;120;82;129;92;57;179;145;78;31;56;113;175;171;16;25;44;75;86;53;154;70;135;180;63;79;133;51;118;59;115;46;0;143;117;93;140;68;139;193;41;5;42;181;159;69;108;18;22;146;34;160;48;54;177;184;43;116;65;149;123;162;151;80;176;137;23;183;89;186;114;15;9;62;144;14;138;165;90;81;196;40;185;55;52;106;178;49;102;148;124;94;121;100;26;101;1;97;152,3143521137353886262,0.001998
steepest_intra:nodes_start:greedy,126,71710,23103,48607,104650,6,131;112;4;84;35;184;177;54;48;160;34;181;146;22;18;108;69;159;193;41;5;42;43;116;65;46;68;139;115;59;118;51;0;117;143;183;89;186;23;137;176;80;79;63;94;124;152;97;1;101;2;120;82;129;92;57;55;52;49;102;148;9;62;144;14;3;178;106;185;40;165;90;81;196;179;145;78;31;56;113;175;171;16;25;44;75;86;26;100;121;53;180;154;70;135;133;151;162;123;149,6336990460253463826,0.004000
steepest_intra:nodes_start:greedy,127,71753,23248,48505,74750,4,127;70;135;154;180;53;121;100;26;86;75;44;25;16;171;175;113;56;31;78;145;179;196;81;90;165;40;185;106;178;3;14;144;62;9;148;102;49;52;55;57;92;129;82;120;2;101;1;97;152;124;94;63;79;80;176;133;151;51;118;59;115;46;0;137;23;186;89;183;143;117;93;140;68;139;193;41;5;42;181;159;69;108;18;22;146;34;160;48;54;177;10;184;43;116;65;131;149;162;123,2117646447533732205,0.002005
steepest_intra:nodes_start:greedy,128,71536,23367,48169,134550,8,178;167;148;9;62;102;144;14;49;3;106;185;40;165;90;81;196;179;145;78;31;56;113;175;171;16;25;44;120;75;86;152;124;94;63;79;80;176;133;151;51;118;59;115;46;0;137;23;186;89;183;143;117;93;140;68;139;193;41;5;42;181;159;69;108;18;22;146;34;160;48;54;177;10;190;184;43;116;65;131;149;162;123;127;70;135;154;180;53;100;26;97;1;101;2;129;92;57;55;52,4565454154232588158,0.004000
steepest_intra:nodes_start:greedy,129,71427,23287,48140,119600,7,129;92;57;55;52;49;102;148;9;62;144;14;3;178;106;185;40;165;90;81;196;179;145;78;31;56;113;175;171;16;25;44;120;75;86;152;124;94;63;79;80;176;133;151;51;118;59;115;46;0;137;23;186;89;183;143;117;93;140;68;139;193;41;5;42;181;159;69;108;18;22;146;34;160;48;54;177;10;190;84;184;43;116;65;131;149;162;123;127;70;135;154;180;53;100;26;97;1;101;2,3645193584451825767,0.003030
steepest_intra:nodes_start:greedy,130,71633,23063,48570,44850,2,124;148;102;49;178;106;52;55;57;92;129;2;120;44;25;16;171;175;113;56;31;78;145;179;196;81;90;165;40;185;138;14;144;62;9;15;114;186;89;183;23;137;176;80;151;162;127;123;149;65;116;43;184;177;54;48;160;34;146;22;18;108;69;159;181;42;5;41;193;139;68;140;93;117;143;0;46;115;59;118;51;133;79;63;180;135;70;154;158;53;121;100;26;86;75;101;1;97;152;94,1927158822219721762,0.002003
steepest_intra:nodes_start:greedy,131,71630,23068,48562,59800,3,131;149;123;127;162;151;133;135;70;154;180;53;121;100;26;86;75;44;25;16;171;175;113;56;31;78;145;179;196;81;90;165;40;185;106;178;3;14;144;62;9;148;102;49;52;55;57;92;129;82;120;2;101;1;97;152;124;94;63;79;80;176;137;23;186;89;183;143;117;0;51;118;59;115;46;68;139;193;41;5;42;181;159;69;108;18;22;146;34;160;48;54;177;10;190;84;184;43;116;65,8585060927533692616,0.002033
steepest_intra:nodes_start:greedy,132,71756,23851,47905,104650,6,21;14;138;185;40;165;90;81;196;179;145;78;31;56;113;175;171;16;25;44;120;75;86;152;124;94;63;79;80;176;133;151;51;118;59;115;46;0;137;23;186;89;183;143;117;93;140;68;139;193;41;5;42;181;159;69;108;18;22;146;34;160;48;54;177;10;190;184;43;116;65;131;149;162;123;127;70;135;154;180;53;100;26;97;1;101;2;129;92;57;55;52;106;178;49;102;148;9;62;144,3340233022820615397,0.002050
steepest_intra:nodes_start:greedy,133,71753,23248,48505,74750,4,133;151;51;118;59;115;46;0;137;23;186;89;183;143;117;93;140;68;139;193;41;5;42;181;159;69;108;18;22;146;34;160;48;54;177;10;184;43;116;65;131;149;162;123;127;70;135;154;180;53;121;100;26;86;75;44;25;16;171;175;113;56;31;78;145;179;196;81;90;165;40;185;106;178;3;14;144;62;9;148;102;49;52;55;57;92;129;82;120;2;101;1;97;152;124;94;63;79;80;176,4406311670969396135,0.002011
steepest_intra:nodes_start:greedy,134,71818,22753,49065,134550,8,199;18;108;69;139;68;46;115;59;118;51;0;117;143;183;89;186;23;137;176;80;79;63;94;124;152;97;1;101;2;120;82;129;92;57;55;52;49;102;148;9;62;144;14;3;178;106;185;40;165;90;81;196;179;145;78;31;56;113;175;171;16;25;44;75;86;26;100;121;53;180;154;70;135;133;151;162;127;123;149;65;116;43;184;190;10;177;54;48;160;34;181;42;5;41;193;159;195;146;22,7417545590766857327,0.003001
steepest_intra:nodes_start:greedy,135,71633,23063,48570,29900,1,135;70;154;158;53;121;100;26;86;75;101;1;97;152;94;124;148;102;49;178;106;52;55;57;92;129;2;120;44;25;16;171;175;113;56;31;78;145;179;196;81;90;165;40;185;138;14;144;62;9;15;114;186;89;183;23;137;176;80;151;162;127;123;149;65;116;43;184;177;54;48;160;34;146;22;18;108;69;159;181;42;5;41;193;139;68;140;93;117;143;0;46;115;59;118;51;133;79;63;180,7582380977905599401,0.000000
steepest_intra:nodes_start:greedy,136,71783,23084,48699,134550,8,53;121;100;26;86;75;44;25;16;171;175;113;56;31;78;145;179;196;81;90;165;40;185;106;178;3;14;144;62;9;148;102;49;52;55;57;92;129;82;120;2;101;1;97;152;124;94;63;79;80;176;137;23;186;89;183;143;117;0;51;118;59;115;46;68;139;193;41;5;42;181;159;69;108;18;22;146;34;160;48;54;177;10;190;84;184;43;116;65;149;123;127;162;151;133;135;70;154;180;158,6257737676211451081,0.004008
steepest_intra:nodes_start:greedy,137,71633,23063,48570,29900,1,137;23;183;89;186;114;15;9;62;144;14;138;185;40;165;90;81;196;179;145;78;31;56;113;175;171;16;25;44;120;2;129;92;57;55;52;106;178;49;102;148;124;94;152;97;1;101;75;86;26;100;121;53;158;154;70;135;180;63;79;133;51;118;59;115;46;0;143;117;93;140;68;139;193;41;5;42;181;159;69;108;18;22;146;34;160;48;54;177;184;43;116;65;149;123;127;162;151;80;176,4615424154745740505,0.001002
steepest_intra:nodes_start:greedy,138,71291,23229,48062,89700,5,138;14;144;62;9;148;102;49;178;106;52;55;57;92;129;2;101;1;97;26;100;53;180;154;135;70;127;123;162;149;131;65;116;43;184;84;190;10;177;54;48;160;34;146;22;18;108;69;159;181;42;5;41;193;139;68;140;93;117;143;183;89;186;23;137;0;46;115;59;118;51;151;133;176;80;79;63;94;124;152;86;75;120;44;25;16;171;175;113;56;31;78;145;179;196;81;90;165;40;185,229720878708604015,0.002003
steepest_intra:nodes_start:greedy,139,71485,23362,48123,74750,4,139;68;46;115;59;118;51;0;117;143;183;89;186;23;137;176;80;79;63;94;124;152;97;1;101;2;120;82;129;92;57;55;52;49;102;148;9;62;144;14;3;178;106;185;40;165;90;81;196;179;145;78;31;56;113;175;171;16;25;44;75;86;26;100;121;53;180;154;70;135;133;151;162;127;123;149;65;116;43;184;112;4;190;10;177;54;48;160;34;146;22;18;108;69;159;181;42;5;41;193,3226442065485426589,0.002001
steepest_intra:nodes_start:greedy,140,71475,23225,48250,89700,5,140;108;69;18;22;146;159;193;41;5;42;181;34;160;48;54;177;10;190;4;112;184;43;116;65;149;123;127;162;151;133;135;70;154;180;53;121;100;26;86;75;44;25;16;171;175;113;56;31;78;145;179;196;81;90;165;40;185;106;178;3;14;144;62;9;148;102;49;52;55;57;92;129;82;120;2;101;1;97;152;124;94;63;79;80;176;137;51;118;59;115;139;68;46;0;89;183;143;117;93,2678486043694424251,0.002001
steepest_intra:nodes_start:greedy,141,70908,22317,48591,119600,7,23;186;114;89;183;143;0;117;93;140;68;46;115;139;193;41;5;42;181;159;69;108;18;22;146;34;160;48;54;177;10;190;184;43;116;65;59;118;51;151;133;162;123;127;70;135;154;180;53;121;100;26;86;75;44;25;16;171;175;113;56;31;78;145;179;196;81;90;165;40;185;106;178;3;14;144;62;9;148;102;49;52;55;57;92;129;82;120;2;101;1;97;152;124;94;63;79;80;176;137,8630147454898016719,0.003971
steepest_intra:nodes_start:greedy,142,71964,23165,48799,89700,5,139;198;68;46;115;59;118;51;0;117;143;183;89;186;23;137;176;80;79;63;94;124;152;97;1;101;2;120;82;129;92;57;55;52;49;102;148;9;62;144;14;3;178;106;185;40;165;90;81;196;179;145;78;31;56;113;175;171;16;25;44;75;86;26;100;121;53;180;154;70;135;133;151;162;127;123;149;65;116;43;184;84;190;10;177;54;48;160;34;146;22;18;108;69;159;181;42;5;41;193,1978152573821014037,0.002011
steepest_intra:nodes_start:greedy,143,70687,22482,48205,89700,5,143;117;0;46;68;139;115;193;41;5;42;181;159;69;108;18;22;146;34;160;48;54;177;10;190;4;112;84;184;43;116;65;59;118;51;151;133;162;123;127;70;135;154;180;53;121;100;26;86;75;44;25;16;171;175;113;56;31;78;145;179;196;81;90;165;40;185;106;178;3;14;144;62;9;148;102;49;52;55;57;92;129;82;120;2;101;1;97;152;124;94;63;79;80;176;137;23;186;89;183,5204570602529342096,0.003007
steepest_intra:nodes_start:greedy,144,71291,23229,48062,89700,5,144;14;138;185;40;165;90;81;196;179;145;78;31;56;113;175;171;16;25;44;120;75;86;152;124;94;63;79;80;176;133;151;51;118;59;115;46;0;137;23;186;89;183;143;117;93;140;68;139;193;41;5;42;181;159;69;108;18;22;146;34;160;48;54;177;10;190;84;184;43;116;65;131;149;162;123;127;70;135;154;180;53;100;26;97;1;101;2;129;92;57;55;52;106;178;49;102;148;9;62,4918015896369979781,0.003267
steepest_intra:nodes_start:greedy,145,71427,23287,48140,119600,7,145;179;196;81;90;165;40;185;106;178;3;14;144;62;9;148;102;49;52;55;57;92;129;2;101;1;97;26;100;53;180;154;135;70;127;123;162;149;131;65;116;43;184;84;190;10;177;54;48;160;34;146;22;18;108;69;159;181;42;5;41;193;139;68;140;93;117;143;183;89;186;23;137;0;46;115;59;118;51;151;133;176;80;79;63;94;124;152;86;75;120;44;25;16;171;175;113;56;31;78,8476436886675094509,0.003000
steepest_intra:nodes_start:greedy,146,71022,23049,47973,59800,3,146;181;34;160;48;54;177;10;190;4;112;84;184;42;43;116;65;149;123;127;162;151;133;135;70;154;180;53;121;100;26;86;75;44;25;16;171;175;113;56;31;78;145;179;196;81;90;165;40;185;106;178;3;14;144;62;9;148;102;49;52;55;57;92;129;82;120;2;101;1;97;152;124;94;63;79;80;176;137;23;186;89;183;143;117;0;51;118;59;115;46;68;139;41;193;159;69;108;18;22,9096170817830950186,0.002001
steepest_intra:nodes_start:greedy,147,71640,22982,48658,134550,8,30;177;10;190;184;43;116;65;59;118;115;46;0;51;151;133;162;123;127;70;135;154;180;53;121;100;26;86;75;44;25;16;171;175;113;56;31;78;145;179;196;81;90;165;40;185;106;178;3;14;144;62;9;148;102;49;52;55;57;92;129;82;120;2;101;1;97;152;124;94;63;79;80;176;137;23;186;89;183;143;117;93;140;68;139;41;193;159;69;108;18;22;146;195;181;42;160;34;48;54,7105768687110868415,0.002998
steepest_intra:nodes_start:greedy,148,71291,23229,48062,89700,5,148;102;49;178;106;52;55;57;92;129;2;101;1;97;26;100;53;180;154;135;70;127;123;162;149;131;65;116;43;184;84;190;10;177;54;48;160;34;146;22;18;108;69;159;181;42;5;41;193;139;68;140;93;117;143;183;89;186;23;137;0;46;115;59;118;51;151;133;176;80;79;63;94;124;152;86;75;120;44;25;16;171;175;113;56;31;78;145;179;196;81;90;165;40;185;138;14;144;62;9,7629217858048309510,0.002011
steepest_intra:nodes_start:greedy,149,71485,23362,48123,74750,4,149;123;127;162;151;133;135;70;154;180;53;121;100;26;86;75;44;25;16;171;175;113;56;31;78;145;179;196;81;90;165;40;185;106;178;3;14;144;62;9;148;102;49;52;55;57;92;129;82;120;2;101;1;97;152;124;94;63;79;80;176;137;23;186;89;183;143;117;0;51;118;59;115;46;68;139;193;41;5;42;181;159;69;108;18;22;146;34;160;48;54;177;10;190;4;112;184;43;116;65,2304120569176938570,0.002000
steepest_intra:nodes_start:greedy,150,72586,23548,49038,89700,5,101;75;44;25;16;171;175;113;56;31;78;145;179;57;92;129;82;120;2;152;1;97;26;100;189;94;124;148;102;49;178;106;52;55;185;40;196;81;90;165;138;14;144;62;9;15;114;186;89;183;23;137;176;80;151;162;123;149;65;116;43;184;177;54;48;160;34;146;22;18;108;69;159;181;42;5;41;193;139;68;140;93;117;143;0;46;115;59;118;51;133;79;63;180;135;70;154;53;121;86,4654628602731330999,0.002033
steepest_intra:nodes_start:greedy,151,71577,23015,48562,59800,3,151;133;162;123;127;70;135;154;180;53;121;100;26;86;75;44;25;16;171;175;113;56;31;78;145;179;196;81;90;165;40;185;106;178;3;14;144;62;9;148;102;49;52;55;57;92;129;82;120;2;101;1;97;152;124;94;63;79;80;176;137;23;186;89;183;143;117;0;51;118;59;115;46;68;139;193;41;5;42;181;159;69;108;18;22;146;34;160;48;54;177;10;190;84;184;43;116;65;131;149,7109185347024019670,0.002000
steepest_intra:nodes_start:greedy,152,71666,23477,48189,59800,3,152;1;101;75;86;53;154;70;135;180;63;79;133;51;118;59;115;46;0;143;117;93;140;68;139;193;41;5;42;181;159;69;108;18;22;146;34;160;48;54;177;10;184;43;116;65;149;123;127;162;151;80;176;137;23;183;89;186;114;15;9;62;144;14;138;185;40;165;90;81;196;179;145;78;31;56;113;175;171;16;25;44;120;2;129;92;57;55;52;106;178;49;102;148;124;94;121;100;26;97,9219707739393525058,0.002000
steepest_intra:nodes_start:greedy,153,70626,22492,48134,164450,10,93;117;0;143;183;89;186;23;137;176;80;79;63;94;124;152;97;1;101;2;120;82;129;92;57;55;52;49;102;148;9;62;144;14;3;178;106;185;40;165;90;81;196;179;145;78;31;56;113;175;171;16;25;44;75;86;26;100;121;53;180;154;135;70;127;123;162;133;151;51;118;59;65;116;43;184;112;4;190;10;177;54;48;160;34;146;22;18;108;69;159;181;42;5;41;193;139;115;46;68,6292692617743076406,0.004973
steepest_intra:nodes_start:greedy,154,71633,23063,48570,29900,1,154;158;53;121;100;26;86;75;101;1;97;152;94;124;148;102;49;178;106;52;55;57;92;129;2;120;44;25;16;171;175;113;56;31;78;145;179;196;81;90;165;40;185;138;14;144;62;9;15;114;186;89;183;23;137;176;80;151;162;127;123;149;65;116;43;184;177;54;48;160;34;146;22;18;108;69;159;181;42;5;41;193;139;68;140;93;117;143;0;46;115;59;118;51;133;79;63;180;135;70,1839660732056186391,0.001000
steepest_intra:nodes_start:greedy,155,71756,23851,47905,104650,6,21;14;138;185;40;165;90;81;196;179;145;78;31;56;113;175;171;16;25;44;120;75;86;152;124;94;63;79;80;176;133;151;51;118;59;115;46;0;137;23;186;89;183;143;117;93;140;68;139;193;41;5;42;181;159;69;108;18;22;146;34;160;48;54;177;10;190;184;43;116;65;131;149;162;123;127;70;135;154;180;53;100;26;97;1;101;2;129;92;57;55;52;106;178;49;102;148;9;62;144,727557158004243874,0.003003
steepest_intra:nodes_start:greedy,156,71710,23103,48607,104650,6,131;112;4;84;35;184;177;54;48;160;34;181;146;22;18;108;69;159;193;41;5;42;43;116;65;46;68;139;115;59;118;51;0;117;143;183;89;186;23;137;176;80;79;63;94;124;152;97;1;101;2;120;82;129;92;57;55;52;49;102;148;9;62;144;14;3;178;106;185;40;165;90;81;196;179;145;78;31;56;113;175;171;16;25;44;75;86;26;100;121;53;180;154;70;135;133;151;162;123;149,3512496817346107128,0.003001
steepest_intra:nodes_start:greedy,157,71731,23416,48315,104650,6,157;196;81;90;165;40;185;106;178;3;14;144;62;9;148;102;49;52;55;179;145;78;92;57;129;2;101;1;97;26;100;53;180;154;135;70;127;123;162;149;131;65;116;43;184;190;10;177;54;48;160;34;146;22;18;108;69;159;181;42;5;41;193;139;68;140;93;117;143;183;89;186;23;137;0;46;115;59;118;51;151;133;176;80;79;63;94;124;152;86;75;120;44;25;16;171;175;113;56;31,7648311383791102410,0.003001
steepest_intra:nodes_start:greedy,158,71633,23063,48570,29900,1,158;154;70;135;180;63;79;133;51;118;59;115;46;0;143;117;93;140;68;139;193;41;5;42;181;159;69;108;18;22;146;34;160;48;54;177;184;43;116;65;149;123;127;162;151;80;176;137;23;183;89;186;114;15;9;62;144;14;138;185;40;165;90;81;196;179;145;78;31;56;113;175;171;16;25;44;120;2;129;92;57;55;52;106;178;49;102;148;124;94;152;97;1;101;75;86;26;100;121;53,3271663658324808449,0.000999
steepest_intra:nodes_start:greedy,159,71475,23225,48250,89700,5,159;146;22;18;69;108;140;93;117;143;183;89;0;46;68;139;115;59;118;51;137;176;80;79;63;94;124;152;97;1;101;2;120;82;129;92;57;55;52;49;102;148;9;62;144;14;3;178;106;185;40;165;90;81;196;179;145;78;31;56;113;175;171;16;25;44;75;86;26;100;121;53;180;154;70;135;133;151;162;127;123;149;65;116;43;184;112;4;190;10;177;54;48;160;34;181;42;5;41;193,8351009176600086115,0.002290
steepest_intra:nodes_start:greedy,160,71022,23049,47973,59800,3,160;48;54;177;10;190;4;112;84;184;42;43;116;65;149;123;127;162;151;133;135;70;154;180;53;121;100;26;86;75;44;25;16;171;175;113;56;31;78;145;179;196;81;90;165;40;185;106;178;3;14;144;62;9;148;102;49;52;55;57;92;129;82;120;2;101;1;97;152;124;94;63;79;80;176;137;23;186;89;183;143;117;0;51;118;59;115;46;68;139;41;193;159;69;108;18;22;146;181;34,7636899891116712655,0.002003
steepest_intra:nodes_start:greedy,161,72032,23246,48786,89700,5,127;70;135;133;180;154;158;53;121;100;26;86;75;44;25;16;171;175;113;56;31;78;145;179;196;81;90;165;40;185;106;178;3;14;144;62;9;148;102;49;52;55;57;92;129;82;120;2;101;1;97;152;124;94;63;79;80;176;137;23;186;89;183;143;117;0;51;118;59;115;46;68;139;193;41;5;42;181;159;69;108;18;22;146;34;160;48;54;177;10;190;184;43;116;65;131;149;151;162;123,7738715834908451348,0.003001
steepest_intra:nodes_start:greedy,162,71485,23362,48123,74750,4,162;151;133;135;70;154;180;53;121;100;26;86;75;44;25;16;171;175;113;56;31;78;145;179;196;81;90;165;40;185;106;178;3;14;144;62;9;148;102;49;52;55;57;92;129;82;120;2;101;1;97;152;124;94;63;79;80;176;137;23;186;89;183;143;117;0;51;118;59;115;46;68;139;193;41;5;42;181;159;69;108;18;22;146;34;160;48;54;177;10;190;4;112;184;43;116;65;149;123;127,6796995497772657075,0.001972
steepest_intra:nodes_start:greedy,163,71759,22908,48851,89700,5,69;139;68;46;115;59;118;51;0;117;143;183;89;186;23;137;176;80;79;63;94;124;152;97;1;101;2;120;82;129;92;57;55;52;49;102;148;9;62;144;14;3;178;106;185;40;165;90;81;196;179;145;78;31;56;113;175;171;16;25;44;75;86;26;100;121;53;180;154;70;135;133;151;162;127;123;149;65;116;43;184;84;190;10;177;54;48;160;34;181;42;5;41;193;159;146;22;199;18;108,8931201082523147470,0.002635
steepest_intra:nodes_start:greedy,164,72157,23629,48528,29900,1,164;7;95;39;165;138;14;144;62;9;148;102;49;178;106;52;55;57;92;129;2;152;97;1;101;100;53;180;154;135;70;127;123;162;149;65;116;43;184;177;54;48;160;34;146;22;18;108;69;159;181;42;5;41;193;139;68;140;93;117;143;183;89;23;137;0;46;115;59;118;51;151;133;176;80;79;63;94;26;86;75;120;44;25;16;171;175;113;56;31;78;145;179;196;81;185;40;90;27;58,8867498652282032736,0.001001
steepest_intra:nodes_start:greedy,165,71291,23229,48062,89700,5,185;40;165;90;81;196;179;145;78;31;56;113;175;171;16;25;44;120;75;86;152;124;94;63;79;80;176;133;151;51;118;59;115;46;0;137;23;186;89;183;143;117;93;140;68;139;193;41;5;42;181;159;69;108;18;22;146;34;160;48;54;177;10;190;84;184;43;116;65;131;149;162;123;127;70;135;154;180;53;100;26;97;1;101;2;129;92;57;55;52;106;178;49;102;148;9;62;144;14;138,3372899125328338451,0.003300
steepest_intra:nodes_start:greedy,166,71791,23246,48545,89700,5,35;184;190;10;177;54;48;160;34;146;22;18;108;69;159;181;42;5;41;193;139;68;140;93;117;143;183;89;186;23;137;176;80;79;63;94;124;152;97;1;101;2;120;82;129;92;57;55;52;49;102;148;9;62;144;14;3;178;106;185;40;165;90;81;196;179;145;78;31;56;113;175;171;16;25;44;75;86;26;100;121;53;180;154;135;70;127;123;162;133;151;51;0;46;115;118;59;65;116;43,4204844339029179045,0.003025
steepest_intra:nodes_start:greedy,167,72658,24082,48576,44850,2,167;148;9;62;102;144;14;49;178;106;165;39;95;7;164;58;27;90;81;196;40;185;52;55;57;129;92;179;145;78;31;56;113;175;171;16;25;44;120;2;75;101;1;152;97;26;100;86;53;154;70;135;180;63;79;133;51;118;59;115;46;0;89;183;143;117;93;140;68;139;193;41;5;42;181;159;69;108;18;22;146;34;160;48;54;177;184;43;116;65;149;123;127;162;151;80;176;137;94;124,8389412590362313268,0.001000
steepest_intra:nodes_start:greedy,168,71656,23341,48315,149500,9,78;145;179;196;81;90;165;40;185;106;178;3;14;144;62;9;148;102;49;52;55;57;92;129;2;101;1;97;26;100;53;180;154;135;70;127;123;162;149;131;65;116;43;184;190;10;177;54;48;160;34;146;22;18;108;69;159;181;42;5;41;193;139;68;140;93;117;143;183;89;186;23;137;0;46;115;59;118;51;151;133;176;80;79;63;94;124;152;86;75;120;44;25;16;171;175;113;56;31;157,3132896741685503155,0.004012
steepest_intra:nodes_start:greedy,169,71301,23106,48195,119600,7,119;40;185;165;138;14;144;62;9;148;102;49;178;106;52;55;57;92;129;2;101;1;97;26;100;53;180;154;135;70;127;123;162;149;131;65;116;43;184;190;10;177;54;48;160;34;146;22;18;108;69;159;181;42;5;41;193;139;68;140;93;117;143;183;89;186;23;137;0;46;115;59;118;51;151;133;176;80;79;63;94;124;152;86;75;120;44;25;16;171;175;113;56;31;78;145;179;196;81;90,284765317055158963,0.003000
steepest_intra:nodes_start:greedy,170,71121,22497,48624,104650,6,170;117;0;46;68;139;115;193;41;5;42;181;159;69;108;18;22;146;34;160;48;54;177;10;190;4;112;184;43;116;65;59;118;51;151;133;162;123;127;70;135;154;180;53;121;100;26;86;75;44;25;16;171;175;113;56;31;78;145;179;196;81;90;165;40;185;106;178;3;14;144;62;9;148;102;49;52;55;57;92;129;82;120;2;101;1;97;152;124;94;63;79;80;176;137;23;186;89;183;143,9201377410396862925,0.003008
steepest_intra:nodes_start:greedy,171,71624,23484,48140,119600,7,171;175;113;56;31;78;145;92;179;196;81;90;165;40;185;106;178;3;14;144;62;9;148;102;49;52;55;57;129;2;101;1;97;26;100;53;180;154;135;70;127;123;162;149;131;65;116;43;184;84;190;10;177;54;48;160;34;146;22;18;108;69;159;181;42;5;41;193;139;68;140;93;117;143;183;89;186;23;137;0;46;115;59;118;51;151;133;176;80;79;63;94;124;152;86;75;120;44;25;16,2028697813532642197,0.003011
steepest_intra:nodes_start:greedy,172,71965,23500,48465,59800,3,124;167;148;9;62;102;144;14;49;178;106;165;39;27;90;81;196;40;185;52;55;57;129;92;179;145;78;31;56;113;175;171;16;25;44;120;2;75;86;100;121;94;63;79;80;176;133;151;51;118;59;115;46;0;137;23;186;89;183;143;117;93;140;68;139;193;41;5;42;181;159;69;108;18;22;146;34;160;48;54;177;184;43;116;65;131;149;162;123;127;70;135;154;180;53;26;101;1;97;152,1985111850944741110,0.002000
steepest_intra:nodes_start:greedy,173,71791,23221,48570,59800,3,135;127;70;154;158;53;121;100;26;86;75;101;1;97;152;94;124;148;102;49;178;106;52;55;57;92;129;2;120;44;25;16;171;175;113;56;31;78;145;179;196;81;90;165;40;185;138;14;144;62;9;15;114;186;89;183;23;137;176;80;151;162;123;149;65;116;43;184;177;54;48;160;34;146;22;18;108;69;159;181;42;5;41;193;139;68;140;93;117;143;0;46;115;59;118;51;133;79;63;180,3108566094706465080,0.001001
steepest_intra:nodes_start:greedy,174,71515,23453,48062,89700,5,196;40;185;179;145;78;31;56;113;175;171;16;25;44;120;75;86;152;124;94;63;79;80;176;133;151;51;118;59;115;46;0;137;23;186;89;183;143;117;93;140;68;139;193;41;5;42;181;159;69;108;18;22;146;34;160;48;54;177;10;190;84;184;43;116;65;131;149;162;123;127;70;135;154;180;53;100;26;97;1;101;2;129;92;57;55;52;106;178;49;102;148;9;62;144;14;138;165;90;81,4388089596243717783,0.002000
steepest_intra:nodes_start:greedy,175,71624,23484,48140,119600,7,175;113;56;31;78;145;92;179;196;81;90;165;40;185;106;178;3;14;144;62;9;148;102;49;52;55;57;129;2;101;1;97;26;100;53;180;154;135;70;127;123;162;149;131;65;116;43;184;84;190;10;177;54;48;160;34;146;22;18;108;69;159;181;42;5;41;193;139;68;140;93;117;143;183;89;186;23;137;0;46;115;59;118;51;151;133;176;80;79;63;94;124;152;86;75;120;44;25;16;171,7893890339977394859,0.004000
steepest_intra:nodes_start:greedy,176,71577,23015,48562,59800,3,176;80;79;63;94;124;152;97;1;101;2;120;82;129;92;57;55;52;49;102;148;9;62;144;14;3;178;106;185;40;165;90;81;196;179;145;78;31;56;113;175;171;16;25;44;75;86;26;100;121;53;180;154;135;70;127;123;162;133;151;149;131;65;116;43;184;84;190;10;177;54;48;160;34;146;22;18;108;69;159;181;42;5;41;193;139;68;46;115;59;118;51;0;117;143;183;89;186;23;137,2009586221107306302,0.002001
steepest_intra:nodes_start:greedy,177,71628,23064,48564,104650,6,177;54;48;34;160;42;181;195;146;22;18;108;69;159;193;41;139;68;140;93;117;143;183;89;186;23;137;176;80;79;63;94;124;152;97;1;101;2;120;82;129;92;57;55;52;49;102;148;9;62;144;14;3;178;106;185;40;165;90;81;196;179;145;78;31;56;113;175;171;16;25;44;75;86;26;100;121;53;180;154;135;70;127;123;162;133;151;51;0;46;115;118;59;65;116;43;184;84;190;10,2818298825777439174,0.003004
steepest_intra:nodes_start:greedy,178,71291,23229,48062,89700,5,178;49;102;148;9;62;144;14;138;185;40;165;90;81;196;179;145;78;31;56;113;175;171;16;25;44;120;75;86;152;124;94;63;79;80;176;133;151;51;118;59;115;46;0;137;23;186;89;183;143;117;93;140;68;139;193;41;5;42;181;159;69;108;18;22;146;34;160;48;54;177;10;190;84;184;43;116;65;131;149;162;123;127;70;135;154;180;53;100;26;97;1;101;2;129;92;57;55;52;106,7129417069043698510,0.003033
steepest_intra:nodes_start:greedy,179,71427,23287,48140,104650,6,179;145;78;31;56;113;175;171;16;25;44;120;75;86;152;124;94;63;79;80;176;133;151;51;118;59;115;46;0;137;23;186;89;183;143;117;93;140;68;139;193;41;5;42;181;159;69;108;18;22;146;34;160;48;54;177;10;190;84;184;43;116;65;131;149;162;123;127;70;135;154;180;53;100;26;97;1;101;2;129;92;57;55;52;49;102;148;9;62;144;14;3;178;106;185;40;165;90;81;196,4409692626547027171,0.003000
steepest_intra:nodes_start:greedy,180,71633,23063,48570,29900,1,180;135;70;154;158;53;121;100;26;86;75;101;1;97;152;94;124;148;102;49;178;106;52;55;57;92;129;2;120;44;25;16;171;175;113;56;31;78;145;179;196;81;90;165;40;185;138;14;144;62;9;15;114;186;89;183;23;137;176;80;151;162;127;123;149;65;116;43;184;177;54;48;160;34;146;22;18;108;69;159;181;42;5;41;193;139;68;140;93;117;143;0;46;115;59;118;51;133;79;63,1687853677620490533,0.001001
steepest_intra:nodes_start:greedy,181,71022,23049,47973,59800,3,181;34;160;48;54;177;10;190;4;112;84;184;42;43;116;65;149;123;127;162;151;133;135;70;154;180;53;121;100;26;86;75;44;25;16;171;175;113;56;31;78;145;179;196;81;90;165;40;185;106;178;3;14;144;62;9;148;102;49;52;55;57;92;129;82;120;2;101;1;97;152;124;94;63;79;80;176;137;23;186;89;183;143;117;0;51;118;59;115;46;68;139;41;193;159;69;108;18;22;146,8451828783342678407,0.001002
steepest_intra:nodes_start:greedy,182,71633,23063,48570,59800,3,53;121;100;26;86;75;101;1;97;152;94;124;148;102;49;178;106;52;55;57;92;129;2;120;44;25;16;171;175;113;56;31;78;145;179;196;81;90;165;40;185;138;14;144;62;9;15;114;186;89;183;23;137;176;80;151;162;127;123;149;65;116;43;184;177;54;48;160;34;146;22;18;108;69;159;181;42;5;41;193;139;68;140;93;117;143;0;46;115;59;118;51;133;79;63;180;135;70;154;158,2531019631219662101,0.001005
steepest_intra:nodes_start:greedy,183,70687,22482,48205,89700,5,183;89;186;23;137;176;80;79;63;94;124;152;97;1;101;2;120;82;129;92;57;55;52;49;102;148;9;62;144;14;3;178;106;185;40;165;90;81;196;179;145;78;31;56;113;175;171;16;25;44;75;86;26;100;121;53;180;154;135;70;127;123;162;133;151;51;118;59;65;116;43;184;84;112;4;190;10;177;54;48;160;34;146;22;18;108;69;159;181;42;5;41;193;115;139;68;46;0;117;143,6882397999839691096,0.003001
steepest_intra:nodes_start:greedy,184,71664,23164,48500,74750,4,184;43;116;65;59;118;115;46;0;51;151;133;162;123;127;70;135;154;180;53;121;100;26;86;75;44;25;16;171;175;113;56;31;78;145;179;196;81;90;165;40;185;106;178;3;14;144;62;9;148;102;49;52;55;57;92;129;82;120;2;101;1;97;152;124;94;63;79;80;176;137;23;186;89;183;143;117;93;140;68;139;193;41;5;42;181;159;69;108;18;22;146;34;160;48;54;177;10;190;84,1643667656361478310,0.002000
steepest_intra:nodes_start:greedy,185,71291,23229,48062,89700,5,165;90;81;196;179;145;78;31;56;113;175;171;16;25;44;120;75;86;152;124;94;63;79;80;176;133;151;51;118;59;115;46;0;137;23;186;89;183;143;117;93;140;68;139;193;41;5;42;181;159;69;108;18;22;146;34;160;48;54;177;10;190;84;184;43;116;65;131;149;162;123;127;70;135;154;180;53;100;26;97;1;101;2;129;92;57;55;52;106;178;49;102;148;9;62;144;14;138;185;40,1274902765191153946,0.002297
steepest_intra:nodes_start:greedy,186,70687,22482,48205,89700,5,186;89;183;143;117;0;46;68;139;115;193;41;5;42;181;159;69;108;18;22;146;34;160;48;54;177;10;190;4;112;84;184;43;116;65;59;118;51;151;133;162;123;127;70;135;154;180;53;121;100;26;86;75;44;25;16;171;175;113;56;31;78;145;179;196;81;90;165;40;185;106;178;3;14;144;62;9;148;102;49;52;55;57;92;129;82;120;2;101;1;97;152;124;94;63;79;80;176;137;23,2057851503661605093,0.003021
steepest_intra:nodes_start:greedy,187,71554,23449,48105,104650,6,90;81;196;40;185;179;145;78;31;56;113;175;171;16;25;44;120;75;86;152;124;94;63;79;80;176;133;151;51;118;59;115;46;0;137;23;186;89;183;143;117;93;140;68;139;193;41;5;42;181;159;69;108;18;22;146;34;160;48;54;177;10;190;184;43;116;65;131;149;162;123;127;70;135;154;180;53;100;26;97;1;101;2;129;92;57;55;52;106;178;49;102;148;9;62;144;14;138;165;27,5437417510193528040,0.002980
steepest_intra:nodes_start:greedy,188,71853,23538,48315,149500,9,31;157;78;145;92;179;196;81;90;165;40;185;106;178;3;14;144;62;9;148;102;49;52;55;57;129;2;101;1;97;26;100;53;180;154;135;70;127;123;162;149;131;65;116;43;184;190;10;177;54;48;160;34;146;22;18;108;69;159;181;42;5;41;193;139;68;140;93;117;143;183;89;186;23;137;0;46;115;59;118;51;151;133;176;80;79;63;94;124;152;86;75;120;44;25;16;171;175;113;56,7188116858012650907,0.003972
steepest_intra:nodes_start:greedy,189,71828,22768,49060,29900,1,189;94;124;148;102;49;178;106;52;55;57;92;129;2;120;44;25;16;171;175;113;56;31;78;145;179;196;81;90;165;40;185;138;14;144;62;9;15;114;186;89;183;23;137;176;80;151;162;123;149;65;116;43;184;177;54;48;160;34;146;22;18;108;69;159;181;42;5;41;193;139;68;140;93;117;143;0;46;115;59;118;51;133;79;63;180;135;70;154;158;53;121;100;26;86;75;101;1;97;152,451921962285127961,0.000986
steepest_intra:nodes_start:greedy,190,71443,23266,48177,119600,7,190;10;177;54;48;34;160;42;181;146;22;18;108;69;159;193;41;139;68;46;115;118;59;65;116;43;184;35;131;149;123;162;133;151;51;0;117;143;183;89;23;137;176;80;79;63;94;124;152;97;1;101;2;120;82;129;92;57;55;52;49;102;148;9;62;144;14;3;178;106;185;40;165;90;81;196;179;145;78;31;56;113;175;171;16;25;44;75;86;26;100;121;53;180;154;135;70;127;112;4,8665228691407653324,0.004003
steepest_intra:nodes_start:greedy,191,71964,23165,48799,89700,5,139;193;41;5;42;181;159;69;108;18;22;146;34;160;48;54;177;10;190;84;184;43;116;65;149;123;127;162;151;133;135;70;154;180;53;121;100;26;86;75;44;25;16;171;175;113;56;31;78;145;179;196;81;90;165;40;185;106;178;3;14;144;62;9;148;102;49;52;55;57;92;129;82;120;2;101;1;97;152;124;94;63;79;80;176;137;23;186;89;183;143;117;0;51;118;59;115;46;68;198,5232973515695984131,0.001998
steepest_intra:nodes_start:greedy,192,71856,23009,48847,119600,7,42;5;96;41;193;139;68;140;93;117;143;183;89;186;23;137;176;80;79;63;94;124;152;97;1;101;2;120;82;129;92;57;55;52;49;102;148;9;62;144;14;3;178;106;185;40;165;90;81;196;179;145;78;31;56;113;175;171;16;25;44;75;86;26;100;121;53;180;154;135;70;127;123;162;133;151;51;0;46;115;118;59;65;116;43;184;190;10;177;54;48;160;34;146;22;18;108;69;159;181,5834202795839269317,0.002998
steepest_intra:nodes_start:greedy,193,71485,23362,48123,74750,4,193;139;68;46;115;59;118;51;0;117;143;183;89;186;23;137;176;80;79;63;94;124;152;97;1;101;2;120;82;129;92;57;55;52;49;102;148;9;62;144;14;3;178;106;185;40;165;90;81;196;179;145;78;31;56;113;175;171;16;25;44;75;86;26;100;121;53;180;154;70;135;133;151;162;127;123;149;65;116;43;184;112;4;190;10;177;54;48;160;34;146;22;18;108;69;159;181;42;5;41,2751120975589555095,0.002012
steepest_intra:nodes_start:greedy,194,71989,23018,48971,74750,4,194;127;123;162;133;151;149;131;65;116;43;184;190;10;177;54;48;160;34;146;22;18;108;69;159;181;42;5;41;193;139;68;46;115;59;118;51;0;117;143;183;89;186;23;137;176;80;79;63;94;124;152;97;1;101;2;120;82;129;92;57;55;52;49;102;148;9;62;144;14;3;178;106;185;40;165;90;81;196;179;145;78;31;56;113;175;171;16;25;44;75;86;26;100;121;53;180;154;70;135,5920188398333131913,0.002001
steepest_intra:nodes_start:greedy,195,71272,23085,48187,74750,4,195;181;34;160;48;54;177;10;190;4;112;184;42;43;116;65;149;123;127;162;151;133;135;70;154;180;53;121;100;26;86;75;44;25;16;171;175;113;56;31;78;145;179;196;81;90;165;40;185;106;178;3;14;144;62;9;148;102;49;52;55;57;92;129;82;120;2;101;1;97;152;124;94;63;79;80;176;137;23;186;89;183;143;117;0;51;118;59;115;46;68;139;41;193;159;69;108;18;22;146,808501827881599794,0.001000
steepest_intra:nodes_start:greedy,196,72023,23506,48517,119600,7,196;81;90;165;40;185;106;178;3;14;144;62;9;148;102;49;52;55;57;129;92;179;145;78;82;2;101;1;97;26;100;53;180;154;135;70;127;123;162;149;131;65;116;43;184;10;177;54;48;160;34;146;22;18;108;69;159;181;42;5;41;193;139;68;140;93;117;143;183;89;186;23;137;0;46;115;59;118;51;151;133;176;80;79;63;94;124;152;86;75;120;44;25;16;171;175;113;56;31;157,5026464509060556204,0.002999
steepest_intra:nodes_start:greedy,197,71876,23077,48799,74750,4,198;46;68;139;193;41;5;42;181;159;69;108;18;22;146;34;160;48;54;177;10;190;84;184;43;116;65;149;123;127;162;151;133;135;70;154;180;53;121;100;26;86;75;44;25;16;171;175;113;56;31;78;145;179;196;81;90;165;40;185;106;178;3;14;144;62;9;148;102;49;52;55;57;92;129;82;120;2;101;1;97;152;124;94;63;79;80;176;137;23;186;89;183;143;117;0;51;118;59;115,5989942290663507136,0.002000
steepest_intra:nodes_start:greedy,198,71485,23362,48123,89700,5,68;46;115;59;118;51;0;117;143;183;89;186;23;137;176;80;79;63;94;124;152;97;1;101;2;120;82;129;92;57;55;52;49;102;148;9;62;144;14;3;178;106;185;40;165;90;81;196;179;145;78;31;56;113;175;171;16;25;44;75;86;26;100;121;53;180;154;70;135;133;151;162;127;123;149;65;116;43;184;112;4;190;10;177;54;48;160;34;146;22;18;108;69;159;181;42;5;41;193;139,1262281615706471059,0.003000
steepest_intra:nodes_start:greedy,199,71304,22988,48316,134550,8,93;68;46;139;115;59;118;51;0;117;143;183;89;186;23;137;176;80;79;63;94;124;152;97;1;101;2;120;82;129;92;57;55;52;49;102;148;9;62;144;14;3;178;106;185;40;165;90;81;196;179;145;78;31;56;113;175;171;16;25;44;75;86;26;100;121;53;180;154;70;135;133;151;162;127;123;149;65;116;43;184;84;190;10;177;54;48;160;34;181;42;5;41;193;159;146;22;18;108;140,8911128630972429270,0.003001
steepest_intra:edges_start:random,0,72545,22644,49901,2093000,139,4;190;10;177;54;48;34;22;159;193;41;5;43;42;181;160;184;84;35;131;149;116;65;162;151;51;118;59;115;139;46;68;117;0;143;183;89;23;137;176;80;133;79;122;63;94;148;9;62;144;49;14;138;3;178;106;52;55;57;185;40;119;165;39;164;27;90;81;196;145;78;31;56;113;175;171;16;25;44;120;92;129;2;75;86;101;1;152;97;26;53;158;180;154;70;135;194;127;123;112,7503574184151038109,0.046998
steepest_intra:edges_start:random,1,72944,23635,49309,2063100,137,162;151;176;51;118;59;123;112;184;10;177;54;48;34;160;42;43;65;116;115;46;68;139;41;193;159;146;22;18;69;108;140;93;117;143;0;153;183;89;23;137;148;9;62;102;49;178;106;138;14;144;21;164;39;165;185;40;119;90;81;196;157;31;56;113;175;171;16;25;44;120;82;78;145;179;52;55;57;92;129;2;152;97;1;101;75;86;100;26;94;63;122;80;79;133;180;53;158;154;135,5515915607128417681,0.046027
steepest_intra:edges_start:random,2,74014,23339,50675,2122900,141,131;149;123;127;29;112;35;84;4;190;10;177;54;48;160;184;77;43;5;42;181;34;146;22;18;159;193;41;139;115;46;68;140;93;117;143;0;153;183;89;186;23;137;148;9;62;144;102;49;14;138;165;27;90;81;196;40;185;106;178;52;55;57;145;78;113;175;171;16;44;120;92;129;2;152;97;1;101;75;86;26;94;53;154;70;135;180;63;79;133;162;151;80;176;51;59;116;105;65;47,7428713647195789561,0.047974
steepest_intra:edges_start:random,3,75311,24598,50713,1913600,127,102;148;15;9;62;144;21;14;138;106;185;165;40;196;31;113;175;171;16;78;145;92;44;120;75;101;86;26;100;121;53;158;154;180;63;79;135;127;112;4;10;177;30;54;48;34;160;184;84;35;43;42;116;65;131;149;123;162;133;151;51;118;59;115;139;41;193;159;181;146;22;18;108;140;68;46;0;143;183;89;114;186;23;137;176;80;122;94;124;189;97;1;152;2;57;55;52;178;3;49,3785942958552360736,0.042000
steepest_intra:edges_start:random,4,73193,24322,48871,1883700,125,145;179;196;40;119;165;90;164;7;21;14;144;62;9;49;178;106;185;52;55;57;92;129;2;152;97;1;101;26;100;121;63;79;133;162;151;51;176;80;94;124;148;137;183;143;170;0;117;93;68;46;118;59;115;42;159;193;41;139;108;18;22;146;181;34;160;48;54;177;10;190;184;43;116;65;47;77;149;131;35;84;112;123;127;70;135;154;180;53;86;75;120;44;25;16;171;175;113;31;78,8758375061644008592,0.040509
steepest_intra:edges_start:random,5,73367,22931,50436,1943500,129,26;100;121;182;136;53;158;180;154;135;70;127;123;162;133;151;51;118;59;115;41;193;159;42;116;65;47;149;131;77;43;184;35;84;112;4;177;54;160;34;146;22;18;108;139;46;68;117;0;143;183;89;137;176;80;79;63;94;152;2;129;92;57;55;52;106;178;49;9;62;144;14;165;39;95;7;164;27;90;81;196;40;185;145;78;31;56;113;175;171;16;25;44;82;120;75;86;101;1;97,7358395155234315295,0.043506
steepest_intra:edges_start:random,6,72937,23611,49326,2018250,134,23;89;183;153;0;143;117;93;108;69;18;199;159;22;146;34;48;54;177;184;84;112;65;116;43;5;42;160;181;193;41;139;68;46;198;115;59;118;51;137;176;80;133;151;162;123;127;70;135;154;180;53;63;94;97;26;100;86;75;101;1;152;2;129;120;44;145;78;16;171;175;113;56;31;196;81;90;27;164;7;95;39;165;40;185;92;57;55;52;106;178;49;14;144;102;62;9;148;15;186,6605371495121151939,0.045508
steepest_intra:edges_start:random,7,74209,23872,50337,1853800,123,162;123;112;4;190;10;177;184;35;131;149;47;43;116;65;59;118;115;5;42;181;160;48;54;30;34;103;146;195;22;18;108;159;193;41;139;46;0;143;183;137;144;14;21;164;27;90;165;185;119;40;81;196;157;56;113;175;171;16;31;145;78;25;44;120;129;92;179;57;55;52;106;178;3;138;49;102;62;9;148;124;94;152;1;97;26;101;75;86;53;180;154;135;133;79;63;80;176;51;151,8489177695450817266,0.039505
steepest_intra:edges_start:random,8,74432,23356,51076,1988350,132,123;127;194;135;70;154;180;63;79;133;162;151;72;109;51;66;176;80;122;94;124;152;1;97;26;100;121;53;158;86;101;75;2;120;44;16;171;175;113;56;31;81;196;145;78;92;129;57;55;52;178;106;185;40;90;27;165;14;49;144;62;9;148;137;23;89;183;143;0;46;115;118;59;149;131;65;116;43;42;5;96;41;193;159;139;68;108;69;18;22;146;181;34;160;54;177;10;184;84;112,7810206015073775397,0.043040
steepest_intra:edges_start:random,9,75831,23836,51995,1988350,132,162;59;118;51;176;137;183;143;0;46;139;68;140;108;69;18;22;146;103;34;160;181;159;193;41;115;5;42;184;177;10;4;112;84;35;43;105;116;65;47;131;149;123;135;154;180;53;86;101;75;120;44;16;171;175;113;31;196;81;40;119;185;165;39;90;27;95;58;164;7;21;144;14;49;102;62;9;15;148;37;167;3;178;106;52;55;57;179;145;78;92;129;2;1;97;152;94;63;133;151,7966614561790159191,0.043624
steepest_intra:edges_start:random,10,73628,24258,49370,1988350,132,113;56;31;81;90;164;7;21;138;14;144;49;102;62;9;15;148;37;167;55;52;178;106;185;165;119;40;196;78;145;179;57;92;129;2;152;97;26;100;94;63;122;79;80;176;137;89;183;143;0;117;68;46;198;115;139;140;108;69;18;22;159;193;41;5;42;181;34;160;177;4;112;184;43;116;65;131;149;59;118;51;151;133;162;123;127;135;154;180;53;86;101;1;75;120;44;25;16;171;175,3150388612778113112,0.044521
steepest_intra:edges_start:random,11,75931,22158,53773,1958450,130,151;162;123;149;131;43;116;65;59;118;109;51;46;198;115;139;193;41;5;42;181;160;28;184;35;84;112;4;190;10;177;104;54;30;48;34;146;195;159;22;18;69;108;36;140;93;68;117;143;170;0;153;183;89;137;176;80;79;122;63;94;148;9;62;144;49;14;138;165;90;40;185;106;178;52;57;92;145;78;113;175;171;16;44;120;2;152;1;101;75;86;97;26;100;53;180;154;70;135;133,1499963129461578531,0.042999
steepest_intra:edges_start:random,12,73334,24085,49249,2078050,138,63;135;154;180;53;86;101;75;120;44;92;145;78;16;171;175;113;56;31;196;81;40;185;165;90;27;95;164;7;21;14;144;102;49;178;106;52;55;57;129;2;1;97;152;94;124;148;9;62;15;114;186;89;183;23;137;176;51;109;118;59;115;139;68;46;0;143;117;108;69;18;193;41;5;42;159;22;146;181;34;160;48;54;177;10;184;43;116;65;47;131;149;123;127;162;151;133;79;80;122,1165120496672001419,0.046000
steepest_intra:edges_start:random,13,72333,22688,49645,1853800,123,53;86;75;101;100;26;97;1;152;2;120;44;25;145;78;16;171;175;113;56;31;81;196;92;57;55;52;178;3;106;185;40;119;165;90;27;39;138;14;49;102;144;62;9;148;124;94;80;176;137;23;89;183;143;117;0;46;139;68;140;108;69;18;22;159;193;41;34;160;48;54;184;177;10;190;4;112;123;149;131;47;65;116;43;42;5;115;59;118;51;151;162;133;79;63;180;154;135;70;158,5484470889475137877,0.041014
steepest_intra:edges_start:random,14,73733,22447,51286,2152800,143,112;4;84;184;177;54;160;34;181;146;22;18;108;69;199;159;193;41;139;46;115;5;42;43;116;47;65;59;118;51;80;176;137;183;89;186;15;62;9;37;148;167;49;102;144;14;138;3;178;106;52;55;185;40;119;165;27;90;81;196;145;78;31;113;175;171;16;25;44;120;82;92;179;57;129;2;152;97;1;101;75;86;26;100;121;53;154;135;180;124;94;63;79;133;151;162;149;131;123;127,8637569204739446279,0.048001
steepest_intra:edges_start:random,15,72165,22252,49913,2048150,136,127;135;154;180;158;53;121;100;26;86;75;101;1;97;152;2;120;44;145;78;16;171;175;113;31;81;90;165;119;40;185;92;129;57;55;52;106;178;3;14;144;49;102;62;9;148;124;94;63;79;133;151;162;59;118;109;51;80;176;137;23;89;183;143;0;117;93;140;108;69;18;22;146;195;159;181;42;41;193;139;68;46;115;43;116;65;47;149;131;35;84;184;160;34;48;54;177;4;112;123,1908559608413616080,0.044000
steepest_intra:edges_start:random,16,72513,22267,50246,2093000,139,47;131;149;59;151;51;46;115;139;41;193;159;22;18;108;93;117;0;143;183;89;23;137;176;80;133;79;63;94;148;9;62;144;102;49;14;138;3;178;106;165;27;90;119;40;185;52;55;57;92;179;196;81;157;85;56;113;175;171;16;31;145;78;25;44;120;82;129;2;152;97;1;101;75;86;26;100;121;53;180;154;135;70;127;123;112;84;184;10;177;54;48;160;34;181;42;5;43;116;65,8148968705654939743,0.045505
steepest_intra:edges_start:random,17,73257,23483,49774,2033200,135,97;1;101;86;75;2;120;44;145;78;16;171;175;113;31;157;196;81;90;27;165;119;40;185;179;92;57;55;52;106;178;3;138;14;144;102;49;167;148;9;62;15;114;186;137;23;89;183;143;117;0;46;68;93;140;108;18;159;22;146;181;193;41;139;198;115;59;42;160;34;48;54;30;177;10;190;184;43;116;65;123;127;70;135;154;180;53;63;79;133;162;151;176;80;94;124;152;121;100;26,6751444369897646578,0.044000
steepest_intra:edges_start:random,18,72387,22585,49802,2048150,136,149;59;118;65;116;43;184;35;84;112;4;190;10;177;54;48;34;160;42;5;41;193;159;181;195;146;22;18;108;140;68;139;115;46;0;143;183;89;137;51;176;80;79;63;94;124;148;9;62;144;14;49;178;106;52;55;57;92;78;145;179;185;40;119;165;90;81;196;157;38;31;56;113;175;171;16;25;44;120;129;2;75;101;1;152;97;26;86;53;154;180;133;151;162;135;70;127;123;24;131,3149045923337657039,0.047002
steepest_intra:edges_start:random,19,74280,23648,50632,2033200,135,177;184;112;127;70;135;154;158;180;63;79;133;151;162;123;149;131;47;65;116;105;43;42;5;159;193;41;115;198;139;68;46;118;59;72;109;51;176;80;94;124;152;97;26;100;53;86;75;101;1;2;129;120;44;25;16;171;175;113;31;78;145;179;92;57;52;185;40;165;90;164;21;144;14;106;178;49;62;9;148;15;186;137;23;89;183;143;170;0;117;108;69;18;22;146;195;181;34;160;54,6335446518232694108,0.043504
steepest_intra:edges_start:random,20,74022,23913,50109,1988350,132,184;177;4;112;127;70;135;123;162;151;133;79;122;63;180;154;158;53;121;189;152;97;26;100;86;75;101;1;2;120;44;16;171;175;113;31;78;145;179;92;129;57;55;52;178;3;106;185;40;81;90;27;164;39;165;138;14;144;49;102;62;9;15;148;124;94;80;176;51;59;149;131;65;116;43;42;159;193;41;139;68;46;198;115;118;109;137;23;186;89;183;143;0;117;108;18;22;146;34;160,4322092836184751876,0.044041
steepest_intra:edges_start:random,21,72902,23922,48980,2018250,134,119;165;27;90;81;196;157;31;56;113;175;171;16;78;145;179;57;92;129;25;44;120;2;75;86;101;1;152;97;26;53;180;154;135;70;127;194;133;79;63;122;80;176;51;151;162;123;149;131;112;84;184;10;177;54;34;22;18;159;193;181;160;42;5;43;116;65;59;118;115;41;139;46;68;93;117;0;143;183;89;23;186;114;15;137;94;148;9;62;102;49;144;14;3;178;106;52;55;185;40,7093872461269885919,0.045005
steepest_intra:edges_start:random,22,74548,22617,51931,2048150,136,120;2;152;97;1;101;75;86;26;100;53;154;180;63;94;124;122;79;80;176;51;109;118;72;151;133;162;135;123;149;131;35;112;4;84;184;177;54;48;160;34;181;146;22;159;193;41;96;5;42;43;116;65;59;115;46;68;139;199;18;69;108;93;117;0;170;143;183;89;186;23;137;148;9;62;144;102;49;14;178;106;52;55;57;92;78;145;185;40;119;165;39;27;90;81;31;113;175;171;16,9045910751841973785,0.043999
steepest_intra:edges_start:random,23,75310,24965,50345,1868750,124,53;158;180;154;135;70;127;123;112;4;177;54;184;131;149;47;65;116;43;42;160;48;34;181;41;193;159;22;18;108;117;143;183;0;46;68;139;115;59;118;51;151;162;133;176;80;79;63;94;124;152;97;1;2;82;129;167;148;137;23;89;186;114;15;9;62;102;49;144;21;14;138;3;178;106;165;90;81;40;185;52;55;57;92;145;78;113;175;171;16;44;120;75;101;86;26;100;121;182;136,1273542151953976104,0.042001
steepest_intra:edges_start:random,24,72465,23823,48642,1988350,132,22;18;159;193;41;139;68;140;93;117;143;0;46;115;116;59;118;51;80;176;137;183;89;23;186;9;62;102;144;14;49;167;148;124;94;152;2;129;92;57;55;52;178;3;106;185;40;119;165;90;81;196;179;145;78;157;31;56;113;175;171;16;25;44;82;120;75;86;101;1;97;26;100;53;154;70;135;180;63;122;79;133;151;162;123;127;112;4;177;54;48;184;149;65;43;42;160;34;181;146,201349874793537262,0.043999
steepest_intra:edges_start:random,25,74846,23571,51275,1958450,130,41;193;159;22;18;69;108;140;93;117;143;0;153;183;89;114;186;23;137;148;9;62;144;49;178;106;14;21;7;164;27;90;165;40;185;52;55;57;92;145;78;113;175;171;16;44;120;2;152;97;1;101;75;86;26;100;121;94;124;176;80;79;63;53;180;154;70;135;133;151;162;123;112;4;10;177;34;160;184;84;35;131;149;47;65;105;116;59;118;109;51;46;68;139;198;115;5;43;42;181,8409203329805918034,0.043505
steepest_intra:edges_start:random,26,72864,21249,51615,2033200,135,100;26;86;75;101;1;97;152;2;120;44;25;129;92;145;78;16;171;175;113;56;31;196;81;90;165;40;185;55;52;106;178;3;49;14;144;62;9;15;148;124;94;63;122;80;79;133;162;151;72;118;109;51;176;137;23;186;89;183;143;170;117;0;46;139;115;59;65;47;116;43;5;42;181;41;193;159;22;146;34;160;184;54;177;10;190;4;112;84;35;131;149;123;127;135;154;180;158;53;121,7803714743521528602,0.044001
steepest_intra:edges_start:random,27,75464,24506,50958,1883700,125,25;78;145;31;16;171;175;113;56;196;81;90;27;71;95;58;164;7;21;144;62;9;15;137;89;183;143;139;115;116;65;149;43;42;41;193;69;108;18;199;22;146;195;159;181;34;160;184;48;54;177;4;112;84;35;123;127;70;135;154;180;158;53;63;79;133;151;162;59;51;176;80;94;148;49;14;138;3;178;106;39;165;119;40;185;52;55;57;92;129;2;152;1;97;26;86;101;75;120;44,982383098405087384,0.041512
steepest_intra:edges_start:random,28,72581,23605,48976,2093000,139,90;165;119;40;185;106;52;55;57;129;92;145;78;31;56;113;175;171;16;44;120;2;1;101;75;86;53;158;180;154;135;70;127;123;149;131;47;65;116;43;42;181;160;184;84;112;4;190;10;177;54;48;34;103;146;22;18;159;193;41;139;68;93;117;46;115;59;118;51;176;80;151;162;133;79;63;121;100;26;97;152;94;124;148;137;0;143;183;89;186;15;9;62;144;49;178;14;21;164;27,3007223016007190944,0.046000
steepest_intra:edges_start:random,29,72547,23115,49432,2122900,141,113;175;171;16;78;145;25;44;120;82;129;92;57;55;52;106;178;14;49;102;62;9;148;94;97;152;2;1;101;75;86;26;100;121;53;180;154;135;70;127;112;4;84;35;184;190;10;177;54;48;160;42;181;34;146;22;159;193;41;139;68;46;115;118;59;65;116;43;47;131;149;123;162;151;133;79;63;80;176;137;23;0;117;143;183;89;186;144;21;7;164;95;27;90;39;165;40;185;196;31,3353690359602277823,0.046000
steepest_intra:edges_start:random,30,73159,23980,49179,2167750,144,40;165;39;95;21;7;164;90;31;113;175;171;16;25;44;120;78;145;92;129;57;55;52;106;178;3;49;62;9;148;124;94;189;152;2;75;86;101;1;97;26;100;121;53;158;70;135;154;180;63;122;79;133;151;162;123;112;4;84;184;177;54;160;34;22;18;108;93;117;143;0;68;46;115;139;41;193;159;181;42;43;116;65;131;149;59;118;51;80;176;137;23;183;89;186;15;144;14;138;185,4919150180037590076,0.048003
steepest_intra:edges_start:random,31,76055,23628,52427,1958450,130,85;31;38;157;196;81;40;119;185;165;39;90;27;95;164;7;21;138;14;144;102;49;3;178;106;52;55;167;9;62;15;37;148;94;63;79;80;133;151;162;123;149;65;116;59;118;51;176;137;89;183;143;0;46;115;139;68;117;93;140;36;108;69;18;22;159;193;41;43;42;181;34;160;54;184;84;112;135;154;180;53;101;1;97;152;2;129;92;57;179;145;78;25;120;44;16;171;175;113;56,5335643235993228466,0.042505
steepest_intra:edges_start:random,32,72961,22263,50698,1928550,128,55;57;185;40;119;165;39;27;90;81;196;31;56;113;175;171;16;25;78;145;179;92;129;82;44;120;2;75;86;100;26;101;1;97;152;124;94;19;189;121;53;180;154;135;70;127;123;65;116;43;5;42;184;190;10;177;54;160;34;181;146;22;18;159;193;41;139;115;59;118;51;151;162;133;79;63;80;176;137;0;117;143;183;89;23;186;15;62;9;37;148;167;49;102;144;14;3;178;106;52,4045225874829045255,0.042000
steepest_intra:edges_start:random,33,73290,23937,49353,2048150,136,81;90;27;164;7;95;39;165;40;185;14;144;62;9;49;178;106;52;55;57;92;145;78;2;152;1;97;26;100;121;94;124;167;148;137;23;89;183;143;117;93;140;108;18;22;159;193;41;139;68;46;115;5;42;181;146;34;48;54;177;10;4;112;184;160;43;116;47;131;149;65;59;118;51;151;176;80;63;79;133;162;123;127;70;135;154;180;158;53;86;101;75;120;44;16;171;175;113;56;31,7116853160223366184,0.044505
steepest_intra:edges_start:random,34,73358,23673,49685,2078050,138,151;162;180;53;158;154;135;127;123;112;84;184;10;177;54;48;160;34;146;22;159;18;108;117;143;0;46;139;41;193;181;42;5;43;131;149;65;116;115;59;118;109;51;176;137;23;183;89;186;15;9;62;102;144;14;49;178;106;52;55;57;92;78;145;185;40;119;165;27;90;81;196;157;31;113;175;171;16;25;44;120;2;152;97;1;101;75;86;26;100;121;124;167;37;148;94;63;79;80;133,5020055931251348021,0.046000
steepest_intra:edges_start:random,35,73318,24133,49185,1898650,126,31;16;171;175;113;81;90;165;164;7;21;144;62;9;102;49;14;178;106;119;40;185;52;55;57;92;129;167;148;124;94;63;79;133;151;80;176;137;23;186;114;89;183;143;0;117;93;140;68;139;41;193;159;108;18;22;146;34;181;42;5;115;198;46;118;59;149;131;47;65;116;43;184;160;54;30;177;10;190;4;112;123;127;135;154;180;53;100;26;97;152;1;101;86;75;2;120;44;78;145,997594225446429123,0.041000
steepest_intra:edges_start:random,36,73947,24625,49322,1898650,126,9;37;148;167;129;92;57;55;52;106;178;3;49;102;144;21;14;138;165;39;164;27;90;81;196;40;185;179;145;78;31;113;175;171;16;25;44;120;82;2;75;86;100;26;101;1;97;152;124;94;63;53;158;180;154;135;70;127;123;112;4;10;177;184;160;43;65;116;42;181;34;22;18;108;69;159;193;41;139;68;46;198;115;59;118;51;151;133;79;80;176;0;117;143;183;89;23;137;15;62,3917278557998057340,0.041000
steepest_intra:edges_start:random,37,73680,25461,48219,1988350,132,149;47;65;59;118;116;43;5;42;181;41;115;46;0;183;143;117;93;68;139;193;159;18;22;146;34;160;184;54;30;177;10;190;84;4;112;127;70;135;154;180;53;100;26;97;152;1;101;86;75;2;120;44;25;78;16;171;175;113;31;145;92;129;57;196;81;90;40;185;165;39;164;21;14;144;102;49;3;178;106;52;55;167;62;9;148;124;94;63;79;80;176;137;51;151;133;162;123;35;131,700461829353762378,0.044000
steepest_intra:edges_start:random,38,73615,22843,50772,2197650,146,180;154;158;53;121;100;26;86;101;1;97;94;124;148;167;152;2;75;120;44;25;16;171;175;113;56;31;78;145;196;81;90;165;40;185;179;92;129;57;55;52;106;178;49;14;144;102;62;9;183;89;23;137;176;80;51;118;59;115;46;68;139;69;108;18;22;146;195;159;193;41;96;5;181;34;48;54;177;4;112;84;184;160;42;43;116;65;131;149;123;127;70;135;194;162;151;133;79;122;63,8862114550150400468,0.046999
steepest_intra:edges_start:random,39,73361,23407,49954,1958450,130,112;127;123;162;59;118;51;176;80;122;63;79;133;151;135;154;180;53;86;100;26;97;1;101;75;2;152;189;94;124;148;9;62;49;14;178;106;52;55;57;92;129;120;44;16;171;175;113;56;31;78;145;179;185;40;119;165;90;27;164;7;21;144;15;114;186;23;137;183;143;117;93;140;108;18;22;159;195;146;103;34;181;42;5;41;193;139;68;46;115;116;65;149;43;184;160;48;54;177;4,1030228523330983712,0.043000
steepest_intra:edges_start:random,40,73699,23903,49796,1958450,130,1;2;120;44;25;16;171;175;113;56;85;31;157;196;81;40;185;165;90;27;164;21;14;144;62;9;148;102;49;178;106;52;55;57;92;145;78;129;152;124;94;63;180;133;79;80;176;137;183;143;170;117;0;46;115;139;41;193;159;108;18;22;146;181;34;160;48;54;30;177;10;190;184;112;123;149;131;47;77;43;42;116;65;59;118;51;151;162;127;70;135;154;158;53;86;75;101;100;26;97,952817283806459889,0.042001
steepest_intra:edges_start:random,41,72498,24404,48094,1973400,131,27;164;21;14;49;102;144;62;9;148;15;186;23;89;183;137;94;63;79;133;80;176;51;151;162;123;149;131;43;116;65;59;118;46;68;0;143;117;93;140;108;18;22;159;193;41;139;115;42;181;146;34;160;184;48;54;177;10;4;112;135;154;180;53;86;75;101;1;97;152;2;129;92;82;120;44;25;78;16;171;175;113;56;31;157;145;179;57;55;52;106;178;3;165;119;40;185;196;81;90,1951300301965496629,0.044508
steepest_intra:edges_start:random,42,73398,24035,49363,1943500,129,56;31;78;157;196;81;90;40;119;165;21;144;15;148;9;62;102;49;14;138;3;178;106;185;52;55;57;179;145;92;129;2;152;124;94;63;79;80;176;133;162;151;72;51;118;59;65;116;43;42;115;139;46;137;23;89;183;143;0;117;18;22;159;193;41;181;34;160;48;54;30;177;10;4;112;84;184;131;149;123;127;135;154;180;158;53;100;26;97;1;101;86;75;120;44;25;16;171;175;113,2560860030171489100,0.045000
steepest_intra:edges_start:random,43,72767,23578,49189,2048150,136,34;181;146;22;18;69;108;140;68;139;159;193;41;5;42;43;116;65;131;149;162;151;133;79;63;122;80;176;51;59;115;46;0;117;143;183;89;23;137;9;62;144;102;49;14;3;178;106;165;90;40;185;52;55;179;196;31;113;175;171;16;78;145;25;44;120;82;129;92;57;167;148;124;94;189;121;100;26;97;152;2;1;101;75;86;53;180;154;135;70;127;123;112;4;10;177;54;48;184;160,7267849928704466553,0.045001
steepest_intra:edges_start:random,44,73476,22741,50735,2048150,136,118;59;72;151;162;133;79;63;53;158;180;154;135;70;127;123;149;131;112;4;84;184;177;54;160;34;181;42;43;65;116;5;41;193;159;146;22;18;139;115;46;68;117;0;143;183;89;23;137;148;9;62;144;102;49;178;106;138;14;21;164;90;165;119;40;185;52;55;57;92;179;145;78;31;113;175;171;16;44;120;129;2;74;152;97;1;101;75;86;26;100;121;189;124;94;122;80;176;51;109,1557709947093146729,0.043506
steepest_intra:edges_start:random,45,72874,23527,49347,2137850,142,46;68;139;41;193;159;42;43;47;65;116;115;59;51;151;162;133;79;63;94;124;122;80;176;137;23;183;89;186;148;9;62;144;14;49;3;178;106;52;55;57;145;179;185;40;165;39;95;164;27;90;81;196;31;56;113;175;171;16;78;25;44;120;82;92;129;2;152;97;1;101;75;86;26;100;121;53;180;154;135;123;149;131;112;4;10;177;184;160;48;54;30;34;146;22;18;108;117;143;0,3379386731899404898,0.047000
steepest_intra:edges_start:random,46,73111,22403,50708,2033200,135,151;133;162;123;127;70;135;154;180;53;136;182;121;100;26;86;101;1;97;152;2;75;120;44;25;78;16;171;175;113;31;145;92;129;57;52;185;40;81;90;165;106;178;49;14;144;102;62;9;15;148;124;94;63;79;80;176;137;23;186;89;183;143;0;117;93;140;36;68;46;115;139;41;193;181;159;69;108;18;22;146;34;160;48;54;30;177;10;190;184;42;5;43;116;65;59;118;109;51;72,4673667877186848042,0.044508
steepest_intra:edges_start:random,47,72809,23037,49772,2093000,139,41;193;18;108;139;115;198;46;68;117;0;143;183;89;137;51;109;118;59;72;151;162;133;176;80;79;63;94;124;148;9;62;49;14;144;21;164;90;165;119;40;185;106;178;52;55;57;129;92;78;145;179;196;81;31;113;175;171;16;25;44;120;2;74;152;97;1;101;75;86;26;100;53;158;180;154;135;127;123;149;65;116;43;5;42;181;160;184;84;112;4;10;177;54;48;34;103;146;22;159,2142118461733197507,0.046006
steepest_intra:edges_start:random,48,73891,23509,50382,2003300,133,180;53;158;154;135;70;127;123;149;131;112;84;184;10;177;54;160;34;181;42;43;116;47;65;59;72;162;151;176;51;118;115;41;193;22;18;139;46;68;93;117;0;143;183;89;23;137;148;9;62;144;14;49;3;178;106;185;52;55;57;179;145;196;40;119;165;39;27;90;81;157;31;85;56;113;175;171;16;78;25;44;120;92;129;2;75;101;86;100;26;97;1;152;124;94;63;122;80;79;133,1229913545870308454,0.043994
steepest_intra:edges_start:random,49,74432,22459,51973,2107950,140,10;177;54;160;181;34;103;146;22;195;159;193;41;96;5;42;116;47;65;59;118;115;139;198;46;68;18;108;117;0;143;183;89;23;137;176;80;94;148;9;62;102;49;144;14;138;3;178;106;52;55;185;40;119;165;39;164;27;90;81;196;157;38;31;56;113;175;171;16;25;44;120;78;145;179;57;92;129;2;152;97;1;101;53;180;154;135;63;79;133;151;162;123;149;131;43;184;84;112;4,1244362002365915714,0.045507
steepest_intra:edges_start:random,50,72905,24147,48758,2003300,133,22;159;199;18;69;108;93;117;0;143;183;89;137;148;9;62;49;14;144;21;7;164;39;165;185;40;119;90;81;196;157;31;56;113;175;171;16;78;145;179;25;44;120;75;86;101;1;97;152;2;129;92;57;55;52;106;178;3;167;94;176;80;133;79;63;53;158;180;154;135;70;127;123;112;4;10;177;184;42;43;116;65;149;162;151;51;118;59;115;46;139;41;193;181;160;48;54;34;103;146,2286879255699807529,0.044001
steepest_intra:edges_start:random,51,73091,25021,48070,2152800,143,97;152;2;129;167;148;62;144;49;14;138;3;178;106;52;55;57;92;179;185;40;119;165;39;164;27;90;81;196;31;113;175;171;16;78;145;25;44;120;75;1;101;86;53;180;154;135;70;127;123;35;84;112;4;10;177;54;48;34;103;146;22;18;108;159;193;41;181;160;184;43;149;65;116;42;5;115;139;68;117;0;143;183;89;186;23;137;46;118;59;51;151;162;133;176;80;79;63;94;26,6384672115848643633,0.046505
steepest_intra:edges_start:random,52,71651,22748,48903,2048150,136,102;144;62;9;148;124;94;63;79;133;80;176;137;89;183;143;117;93;0;46;115;139;68;108;18;22;159;193;41;181;34;42;43;184;160;48;54;177;10;190;4;112;84;35;131;149;47;65;105;116;59;118;51;151;162;123;127;70;135;154;180;53;100;26;97;152;1;101;86;75;2;120;44;16;171;175;113;56;31;78;145;179;92;129;57;55;52;185;119;40;196;81;90;27;165;106;178;3;14;49,8545420268417380197,0.044505
steepest_intra:edges_start:random,53,72752,22729,50023,2033200,135,34;160;184;84;35;131;149;47;65;116;43;5;42;181;41;193;159;22;18;108;68;46;139;115;59;118;51;176;137;183;89;23;148;9;62;102;49;144;14;138;3;178;106;52;185;40;119;165;27;90;81;196;31;56;113;175;171;16;78;145;179;55;57;92;129;25;44;120;75;86;154;180;53;100;26;97;1;101;2;152;124;94;63;122;80;79;133;151;162;135;70;127;123;112;4;190;10;177;54;48,7398551692570444457,0.047001
steepest_intra:edges_start:random,54,73734,24532,49202,1853800,123,176;51;118;59;149;131;65;116;43;42;115;198;139;68;46;137;183;143;0;117;93;108;69;18;193;41;159;22;146;181;34;160;184;48;54;177;10;4;112;127;123;162;151;133;79;180;154;135;70;158;53;121;100;26;86;75;120;44;16;171;175;113;31;78;145;92;57;185;165;119;40;196;81;90;27;164;7;21;138;14;144;62;9;148;37;102;49;3;178;106;52;55;2;152;1;101;97;94;63;80,5005376765256613078,0.041998
steepest_intra:edges_start:random,55,73998,23500,50498,2093000,139,175;171;16;25;44;120;75;101;1;152;97;86;53;180;154;135;63;79;133;151;162;123;149;131;47;65;116;105;43;42;181;160;184;35;84;112;4;190;10;177;54;48;34;22;159;193;41;139;199;20;18;69;108;140;93;68;115;46;0;117;143;183;89;137;118;59;51;176;80;94;124;167;148;15;9;62;102;49;144;14;138;165;39;27;90;81;196;40;185;106;178;52;55;57;129;92;145;78;31;113,5720778871886609610,0.048000
steepest_intra:edges_start:random,56,72790,22875,49915,1958450,130,53;63;79;180;154;135;123;162;133;151;51;118;59;65;116;43;131;149;112;4;84;184;10;177;54;48;160;34;181;195;146;22;18;108;159;193;41;42;5;115;139;198;46;68;140;93;117;0;143;183;137;176;80;122;94;124;148;15;9;62;102;49;14;144;21;164;27;90;39;165;119;40;185;106;3;178;52;55;57;129;92;145;78;31;113;175;171;16;44;120;2;152;97;1;101;75;86;26;100;121,6776387711895674622,0.046000
steepest_intra:edges_start:random,57,73326,23450,49876,2018250,134,112;4;84;184;177;54;160;34;181;195;146;22;159;193;18;108;140;93;117;143;0;68;46;198;115;139;41;5;42;43;116;65;59;118;109;51;80;176;137;183;89;9;62;144;14;49;148;167;55;52;178;106;185;40;119;165;90;81;196;157;31;56;113;175;171;16;44;120;78;145;92;57;129;2;152;1;97;26;100;101;75;86;53;158;154;70;135;180;121;124;94;63;79;133;151;162;123;149;131;35,6635422643107604568,0.047000
steepest_intra:edges_start:random,58,72792,22870,49922,2033200,135,84;190;10;177;30;54;48;160;34;146;22;18;108;159;193;41;42;43;116;65;59;118;115;139;46;68;93;117;143;0;153;183;89;186;23;137;51;151;133;79;80;176;122;63;94;124;167;148;15;9;62;144;14;49;178;106;52;55;57;92;78;145;179;185;40;165;27;90;81;31;113;175;171;16;25;44;120;2;75;101;86;100;26;97;1;152;189;121;136;53;158;180;154;135;70;127;123;162;149;184,2771334453961574213,0.045000
steepest_intra:edges_start:random,59,71961,21720,50241,2212600,147,144;14;138;21;7;164;27;90;165;119;40;81;196;185;106;178;52;55;57;129;92;179;145;78;31;56;113;175;171;16;25;44;120;2;75;101;86;100;26;97;1;152;189;121;53;180;154;135;70;127;123;162;133;151;51;118;59;65;116;43;42;181;160;184;177;54;34;146;22;159;193;41;139;115;46;68;117;0;143;183;89;186;23;137;176;80;79;122;63;94;124;111;167;37;148;15;9;62;102;49,1229894620443083662,0.048849
steepest_intra:edges_start:random,60,74330,22721,51609,2107950,140,158;154;180;136;182;63;122;79;80;176;51;72;151;133;162;135;70;127;123;112;4;84;190;10;177;54;184;160;34;146;22;193;41;139;115;5;42;43;116;65;131;149;59;118;46;68;117;0;143;183;89;137;124;94;152;97;1;2;82;129;92;57;55;52;106;178;49;167;148;9;62;102;144;14;164;27;90;165;40;185;179;145;78;31;56;113;175;171;16;25;44;120;75;101;86;100;26;189;121;53,8568960118962179939,0.046310
steepest_intra:edges_start:random,61,74718,24468,50250,1913600,127,135;133;162;127;123;149;131;47;65;116;43;42;160;184;10;177;54;48;34;22;18;159;193;41;139;115;59;72;151;51;118;46;0;117;143;183;89;23;137;186;15;148;37;9;62;102;144;14;49;3;178;106;138;21;7;164;165;185;40;119;90;81;196;56;113;175;171;16;31;145;78;25;44;120;129;92;57;55;52;167;124;152;2;75;86;101;1;97;26;100;94;176;80;79;63;182;121;53;180;154,3213482179837017083,0.042042
steepest_intra:edges_start:random,62,72278,23325,48953,2107950,140,92;57;55;52;49;102;9;62;144;14;178;106;185;40;119;165;39;164;27;90;81;196;157;31;56;113;175;171;16;78;145;25;44;120;75;86;101;1;97;26;100;53;158;154;70;135;180;63;122;79;80;176;51;151;133;162;123;127;112;4;84;190;10;177;54;48;184;43;116;65;59;118;115;46;139;193;41;42;181;160;34;146;22;159;199;18;69;108;140;93;117;0;143;183;137;148;94;152;2;129,4564571908864807584,0.047194
steepest_intra:edges_start:random,63,73630,23847,49783,1898650,126,10;177;54;48;160;34;181;195;146;22;18;108;159;193;41;5;42;43;116;47;65;59;118;115;139;46;0;143;183;89;23;137;186;15;148;9;62;144;102;49;3;178;106;52;55;179;185;40;119;165;138;14;21;164;27;90;81;145;78;113;175;171;16;25;44;120;92;57;129;2;75;101;86;100;26;97;1;152;94;121;53;180;154;70;135;133;79;63;80;176;51;72;151;162;123;149;131;112;84;184,777996344041004704,0.043858
steepest_intra:edges_start:random,64,73906,23842,50064,1988350,132,57;92;129;120;44;25;16;171;175;113;31;78;145;196;81;90;165;40;185;14;49;102;144;62;9;186;23;137;176;51;59;118;46;0;183;143;117;139;115;41;193;159;18;22;195;146;103;34;181;42;5;43;116;65;47;77;149;131;35;84;184;160;48;54;177;10;190;4;112;29;127;123;162;151;133;79;80;122;63;180;135;70;154;53;100;26;86;75;101;1;2;152;97;94;124;148;178;106;52;55,7246925440297683782,0.045349
steepest_intra:edges_start:random,65,72914,22563,50351,2137850,142,143;0;46;115;5;181;42;43;116;65;131;149;59;118;51;151;162;133;79;63;122;80;176;137;183;89;186;15;62;9;37;148;167;49;102;144;14;138;3;178;106;52;55;185;40;165;90;81;196;179;145;78;31;56;113;175;171;16;25;44;120;82;92;57;129;2;75;101;1;97;152;124;94;121;100;26;86;53;180;154;135;70;127;123;112;84;184;160;34;103;146;22;18;108;69;159;193;41;139;117,740803402948218109,0.047587
steepest_intra:edges_start:random,66,74866,23181,51685,2003300,133,131;149;123;127;194;135;70;154;180;162;59;51;151;133;79;63;94;152;1;97;26;100;121;53;86;101;75;2;120;44;25;129;92;57;179;145;78;16;171;175;113;56;31;38;157;196;81;90;27;164;7;21;95;39;165;119;40;185;55;52;106;178;3;138;14;49;102;144;62;9;148;80;176;137;89;183;46;115;139;68;93;140;108;69;18;22;146;159;193;41;5;42;181;34;160;54;184;43;116;65,2485283471892038193,0.044284
steepest_intra:edges_start:random,67,73289,24034,49255,1973400,131,53;158;70;135;154;180;63;94;176;80;79;133;151;162;59;115;41;193;159;181;42;43;116;65;47;131;149;123;127;112;4;10;177;54;184;160;34;146;22;199;18;69;108;140;93;117;68;139;46;118;51;137;0;143;183;89;186;15;148;9;62;102;49;144;14;3;178;106;165;27;90;40;185;52;55;179;145;92;57;129;82;25;78;31;56;113;175;171;16;44;120;2;152;97;1;101;75;86;26;100,6162257918558478198,0.043003
steepest_intra:edges_start:random,68,71246,21327,49919,1868750,124,158;180;154;135;70;127;123;35;84;112;4;190;10;177;184;149;65;116;43;5;42;181;160;48;54;30;34;146;22;159;193;41;139;115;46;68;140;93;117;143;0;153;183;89;137;176;80;51;118;59;162;151;133;79;63;94;124;148;9;62;144;14;49;178;106;52;55;185;40;119;165;39;27;90;81;196;179;57;92;145;78;31;113;175;171;16;25;44;120;2;152;97;1;101;75;86;26;100;121;53,8193036591669434709,0.041578
steepest_intra:edges_start:random,69,73679,22726,50953,2018250,134,56;85;31;157;196;81;90;27;165;40;185;179;145;92;57;55;52;106;178;3;32;138;14;144;155;49;102;62;9;148;124;94;122;80;176;51;137;23;89;183;143;0;117;68;46;139;115;5;42;41;193;159;18;22;146;181;34;160;184;54;177;10;4;112;127;70;135;154;180;162;123;149;131;43;47;65;116;59;118;151;133;79;63;53;86;75;101;1;97;152;2;129;120;44;25;78;16;171;175;113,4094753956589009424,0.044011
steepest_intra:edges_start:random,70,73350,22857,50493,1958450,130,40;185;106;178;14;144;15;186;23;89;183;143;0;117;108;69;18;199;22;146;103;34;54;177;10;190;184;160;181;195;159;193;41;139;68;46;198;115;42;43;116;65;149;162;123;127;135;154;180;53;86;75;101;100;26;97;1;152;94;63;79;80;133;151;72;59;118;109;51;176;137;148;37;9;62;102;49;52;55;57;129;2;120;44;25;92;145;78;16;171;175;113;31;157;196;81;90;27;39;165,5700068436052218879,0.043044
steepest_intra:edges_start:random,71,73735,24177,49558,2107950,140,78;145;92;129;57;55;52;178;106;185;179;196;81;40;119;165;39;90;27;164;21;144;14;49;62;9;148;167;124;94;63;122;79;133;151;162;123;149;131;77;43;116;47;65;59;118;51;80;176;137;23;186;89;183;143;0;117;108;18;159;22;146;181;193;41;139;68;46;115;96;5;42;160;34;48;54;177;10;184;84;112;127;135;154;180;53;26;97;1;152;2;101;86;75;120;44;16;171;175;113,7835866199429599717,0.046996
steepest_intra:edges_start:random,72,73475,23763,49712,1808950,120,164;21;14;32;138;119;40;185;55;52;106;178;3;49;102;144;62;9;148;94;63;79;133;80;176;137;23;186;89;183;143;0;46;68;108;69;18;159;193;41;139;115;181;22;146;34;48;54;177;4;112;184;160;42;43;105;116;65;47;131;149;59;118;51;151;162;123;127;70;135;154;180;53;86;75;101;1;97;152;2;129;57;92;145;78;82;120;44;25;16;171;175;113;56;31;196;81;90;165;39,2001172624033562660,0.040002
steepest_intra:edges_start:random,73,73304,22939,50365,2107950,140,164;27;90;81;196;157;31;113;175;171;16;78;145;92;57;129;25;44;120;2;152;75;101;1;97;94;176;80;133;79;63;53;180;154;135;127;123;162;151;72;51;109;118;59;149;131;47;65;116;43;160;48;184;84;112;4;10;177;54;34;181;42;5;41;193;159;195;146;22;18;139;115;46;0;117;143;183;89;186;23;137;148;9;62;102;49;144;14;3;178;106;52;55;185;40;119;165;39;95;7,4363479584921566358,0.047000
steepest_intra:edges_start:random,74,73305,22745,50560,2078050,138,22;18;108;139;46;0;117;143;183;89;23;137;176;80;79;63;94;124;189;19;152;2;82;129;92;145;179;57;55;52;106;178;49;102;62;9;37;148;15;144;14;138;185;40;165;27;90;81;196;157;31;85;56;113;175;171;16;78;25;44;120;75;86;101;1;97;26;100;121;53;180;154;70;135;133;151;51;118;59;162;123;112;4;84;184;10;177;54;48;34;160;42;43;149;65;116;115;41;193;159,3061684427768408856,0.046612
steepest_intra:edges_start:random,75,72737,24106,48631,1898650,126,138;14;144;186;23;89;183;143;117;0;137;176;51;118;59;115;46;93;140;108;18;69;68;139;41;193;159;22;146;103;34;48;54;30;177;10;4;112;84;35;184;160;181;42;5;43;116;65;131;149;123;162;151;133;135;70;154;180;53;63;79;80;94;148;9;62;102;49;178;106;52;55;57;92;129;2;152;97;1;101;86;75;120;44;16;171;175;113;31;78;145;81;90;27;164;39;165;119;40;185,4320345088234426780,0.042131
steepest_intra:edges_start:random,76,74716,23768,50948,1958450,130,26;97;1;101;86;75;120;44;25;16;171;175;113;56;31;38;157;196;81;40;185;165;90;27;164;144;102;49;14;178;106;52;55;57;179;145;78;92;129;2;152;189;121;182;63;94;148;9;62;186;23;89;183;137;176;51;151;80;79;133;162;123;35;184;42;5;43;116;65;131;149;59;118;115;139;198;46;68;108;18;22;159;193;41;181;34;160;48;54;177;10;190;4;112;127;135;154;180;53;100,8383548658166365881,0.043915
steepest_intra:edges_start:random,77,74959,23791,51168,1988350,132,183;153;143;170;117;0;46;115;116;65;47;77;43;42;181;159;193;41;139;68;93;140;108;69;18;199;22;146;103;34;160;184;54;177;10;190;4;112;35;131;149;123;162;59;118;51;151;133;176;80;79;135;70;154;180;53;63;94;152;97;1;101;86;75;120;44;129;92;57;55;52;178;3;106;179;145;78;16;171;175;113;185;40;119;165;90;164;7;21;144;14;49;102;62;9;148;137;23;186;89,4731472368960357442,0.043997
steepest_intra:edges_start:random,78,77246,22537,54709,1943500,129,131;47;65;116;43;184;84;112;4;10;177;54;48;160;34;181;42;5;96;41;193;159;22;18;108;69;139;115;198;46;68;117;0;143;183;89;186;23;137;176;80;79;122;63;94;124;111;167;148;15;9;62;144;14;49;178;106;165;90;40;185;52;57;92;145;78;175;171;16;120;2;1;97;152;189;26;101;75;86;100;121;136;53;158;180;154;135;70;127;194;133;151;51;109;118;59;72;162;123;149,8892759671667190253,0.042044
steepest_intra:edges_start:random,79,72691,24096,48595,1868750,124,135;127;123;162;151;51;59;65;116;43;160;184;112;4;177;54;34;181;42;5;115;46;139;41;193;159;22;18;108;93;117;0;143;183;89;23;137;186;15;148;167;129;92;57;55;52;106;178;14;49;102;9;62;144;21;7;164;95;27;90;39;165;40;185;179;145;78;196;81;157;31;56;113;175;171;16;25;44;120;82;2;75;101;86;100;26;97;1;152;124;94;176;80;133;79;63;121;53;180;154,1829728616442608320,0.041000
steepest_intra:edges_start:random,80,77257,24531,52726,1958450,130,129;167;148;94;63;53;180;154;135;123;112;4;10;177;54;48;34;181;160;184;131;149;59;65;47;116;43;42;5;115;41;193;159;195;103;146;22;18;108;139;46;118;51;151;133;79;80;176;137;183;89;62;144;102;49;14;21;164;27;90;81;196;157;85;56;113;175;171;16;31;179;91;185;40;119;165;138;3;178;106;52;55;57;92;145;78;25;44;120;75;86;101;1;26;100;121;97;152;2;82,4112505802873598920,0.043001
steepest_intra:edges_start:random,81,73277,23274,50003,1973400,131,127;162;151;51;109;118;59;116;43;47;65;149;123;112;4;10;177;54;48;34;160;184;42;5;181;146;22;159;193;41;115;198;46;68;139;18;108;140;93;117;143;170;0;153;183;89;114;186;23;137;176;80;94;148;9;62;144;14;49;178;106;52;55;185;40;165;27;90;81;196;179;57;129;92;145;78;113;175;171;16;44;120;2;152;97;1;101;75;86;26;100;121;53;63;79;133;180;154;135;70,8371318064733958429,0.043967
steepest_intra:edges_start:random,82,75056,23164,51892,2137850,142,137;186;15;9;62;144;21;7;164;27;90;165;185;40;81;196;145;78;31;113;175;171;16;44;120;129;92;179;57;55;52;106;178;14;49;102;148;124;94;189;152;97;1;2;75;101;86;26;100;121;136;53;158;154;180;63;122;79;133;162;151;80;176;66;51;109;72;118;59;116;65;149;123;135;127;112;84;35;184;177;54;34;160;42;181;22;159;193;41;139;115;46;68;117;143;0;153;183;89;23,2014335238868452220,0.047074
steepest_intra:edges_start:random,83,73232,23457,49775,2122900,141,46;0;117;143;183;89;137;176;51;151;80;94;124;148;37;15;9;62;102;144;14;138;49;178;106;52;55;179;185;40;119;165;39;95;7;164;58;27;90;81;196;31;113;175;171;16;78;145;25;44;120;82;92;57;129;2;152;97;1;101;75;86;53;63;79;133;162;123;180;154;135;70;127;112;4;84;184;190;10;177;54;48;160;34;181;146;22;159;193;41;139;115;42;43;116;65;131;149;59;118,3158886468817870078,0.047003
steepest_intra:edges_start:random,84,73101,22418,50683,1988350,132,37;148;15;9;62;144;102;49;14;138;3;178;106;185;40;165;39;164;27;90;81;196;31;56;113;175;171;16;78;145;179;52;55;57;92;129;82;25;44;120;2;152;97;1;101;75;86;26;100;121;53;158;180;154;70;135;133;151;59;115;42;43;116;65;131;149;123;127;112;4;84;184;190;10;177;54;48;160;34;22;18;159;193;41;139;46;0;117;143;183;89;137;176;80;79;63;94;124;111;167,9129614071047729212,0.044515
steepest_intra:edges_start:random,85,74044,23910,50134,1958450,130,151;51;80;176;137;89;183;143;0;117;93;108;18;159;22;146;181;42;5;41;193;191;110;139;198;68;46;115;118;59;149;131;47;65;116;43;184;160;34;54;177;10;4;112;123;127;70;135;154;180;53;100;26;86;75;120;44;129;92;145;78;31;16;171;175;113;56;196;81;90;27;164;39;165;40;185;55;52;106;178;49;14;144;102;62;9;15;37;148;124;94;152;2;101;1;97;63;79;133;162,1275806548036765499,0.044040
steepest_intra:edges_start:random,86,75315,24703,50612,1898650,126,39;165;119;40;81;196;157;56;113;175;171;16;31;78;145;179;91;185;106;178;52;55;57;92;129;25;44;120;2;75;101;86;100;26;97;1;152;94;124;148;176;80;133;79;63;182;121;53;158;180;154;70;135;194;127;112;84;184;42;5;181;160;34;22;18;108;93;117;143;0;46;68;139;193;41;115;43;116;65;131;149;123;162;151;59;118;51;137;23;183;89;186;9;62;144;49;14;164;27;90,2988441372225579076,0.042041
steepest_intra:edges_start:random,87,74931,23433,51498,2033200,135,171;16;31;179;57;129;92;145;78;25;44;120;2;75;1;152;97;101;86;53;121;63;79;133;180;154;135;127;123;162;151;72;51;176;80;94;124;167;148;137;118;59;116;65;47;149;131;184;54;160;34;181;146;22;159;193;41;5;42;43;115;139;46;68;117;0;143;183;89;186;15;9;62;102;144;14;49;178;106;52;55;185;40;119;165;39;95;21;7;164;58;71;27;90;81;196;157;56;113;175,6307628956213466307,0.047475
steepest_intra:edges_start:random,88,74167,24025,50142,1838850,122,178;106;52;55;185;40;119;165;39;95;164;27;90;81;196;145;78;31;113;175;171;16;44;120;129;92;57;2;75;86;101;1;26;97;152;167;111;124;94;53;180;154;70;135;133;79;63;80;176;51;151;162;123;127;112;184;177;54;34;160;43;5;42;181;146;22;159;193;41;139;115;116;65;131;149;59;118;46;68;93;117;0;143;183;89;23;137;186;15;148;9;62;102;49;144;21;14;138;32;3,6313346589223980912,0.041289
steepest_intra:edges_start:random,89,72961,23944,49017,2048150,136,14;165;27;90;119;40;185;106;178;52;55;57;179;196;81;157;31;85;56;113;175;171;16;44;25;78;145;92;129;120;75;86;101;97;1;2;152;94;80;176;51;118;59;162;151;133;79;63;53;180;154;135;70;127;123;112;4;84;184;149;65;116;43;160;48;177;10;54;34;146;181;42;5;115;41;193;159;22;199;18;69;108;140;93;68;139;46;0;117;143;183;89;23;137;148;9;62;102;49;144,9135666312743863279,0.045652
steepest_intra:edges_start:random,90,75086,23946,51140,1943500,129,165;40;185;179;145;31;113;175;171;16;78;92;129;57;55;52;106;178;167;152;2;120;44;75;86;101;1;97;26;100;121;53;180;154;135;70;127;123;112;131;149;72;51;109;118;59;65;47;116;43;160;184;190;10;177;54;34;181;146;22;18;159;193;41;42;5;96;115;139;198;46;68;117;0;143;183;89;137;176;80;151;45;162;133;79;63;94;124;148;15;9;62;144;102;49;14;164;27;90;39,1868992704518953762,0.044001
steepest_intra:edges_start:random,91,74257,23735,50522,2033200,135,159;146;22;18;69;108;68;46;139;115;96;5;42;43;116;65;59;149;123;162;151;51;118;0;117;143;183;89;23;186;114;15;144;14;165;40;185;55;52;106;178;3;49;102;62;9;37;148;137;176;80;133;79;63;94;124;189;152;1;2;82;129;57;92;78;145;196;81;31;113;175;171;16;25;44;120;75;86;101;97;26;100;121;53;158;180;154;135;112;84;184;10;177;54;48;160;34;181;41;193,2967772005363818279,0.045966
steepest_intra:edges_start:random,92,76321,23857,52464,2122900,141,97;26;100;121;63;94;124;148;102;49;178;106;52;92;120;44;16;171;175;113;78;145;185;40;165;90;27;164;21;14;144;62;9;137;183;143;0;117;93;140;108;69;18;22;159;195;146;103;34;160;181;42;5;96;41;193;115;198;139;68;46;118;59;72;109;51;176;80;122;79;133;151;162;149;131;47;65;116;43;184;48;54;177;10;4;112;123;127;70;135;154;180;158;53;86;75;2;152;1;101,4631180076737363784,0.046999
steepest_intra:edges_start:random,93,73730,23892,49838,1853800,123,117;46;139;41;193;159;69;108;18;199;22;146;181;34;160;184;54;177;10;190;4;112;127;123;149;131;47;65;116;43;42;5;96;115;59;151;79;133;162;194;135;70;154;180;158;53;121;100;26;86;75;101;1;97;152;2;120;44;25;78;16;171;175;113;31;81;196;179;145;92;129;57;55;52;178;106;185;40;90;27;165;14;49;102;144;62;9;148;23;89;183;137;94;63;122;80;176;51;0;143,3689999978112933069,0.042612
steepest_intra:edges_start:random,94,71737,23669,48068,1913600,127,178;3;185;165;119;40;81;90;27;164;21;138;14;144;49;102;62;9;148;15;114;186;23;89;183;143;170;117;0;46;68;93;140;108;18;22;159;193;41;139;115;118;59;65;116;43;5;42;181;34;160;54;177;10;4;112;184;131;149;123;127;70;135;154;180;53;63;79;133;162;151;51;137;176;80;94;26;86;75;101;1;97;152;2;129;120;44;25;16;171;175;113;31;78;145;92;57;55;52;106,7368808619552157084,0.043532
steepest_intra:edges_start:random,95,75564,23599,51965,1988350,132,139;115;46;68;163;69;18;108;36;140;93;117;143;170;0;153;183;89;23;137;94;152;2;129;92;57;55;52;185;40;165;106;178;3;49;148;9;62;144;14;21;164;90;81;196;31;56;113;175;171;16;78;145;25;44;120;1;97;101;86;53;180;154;70;135;63;80;176;51;59;151;162;123;149;131;35;84;112;4;190;10;177;54;184;43;77;47;65;116;96;5;42;181;160;34;146;22;159;193;41,1399657060670844595,0.046028
steepest_intra:edges_start:random,96,72670,24201,48469,1973400,131,1;26;100;121;53;154;135;180;63;79;133;151;80;176;51;118;59;115;5;181;42;43;116;65;131;149;162;123;127;112;4;84;184;177;54;160;34;146;22;18;159;193;41;139;46;68;93;117;0;143;183;89;137;148;9;62;144;102;49;14;138;21;7;164;27;90;165;185;119;40;81;196;157;31;56;113;175;171;16;78;145;179;57;55;52;106;178;167;94;97;152;2;129;92;25;44;120;75;86;101,4470017879377198111,0.045122
steepest_intra:edges_start:random,97,72763,22906,49857,2107950,140,154;158;53;180;133;162;151;51;176;80;79;63;94;148;49;14;138;3;178;106;52;55;57;92;129;82;2;152;97;1;101;86;75;120;44;25;16;171;175;113;56;31;78;145;179;185;40;119;165;39;90;27;164;7;21;144;102;62;9;15;186;137;23;89;183;143;0;117;93;108;69;18;22;146;195;181;34;54;177;4;112;84;35;184;160;42;159;193;41;139;115;59;65;116;43;131;149;123;127;135,5833783165986576996,0.048115
steepest_intra:edges_start:random,98,71738,23007,48731,2063100,137,92;179;145;78;31;113;175;171;16;25;44;120;2;152;97;1;101;75;86;26;94;121;53;180;154;135;70;127;123;194;162;151;133;79;63;80;176;51;118;59;65;47;149;131;35;184;84;112;4;10;177;54;48;160;34;181;146;22;159;193;41;5;42;43;116;115;139;46;68;18;108;93;117;0;143;183;89;186;23;137;148;9;62;144;14;49;3;178;106;165;39;164;27;90;40;185;52;55;57;129,5152931100599679153,0.047044
steepest_intra:edges_start:random,99,74456,25413,49043,1808950,120,78;31;56;113;175;171;16;25;44;120;92;129;2;75;86;101;1;152;97;26;53;154;180;79;133;151;162;123;135;127;112;4;10;177;54;48;184;160;34;181;41;5;42;43;131;149;65;116;115;198;68;139;193;159;22;18;108;93;117;0;143;183;137;46;118;59;51;176;80;63;94;124;148;15;9;62;144;102;49;14;21;164;39;165;138;3;178;106;52;55;57;185;8;119;40;90;81;196;179;145,8909493387397254158,0.039998
steepest_intra:edges_start:random,100,73246,23637,49609,2063100,137,116;65;59;118;51;151;162;135;70;154;180;158;53;86;101;1;75;120;44;25;16;171;175;113;31;78;145;179;196;81;90;165;119;40;185;106;178;52;55;57;92;129;2;167;49;14;144;62;9;15;148;94;152;97;26;100;63;79;133;80;176;137;89;183;143;0;46;198;115;139;68;117;93;108;69;18;199;22;146;103;34;160;54;177;184;35;84;4;112;123;149;131;43;42;181;159;193;41;96;5,2377796309029951583,0.046000
steepest_intra:edges_start:random,101,73899,23507,50392,2107950,140,41;193;159;69;108;18;22;146;103;34;160;54;177;184;84;112;123;149;59;118;51;176;80;94;63;79;133;151;162;135;70;154;180;53;86;101;1;97;152;148;37;9;62;102;49;3;178;106;185;52;55;57;92;145;78;129;120;44;25;16;171;175;113;31;196;81;40;119;165;39;90;27;95;58;164;7;21;14;144;15;114;186;137;23;89;183;153;0;143;117;68;46;139;115;116;65;43;5;42;181,7108766642410310327,0.046718
steepest_intra:edges_start:random,102,74387,23942,50445,1988350,132,122;79;133;80;176;137;51;59;151;162;149;65;116;115;46;0;183;143;117;139;41;193;159;108;18;22;34;160;181;42;43;184;54;177;10;4;112;123;127;70;135;154;180;158;53;136;182;121;100;26;97;86;75;101;1;152;2;129;92;57;55;52;179;145;78;120;44;25;16;171;175;113;56;31;196;81;90;27;39;165;119;40;185;8;138;106;178;3;49;102;14;144;62;9;15;148;167;124;94;63,4740038019314964866,0.045497
steepest_intra:edges_start:random,103,71684,23017,48667,2048150,136,108;18;22;146;34;181;42;5;116;65;149;131;43;184;160;48;54;30;177;10;190;84;4;112;123;127;70;135;154;180;53;86;75;101;26;97;1;152;2;120;44;16;171;175;113;56;31;78;145;92;129;57;55;52;178;3;106;185;119;40;196;81;90;27;164;7;95;39;165;138;14;49;144;62;9;148;94;63;79;80;176;133;151;162;59;51;137;23;89;183;143;117;0;46;115;139;41;193;159;69,2866251291981676819,0.046077
steepest_intra:edges_start:random,104,73392,24220,49172,1868750,124,2;75;86;100;26;101;1;97;152;124;94;121;53;180;154;70;135;63;79;80;137;176;133;151;51;118;59;115;116;65;149;123;127;112;4;84;184;190;10;177;30;54;48;34;160;43;42;41;193;159;22;18;108;139;46;0;117;143;183;89;23;186;114;15;148;37;9;62;102;49;3;178;55;52;106;138;14;144;21;90;165;185;40;81;196;31;56;113;175;171;16;78;145;25;44;120;82;92;57;129,5052383900565544140,0.041999
steepest_intra:edges_start:random,105,73569,22285,51284,1958450,130,127;123;149;131;65;116;47;77;43;184;112;4;10;177;54;48;160;34;181;42;5;96;41;193;159;22;18;69;108;163;139;115;198;46;68;36;140;93;117;0;143;183;89;23;137;176;80;51;118;59;162;151;133;79;63;94;148;9;62;102;49;144;14;138;21;164;90;165;40;185;106;178;52;55;57;129;92;145;78;113;175;171;16;25;44;120;75;2;152;97;1;101;86;26;100;53;158;180;154;135,7733089707553349587,0.043517
steepest_intra:edges_start:random,106,74341,23605,50736,1973400,131,34;54;177;112;123;149;65;116;59;118;51;176;80;151;72;162;133;79;122;63;182;136;180;135;127;70;154;158;53;86;75;101;1;97;26;100;121;94;124;152;2;120;44;25;16;171;175;113;31;78;145;196;81;90;27;165;119;40;185;92;57;55;52;106;178;49;102;14;144;62;148;137;23;89;183;153;0;143;117;93;140;108;18;69;68;46;198;115;139;41;193;159;42;43;184;160;181;195;22;146,8115035403744057245,0.045039
steepest_intra:edges_start:random,107,73523,22921,50602,1943500,129,62;144;14;49;178;106;52;55;185;40;119;165;27;90;81;196;113;175;171;16;31;78;145;92;57;129;25;44;120;2;75;101;1;97;26;100;86;53;158;180;154;70;135;194;127;123;162;133;151;51;118;59;115;46;68;139;193;41;43;116;65;149;131;112;84;184;42;181;160;34;146;22;159;18;69;108;140;93;117;0;170;143;183;89;186;23;137;176;80;79;122;63;136;182;121;152;94;148;15;9,3592764113876600776,0.044012
steepest_intra:edges_start:random,108,73633,23228,50405,2063100,137,9;62;102;144;14;49;178;106;165;90;81;40;119;185;52;55;57;179;145;78;196;157;31;85;56;113;175;171;16;25;44;120;82;92;129;2;75;101;86;158;154;180;53;121;100;26;97;1;152;124;94;63;133;151;162;135;70;127;123;112;84;184;10;177;54;48;160;34;181;42;43;5;41;193;159;22;18;69;108;36;140;93;117;143;0;46;68;139;115;116;65;59;118;51;80;176;137;183;89;148,3282180049450699241,0.045583
steepest_intra:edges_start:random,109,74583,23837,50746,2033200,135,51;109;118;115;139;46;0;153;89;183;143;117;108;18;159;193;41;5;42;160;181;22;34;48;54;177;184;84;112;127;194;135;70;154;180;53;121;100;26;86;75;120;44;16;171;175;113;31;78;145;179;185;40;119;165;90;164;7;21;144;102;49;14;138;32;3;178;106;52;55;57;92;2;101;1;97;152;94;124;148;9;62;15;186;23;137;176;80;63;79;133;151;162;123;149;131;43;116;65;59,7577209552520268126,0.045632
steepest_intra:edges_start:random,110,73250,21932,51318,1958450,130,139;115;5;42;41;193;159;69;108;18;22;146;34;160;48;54;177;10;190;184;43;105;116;65;47;131;149;123;162;133;151;59;118;51;176;80;79;63;94;124;189;121;53;180;154;135;70;158;100;26;86;75;101;1;97;152;74;2;129;57;92;145;78;120;44;16;171;175;113;31;81;90;27;165;40;185;55;52;106;178;3;14;49;102;144;62;9;148;137;23;186;89;183;143;0;117;93;68;46;198,6226818085435858625,0.045001
steepest_intra:edges_start:random,111,75451,23699,51752,1749150,116,146;22;18;108;139;115;46;68;93;117;0;143;183;89;23;137;186;15;144;102;49;14;3;178;106;52;55;167;62;9;148;176;80;151;133;79;122;63;94;124;189;97;1;152;74;2;129;57;92;78;145;179;185;40;119;165;39;27;90;81;196;157;31;85;56;113;175;171;16;25;44;120;75;101;86;26;100;121;53;158;180;154;135;162;59;123;112;4;177;184;65;116;43;42;41;193;159;181;160;34,1942151813304637759,0.038997
steepest_intra:edges_start:random,112,71564,22665,48899,2078050,138,144;62;9;15;148;94;63;79;80;176;137;23;89;183;143;0;117;93;140;108;18;68;46;118;59;149;131;47;65;116;43;42;5;115;139;41;193;159;22;146;34;160;48;54;177;184;112;123;162;151;133;135;70;154;180;158;53;26;86;75;101;1;97;152;2;120;44;25;16;171;175;113;56;31;157;81;196;179;145;78;92;129;57;55;52;178;3;106;185;40;165;39;90;27;164;7;21;14;49;102,8246290912185366192,0.045779
steepest_intra:edges_start:random,113,73955,22144,51811,1898650,126,63;79;133;135;70;127;123;162;151;80;176;51;118;59;149;131;184;177;54;160;34;181;42;43;65;116;115;46;139;41;193;22;18;108;117;0;143;183;89;186;23;137;148;9;62;102;49;144;14;138;3;178;106;52;55;57;129;92;78;145;179;91;196;169;40;119;185;8;165;39;27;90;81;157;38;31;56;113;175;171;16;25;44;120;2;75;86;158;154;180;53;121;100;26;97;101;1;152;124;94,1442141547732016176,0.042010
steepest_intra:edges_start:random,114,75025,22364,52661,2182700,145,57;179;145;92;129;82;120;44;25;78;16;171;175;113;31;196;81;90;27;39;165;8;119;40;185;106;178;3;138;14;49;102;144;62;9;89;183;137;51;176;80;122;63;79;133;162;151;72;59;118;115;46;139;193;41;96;5;42;181;195;159;69;108;18;22;146;34;54;177;184;160;43;116;65;149;123;127;70;135;154;180;158;53;121;100;26;97;1;101;86;75;2;152;189;94;124;148;167;52;55,3250923740632617121,0.047495
steepest_intra:edges_start:random,115,73998,24201,49797,2018250,134,115;139;46;68;108;18;22;146;159;193;41;42;160;34;48;54;177;10;190;4;112;84;184;35;123;162;151;133;135;154;180;158;53;121;100;26;86;75;101;1;97;152;94;63;79;80;148;167;2;120;44;25;129;92;57;179;145;78;31;16;171;175;113;56;196;81;90;27;164;95;39;165;8;119;40;185;55;52;106;178;3;49;14;144;62;9;89;183;143;0;137;176;51;118;59;65;149;131;43;116,5146250501916973998,0.046024
steepest_intra:edges_start:random,116,78153,22851,55302,2018250,134,129;92;57;55;52;106;178;3;49;167;124;94;152;97;1;101;86;53;158;154;180;63;79;80;176;133;151;162;59;116;65;47;43;131;149;123;135;127;112;4;84;184;190;10;177;54;48;160;34;103;146;22;195;159;193;41;181;42;5;96;115;139;198;46;68;18;108;140;93;117;143;0;153;183;89;23;186;114;15;137;148;37;9;62;102;144;14;138;165;90;81;196;40;119;185;145;78;44;120;2,8431713221148711539,0.045972
steepest_intra:edges_start:random,117,72796,23373,49423,1973400,131,89;23;137;176;80;79;63;94;124;167;148;186;114;15;9;62;102;49;144;14;138;32;3;178;106;165;90;81;196;40;185;52;55;57;129;92;145;31;113;175;171;16;78;25;44;120;2;152;97;1;101;75;86;26;100;121;53;158;180;154;135;70;127;123;162;133;151;51;118;59;115;46;68;139;41;193;159;42;116;65;149;43;184;112;4;190;10;177;30;54;160;34;22;18;108;117;0;170;143;183,2356648187696210859,0.044964
steepest_intra:edges_start:random,118,71618,22618,49000,2093000,139,47;149;131;184;177;54;48;160;34;181;146;22;18;108;69;159;193;41;139;46;68;117;0;143;183;89;23;137;186;15;148;9;62;102;144;14;49;3;178;106;52;185;165;39;95;164;27;90;40;81;196;31;56;113;175;171;16;25;44;120;78;145;179;55;57;92;129;2;75;86;100;26;101;1;97;152;94;121;53;180;154;135;127;123;162;151;133;79;63;80;176;51;118;59;115;5;42;43;116;65,6697863441648071819,0.046512
steepest_intra:edges_start:random,119,72840,23068,49772,2018250,134,154;135;70;127;112;4;84;184;190;10;177;54;48;160;34;146;22;18;159;193;41;139;117;143;0;46;115;5;42;43;116;65;47;131;149;123;162;151;59;118;109;51;133;79;63;80;176;137;183;89;23;186;114;15;62;9;148;94;124;167;129;82;92;57;55;52;106;178;3;49;102;144;14;138;165;90;40;185;196;179;145;78;31;113;175;171;16;44;120;2;152;97;1;101;75;86;26;100;53;180,2048695310100877988,0.047999
steepest_intra:edges_start:random,120,72652,21833,50819,2078050,138,159;22;18;69;108;140;93;117;143;0;153;183;89;186;23;137;176;80;79;122;63;189;94;124;167;37;148;15;9;62;102;49;144;14;165;40;185;3;178;106;52;55;57;92;145;179;196;81;31;113;175;171;16;78;25;44;120;2;152;97;1;101;75;86;26;100;121;53;180;154;135;70;127;123;162;133;151;72;51;118;59;65;149;131;35;184;177;54;160;34;181;42;43;116;115;46;68;139;41;193,1761030413975326690,0.047034
steepest_intra:edges_start:random,121,73645,23695,49950,2167750,144,149;123;127;70;135;162;133;151;72;51;176;80;79;63;94;124;189;136;180;154;158;53;121;100;26;86;75;101;1;97;152;2;120;44;25;129;57;92;145;78;16;171;175;113;31;196;81;90;27;164;95;39;165;119;40;185;179;55;52;106;178;3;49;14;144;62;9;148;137;23;186;89;183;143;0;117;108;18;193;159;22;34;54;48;160;42;41;139;115;118;59;65;116;43;184;177;4;112;84;35,4604740964441350435,0.048000
steepest_intra:edges_start:random,122,73622,24769,48853,1988350,132,25;78;16;171;175;113;56;31;81;196;145;92;129;57;55;52;167;124;94;148;9;62;102;49;3;178;106;185;40;119;165;90;27;164;21;14;144;15;186;137;23;89;183;143;117;0;46;115;41;193;139;68;93;140;108;18;159;22;34;160;48;54;177;10;190;184;181;42;5;43;35;84;112;123;149;131;65;116;59;118;51;151;176;80;79;63;135;154;180;53;86;75;101;26;97;1;152;2;120;44,7524682005038461311,0.045268
steepest_intra:edges_start:random,123,75430,23440,51990,1988350,132,48;34;181;146;22;18;108;69;159;193;41;139;115;46;0;143;183;89;137;176;80;79;63;94;124;148;15;144;49;102;62;9;167;152;2;82;129;57;55;52;106;178;14;138;185;40;119;165;39;95;7;164;58;27;90;187;81;169;196;157;56;113;175;171;16;31;145;179;92;78;44;120;75;86;101;1;97;26;53;180;154;135;133;151;59;162;123;149;131;65;116;43;5;42;160;184;190;10;177;54,7904313433553848179,0.043753
steepest_intra:edges_start:random,124,76289,23919,52370,2003300,133,55;52;106;178;49;102;14;144;62;89;183;137;148;167;124;94;189;121;182;63;122;79;133;162;151;80;176;51;109;118;0;143;117;68;46;139;115;5;41;193;159;199;69;108;18;22;146;103;34;160;54;184;181;42;43;116;47;65;59;149;131;112;123;127;135;154;180;53;86;75;101;100;26;97;1;152;2;129;92;179;145;78;120;44;25;16;88;171;175;113;56;31;157;196;81;90;165;40;185;57,2361718115855140124,0.045999
steepest_intra:edges_start:random,125,73725,23671,50054,1913600,127,4;112;84;35;123;162;133;79;63;180;135;154;53;86;75;101;1;97;26;100;94;152;2;120;44;25;16;171;175;113;56;31;81;196;179;145;78;92;129;57;55;52;178;106;185;40;90;164;7;21;95;39;165;138;14;144;49;102;62;9;148;15;186;89;183;23;137;176;80;151;51;59;149;131;47;65;116;43;42;5;115;139;198;46;68;108;18;22;146;195;159;193;41;181;34;160;184;54;177;10,4726296141124100966,0.043078
steepest_intra:edges_start:random,126,75079,24112,50967,1958450,130,193;41;181;195;146;103;34;160;48;54;30;177;10;4;112;123;162;133;135;70;154;180;158;53;100;86;101;75;2;120;44;16;171;175;113;56;31;157;81;196;179;145;78;25;129;92;57;55;52;106;185;40;119;165;39;90;27;164;7;21;178;49;14;144;62;9;15;148;167;152;1;97;26;124;94;63;79;80;176;51;151;59;65;47;116;43;35;184;42;5;115;139;46;0;143;117;108;18;22;159,6024394489591040068,0.044044
steepest_intra:edges_start:random,127,73431,23133,50298,2078050,138,51;72;151;162;133;80;176;137;183;89;23;186;15;144;14;138;39;90;165;119;40;185;55;52;106;178;3;49;102;62;9;148;167;124;94;189;152;129;92;57;179;145;78;31;113;175;171;16;25;44;120;82;2;1;97;101;75;86;26;100;121;53;63;79;180;154;135;127;123;112;84;184;177;54;48;160;34;181;42;41;193;159;146;22;18;108;117;143;0;46;139;115;43;116;65;47;131;149;59;118,666900788715155607,0.046615
steepest_intra:edges_start:random,128,74021,22477,51544,1988350,132,59;115;139;18;22;193;41;42;181;34;160;48;54;177;184;43;116;65;47;131;149;123;127;135;154;180;63;79;133;162;151;51;176;80;124;94;121;53;86;100;26;97;152;2;1;101;75;120;44;25;82;129;92;57;55;52;91;179;145;78;16;171;175;113;56;31;196;81;90;165;119;40;185;106;178;3;138;14;49;102;155;144;62;9;37;167;148;15;114;186;137;23;89;183;143;0;117;68;46;118,6508601142401383547,0.047240
steepest_intra:edges_start:random,129,72844,23104,49740,2063100,137,124;148;176;137;183;143;0;117;93;108;69;18;22;146;195;159;193;41;139;115;5;42;181;34;160;48;54;30;177;10;190;184;35;131;149;47;43;116;65;59;118;51;151;80;122;63;79;133;162;123;127;135;154;180;53;100;26;1;101;86;75;120;44;25;16;171;175;113;56;31;157;196;81;40;185;165;90;27;164;7;21;144;62;9;49;14;178;106;52;55;57;179;145;78;92;129;2;152;97;94,5816321035422847361,0.047141
steepest_intra:edges_start:random,130,75293,22465,52828,2003300,133,115;59;118;51;151;133;162;123;149;131;47;65;116;43;42;181;41;193;22;34;160;54;184;84;112;127;194;135;70;154;180;158;53;136;182;121;189;152;97;26;100;86;75;101;1;2;120;44;16;171;175;113;56;85;31;78;145;179;92;129;57;55;52;196;157;81;40;90;27;164;7;95;39;165;185;106;178;49;14;144;102;62;9;148;124;94;63;122;79;80;176;137;89;183;143;0;117;68;46;139,5374694079647913252,0.045001
steepest_intra:edges_start:random,131,74520,21358,53162,2107950,140,120;44;25;16;171;175;113;56;31;78;145;196;81;90;27;58;164;7;95;39;165;119;40;185;55;52;106;178;3;49;14;144;62;9;148;94;63;79;80;176;133;151;162;149;131;47;65;105;43;42;5;116;59;118;115;139;68;46;0;143;117;93;140;108;69;18;199;20;22;146;195;159;193;41;181;34;160;48;54;177;10;184;84;4;112;123;127;135;154;180;53;86;101;1;97;152;2;57;92;129,4935295058517281239,0.046585
steepest_intra:edges_start:random,132,72845,23588,49257,1928550,128,176;80;94;124;152;1;97;26;100;86;101;75;2;129;82;120;44;25;16;171;175;113;31;78;145;92;57;55;52;106;178;49;14;138;165;185;40;81;90;27;164;21;144;62;148;137;23;89;183;143;0;117;93;140;68;46;118;59;65;149;131;77;47;116;105;43;42;115;139;41;193;159;108;18;22;146;181;34;160;48;54;177;10;190;184;84;112;127;123;162;135;70;154;180;158;53;63;79;133;151,1588954661431291936,0.043999
steepest_intra:edges_start:random,133,74526,23013,51513,1883700,125,14;144;62;9;137;183;143;117;0;46;115;139;41;193;159;69;108;18;199;22;146;34;54;177;160;181;42;5;43;116;65;47;149;131;184;84;112;127;123;162;151;72;59;118;109;51;66;176;80;63;79;133;135;70;154;180;158;53;136;121;100;26;97;1;101;86;75;120;44;25;16;171;175;113;31;78;145;92;57;129;2;152;94;124;148;49;3;178;106;52;55;185;119;40;196;81;90;27;165;138,4302441851589858579,0.043969
steepest_intra:edges_start:random,134,72743,23448,49295,1838850,122,185;106;178;52;55;179;196;81;31;113;175;171;16;44;120;25;78;145;92;57;129;2;152;124;94;122;79;63;189;26;97;1;101;75;86;100;121;53;180;154;135;70;127;123;112;84;184;54;160;34;181;42;43;131;149;162;151;133;80;176;51;118;59;65;47;116;115;139;41;193;159;146;22;18;69;108;93;117;0;143;183;89;186;23;137;148;9;62;144;49;14;138;21;164;27;90;39;165;119;40,5697391110183268150,0.039606
steepest_intra:edges_start:random,135,73967,22814,51153,1988350,132,9;62;102;49;178;106;52;55;57;92;129;152;124;94;122;79;133;151;51;80;176;137;23;89;183;143;0;117;93;108;18;159;193;41;181;22;146;103;34;160;48;54;177;10;190;184;42;5;43;77;131;149;47;65;116;115;139;68;46;118;59;72;162;123;135;154;180;63;121;53;86;100;26;97;1;101;75;2;82;120;44;25;16;171;175;113;31;78;145;179;185;40;90;165;138;14;144;15;148;37,40651272683709838,0.044583
steepest_intra:edges_start:random,136,73055,22250,50805,2018250,134,65;116;43;42;184;84;112;4;177;54;160;34;181;5;41;193;159;195;146;22;199;18;108;69;139;115;46;68;93;117;0;143;183;89;23;137;148;9;62;144;14;138;102;49;3;178;106;52;55;57;129;92;179;185;40;119;165;39;27;90;187;81;196;145;78;31;56;113;175;171;16;25;44;120;2;75;101;1;97;152;94;63;79;80;176;51;118;59;72;151;162;133;180;53;154;135;127;123;149;131,3405434939680566863,0.044080
steepest_intra:edges_start:random,137,74730,22847,51883,1988350,132,56;113;175;171;88;16;25;44;120;82;129;92;78;145;179;57;55;52;185;106;178;167;37;148;124;94;152;2;75;101;1;97;26;86;53;158;180;154;135;133;79;63;80;176;151;162;123;112;4;84;35;131;149;65;47;43;116;59;118;115;5;42;184;10;177;54;160;34;22;159;193;41;139;46;0;143;183;89;23;137;186;15;9;62;102;49;14;144;21;7;164;27;90;39;165;40;81;196;157;31,7729755037433670917,0.045030
steepest_intra:edges_start:random,138,75067,23628,51439,1988350,132,112;123;135;154;180;53;121;100;26;86;101;1;97;152;2;75;120;44;25;16;171;175;113;56;31;157;38;78;82;129;57;92;145;179;91;169;196;81;90;164;7;95;39;165;119;40;185;55;52;106;178;49;14;144;102;62;9;89;183;137;148;124;94;63;79;133;162;151;80;176;51;109;118;59;115;139;68;46;0;143;117;108;18;22;146;195;159;193;41;5;116;65;43;42;181;34;160;54;177;184,8549093037148020508,0.045051
steepest_intra:edges_start:random,139,72625,23150,49475,2003300,133,184;35;84;112;127;70;135;154;180;158;53;86;75;101;100;26;97;1;152;2;129;120;44;16;171;175;113;56;31;78;145;179;92;57;55;52;178;106;185;165;119;40;81;90;27;164;21;144;14;49;102;62;9;148;124;94;63;122;79;133;80;176;137;183;143;0;46;198;59;118;51;151;162;123;149;131;65;116;43;42;5;115;139;68;108;69;18;193;41;159;22;146;195;181;34;160;48;54;177;10,2470381966807589955,0.043994
steepest_intra:edges_start:random,140,71983,23454,48529,2093000,139,54;48;160;34;181;42;43;65;116;115;139;41;193;159;146;22;18;108;93;117;143;0;68;46;118;59;162;151;133;79;63;122;80;176;137;23;183;89;186;15;62;9;148;124;94;189;152;2;129;92;78;145;57;55;52;106;178;49;144;14;165;39;95;7;164;27;90;40;185;81;196;31;113;175;171;16;25;44;120;75;86;101;1;97;26;100;121;53;180;154;135;127;123;112;4;84;184;190;10;177,3185842173468156815,0.046999
steepest_intra:edges_start:random,141,75679,23168,52511,2122900,141,78;92;57;55;52;185;40;90;165;106;178;49;14;144;62;9;15;148;124;94;63;79;80;176;137;183;143;117;0;46;68;140;108;18;22;146;103;34;160;184;43;131;149;47;65;116;5;42;181;159;193;41;191;110;139;198;115;118;59;72;109;51;151;133;162;123;4;112;127;70;135;154;180;158;53;121;100;26;97;1;101;86;75;2;152;167;129;82;120;44;25;16;171;175;113;56;31;196;179;145,5371207870546031985,0.046620
steepest_intra:edges_start:random,142,74912,24175,50737,1764100,117,56;31;157;78;145;196;81;40;119;185;165;90;27;164;7;21;14;144;15;186;89;183;137;176;151;59;118;139;68;46;0;143;117;108;69;18;22;159;193;41;115;116;65;43;42;181;34;160;48;54;177;184;112;123;127;70;135;154;133;79;63;94;124;148;9;62;102;49;138;3;178;106;52;55;57;179;92;129;82;2;152;1;97;26;100;121;180;158;53;86;101;75;120;44;25;16;88;171;175;113,8977899159157265764,0.040043
steepest_intra:edges_start:random,143,73896,22312,51584,1853800,123,18;22;159;193;41;115;139;68;46;118;59;149;131;47;65;116;43;42;160;34;54;184;84;112;123;135;154;180;158;53;86;100;26;97;1;101;75;2;152;167;57;92;145;78;129;120;44;25;16;171;175;113;31;196;81;90;27;39;165;119;40;185;55;52;106;178;3;49;14;144;102;62;9;148;124;94;189;121;182;63;122;79;133;162;151;72;51;80;176;137;23;89;183;153;0;143;117;93;108;69,5019995513792455344,0.040993
steepest_intra:edges_start:random,144,73726,24353,49373,1988350,132,10;177;54;48;160;34;146;22;18;69;108;68;140;93;117;0;170;143;183;89;137;148;9;62;102;49;14;144;21;138;178;106;52;55;57;129;92;145;185;40;119;165;39;164;27;90;81;196;31;56;113;175;171;16;78;44;120;2;152;1;97;26;101;75;86;53;94;63;180;154;135;123;162;151;133;79;80;176;51;118;59;115;46;198;139;159;193;41;96;5;116;65;149;43;42;181;184;84;112;4,3344980611170860838,0.045003
steepest_intra:edges_start:random,145,74204,24499,49705,1883700,125,162;151;194;127;70;135;154;180;53;86;101;75;2;120;44;25;16;171;175;113;31;196;81;90;27;165;40;185;138;14;144;62;9;148;49;3;178;106;52;55;57;92;179;145;78;82;129;152;1;97;26;94;63;122;79;133;80;176;137;15;114;186;23;89;183;51;59;115;139;46;0;143;117;108;69;18;22;159;193;41;5;116;65;47;77;43;42;181;34;160;54;177;10;4;112;84;184;131;149;123,2224057934942208968,0.042244
steepest_intra:edges_start:random,146,73695,23572,50123,2063100,137,75;86;101;1;97;26;100;53;158;70;135;154;180;136;63;122;80;79;133;151;162;123;127;112;4;84;184;190;10;177;54;160;34;22;18;159;193;41;139;46;115;42;43;116;65;149;59;118;109;51;176;137;0;117;143;183;89;23;186;114;15;148;167;124;94;189;152;2;82;129;92;145;179;57;55;52;106;178;49;102;9;62;144;14;138;165;27;90;40;185;196;113;175;171;16;31;78;25;44;120,5364113935964422972,0.046277
steepest_intra:edges_start:random,147,73436,23485,49951,1928550,128,135;154;53;180;133;79;122;63;94;124;152;97;26;100;1;101;86;75;2;167;148;37;102;49;178;106;52;55;179;145;92;57;129;120;44;78;16;171;175;113;56;31;196;81;90;165;119;40;185;138;14;144;62;9;15;186;137;23;89;183;143;117;0;46;68;139;69;108;18;159;22;146;181;34;160;48;54;177;184;35;43;42;5;41;193;115;116;65;59;118;72;109;51;176;80;151;162;123;127;70,8992800328308264339,0.042000
steepest_intra:edges_start:random,148,74183,24917,49266,1943500,129,39;165;138;14;144;102;62;9;15;114;186;23;137;176;80;151;51;109;118;59;115;139;46;0;89;183;143;117;93;140;108;18;22;146;103;195;159;193;41;5;116;65;149;43;42;181;34;160;54;177;184;84;112;123;127;70;135;162;133;63;180;154;53;97;1;101;86;75;120;44;25;16;171;175;113;31;81;196;145;78;92;57;129;2;152;94;148;167;49;3;178;106;52;55;185;40;119;90;27;164,3028970090131454535,0.042507
steepest_intra:edges_start:random,149,74947,23569,51378,2122900,141,102;62;9;148;137;89;183;0;46;198;115;139;68;140;108;69;18;199;22;146;195;159;193;41;5;42;181;34;160;48;54;177;10;184;84;112;35;43;116;65;47;131;149;123;162;151;72;59;118;109;51;176;80;94;63;79;133;135;70;154;180;53;86;75;101;1;97;152;120;44;129;57;92;145;78;16;171;175;113;31;196;81;90;27;39;165;119;40;185;55;52;106;178;138;164;7;21;144;14;49,1970706743412687418,0.047000
steepest_intra:edges_start:random,150,73741,24032,49709,1958450,130,0;137;176;80;79;133;162;151;51;46;139;115;96;5;42;41;193;159;18;22;146;34;160;48;54;177;4;112;184;43;116;65;118;59;149;123;127;70;135;154;180;53;63;94;124;121;100;26;86;75;101;1;97;152;2;120;44;25;129;92;145;78;16;171;175;113;31;157;196;81;40;185;165;39;95;90;27;71;58;164;7;21;14;144;102;49;178;106;52;55;57;167;148;9;62;186;23;89;183;143,4532399128279657027,0.043000
steepest_intra:edges_start:random,151,73807,23983,49824,1928550,128,92;129;57;55;52;106;178;3;49;102;144;62;9;37;167;148;137;23;89;183;143;117;0;46;118;59;116;65;47;43;42;181;5;96;115;139;41;193;159;108;18;22;34;160;54;177;184;35;131;149;123;127;135;154;53;180;133;162;151;51;176;80;79;63;94;124;152;97;26;100;121;86;75;101;1;2;120;44;25;145;78;16;171;175;113;31;196;81;90;27;164;21;14;138;39;165;119;40;185;179,5971302147561959510,0.042000
steepest_intra:edges_start:random,152,74893,24068,50825,1928550,128,95;39;165;138;14;144;62;9;15;186;89;183;143;170;0;117;93;68;46;198;115;139;41;193;159;69;108;18;22;146;34;160;54;177;10;190;184;84;4;112;127;123;149;65;116;42;59;118;51;151;162;135;70;154;158;100;26;86;75;101;1;97;152;124;94;189;121;53;180;133;79;63;122;80;176;137;148;102;49;178;106;52;55;57;92;129;2;120;44;16;171;175;113;78;145;185;40;90;164;7,4872030761892772474,0.044000
steepest_intra:edges_start:random,153,73198,23303,49895,1973400,131,135;70;154;180;53;121;100;26;97;152;1;101;86;75;2;120;44;129;55;52;57;92;145;78;16;171;175;113;56;85;31;157;196;81;90;165;40;185;106;178;3;138;14;144;49;102;62;9;15;148;124;94;122;80;176;51;137;23;89;183;143;0;117;93;140;68;139;108;18;22;34;181;159;193;41;115;198;46;118;72;59;65;116;43;42;160;184;54;177;10;190;4;112;127;123;162;151;133;79;63,4855958961804020435,0.044000
steepest_intra:edges_start:random,154,72075,22134,49941,1898650,126,129;57;92;82;120;44;25;16;171;175;113;31;78;145;179;196;81;90;27;164;39;165;119;40;185;55;52;106;178;3;49;102;14;144;62;9;148;124;94;63;79;133;80;176;137;89;183;143;0;117;68;46;139;115;96;5;41;193;159;18;22;146;103;34;30;54;177;10;190;84;184;48;160;181;42;43;116;65;59;51;151;162;149;131;123;127;135;154;180;158;53;100;26;86;75;101;1;97;152;2,1889038773817370176,0.042001
steepest_intra:edges_start:random,155,73614,23697,49917,2182700,145,97;26;100;121;189;94;124;152;2;120;44;16;171;175;113;78;145;179;92;129;57;55;52;196;81;90;27;165;40;185;106;178;3;49;14;144;62;9;148;15;186;89;183;137;51;118;59;72;151;176;80;122;63;79;133;162;149;131;35;84;184;42;43;47;65;116;115;139;68;46;0;143;117;93;108;18;193;41;159;22;146;181;34;160;54;177;4;112;123;127;70;135;154;180;158;53;86;75;101;1,5841135327519625876,0.049000
steepest_intra:edges_start:random,156,73611,24427,49184,1973400,131,133;79;63;180;135;154;158;53;86;75;101;1;26;97;152;2;120;44;25;16;171;175;113;56;31;157;78;145;196;81;90;27;165;119;40;185;57;92;129;55;52;106;178;14;144;49;102;62;9;167;124;94;148;186;89;183;23;137;176;80;151;51;59;46;139;68;0;143;117;108;18;193;41;115;181;195;159;22;146;103;34;160;54;30;177;10;190;4;112;84;35;184;42;43;116;65;131;149;123;162,7289324939277188051,0.043000
steepest_intra:edges_start:random,157,73435,24510,48925,1988350,132,186;114;89;183;143;0;117;93;68;46;139;193;41;115;118;59;151;162;123;149;131;65;116;43;42;181;159;69;108;18;22;34;160;48;54;177;10;184;84;112;127;194;135;70;154;53;121;100;26;86;75;120;44;16;171;175;113;31;78;145;81;90;27;164;39;165;40;185;138;14;144;62;9;148;49;3;178;106;52;55;57;92;129;2;101;1;97;152;124;94;63;180;133;79;122;80;176;51;137;23,8728077424116324808,0.043000
steepest_intra:edges_start:random,158,72932,23402,49530,2078050,138,55;52;106;178;3;138;14;49;102;144;62;9;148;15;186;137;23;89;183;143;0;46;68;140;108;18;159;22;146;34;160;48;54;177;10;190;184;43;42;181;193;41;139;115;116;65;149;35;84;4;112;127;123;162;151;59;118;109;51;176;80;63;79;133;135;70;154;180;158;53;86;75;101;1;97;26;100;94;124;152;2;120;44;16;171;175;113;31;90;27;39;165;119;40;185;145;78;92;129;57,7723540990072081450,0.046000
steepest_intra:edges_start:random,159,72990,23246,49744,2048150,136,0;143;183;89;23;137;186;15;144;102;62;9;37;148;167;129;92;57;55;52;106;178;3;49;14;138;21;7;164;27;90;165;185;119;40;81;196;145;78;31;113;175;171;16;25;44;120;2;75;101;86;100;26;97;1;152;124;94;121;53;158;180;154;70;135;194;127;162;151;133;79;63;80;176;51;118;59;65;116;5;42;43;131;149;123;112;84;184;177;54;160;34;22;18;159;193;41;139;115;46,518409855074388123,0.046000
steepest_intra:edges_start:random,160,74816,24849,49967,1823900,121,135;70;127;123;112;177;54;184;42;160;34;181;195;146;22;18;108;159;193;41;139;68;93;117;143;0;46;115;43;116;47;65;59;118;51;151;80;176;137;183;89;9;62;102;49;144;14;138;3;178;106;52;185;40;119;165;39;95;164;27;90;31;113;175;171;16;25;44;120;75;86;101;1;97;26;100;53;158;154;180;121;152;2;129;92;78;145;179;57;55;167;37;148;124;94;63;122;79;133;162,169509249850168658,0.040003
steepest_intra:edges_start:random,161,73681,23330,50351,2018250,134,70;154;180;53;86;101;75;120;44;25;16;171;175;113;31;78;145;179;185;40;165;90;27;95;164;7;21;144;62;9;148;102;49;14;138;3;178;106;52;55;57;92;129;82;2;152;1;97;26;100;94;63;122;79;80;176;137;23;89;183;143;117;0;51;118;59;116;115;139;198;46;68;140;108;69;18;22;146;34;54;184;160;181;195;159;193;41;5;42;43;65;131;149;123;127;162;72;151;133;135,2821701852936818704,0.044672
steepest_intra:edges_start:random,162,72733,23683,49050,2152800,143,196;31;113;175;171;16;25;44;120;2;75;86;101;1;97;26;53;158;180;154;70;135;194;127;123;162;149;131;112;4;84;184;177;54;160;34;181;146;22;18;108;140;93;117;143;183;0;68;46;115;139;159;193;41;96;5;42;43;116;65;59;118;51;137;176;80;151;133;79;63;94;152;129;92;78;145;179;57;55;52;106;178;3;49;102;148;9;62;144;14;138;185;40;119;165;39;164;27;90;81,2181617240046075918,0.048546
steepest_intra:edges_start:random,163,73199,23538,49661,1988350,132,25;16;171;175;113;56;31;157;196;81;185;40;119;90;27;164;95;39;165;138;14;144;15;137;23;89;183;143;0;18;22;146;34;160;54;177;10;190;184;84;112;127;123;149;131;47;65;116;43;42;181;159;193;41;139;115;59;51;176;80;133;151;162;135;70;154;180;53;86;75;101;1;2;152;97;26;100;121;63;79;94;124;148;9;62;102;49;178;106;52;55;179;145;78;92;57;129;82;120;44,876025765651694993,0.043938
steepest_intra:edges_start:random,164,73290,22990,50300,2078050,138,31;38;157;196;179;145;78;92;129;57;55;52;178;106;185;119;40;81;90;27;164;7;95;39;165;138;14;144;49;102;62;9;15;148;167;111;124;94;63;79;133;151;59;65;116;43;42;115;118;51;80;176;137;23;89;183;143;0;46;139;41;193;159;69;108;18;22;34;160;54;177;10;190;184;84;112;123;127;70;135;154;180;53;100;26;97;152;2;1;101;86;75;120;44;25;16;171;175;113;56,4472611242919870675,0.046301
steepest_intra:edges_start:random,165,72765,23529,49236,2093000,139,7;21;144;62;9;148;49;14;178;106;185;52;55;57;92;179;145;78;129;2;1;97;152;94;63;122;80;79;133;151;51;176;137;23;186;89;183;143;0;46;139;108;18;22;159;193;41;115;42;160;34;48;54;30;177;10;190;4;112;84;35;184;43;116;65;131;149;59;162;123;127;70;135;154;180;158;53;100;26;86;101;75;120;44;25;16;171;175;113;56;31;38;157;196;81;40;165;90;27;164,7607017651194568017,0.045997
steepest_intra:edges_start:random,166,73590,24857,48733,2078050,138,26;100;53;158;154;70;127;194;135;180;63;79;133;151;162;123;149;131;47;65;116;43;184;10;177;54;48;160;34;146;181;42;5;59;118;51;46;115;41;193;159;22;18;108;139;68;140;93;117;0;143;183;89;23;137;176;80;122;94;124;148;9;62;144;21;164;27;90;81;196;31;113;175;171;16;78;145;92;129;57;55;52;178;106;185;40;165;14;49;102;167;152;97;1;2;120;44;75;101;86,98402904166209172,0.045001
steepest_intra:edges_start:random,167,73824,24265,49559,1928550,128,57;92;129;82;120;44;25;78;16;171;175;113;31;145;179;196;81;90;27;165;119;40;185;138;14;144;15;137;176;80;79;133;162;151;51;109;118;59;115;46;0;23;89;183;143;117;139;193;159;69;108;18;22;146;181;41;5;42;160;34;54;177;10;184;35;43;116;65;149;123;127;70;135;154;180;53;86;101;75;2;1;97;26;100;121;63;94;152;167;148;37;9;62;102;49;3;178;106;52;55,24770542925233975,0.043000
steepest_intra:edges_start:random,168,73630,24718,48912,2063100,137,43;42;181;160;184;177;54;34;22;159;41;193;18;108;117;143;0;46;68;139;115;116;65;59;51;176;137;23;183;89;186;148;9;62;102;49;57;55;52;106;178;3;138;14;144;21;7;164;95;27;90;39;165;185;119;40;81;196;157;31;56;113;175;171;16;25;78;145;179;92;129;44;120;2;152;124;94;97;1;101;75;86;26;100;53;158;70;127;135;154;180;63;122;80;79;133;151;162;123;149,2511678222461449891,0.045000
steepest_intra:edges_start:random,169,73924,24951,48973,2033200,135,4;10;177;54;48;160;34;146;22;18;108;69;159;181;184;84;35;43;42;5;41;193;139;115;46;0;117;143;183;137;176;80;94;124;152;167;148;9;62;102;49;14;144;21;164;90;165;119;40;185;106;178;52;57;92;179;196;81;31;113;175;171;16;78;145;25;44;120;129;2;1;97;101;75;86;26;100;53;158;70;127;135;154;180;63;79;133;151;51;109;118;59;116;65;47;131;149;162;123;112,7735516804381959870,0.044000
steepest_intra:edges_start:random,170,75025,22914,52111,1958450,130,0;143;117;139;41;193;159;108;18;22;146;103;34;30;54;48;160;181;42;5;43;77;105;116;65;47;149;131;184;177;10;4;112;123;127;135;154;180;53;86;101;97;152;1;75;2;120;44;25;16;171;175;113;56;85;31;38;157;81;196;179;145;78;92;82;129;57;55;52;185;40;119;90;27;165;106;178;49;102;14;144;62;9;148;23;89;183;137;176;80;63;79;133;162;151;51;118;59;115;46,3742659229697521849,0.044000
steepest_intra:edges_start:random,171,73346,23254,50092,1928550,128,75;86;53;158;180;154;135;70;127;112;123;162;133;151;51;118;59;65;116;5;42;43;77;47;149;131;35;184;177;54;160;34;103;146;181;41;193;159;22;18;108;140;68;139;115;198;46;0;117;143;183;89;137;176;80;79;63;94;121;100;26;101;1;97;152;2;129;92;57;55;167;148;15;9;62;144;14;49;178;106;52;185;40;119;165;27;90;81;196;157;31;56;113;175;171;16;78;145;44;120,7650113514139208494,0.041507
steepest_intra:edges_start:random,172,73134,23238,49896,2078050,138,59;162;133;151;51;80;176;137;23;183;89;186;148;9;62;102;49;144;14;138;3;178;106;185;40;119;165;27;90;81;196;179;52;55;57;92;145;78;31;56;113;175;171;16;25;44;120;82;129;2;75;101;86;100;26;97;1;152;189;124;94;122;79;63;53;158;180;154;135;70;127;123;177;54;34;160;184;43;149;65;116;42;181;41;193;159;22;18;69;108;68;140;93;117;143;170;0;46;139;115,3134374528927487154,0.045001
steepest_intra:edges_start:random,173,71771,23250,48521,2093000,139,135;70;127;123;112;4;84;35;184;177;54;160;34;181;41;193;159;146;22;18;69;108;140;68;46;139;115;42;43;116;65;59;118;51;151;162;133;79;122;63;94;124;167;148;80;176;137;0;117;143;183;89;186;15;9;62;102;144;14;49;3;178;106;52;55;179;185;40;119;165;27;90;81;196;157;31;56;113;175;171;16;25;44;120;78;145;92;57;129;2;152;97;1;101;75;86;26;53;180;154,501880323045768076,0.046015
steepest_intra:edges_start:random,174,75542,24610,50932,2048150,136,93;68;46;176;80;51;109;118;59;5;115;198;139;41;193;159;18;22;34;42;43;116;65;47;149;131;35;184;160;48;54;177;10;4;112;127;123;162;151;133;79;63;180;135;70;154;158;53;86;75;101;1;152;97;26;100;121;94;124;148;49;178;106;52;92;145;78;129;2;120;44;25;16;171;175;113;56;31;157;196;81;90;27;164;95;39;165;40;185;14;144;62;9;137;89;183;143;170;0;117,432842661149215741,0.044492
steepest_intra:edges_start:random,175,72292,23201,49091,2063100,137,175;171;16;25;44;120;75;101;86;53;180;154;135;162;151;133;79;63;122;80;176;51;118;59;115;41;193;159;181;42;5;43;116;65;149;123;127;112;4;177;184;160;34;146;22;18;108;139;198;46;68;93;117;0;143;183;89;23;137;186;15;144;14;49;102;62;9;148;124;94;121;100;26;97;1;152;2;129;92;78;145;179;57;55;52;178;106;185;40;119;165;39;95;7;164;27;90;81;31;113,372054096828839718,0.045000
steepest_intra:edges_start:random,176,72677,23768,48909,1898650,126,100;26;86;75;101;1;97;152;2;120;44;129;92;145;78;16;171;175;113;56;31;157;196;81;90;27;164;39;165;40;185;57;55;52;106;178;49;14;144;62;148;124;94;63;79;80;176;137;89;183;143;0;117;93;140;68;46;198;115;139;18;22;146;34;30;54;177;48;160;184;35;84;190;10;4;112;127;123;149;43;42;181;159;193;41;116;65;59;118;51;151;133;162;135;70;154;180;158;53;121,2732109167395458624,0.041505
steepest_intra:edges_start:random,177,71992,22540,49452,1988350,132,116;65;149;123;127;70;135;162;151;133;180;154;53;121;100;26;86;75;101;1;97;152;2;129;120;44;25;16;171;175;113;56;31;78;145;179;92;57;55;52;106;178;3;138;185;40;119;165;90;27;164;21;144;14;49;102;62;9;148;124;94;63;122;79;80;176;137;23;186;15;114;89;183;143;117;0;46;118;59;115;139;41;193;159;18;22;34;160;48;54;177;10;190;4;112;84;184;43;42;5,3071097595810461221,0.044039
steepest_intra:edges_start:random,178,72950,22885,50065,2078050,138,127;70;135;154;158;53;86;75;101;26;97;1;152;2;120;44;25;129;57;92;145;78;16;171;175;113;31;81;90;165;40;185;55;52;106;178;3;49;102;14;144;62;9;15;114;186;23;89;183;143;117;0;137;148;124;94;180;63;122;80;79;133;151;176;51;109;118;59;65;47;116;115;46;68;139;41;193;159;22;146;34;48;54;30;177;10;190;4;112;84;35;184;160;181;42;5;43;149;162;123,350368305309053631,0.047506
steepest_intra:edges_start:random,179,74181,22543,51638,2197650,146,52;55;129;2;152;94;124;167;3;178;106;185;40;90;165;138;14;144;49;102;62;9;148;137;89;183;143;0;117;68;46;139;115;116;65;47;43;42;5;41;193;159;69;108;18;22;146;181;34;160;54;177;184;84;4;112;35;131;149;123;127;70;135;194;161;162;151;72;59;118;109;51;176;80;133;79;122;63;180;154;158;53;100;26;97;1;101;86;75;120;44;16;171;175;113;31;78;145;92;57,2351673452544634638,0.048000
steepest_intra:edges_start:random,180,71987,22041,49946,2242500,149,127;123;162;151;51;109;59;118;46;115;42;43;116;65;47;149;131;112;84;184;10;177;54;48;160;34;181;146;22;18;159;193;41;139;68;117;0;143;183;89;23;137;176;80;133;79;122;63;94;124;148;15;9;62;102;144;14;49;3;178;106;52;55;185;40;119;165;90;81;196;145;78;31;56;113;175;171;16;25;44;120;82;92;57;129;2;75;86;101;1;97;152;189;26;100;121;53;180;154;135,9008025060633287813,0.049626
steepest_intra:edges_start:random,181,74328,24294,50034,1988350,132,137;183;143;0;117;68;46;198;139;69;108;18;22;146;195;159;193;41;115;96;5;42;43;116;65;47;149;131;35;84;184;48;160;181;34;30;54;177;10;4;112;127;123;162;59;118;51;151;133;79;80;176;94;63;180;135;70;154;53;100;26;86;101;75;2;1;97;152;167;148;9;62;102;49;14;3;178;106;52;55;57;129;120;44;16;171;175;113;56;31;78;145;92;185;40;165;90;21;144;15,2032649592269809401,0.046046
steepest_intra:edges_start:random,182,75079,23926,51153,2093000,139,37;15;9;62;102;49;155;144;21;14;138;3;178;106;52;55;57;185;40;119;165;39;95;7;164;27;90;81;196;56;113;175;171;16;31;78;145;179;92;129;25;44;120;2;75;86;101;1;97;152;189;26;100;121;53;158;180;154;135;127;123;149;65;116;59;115;41;193;159;181;42;160;184;177;54;34;146;22;18;108;139;46;0;117;143;183;137;176;80;51;118;151;162;133;79;122;63;94;124;148,2600112571141611917,0.046214
steepest_intra:edges_start:random,183,72640,23275,49365,2107950,140,46;115;42;43;184;177;10;190;84;4;112;123;149;131;65;116;59;118;51;151;133;135;154;180;53;26;97;1;101;86;75;120;44;25;16;171;175;113;56;31;157;196;81;90;27;164;21;14;144;62;9;148;49;138;165;119;40;185;106;178;52;55;57;179;145;78;92;129;2;152;94;63;79;80;176;137;89;183;143;170;0;117;93;140;108;69;18;199;22;146;34;54;160;181;195;159;193;41;139;68,9041415522538367074,0.047073
steepest_intra:edges_start:random,184,73946,22241,51705,2018250,134,18;193;41;139;46;0;143;183;89;23;137;148;9;62;102;144;14;49;178;106;52;55;57;185;165;40;81;196;179;145;78;157;31;85;56;113;175;171;16;25;44;120;82;92;129;2;75;86;101;1;152;97;26;100;121;94;124;12;122;63;180;53;158;154;135;70;127;123;112;4;190;10;177;54;184;43;116;65;131;149;162;151;133;79;80;176;51;109;118;59;115;5;42;181;160;34;146;195;159;22,8488886771735917395,0.046000
steepest_intra:edges_start:random,185,72667,23606,49061,1973400,131,27;90;81;196;40;165;185;106;178;52;55;57;92;179;145;31;113;175;171;16;78;25;44;120;129;2;152;1;101;75;86;97;26;100;121;53;158;180;154;70;135;194;127;123;162;151;72;51;118;59;116;65;47;149;131;112;4;190;10;177;54;184;43;42;160;34;103;146;22;181;41;193;159;18;139;115;46;0;117;143;183;89;137;176;80;133;79;63;94;124;167;148;9;62;49;14;144;21;7;164,8061135302870200027,0.043970
steepest_intra:edges_start:random,186,76398,22538,53860,2048150,136,194;135;70;154;180;158;53;86;100;26;97;152;74;1;101;75;2;120;44;16;171;175;78;145;92;129;57;55;52;185;40;81;90;27;165;106;178;3;49;14;144;62;9;15;148;167;111;124;94;189;121;182;63;122;176;80;79;133;151;162;59;118;51;137;89;183;143;0;46;139;115;116;65;149;131;43;42;5;96;41;193;159;18;22;146;195;181;34;160;48;54;30;177;10;190;184;84;112;123;127,6714584654977007637,0.045622
steepest_intra:edges_start:random,187,73989,24092,49897,1898650,126,193;181;34;146;22;159;18;108;140;68;46;0;117;143;183;89;23;186;15;148;9;62;144;14;49;178;106;165;90;81;40;185;52;57;129;92;145;78;31;113;175;171;16;25;44;120;75;2;152;1;97;26;100;101;86;158;70;135;154;180;53;136;121;94;63;79;122;137;176;80;133;162;151;72;51;118;59;65;116;43;47;131;149;123;127;112;4;84;184;10;177;54;48;160;42;5;115;198;139;41,2800238849515312523,0.044998
steepest_intra:edges_start:random,188,74265,25048,49217,1958450,130,80;176;151;59;118;51;137;0;143;183;89;23;186;15;9;62;102;144;164;27;90;39;165;119;40;185;196;113;175;171;16;31;78;25;44;120;75;86;26;101;1;97;152;2;129;82;145;179;92;57;55;52;106;178;3;138;14;49;167;148;124;94;63;53;180;154;135;127;123;35;84;112;4;10;177;54;48;34;160;184;43;42;181;41;193;159;146;22;18;68;46;198;139;115;116;65;149;162;133;79,4772115251828629391,0.045231
steepest_intra:edges_start:random,189,74242,24113,50129,1988350,132,143;183;89;23;137;176;94;148;15;9;62;102;49;144;14;3;178;55;52;106;138;21;7;164;95;27;90;39;165;185;40;81;196;145;78;157;31;56;113;175;171;16;25;44;120;92;179;57;129;2;152;97;1;101;75;86;53;63;180;154;135;70;127;112;4;123;194;162;133;79;80;151;51;118;59;149;131;47;65;116;43;42;181;160;184;35;84;177;54;48;34;146;22;159;193;41;139;115;46;0,3649454824232327702,0.042506
steepest_intra:edges_start:random,190,73503,23647,49856,2078050,138,145;179;185;119;40;81;90;165;138;14;144;186;89;183;143;117;0;46;139;115;59;118;109;51;80;79;133;151;162;149;131;65;116;47;77;43;184;48;160;181;42;5;96;41;193;159;108;18;22;146;34;54;177;10;190;4;112;123;127;70;135;154;180;53;26;86;75;101;97;1;2;152;94;63;122;176;137;148;9;62;49;3;178;106;52;55;57;92;129;120;44;25;16;171;175;113;56;31;196;78,6468062402677625972,0.045000
steepest_intra:edges_start:random,191,72815,23860,48955,2137850,142,89;183;143;117;0;46;68;108;18;22;146;159;193;41;139;115;96;5;116;65;47;149;131;43;42;181;34;160;54;177;184;84;4;112;127;123;162;59;118;51;176;80;63;79;133;151;135;154;180;53;86;101;75;120;44;25;145;78;16;171;175;113;56;31;157;196;81;90;27;58;164;7;21;95;39;165;40;185;106;178;52;55;57;92;129;2;1;97;152;94;148;49;14;144;62;9;15;186;137;23,7955322161834544732,0.046506
steepest_intra:edges_start:random,192,73993,22937,51056,1943500,129,165;40;185;138;14;144;15;186;89;183;137;176;80;133;151;162;149;131;47;65;116;43;42;5;96;41;193;115;59;118;46;198;139;68;0;143;117;93;140;108;69;18;22;159;195;146;103;34;181;160;54;177;10;184;35;84;4;112;123;127;70;135;154;180;79;63;53;86;101;1;97;152;94;148;9;62;102;49;3;178;106;52;55;57;92;129;120;44;145;78;16;171;175;113;31;157;196;81;90;27,3129870506058892879,0.042506
steepest_intra:edges_start:random,193,73366,23130,50236,2078050,138,102;144;21;164;90;165;119;40;185;106;178;3;14;49;167;124;94;121;100;26;101;1;97;152;2;129;92;57;55;52;179;145;78;31;56;113;175;171;16;25;44;120;75;86;53;158;180;154;135;70;127;123;162;151;133;79;63;122;80;176;51;118;46;115;59;149;131;47;65;116;105;43;42;160;184;84;190;10;177;54;34;146;22;159;41;193;18;108;139;68;117;0;170;143;183;89;137;148;9;62,7689352983197888875,0.044506
steepest_intra:edges_start:random,194,74126,25112,49014,1943500,129,63;79;133;151;162;123;180;154;135;70;127;112;84;184;10;177;54;48;34;146;22;18;108;69;159;193;41;139;68;93;117;143;0;46;115;5;42;181;160;43;116;47;65;59;51;80;176;137;183;89;23;186;9;62;102;49;144;14;138;106;185;40;165;39;164;27;90;81;196;31;113;175;171;16;78;145;44;120;75;101;86;100;26;97;1;152;2;92;57;55;52;178;167;148;124;94;189;121;53;158,7416950354065932736,0.043001
steepest_intra:edges_start:random,195,73239,22692,50547,1943500,129,137;23;89;183;143;0;46;139;115;59;65;116;43;42;5;41;193;159;18;22;146;181;34;160;54;177;184;84;112;123;127;70;135;154;180;158;53;100;26;86;75;101;1;97;152;2;129;82;120;44;25;16;171;175;113;56;85;31;157;78;145;179;92;57;55;52;178;106;165;119;40;185;196;81;90;27;39;95;164;21;144;14;49;62;9;148;124;94;189;121;182;63;79;133;162;151;118;51;80;176,2748101320924674526,0.042000
steepest_intra:edges_start:random,196,74664,23374,51290,1868750,124,135;154;180;53;94;152;1;97;26;100;86;101;75;2;120;44;16;171;175;113;56;31;157;196;81;40;119;185;165;90;27;164;21;14;144;102;49;138;32;3;178;106;52;55;57;145;78;92;129;167;124;148;37;9;62;15;114;186;23;137;183;143;0;117;93;140;108;69;18;22;193;41;139;115;42;43;184;160;34;48;54;177;10;4;112;123;149;131;47;65;116;59;118;51;176;80;63;79;133;151,7213748145595735210,0.041003
steepest_intra:edges_start:random,197,71951,23214,48737,2033200,135,181;42;41;193;159;22;18;108;139;115;46;0;117;143;183;89;23;137;51;176;80;133;79;122;63;94;124;167;148;15;9;62;144;14;102;49;178;106;52;55;185;40;119;165;39;95;164;27;90;81;196;157;31;56;113;175;171;16;78;145;92;57;129;25;44;120;2;152;97;1;101;75;86;26;100;53;180;154;70;135;194;162;151;59;116;43;65;149;123;127;112;84;184;190;10;177;54;48;160;34,8611459298397858364,0.043503
steepest_intra:edges_start:random,198,73571,22671,50900,1958450,130,105;43;77;131;149;59;118;109;51;151;133;162;123;127;135;154;180;53;86;101;75;2;120;44;25;16;171;175;113;31;78;145;92;129;57;55;52;178;106;185;81;90;40;119;165;138;14;144;49;102;62;9;15;148;37;167;152;1;97;26;100;121;94;63;122;79;80;176;137;89;183;143;0;117;93;108;18;22;146;34;54;177;10;4;112;84;184;160;42;159;193;41;139;68;46;198;115;116;65;47,4327840788728791,0.043002
steepest_intra:edges_start:random,199,76266,22968,53298,1988350,132,185;14;144;62;9;102;49;178;106;52;55;57;167;148;124;94;152;97;26;100;121;182;136;63;79;80;176;137;51;118;59;115;139;46;68;93;140;108;69;18;193;41;159;195;22;146;103;34;181;160;48;54;177;10;184;84;112;127;123;149;131;43;42;5;96;116;47;65;72;151;133;162;135;70;154;180;158;53;86;75;101;1;2;120;44;25;129;92;179;145;78;16;171;175;113;31;90;165;119;40,8327862916171248292,0.042998
steepest_intra:edges_start:greedy,0,70571,22366,48205,119600,7,0;117;143;183;89;186;23;137;176;80;79;63;94;124;152;97;1;101;2;82;129;92;57;55;52;49;102;148;9;62;144;14;3;178;106;185;40;165;90;81;196;179;145;78;31;56;113;175;171;16;25;44;120;75;86;26;100;121;53;180;154;135;70;127;123;162;133;151;51;118;59;65;116;43;184;84;112;4;190;10;177;54;48;160;34;146;22;18;108;69;159;181;42;5;41;193;115;139;68;46,6756833975384749676,0.002000
steepest_intra:edges_start:greedy,1,71446,23257,48189,74750,4,1;101;75;86;53;154;70;135;180;63;79;133;151;162;127;123;149;65;116;43;184;10;177;54;48;160;34;146;22;18;108;69;159;181;42;5;41;193;139;68;140;93;117;143;0;46;115;59;118;51;80;176;137;23;183;89;186;114;15;9;62;144;14;138;185;40;165;90;81;196;179;145;78;31;56;113;175;171;16;25;44;120;2;129;92;57;55;52;106;178;49;102;148;124;94;121;100;26;97;152,3312965088058681214,0.002219
steepest_intra:edges_start:greedy,2,71382,23110,48272,119600,7,2;129;92;57;55;52;49;102;148;9;62;144;14;3;178;106;185;40;165;90;81;196;179;145;78;31;56;113;175;171;16;25;44;120;75;86;53;180;154;135;70;127;123;162;149;131;65;116;43;184;84;190;10;177;54;48;160;34;146;22;18;108;69;159;181;42;5;41;193;139;68;140;93;117;143;183;89;186;23;137;0;46;115;59;118;51;151;133;176;80;79;63;94;121;100;26;101;1;97;152,1865199252380109964,0.002002
steepest_intra:edges_start:greedy,3,71246,23052,48194,104650,6,138;14;144;62;9;148;102;49;178;106;52;55;57;92;129;2;152;97;1;101;26;100;121;94;63;79;80;176;133;151;51;118;59;115;46;0;137;23;186;89;183;143;117;93;140;68;139;193;41;5;42;181;159;69;108;18;22;146;34;160;48;54;177;10;190;84;184;43;116;65;131;149;162;123;127;70;135;154;180;53;86;75;120;44;25;16;171;175;113;56;31;78;145;179;196;81;90;165;40;185,4244367789601465099,0.002859
steepest_intra:edges_start:greedy,4,71327,23150,48177,149500,9,4;190;10;177;54;48;34;160;42;181;146;22;18;108;69;159;193;41;139;68;46;115;118;59;65;116;43;184;35;131;149;123;162;133;151;51;0;117;143;183;89;23;137;176;80;79;63;94;124;152;97;1;101;2;82;129;92;57;55;52;49;102;148;9;62;144;14;3;178;106;185;40;165;90;81;196;179;145;78;31;56;113;175;171;16;25;44;120;75;86;26;100;121;53;180;154;135;70;127;112,4884030660902864448,0.004000
steepest_intra:edges_start:greedy,5,71179,23056,48123,104650,6,5;43;116;65;149;123;127;162;151;133;135;70;154;180;53;121;100;26;86;75;120;44;25;16;171;175;113;56;31;78;145;179;196;81;90;165;40;185;106;178;3;14;144;62;9;148;102;49;52;55;57;92;129;82;2;101;1;97;152;124;94;63;79;80;176;137;23;186;89;183;143;117;0;51;118;59;115;46;68;139;41;193;159;69;108;18;22;146;181;34;160;48;54;177;10;190;4;112;184;42,6001299902470826207,0.003000
steepest_intra:edges_start:greedy,6,71403,22833,48570,89700,5,158;70;135;154;180;63;79;133;151;162;127;123;149;65;116;43;184;177;54;48;160;34;146;22;18;108;69;159;181;42;5;41;193;139;68;140;93;117;143;0;46;115;59;118;51;80;176;137;23;183;89;186;114;15;9;62;144;14;138;185;40;165;90;81;196;179;145;78;31;56;113;175;171;16;25;44;120;2;129;92;57;55;52;106;178;49;102;148;124;94;152;97;1;101;75;86;26;100;121;53,3739894584819501886,0.002031
steepest_intra:edges_start:greedy,7,72221,24124,48097,119600,7,7;21;144;62;9;148;102;49;14;178;106;52;55;185;165;40;179;145;78;92;57;129;2;152;97;1;101;26;100;121;94;63;79;80;176;133;151;51;118;59;115;46;0;137;23;89;183;143;117;93;140;68;139;193;41;5;42;181;159;69;108;18;22;146;34;160;48;54;177;184;43;116;65;149;162;123;127;70;135;154;180;53;86;75;120;44;25;16;171;175;113;56;31;157;196;81;90;27;95;164,2995123482656921370,0.003327
steepest_intra:edges_start:greedy,8,71285,23048,48237,119600,7,27;165;40;185;138;14;144;62;9;148;102;49;178;106;52;55;57;92;129;2;152;97;1;101;26;100;121;94;63;79;80;176;133;151;51;118;59;115;46;0;137;23;186;89;183;143;117;93;140;68;139;193;41;5;42;181;159;69;108;18;22;146;34;160;48;54;177;10;190;184;43;116;65;131;149;162;123;127;70;135;154;180;53;86;75;120;44;25;16;171;175;113;56;31;78;145;179;196;81;90,6491662968545055842,0.003001
steepest_intra:edges_start:greedy,9,71246,23052,48194,89700,5,9;148;102;49;178;106;52;55;57;92;129;2;152;97;1;101;26;100;121;94;63;79;80;176;133;151;51;118;59;115;46;0;137;23;186;89;183;143;117;93;140;68;139;193;41;5;42;181;159;69;108;18;22;146;34;160;48;54;177;10;190;84;184;43;116;65;131;149;162;123;127;70;135;154;180;53;86;75;120;44;25;16;171;175;113;56;31;78;145;179;196;81;90;165;40;185;138;14;144;62,6577803764917350187,0.002002
steepest_intra:edges_start:greedy,10,71327,23150,48177,149500,9,10;190;4;112;127;70;135;154;180;53;121;100;26;86;75;120;44;25;16;171;175;113;56;31;78;145;179;196;81;90;165;40;185;106;178;3;14;144;62;9;148;102;49;52;55;57;92;129;82;2;101;1;97;152;124;94;63;79;80;176;137;23;89;183;143;117;0;51;151;133;162;123;149;131;35;184;43;116;65;59;118;115;46;68;139;41;193;159;69;108;18;22;146;181;42;160;34;48;54;177,6652796964914843463,0.003041
steepest_intra:edges_start:greedy,11,71233,22908,48325,149500,9,149;35;84;4;112;127;123;162;151;133;135;70;154;180;53;121;100;26;86;75;120;44;25;16;171;175;113;56;31;78;145;179;196;81;90;165;40;185;106;178;3;14;144;62;9;148;102;49;52;55;57;92;129;82;2;101;1;97;152;124;94;63;79;80;176;137;23;186;89;183;143;117;0;46;68;139;115;118;51;59;65;116;43;42;5;41;193;159;69;108;18;22;146;181;34;160;48;54;177;184,5010689204484363627,0.004039
steepest_intra:edges_start:greedy,12,72072,23105,48967,89700,5,124;94;152;97;1;101;2;82;129;92;57;179;145;78;31;56;113;175;171;16;25;44;120;75;86;26;100;121;53;158;154;70;135;180;63;79;133;151;162;123;149;65;116;43;184;177;54;48;160;34;146;22;18;108;69;159;181;42;5;41;193;139;68;140;93;117;143;0;46;115;59;118;51;80;176;137;23;183;89;186;114;15;9;62;144;14;138;165;90;81;196;40;185;55;52;106;178;49;102;148,7788537639825121477,0.002000
steepest_intra:edges_start:greedy,13,71808,23361,48447,149500,9,157;31;56;113;175;171;16;25;44;120;75;86;53;180;154;135;70;127;123;162;149;131;65;116;43;184;190;10;177;54;48;160;34;146;22;18;108;69;159;181;42;5;41;193;139;68;140;93;117;143;183;89;186;23;137;0;46;115;59;118;51;151;133;176;80;79;63;94;121;100;26;101;1;97;152;2;129;57;55;52;49;102;148;9;62;144;14;3;178;106;185;40;165;90;81;196;179;92;145;78,9165884673727009051,0.004004
steepest_intra:edges_start:greedy,14,71246,23052,48194,89700,5,14;144;62;9;148;102;49;178;106;52;55;57;92;129;2;152;97;1;101;26;100;121;94;63;79;80;176;133;151;51;118;59;115;46;0;137;23;186;89;183;143;117;93;140;68;139;193;41;5;42;181;159;69;108;18;22;146;34;160;48;54;177;10;190;84;184;43;116;65;131;149;162;123;127;70;135;154;180;53;86;75;120;44;25;16;171;175;113;56;31;78;145;179;196;81;90;165;40;185;138,2879080983912935522,0.002000
steepest_intra:edges_start:greedy,15,71325,23171,48154,89700,5,15;144;14;138;185;40;165;90;81;196;179;145;78;31;56;113;175;171;16;25;44;120;75;86;53;180;154;135;70;127;123;162;149;131;65;116;43;184;190;10;177;54;48;160;34;146;22;18;108;69;159;181;42;5;41;193;139;68;140;93;117;143;183;89;186;23;137;0;46;115;59;118;51;151;133;176;80;79;63;94;121;100;26;101;1;97;152;2;129;92;57;55;52;106;178;49;102;62;9;148,5720685294653384121,0.002002
steepest_intra:edges_start:greedy,16,71579,23307,48272,119600,7,16;25;44;120;75;86;53;180;154;135;70;127;123;162;149;131;65;116;43;184;84;190;10;177;54;48;160;34;146;22;18;108;69;159;181;42;5;41;193;139;68;140;93;117;143;183;89;186;23;137;0;46;115;59;118;51;151;133;176;80;79;63;94;121;100;26;101;1;97;152;2;129;57;55;52;49;102;148;9;62;144;14;3;178;106;185;40;165;90;81;196;179;92;145;78;31;56;113;175;171,8754089507131636540,0.003011
steepest_intra:edges_start:greedy,17,72552,23722,48830,149500,9,119;165;39;95;7;164;58;27;90;81;196;157;31;56;113;175;171;16;25;44;120;75;86;53;180;154;135;70;127;123;162;149;65;116;43;184;177;54;48;160;34;146;22;18;108;159;181;42;41;193;139;68;140;93;117;143;183;89;23;137;0;46;115;59;118;51;151;133;176;80;79;63;94;26;101;1;97;152;2;82;78;145;179;92;129;57;55;52;49;102;148;9;62;144;14;3;178;106;185;40,7054022563382293932,0.003009
steepest_intra:edges_start:greedy,18,71359,23109,48250,119600,7,18;22;146;159;193;41;5;42;181;34;160;48;54;177;10;190;4;112;184;43;116;65;149;123;127;162;151;133;135;70;154;180;53;121;100;26;86;75;120;44;25;16;171;175;113;56;31;78;145;179;196;81;90;165;40;185;106;178;3;14;144;62;9;148;102;49;52;55;57;92;129;82;2;101;1;97;152;124;94;63;79;80;176;137;51;118;59;115;139;68;46;0;89;183;143;117;93;140;108;69,6874253302142229420,0.002755
steepest_intra:edges_start:greedy,19,71608,22548,49060,59800,3,189;94;124;148;102;49;178;106;52;55;57;92;129;2;120;44;25;16;171;175;113;56;31;78;145;179;196;81;90;165;40;185;138;14;144;62;9;15;114;186;89;183;23;137;176;80;51;118;59;115;46;0;143;117;93;140;68;139;193;41;5;42;181;159;69;108;18;22;146;34;160;48;54;177;184;43;116;65;149;123;162;151;133;79;63;180;135;70;154;158;53;121;100;26;86;75;101;1;97;152,5656389849314163695,0.001003
steepest_intra:edges_start:greedy,20,71788,22810,48978,119600,7,199;22;146;159;193;41;5;42;181;34;160;48;54;177;10;190;84;184;43;116;65;149;123;127;162;151;133;135;70;154;180;53;121;100;26;86;75;120;44;25;16;171;175;113;56;31;78;145;179;196;81;90;165;40;185;106;178;3;14;144;62;9;148;102;49;52;55;57;92;129;82;2;101;1;97;152;124;94;63;79;80;176;137;51;118;59;115;139;68;46;0;89;183;143;117;93;140;108;69;18,6309789919973963731,0.002002
steepest_intra:edges_start:greedy,21,71711,23674,48037,89700,5,21;14;138;185;40;165;90;81;196;179;145;78;31;56;113;175;171;16;25;44;120;75;86;53;180;154;135;70;127;123;162;149;131;65;116;43;184;190;10;177;54;48;160;34;146;22;18;108;69;159;181;42;5;41;193;139;68;140;93;117;143;183;89;186;23;137;0;46;115;59;118;51;151;133;176;80;79;63;94;121;100;26;101;1;97;152;2;129;92;57;55;52;106;178;49;102;148;9;62;144,5570593698469145594,0.002004
steepest_intra:edges_start:greedy,22,70906,22933,47973,89700,5,22;146;181;34;160;48;54;177;10;190;4;112;84;184;42;43;116;65;149;123;127;162;151;133;135;70;154;180;53;121;100;26;86;75;120;44;25;16;171;175;113;56;31;78;145;179;196;81;90;165;40;185;106;178;3;14;144;62;9;148;102;49;52;55;57;92;129;82;2;101;1;97;152;124;94;63;79;80;176;137;23;186;89;183;143;117;0;51;118;59;115;46;68;139;41;193;159;69;108;18,7811311712228916870,0.002003
steepest_intra:edges_start:greedy,23,70571,22366,48205,119600,7,23;137;176;80;79;63;94;124;152;97;1;101;2;82;129;92;57;55;52;49;102;148;9;62;144;14;3;178;106;185;40;165;90;81;196;179;145;78;31;56;113;175;171;16;25;44;120;75;86;26;100;121;53;180;154;135;70;127;123;162;133;151;51;118;59;65;116;43;184;84;112;4;190;10;177;54;48;160;34;146;22;18;108;69;159;181;42;5;41;193;115;139;68;46;0;117;143;183;89;186,1406888534550040792,0.003011
steepest_intra:edges_start:greedy,24,71514,22952,48562,119600,7,131;149;123;127;162;151;133;135;70;154;180;53;121;100;26;86;75;120;44;25;16;171;175;113;56;31;78;145;179;196;81;90;165;40;185;106;178;3;14;144;62;9;148;102;49;52;55;57;92;129;82;2;101;1;97;152;124;94;63;79;80;176;137;23;186;89;183;143;117;0;51;118;59;115;46;68;139;193;41;5;42;181;159;69;108;18;22;146;34;160;48;54;177;10;190;84;184;43;116;65,3681556046140715763,0.002999
steepest_intra:edges_start:greedy,25,71382,23110,48272,119600,7,25;44;120;75;86;53;180;154;135;70;127;123;162;149;131;65;116;43;184;84;190;10;177;54;48;160;34;146;22;18;108;69;159;181;42;5;41;193;139;68;140;93;117;143;183;89;186;23;137;0;46;115;59;118;51;151;133;176;80;79;63;94;121;100;26;101;1;97;152;2;129;92;57;55;52;49;102;148;9;62;144;14;3;178;106;185;40;165;90;81;196;179;145;78;31;56;113;175;171;16,5139264933736176787,0.002002
steepest_intra:edges_start:greedy,26,71224,23198,48026,59800,3,26;97;1;152;94;124;148;102;49;178;106;52;55;57;92;129;2;120;44;25;16;171;175;113;56;31;78;145;179;196;81;90;165;40;185;138;14;144;62;9;15;114;186;89;183;23;137;176;80;51;118;59;115;46;0;143;117;93;140;68;139;193;41;5;42;181;159;69;108;18;22;146;34;160;48;54;177;10;190;184;43;116;65;149;123;127;162;151;133;79;63;180;135;70;154;53;86;75;101;100,1789713177088106233,0.002000
steepest_intra:edges_start:greedy,27,71912,23384,48528,59800,3,27;58;164;7;95;39;165;138;14;144;62;9;148;102;49;178;106;52;55;57;92;129;2;152;94;63;79;80;176;133;151;51;118;59;115;46;0;137;23;89;183;143;117;93;140;68;139;193;41;5;42;181;159;69;108;18;22;146;34;160;48;54;177;184;43;116;65;149;162;123;127;70;135;154;180;53;100;26;97;1;101;86;75;120;44;25;16;171;175;113;56;31;78;145;179;196;81;185;40;90,7559218879144884281,0.002000
steepest_intra:edges_start:greedy,28,71641,23034,48607,134550,8,35;43;116;65;131;149;123;127;162;151;133;135;70;154;180;53;121;100;26;86;75;120;44;25;16;171;175;113;56;31;78;145;179;196;81;90;165;40;185;106;178;3;14;144;62;9;148;102;49;52;55;57;92;129;82;2;101;1;97;152;124;94;63;79;80;176;137;23;186;89;183;143;117;0;51;118;59;115;46;68;139;193;41;5;42;181;159;69;108;18;22;146;34;160;48;54;177;10;190;184,5118995480240615408,0.003000
steepest_intra:edges_start:greedy,29,71061,22454,48607,179400,11,149;123;162;151;133;135;70;154;180;53;121;100;26;86;75;120;44;25;16;171;175;113;56;31;78;145;179;196;81;90;165;40;185;106;178;3;14;144;62;9;148;102;49;52;55;57;92;129;82;2;101;1;97;152;124;94;63;79;80;176;137;23;186;89;183;143;117;0;46;68;139;115;118;51;59;65;116;43;42;5;41;193;159;69;108;18;22;146;181;34;160;48;54;177;184;35;84;4;112;131,8229054384965738508,0.004270
steepest_intra:edges_start:greedy,30,71512,22948,48564,149500,9,48;54;177;10;190;84;184;43;116;65;59;118;115;46;0;51;151;133;162;123;127;70;135;154;180;53;121;100;26;86;75;120;44;25;16;171;175;113;56;31;78;145;179;196;81;90;165;40;185;106;178;3;14;144;62;9;148;102;49;52;55;57;92;129;82;2;101;1;97;152;124;94;63;79;80;176;137;23;186;89;183;143;117;93;140;68;139;41;193;159;69;108;18;22;146;195;181;42;160;34,3048549312390364586,0.002784
steepest_intra:edges_start:greedy,31,71579,23307,48272,119600,7,31;78;145;92;179;196;81;90;165;40;185;106;178;3;14;144;62;9;148;102;49;52;55;57;129;2;152;97;1;101;26;100;121;94;63;79;80;176;133;151;51;118;59;115;46;0;137;23;186;89;183;143;117;93;140;68;139;193;41;5;42;181;159;69;108;18;22;146;34;160;48;54;177;10;190;84;184;43;116;65;131;149;162;123;127;70;135;154;180;53;86;75;120;44;25;16;171;175;113;56,7209075633326051048,0.003001
steepest_intra:edges_start:greedy,32,71246,23052,48194,104650,6,138;14;144;62;9;148;102;49;178;106;52;55;57;92;129;2;152;97;1;101;26;100;121;94;63;79;80;176;133;151;51;118;59;115;46;0;137;23;186;89;183;143;117;93;140;68;139;193;41;5;42;181;159;69;108;18;22;146;34;160;48;54;177;10;190;84;184;43;116;65;131;149;162;123;127;70;135;154;180;53;86;75;120;44;25;16;171;175;113;56;31;78;145;179;196;81;90;165;40;185,3925637751730677414,0.002002
steepest_intra:edges_start:greedy,33,71402,22870,48532,104650,6,37;102;49;178;106;52;55;57;92;129;2;152;97;1;101;26;100;121;94;63;79;80;176;133;151;51;118;59;115;46;0;137;23;186;89;183;143;117;93;140;68;139;193;41;5;42;181;159;69;108;18;22;146;34;160;48;54;177;10;190;184;43;116;65;131;149;162;123;127;70;135;154;180;53;86;75;120;44;25;16;171;175;113;56;31;78;145;179;196;81;90;165;40;185;138;14;144;62;9;148,4618525724680295143,0.003045
steepest_intra:edges_start:greedy,34,70906,22933,47973,89700,5,34;181;146;22;18;108;69;159;193;41;139;68;46;115;59;118;51;0;117;143;183;89;186;23;137;176;80;79;63;94;124;152;97;1;101;2;82;129;92;57;55;52;49;102;148;9;62;144;14;3;178;106;185;40;165;90;81;196;179;145;78;31;56;113;175;171;16;25;44;120;75;86;26;100;121;53;180;154;70;135;133;151;162;127;123;149;65;116;43;42;184;84;112;4;190;10;177;54;48;160,6000753404573287928,0.002040
steepest_intra:edges_start:greedy,35,70846,22596,48250,149500,9,35;84;4;112;127;123;162;151;133;135;70;154;180;53;121;100;26;86;75;120;44;25;16;171;175;113;56;31;78;145;179;196;81;90;165;40;185;106;178;3;14;144;62;9;148;102;49;52;55;57;92;129;82;2;101;1;97;152;124;94;63;79;80;176;137;23;186;89;183;143;117;0;46;68;139;115;118;51;59;65;116;43;42;5;41;193;159;69;108;18;22;146;181;34;160;48;54;177;10;184,700022392908789210,0.004004
steepest_intra:edges_start:greedy,36,71952,22784,49168,104650,6,36;108;69;18;22;146;159;193;41;5;42;181;34;160;48;54;177;10;190;84;184;43;116;65;149;123;127;162;151;133;135;70;154;180;53;121;100;26;86;75;120;44;25;16;171;175;113;56;31;78;145;179;196;81;90;165;40;185;106;178;3;14;144;62;9;148;102;49;52;55;57;92;129;82;2;101;1;97;152;124;94;63;79;80;176;137;51;118;59;115;139;68;46;0;89;183;143;117;93;140,4544565653324246802,0.003001
steepest_intra:edges_start:greedy,37,71402,22870,48532,89700,5,37;102;49;178;106;52;55;57;92;129;2;152;97;1;101;26;100;121;94;63;79;80;176;133;151;51;118;59;115;46;0;137;23;186;89;183;143;117;93;140;68;139;193;41;5;42;181;159;69;108;18;22;146;34;160;48;54;177;10;190;184;43;116;65;131;149;162;123;127;70;135;154;180;53;86;75;120;44;25;16;171;175;113;56;31;78;145;179;196;81;90;165;40;185;138;14;144;62;9;148,5681171574836960441,0.002011
steepest_intra:edges_start:greedy,38,71808,23361,48447,134550,8,157;78;145;92;179;196;81;90;165;40;185;106;178;3;14;144;62;9;148;102;49;52;55;57;129;2;152;97;1;101;26;100;121;94;63;79;80;176;133;151;51;118;59;115;46;0;137;23;186;89;183;143;117;93;140;68;139;193;41;5;42;181;159;69;108;18;22;146;34;160;48;54;177;10;190;184;43;116;65;131;149;162;123;127;70;135;154;180;53;86;75;120;44;25;16;171;175;113;56;31,1012507031314871858,0.003003
steepest_intra:edges_start:greedy,39,71938,23600,48338,74750,4,39;95;7;164;27;90;40;185;81;196;179;145;78;31;56;113;175;171;16;25;44;120;75;86;53;180;154;135;70;127;123;162;149;65;116;43;184;177;54;48;160;34;146;22;18;108;69;159;181;42;5;41;193;139;68;140;93;117;143;183;89;23;137;0;46;115;59;118;51;151;133;176;80;79;63;94;121;100;26;101;1;97;152;2;129;92;57;55;52;106;178;49;102;148;9;62;144;14;138;165,6828932871669065378,0.002033
steepest_intra:edges_start:greedy,40,71246,23052,48194,89700,5,40;165;90;81;196;179;145;78;31;56;113;175;171;16;25;44;120;75;86;53;180;154;135;70;127;123;162;149;131;65;116;43;184;84;190;10;177;54;48;160;34;146;22;18;108;69;159;181;42;5;41;193;139;68;140;93;117;143;183;89;186;23;137;0;46;115;59;118;51;151;133;176;80;79;63;94;121;100;26;101;1;97;152;2;129;92;57;55;52;106;178;49;102;148;9;62;144;14;138;185,7309846845712200945,0.001999
steepest_intra:edges_start:greedy,41,71369,23246,48123,104650,6,41;5;42;181;159;69;108;18;22;146;34;160;48;54;177;10;190;4;112;184;43;116;65;149;123;127;162;151;133;135;70;154;180;53;121;100;26;86;75;120;44;25;16;171;175;113;56;31;78;145;179;196;81;90;165;40;185;106;178;3;14;144;62;9;148;102;49;52;55;57;92;129;82;2;101;1;97;152;124;94;63;79;80;176;137;23;186;89;183;143;117;0;51;118;59;115;46;68;139;193,3178964211393667247,0.002002
steepest_intra:edges_start:greedy,42,71369,23246,48123,104650,6,42;5;41;193;139;68;46;115;59;118;51;0;117;143;183;89;186;23;137;176;80;79;63;94;124;152;97;1;101;2;82;129;92;57;55;52;49;102;148;9;62;144;14;3;178;106;185;40;165;90;81;196;179;145;78;31;56;113;175;171;16;25;44;120;75;86;26;100;121;53;180;154;70;135;133;151;162;127;123;149;65;116;43;184;112;4;190;10;177;54;48;160;34;146;22;18;108;69;159;181,163579305529814417,0.002009
steepest_intra:edges_start:greedy,43,71548,23048,48500,104650,6,43;116;65;59;118;115;46;0;51;151;133;162;123;127;70;135;154;180;53;121;100;26;86;75;120;44;25;16;171;175;113;56;31;78;145;179;196;81;90;165;40;185;106;178;3;14;144;62;9;148;102;49;52;55;57;92;129;82;2;101;1;97;152;124;94;63;79;80;176;137;23;186;89;183;143;117;93;140;68;139;193;41;5;42;181;159;69;108;18;22;146;34;160;48;54;177;10;190;84;184,466432876315413251,0.002000
steepest_intra:edges_start:greedy,44,71382,23110,48272,119600,7,44;25;16;171;175;113;56;31;78;145;179;196;81;90;165;40;185;106;178;3;14;144;62;9;148;102;49;52;55;57;92;129;2;152;97;1;101;26;100;121;94;63;79;80;176;133;151;51;118;59;115;46;0;137;23;186;89;183;143;117;93;140;68;139;193;41;5;42;181;159;69;108;18;22;146;34;160;48;54;177;10;190;84;184;43;116;65;131;149;162;123;127;70;135;154;180;53;86;75;120,3397623797256074035,0.003005
steepest_intra:edges_start:greedy,45,72056,23228,48828,119600,7,72;162;127;123;149;65;116;43;184;84;190;10;177;54;48;160;34;146;22;18;108;69;159;181;42;5;41;193;139;68;46;115;59;118;51;0;117;143;183;89;186;23;137;176;80;79;63;94;124;152;97;1;101;2;82;129;92;57;55;52;49;102;148;9;62;144;14;3;178;106;185;40;165;90;81;196;179;145;78;31;56;113;175;171;16;25;44;120;75;86;26;100;121;53;180;154;70;135;133;151,4271267233770645515,0.002003
steepest_intra:edges_start:greedy,46,71369,23246,48123,104650,6,46;115;59;118;51;0;117;143;183;89;186;23;137;176;80;79;63;94;124;152;97;1;101;2;82;129;92;57;55;52;49;102;148;9;62;144;14;3;178;106;185;40;165;90;81;196;179;145;78;31;56;113;175;171;16;25;44;120;75;86;26;100;121;53;180;154;70;135;133;151;162;127;123;149;65;116;43;184;112;4;190;10;177;54;48;160;34;146;22;18;108;69;159;181;42;5;41;193;139;68,5452234830930314578,0.002011
steepest_intra:edges_start:greedy,47,71514,22952,48562,134550,8,131;149;123;127;162;151;133;135;70;154;180;53;121;100;26;86;75;120;44;25;16;171;175;113;56;31;78;145;179;196;81;90;165;40;185;106;178;3;14;144;62;9;148;102;49;52;55;57;92;129;82;2;101;1;97;152;124;94;63;79;80;176;137;23;186;89;183;143;117;0;51;118;59;115;46;68;139;193;41;5;42;181;159;69;108;18;22;146;34;160;48;54;177;10;190;84;184;43;116;65,432320766674340486,0.003031
steepest_intra:edges_start:greedy,48,71512,22948,48564,134550,8,48;34;160;42;181;195;146;22;18;108;69;159;193;41;139;68;140;93;117;143;183;89;186;23;137;176;80;79;63;94;124;152;97;1;101;2;82;129;92;57;55;52;49;102;148;9;62;144;14;3;178;106;185;40;165;90;81;196;179;145;78;31;56;113;175;171;16;25;44;120;75;86;26;100;121;53;180;154;135;70;127;123;162;133;151;51;0;46;115;118;59;65;116;43;184;84;190;10;177;54,4862310350270943639,0.002007
steepest_intra:edges_start:greedy,49,71246,23052,48194,89700,5,49;178;106;52;55;57;92;129;2;152;97;1;101;26;100;121;94;63;79;80;176;133;151;51;118;59;115;46;0;137;23;186;89;183;143;117;93;140;68;139;193;41;5;42;181;159;69;108;18;22;146;34;160;48;54;177;10;190;84;184;43;116;65;131;149;162;123;127;70;135;154;180;53;86;75;120;44;25;16;171;175;113;56;31;78;145;179;196;81;90;165;40;185;138;14;144;62;9;148;102,5310747993402627241,0.002000
steepest_intra:edges_start:greedy,50,71808,23361,48447,179400,11,157;31;56;113;175;171;16;25;44;120;75;86;53;180;154;135;70;127;123;162;149;131;65;116;43;184;190;10;177;54;48;160;34;146;22;18;108;69;159;181;42;5;41;193;139;68;140;93;117;143;183;89;186;23;137;0;46;115;59;118;51;151;133;176;80;79;63;94;121;100;26;101;1;97;152;2;129;57;55;52;49;102;148;9;62;144;14;3;178;106;185;40;165;90;81;196;179;92;145;78,6750977612404905840,0.003981
steepest_intra:edges_start:greedy,51,71369,23246,48123,104650,6,51;118;59;115;46;68;139;193;41;5;42;181;159;69;108;18;22;146;34;160;48;54;177;10;190;4;112;184;43;116;65;149;123;127;162;151;133;135;70;154;180;53;121;100;26;86;75;120;44;25;16;171;175;113;56;31;78;145;179;196;81;90;165;40;185;106;178;3;14;144;62;9;148;102;49;52;55;57;92;129;82;2;101;1;97;152;124;94;63;79;80;176;137;23;186;89;183;143;117;0,2063542332561163483,0.001986
steepest_intra:edges_start:greedy,52,71246,23052,48194,104650,6,52;106;178;49;102;148;9;62;144;14;138;185;40;165;90;81;196;179;145;78;31;56;113;175;171;16;25;44;120;75;86;53;180;154;135;70;127;123;162;149;131;65;116;43;184;84;190;10;177;54;48;160;34;146;22;18;108;69;159;181;42;5;41;193;139;68;140;93;117;143;183;89;186;23;137;0;46;115;59;118;51;151;133;176;80;79;63;94;121;100;26;101;1;97;152;2;129;92;57;55,5001152843712680546,0.001998
steepest_intra:edges_start:greedy,53,71413,22843,48570,44850,2,53;158;154;70;135;180;63;79;133;151;162;127;123;149;65;116;43;184;177;54;48;160;34;146;22;18;108;69;159;181;42;5;41;193;139;68;140;93;117;143;0;46;115;59;118;51;80;176;137;23;183;89;186;114;15;9;62;144;14;138;185;40;165;90;81;196;179;145;78;31;56;113;175;171;16;25;44;120;2;129;92;57;55;52;106;178;49;102;148;124;94;152;97;1;101;75;86;26;100;121,506796298803686120,0.001029
steepest_intra:edges_start:greedy,54,71512,22948,48564,134550,8,54;48;34;160;42;181;195;146;22;18;108;69;159;193;41;139;68;140;93;117;143;183;89;186;23;137;176;80;79;63;94;124;152;97;1;101;2;82;129;92;57;55;52;49;102;148;9;62;144;14;3;178;106;185;40;165;90;81;196;179;145;78;31;56;113;175;171;16;25;44;120;75;86;26;100;121;53;180;154;135;70;127;123;162;133;151;51;0;46;115;118;59;65;116;43;184;84;190;10;177,1628126704125180561,0.003000
steepest_intra:edges_start:greedy,55,71246,23052,48194,104650,6,55;52;106;178;49;102;148;9;62;144;14;138;185;40;165;90;81;196;179;145;78;31;56;113;175;171;16;25;44;120;75;86;53;180;154;135;70;127;123;162;149;131;65;116;43;184;84;190;10;177;54;48;160;34;146;22;18;108;69;159;181;42;5;41;193;139;68;140;93;117;143;183;89;186;23;137;0;46;115;59;118;51;151;133;176;80;79;63;94;121;100;26;101;1;97;152;2;129;92;57,7274692666331744402,0.001998
steepest_intra:edges_start:greedy,56,71579,23307,48272,119600,7,56;31;78;145;92;179;196;81;90;165;40;185;106;178;3;14;144;62;9;148;102;49;52;55;57;129;2;152;97;1;101;26;100;121;94;63;79;80;176;133;151;51;118;59;115;46;0;137;23;186;89;183;143;117;93;140;68;139;193;41;5;42;181;159;69;108;18;22;146;34;160;48;54;177;10;190;84;184;43;116;65;131;149;162;123;127;70;135;154;180;53;86;75;120;44;25;16;171;175;113,55341452667510160,0.003028
steepest_intra:edges_start:greedy,57,71382,23110,48272,104650,6,57;55;52;49;102;148;9;62;144;14;3;178;106;185;40;165;90;81;196;179;145;78;31;56;113;175;171;16;25;44;120;75;86;53;180;154;135;70;127;123;162;149;131;65;116;43;184;84;190;10;177;54;48;160;34;146;22;18;108;69;159;181;42;5;41;193;139;68;140;93;117;143;183;89;186;23;137;0;46;115;59;118;51;151;133;176;80;79;63;94;121;100;26;101;1;97;152;2;129;92,7677205994927049451,0.002999
steepest_intra:edges_start:greedy,58,72221,23934,48287,89700,5,58;95;27;90;81;196;157;31;56;113;175;171;16;25;44;120;75;86;101;1;97;26;100;53;180;154;135;70;127;123;162;149;65;116;43;184;177;54;48;160;34;146;22;18;108;69;159;181;42;5;41;193;139;68;140;93;117;143;183;89;23;137;0;46;115;59;118;51;151;133;176;80;79;63;94;152;2;129;57;92;78;145;179;40;165;185;55;52;106;178;14;49;102;148;9;62;144;21;7;164,6742784312235201287,0.002000
steepest_intra:edges_start:greedy,59,71369,23246,48123,104650,6,59;115;46;68;139;193;41;5;42;181;159;69;108;18;22;146;34;160;48;54;177;10;190;4;112;184;43;116;65;149;123;127;162;151;133;135;70;154;180;53;121;100;26;86;75;120;44;25;16;171;175;113;56;31;78;145;179;196;81;90;165;40;185;106;178;3;14;144;62;9;148;102;49;52;55;57;92;129;82;2;101;1;97;152;124;94;63;79;80;176;137;23;186;89;183;143;117;0;51;118,3045390084792206026,0.001986
steepest_intra:edges_start:greedy,60,71369,23246,48123,149500,9,68;46;115;59;118;51;0;117;143;183;89;186;23;137;176;80;79;63;94;124;152;97;1;101;2;82;129;92;57;55;52;49;102;148;9;62;144;14;3;178;106;185;40;165;90;81;196;179;145;78;31;56;113;175;171;16;25;44;120;75;86;26;100;121;53;180;154;70;135;133;151;162;127;123;149;65;116;43;184;112;4;190;10;177;54;48;160;34;146;22;18;108;69;159;181;42;5;41;193;139,6618175245504101962,0.004000
steepest_intra:edges_start:greedy,61,71325,23171,48154,104650,6,15;144;14;138;185;40;165;90;81;196;179;145;78;31;56;113;175;171;16;25;44;120;75;86;53;180;154;135;70;127;123;162;149;131;65;116;43;184;190;10;177;54;48;160;34;146;22;18;108;69;159;181;42;5;41;193;139;68;140;93;117;143;183;89;186;23;137;0;46;115;59;118;51;151;133;176;80;79;63;94;121;100;26;101;1;97;152;2;129;92;57;55;52;106;178;49;102;62;9;148,3032728982971650839,0.002000
steepest_intra:edges_start:greedy,62,71246,23052,48194,89700,5,62;144;14;138;185;40;165;90;81;196;179;145;78;31;56;113;175;171;16;25;44;120;75;86;53;180;154;135;70;127;123;162;149;131;65;116;43;184;84;190;10;177;54;48;160;34;146;22;18;108;69;159;181;42;5;41;193;139;68;140;93;117;143;183;89;186;23;137;0;46;115;59;118;51;151;133;176;80;79;63;94;121;100;26;101;1;97;152;2;129;92;57;55;52;106;178;49;102;148;9,7119763128613395374,0.002000
steepest_intra:edges_start:greedy,63,71413,22843,48570,44850,2,63;180;135;70;154;158;53;121;100;26;86;75;101;1;97;152;94;124;148;102;49;178;106;52;55;57;92;129;2;120;44;25;16;171;175;113;56;31;78;145;179;196;81;90;165;40;185;138;14;144;62;9;15;114;186;89;183;23;137;176;80;51;118;59;115;46;0;143;117;93;140;68;139;193;41;5;42;181;159;69;108;18;22;146;34;160;48;54;177;184;43;116;65;149;123;127;162;151;133;79,1922382342510725871,0.001000
steepest_intra:edges_start:greedy,64,72036,22517,49519,44850,2,64;114;186;89;183;23;137;176;80;51;118;59;115;46;0;143;117;93;140;68;139;193;41;5;42;181;159;69;108;18;22;146;34;160;48;54;177;184;43;116;65;149;123;162;151;133;79;63;180;135;70;154;158;53;121;100;26;86;75;101;1;97;152;94;124;148;9;62;102;49;178;106;52;55;57;92;129;2;120;44;25;16;171;175;113;56;31;78;145;179;196;81;90;165;40;185;138;14;144;15,1814123911185891910,0.001000
steepest_intra:edges_start:greedy,65,71369,23246,48123,104650,6,65;149;123;127;162;151;133;135;70;154;180;53;121;100;26;86;75;120;44;25;16;171;175;113;56;31;78;145;179;196;81;90;165;40;185;106;178;3;14;144;62;9;148;102;49;52;55;57;92;129;82;2;101;1;97;152;124;94;63;79;80;176;137;23;186;89;183;143;117;0;51;118;59;115;46;68;139;193;41;5;42;181;159;69;108;18;22;146;34;160;48;54;177;10;190;4;112;184;43;116,2743416950922494847,0.001998
steepest_intra:edges_start:greedy,66,72214,23724,48490,104650,6,23;51;118;59;115;46;0;89;183;143;117;93;140;68;139;193;41;5;42;181;159;69;108;18;22;146;34;160;48;54;177;10;190;84;184;43;116;65;149;123;127;162;151;133;135;70;154;180;53;121;100;26;86;75;120;44;25;16;171;175;113;56;31;78;145;179;196;81;90;165;40;185;106;178;3;14;144;62;9;148;102;49;52;55;57;92;129;82;2;101;1;97;152;124;94;63;79;80;176;137,2038712986519328084,0.002014
steepest_intra:edges_start:greedy,67,71952,22784,49168,119600,7,36;108;69;18;22;146;159;193;41;5;42;181;34;160;48;54;177;10;190;84;184;43;116;65;149;123;127;162;151;133;135;70;154;180;53;121;100;26;86;75;120;44;25;16;171;175;113;56;31;78;145;179;196;81;90;165;40;185;106;178;3;14;144;62;9;148;102;49;52;55;57;92;129;82;2;101;1;97;152;124;94;63;79;80;176;137;51;118;59;115;139;68;46;0;89;183;143;117;93;140,5319179408581735366,0.003001
steepest_intra:edges_start:greedy,68,71369,23246,48123,104650,6,68;46;115;59;118;51;0;117;143;183;89;186;23;137;176;80;79;63;94;124;152;97;1;101;2;82;129;92;57;55;52;49;102;148;9;62;144;14;3;178;106;185;40;165;90;81;196;179;145;78;31;56;113;175;171;16;25;44;120;75;86;26;100;121;53;180;154;70;135;133;151;162;127;123;149;65;116;43;184;112;4;190;10;177;54;48;160;34;146;22;18;108;69;159;181;42;5;41;193;139,5650205885991430407,0.003006
steepest_intra:edges_start:greedy,69,71643,22792,48851,104650,6,69;108;18;199;22;146;159;193;41;5;42;181;34;160;48;54;177;10;190;84;184;43;116;65;149;123;127;162;151;133;135;70;154;180;53;121;100;26;86;75;120;44;25;16;171;175;113;56;31;78;145;179;196;81;90;165;40;185;106;178;3;14;144;62;9;148;102;49;52;55;57;92;129;82;2;101;1;97;152;124;94;63;79;80;176;137;23;186;89;183;143;117;0;51;118;59;115;46;68;139,4101973603328025561,0.003001
steepest_intra:edges_start:greedy,70,71413,22843,48570,44850,2,70;154;158;53;121;100;26;86;75;101;1;97;152;94;124;148;102;49;178;106;52;55;57;92;129;2;120;44;25;16;171;175;113;56;31;78;145;179;196;81;90;165;40;185;138;14;144;62;9;15;114;186;89;183;23;137;176;80;51;118;59;115;46;0;143;117;93;140;68;139;193;41;5;42;181;159;69;108;18;22;146;34;160;48;54;177;184;43;116;65;149;123;127;162;151;133;79;63;180;135,1723040149878932593,0.001000
steepest_intra:edges_start:greedy,71,71912,23384,48528,59800,3,58;164;7;95;39;165;138;14;144;62;9;148;102;49;178;106;52;55;57;92;129;2;152;94;63;79;80;176;133;151;51;118;59;115;46;0;137;23;89;183;143;117;93;140;68;139;193;41;5;42;181;159;69;108;18;22;146;34;160;48;54;177;184;43;116;65;149;162;123;127;70;135;154;180;53;100;26;97;1;101;86;75;120;44;25;16;171;175;113;56;31;78;145;179;196;81;185;40;90;27,4458869983218422037,0.002001
steepest_intra:edges_start:greedy,72,71787,22917,48870,119600,7,109;51;0;117;143;183;89;186;23;137;176;80;79;63;94;124;152;97;1;101;2;82;129;92;57;55;52;49;102;148;9;62;144;14;3;178;106;185;40;165;90;81;196;179;145;78;31;56;113;175;171;16;25;44;120;75;86;26;100;121;53;180;154;70;135;133;151;162;127;123;149;65;116;43;184;84;190;10;177;54;48;160;34;146;22;18;108;69;159;181;42;5;41;193;139;68;46;115;59;118,4002581799290772862,0.003011
steepest_intra:edges_start:greedy,73,71763,23518,48245,119600,7,114;15;148;9;62;102;49;178;106;52;55;57;92;129;2;152;97;1;101;26;100;121;94;63;79;80;176;133;151;51;118;59;115;46;0;137;23;186;89;183;143;117;93;140;68;139;193;41;5;42;181;159;69;108;18;22;146;34;160;48;54;177;10;184;43;116;65;131;149;162;123;127;70;135;154;180;53;86;75;120;44;25;16;171;175;113;56;31;78;145;179;196;81;90;165;40;185;138;14;144,208763389345605597,0.003031
steepest_intra:edges_start:greedy,74,71540,22899,48641,104650,6,121;53;154;70;135;180;63;79;133;151;162;127;123;149;65;116;43;184;177;54;48;160;34;146;22;18;108;69;159;181;42;5;41;193;139;68;140;93;117;143;0;46;115;59;118;51;80;176;137;23;183;89;186;114;15;9;62;144;14;138;185;40;165;90;81;196;179;145;78;31;56;113;175;171;16;25;44;120;2;129;92;57;55;52;106;178;49;102;148;124;94;189;152;97;1;101;75;86;26;100,925086300927371356,0.003002
steepest_intra:edges_start:greedy,75,71569,23095,48474,149500,9,75;120;44;25;16;171;175;113;56;31;78;145;179;196;81;90;165;40;185;106;178;3;14;144;62;9;148;102;49;52;55;57;92;129;82;2;152;97;1;101;26;100;121;94;63;79;80;176;133;151;51;118;59;115;46;0;137;23;186;89;183;143;117;93;140;68;139;193;41;5;42;181;159;69;108;18;22;146;34;160;48;54;177;10;190;184;43;116;65;131;149;162;123;127;70;135;154;180;53;86,5906055478955049365,0.004003
steepest_intra:edges_start:greedy,76,71769,22943,48826,104650,6,153;137;176;80;51;118;59;115;46;68;139;193;41;5;42;181;159;69;108;18;22;146;34;160;48;54;177;10;184;43;116;65;149;123;127;162;151;133;79;63;180;135;70;154;158;53;121;100;26;86;75;101;1;97;152;94;124;148;102;49;178;106;52;55;57;92;129;2;120;44;25;16;171;175;113;56;31;78;145;179;196;81;90;165;40;185;138;14;144;62;9;15;114;186;23;89;183;143;117;0,6751258947849047628,0.002998
steepest_intra:edges_start:greedy,77,71601,23183,48418,119600,7,149;59;118;115;46;0;51;151;133;162;123;127;70;135;154;180;53;121;100;26;86;75;120;44;25;16;171;175;113;56;31;78;145;179;196;81;90;165;40;185;106;178;3;14;144;62;9;148;102;49;52;55;57;92;129;82;2;101;1;97;152;124;94;63;79;80;176;137;23;186;89;183;143;117;93;140;68;139;193;41;5;42;181;159;69;108;18;22;146;34;160;48;54;177;10;190;184;43;116;65,7388981476694334172,0.003001
steepest_intra:edges_start:greedy,78,71382,23110,48272,119600,7,78;31;56;113;175;171;16;25;44;120;75;86;53;180;154;135;70;127;123;162;149;131;65;116;43;184;84;190;10;177;54;48;160;34;146;22;18;108;69;159;181;42;5;41;193;139;68;140;93;117;143;183;89;186;23;137;0;46;115;59;118;51;151;133;176;80;79;63;94;121;100;26;101;1;97;152;2;129;92;57;55;52;49;102;148;9;62;144;14;3;178;106;185;40;165;90;81;196;179;145,5278539279381925469,0.002969
steepest_intra:edges_start:greedy,79,71779,22893,48886,104650,6,79;80;176;133;151;51;118;59;115;46;0;137;23;186;89;183;143;117;93;140;68;139;193;41;5;42;181;159;69;108;18;22;146;34;160;48;54;177;184;43;116;65;131;149;162;123;127;70;135;154;180;158;53;121;100;26;86;75;120;44;25;16;171;175;113;56;31;78;145;179;196;81;90;165;40;185;106;178;3;14;144;62;9;148;102;49;52;55;57;92;129;82;2;101;1;97;152;124;94;63,3181100978348203355,0.002004
steepest_intra:edges_start:greedy,80,71461,22899,48562,89700,5,80;79;63;94;124;152;97;1;101;2;82;129;92;57;55;52;49;102;148;9;62;144;14;3;178;106;185;40;165;90;81;196;179;145;78;31;56;113;175;171;16;25;44;120;75;86;26;100;121;53;180;154;135;70;127;123;162;133;151;149;131;65;116;43;184;84;190;10;177;54;48;160;34;146;22;18;108;69;159;181;42;5;41;193;139;68;46;115;59;118;51;0;117;143;183;89;186;23;137;176,4213597375872395593,0.001968
steepest_intra:edges_start:greedy,81,71470,23276,48194,74750,4,81;196;40;185;179;145;78;31;56;113;175;171;16;25;44;120;75;86;53;180;154;135;70;127;123;162;149;131;65;116;43;184;84;190;10;177;54;48;160;34;146;22;18;108;69;159;181;42;5;41;193;139;68;140;93;117;143;183;89;186;23;137;0;46;115;59;118;51;151;133;176;80;79;63;94;121;100;26;101;1;97;152;2;129;92;57;55;52;106;178;49;102;148;9;62;144;14;138;165;90,3959041850745876136,0.002978
steepest_intra:edges_start:greedy,82,71713,23239,48474,119600,7,82;2;75;86;53;180;154;135;70;127;123;162;149;131;65;116;43;184;190;10;177;54;48;160;34;146;22;18;108;69;159;181;42;5;41;193;139;68;140;93;117;143;183;89;186;23;137;0;46;115;59;118;51;151;133;176;80;79;63;94;121;100;26;101;1;97;152;129;92;57;55;52;49;102;148;9;62;144;14;3;178;106;185;40;165;90;81;196;179;145;78;31;56;113;175;171;16;25;44;120,7519631929323605876,0.003000
steepest_intra:edges_start:greedy,83,70942,22646,48296,149500,9,114;89;183;143;117;0;46;68;139;115;193;41;5;42;181;159;69;108;18;22;146;34;160;48;54;177;10;190;4;112;184;43;116;65;59;118;51;151;133;162;123;127;70;135;154;180;53;121;100;26;86;75;120;44;25;16;171;175;113;56;31;78;145;179;196;81;90;165;40;185;106;178;3;14;144;62;9;148;102;49;52;55;57;92;129;82;2;101;1;97;152;124;94;63;79;80;176;137;23;186,7973418012172362220,0.003002
steepest_intra:edges_start:greedy,84,70846,22596,48250,149500,9,84;4;112;127;123;162;151;133;135;70;154;180;53;121;100;26;86;75;120;44;25;16;171;175;113;56;31;78;145;179;196;81;90;165;40;185;106;178;3;14;144;62;9;148;102;49;52;55;57;92;129;82;2;101;1;97;152;124;94;63;79;80;176;137;23;186;89;183;143;117;0;46;68;139;115;118;51;59;65;116;43;42;5;41;193;159;69;108;18;22;146;181;34;160;48;54;177;10;184;35,3904650346658529552,0.002656
steepest_intra:edges_start:greedy,85,71927,23480,48447,134550,8,157;145;179;196;81;90;165;40;185;106;178;3;14;144;62;9;148;102;49;52;55;57;92;129;2;152;97;1;101;26;100;121;94;63;79;80;176;133;151;51;118;59;115;46;0;137;23;186;89;183;143;117;93;140;68;139;193;41;5;42;181;159;69;108;18;22;146;34;160;48;54;177;10;190;184;43;116;65;131;149;162;123;127;70;135;154;180;53;86;75;120;44;25;78;31;16;171;175;113;56,8783535651439454813,0.003003
steepest_intra:edges_start:greedy,86,71413,22843,48570,44850,2,86;75;101;1;97;152;94;124;148;102;49;178;106;52;55;57;92;129;2;120;44;25;16;171;175;113;56;31;78;145;179;196;81;90;165;40;185;138;14;144;62;9;15;114;186;89;183;23;137;176;80;51;118;59;115;46;0;143;117;93;140;68;139;193;41;5;42;181;159;69;108;18;22;146;34;160;48;54;177;184;43;116;65;149;123;127;162;151;133;79;63;180;135;70;154;158;53;121;100;26,363761931089840051,0.001008
steepest_intra:edges_start:greedy,87,72273,23061,49212,179400,11,74;2;82;129;92;57;55;52;49;102;148;9;62;144;14;3;178;106;185;40;165;90;81;196;179;145;78;31;56;113;175;171;16;25;44;120;75;86;53;180;154;135;70;127;123;162;149;131;65;116;43;184;10;177;54;48;160;34;146;22;18;108;69;159;181;42;5;41;193;139;68;140;93;117;143;183;89;186;23;137;0;46;115;59;118;51;151;133;176;80;79;63;94;121;100;26;101;1;97;152,6714967242819798905,0.004000
steepest_intra:edges_start:greedy,88,71858,23384,48474,164450,10,82;44;25;16;171;175;113;56;31;78;145;92;179;196;81;90;165;40;185;106;178;3;14;144;62;9;148;102;49;52;55;57;129;2;152;97;1;101;26;100;121;94;63;79;80;176;133;151;51;118;59;115;46;0;137;23;186;89;183;143;117;93;140;68;139;193;41;5;42;181;159;69;108;18;22;146;34;160;48;54;177;10;190;184;43;116;65;131;149;162;123;127;70;135;154;180;53;86;75;120,2059989533527150700,0.002970
steepest_intra:edges_start:greedy,89,70599,22099,48500,134550,8,89;186;23;137;176;80;79;63;94;124;152;97;1;101;2;82;129;92;57;55;52;49;102;148;9;62;144;14;3;178;106;185;40;165;90;81;196;179;145;78;31;56;113;175;171;16;25;44;120;75;86;26;100;121;53;180;154;135;70;127;123;162;133;151;51;118;59;65;116;43;184;84;190;10;177;54;48;160;34;146;22;18;108;69;159;181;42;5;41;193;139;115;46;68;140;93;117;0;143;183,5638309254910826330,0.003000
steepest_intra:edges_start:greedy,90,71301,23107,48194,89700,5,90;40;185;165;138;14;144;62;9;148;102;49;178;106;52;55;57;92;129;2;152;97;1;101;26;100;121;94;63;79;80;176;133;151;51;118;59;115;46;0;137;23;186;89;183;143;117;93;140;68;139;193;41;5;42;181;159;69;108;18;22;146;34;160;48;54;177;10;190;84;184;43;116;65;131;149;162;123;127;70;135;154;180;53;86;75;120;44;25;16;171;175;113;56;31;78;145;179;196;81,774283265980699059,0.002000
steepest_intra:edges_start:greedy,91,71706,23259,48447,119600,7,157;179;145;78;31;56;113;175;171;16;25;44;120;75;86;53;180;154;135;70;127;123;162;149;131;65;116;43;184;190;10;177;54;48;160;34;146;22;18;108;69;159;181;42;5;41;193;139;68;140;93;117;143;183;89;186;23;137;0;46;115;59;118;51;151;133;176;80;79;63;94;121;100;26;101;1;97;152;2;129;92;57;55;52;49;102;148;9;62;144;14;3;178;106;185;40;165;90;81;196,2327096935082298396,0.002574
steepest_intra:edges_start:greedy,92,71382,23110,48272,119600,7,92;129;2;152;97;1;101;26;100;121;94;63;79;80;176;133;151;51;118;59;115;46;0;137;23;186;89;183;143;117;93;140;68;139;193;41;5;42;181;159;69;108;18;22;146;34;160;48;54;177;10;190;84;184;43;116;65;131;149;162;123;127;70;135;154;180;53;86;75;120;44;25;16;171;175;113;56;31;78;145;179;196;81;90;165;40;185;106;178;3;14;144;62;9;148;102;49;52;55;57,3556214463172837652,0.003004
steepest_intra:edges_start:greedy,93,71359,23109,48250,119600,7,93;140;108;69;18;22;146;159;193;41;5;42;181;34;160;48;54;177;10;190;4;112;184;43;116;65;149;123;127;162;151;133;135;70;154;180;53;121;100;26;86;75;120;44;25;16;171;175;113;56;31;78;145;179;196;81;90;165;40;185;106;178;3;14;144;62;9;148;102;49;52;55;57;92;129;82;2;101;1;97;152;124;94;63;79;80;176;137;51;118;59;115;139;68;46;0;89;183;143;117,3161217486744882043,0.001999
steepest_intra:edges_start:greedy,94,71413,22843,48570,44850,2,94;152;97;1;101;75;86;26;100;121;53;158;154;70;135;180;63;79;133;151;162;127;123;149;65;116;43;184;177;54;48;160;34;146;22;18;108;69;159;181;42;5;41;193;139;68;140;93;117;143;0;46;115;59;118;51;80;176;137;23;183;89;186;114;15;9;62;144;14;138;185;40;165;90;81;196;179;145;78;31;56;113;175;171;16;25;44;120;2;129;92;57;55;52;106;178;49;102;148;124,7930562656806417106,0.001000
steepest_intra:edges_start:greedy,95,71912,23384,48528,59800,3,95;7;164;58;27;90;40;185;81;196;179;145;78;31;56;113;175;171;16;25;44;120;75;86;101;1;97;26;100;53;180;154;135;70;127;123;162;149;65;116;43;184;177;54;48;160;34;146;22;18;108;69;159;181;42;5;41;193;139;68;140;93;117;143;183;89;23;137;0;46;115;59;118;51;151;133;176;80;79;63;94;152;2;129;92;57;55;52;106;178;49;102;148;9;62;144;14;138;165;39,4814897714955715740,0.001000
steepest_intra:edges_start:greedy,96,71179,23056,48123,119600,7,5;43;116;65;149;123;127;162;151;133;135;70;154;180;53;121;100;26;86;75;120;44;25;16;171;175;113;56;31;78;145;179;196;81;90;165;40;185;106;178;3;14;144;62;9;148;102;49;52;55;57;92;129;82;2;101;1;97;152;124;94;63;79;80;176;137;23;186;89;183;143;117;0;51;118;59;115;46;68;139;41;193;159;69;108;18;22;146;181;34;160;48;54;177;10;190;4;112;184;42,4981376389978685056,0.003003
steepest_intra:edges_start:greedy,97,71446,23257,48189,74750,4,97;152;1;101;75;86;53;154;70;135;180;63;79;133;151;162;127;123;149;65;116;43;184;10;177;54;48;160;34;146;22;18;108;69;159;181;42;5;41;193;139;68;140;93;117;143;0;46;115;59;118;51;80;176;137;23;183;89;186;114;15;9;62;144;14;138;185;40;165;90;81;196;179;145;78;31;56;113;175;171;16;25;44;120;2;129;92;57;55;52;106;178;49;102;148;124;94;121;100;26,3323438947550420050,0.002022
steepest_intra:edges_start:greedy,98,72072,23467,48605,119600,7,119;40;185;106;178;3;14;144;62;9;148;102;49;52;55;57;129;92;179;145;78;82;2;152;94;63;79;80;176;133;151;51;118;59;115;46;0;137;23;89;183;143;117;93;140;68;139;193;41;5;42;181;159;69;108;18;22;146;34;160;48;54;177;184;43;116;65;149;162;123;127;70;135;154;180;53;100;26;97;1;101;86;75;120;44;25;16;171;175;113;56;31;157;196;81;90;27;164;39;165,5335740177969321786,0.002796
steepest_intra:edges_start:greedy,99,71530,22960,48570,74750,4,121;100;26;97;86;75;101;1;152;94;124;148;102;49;178;106;52;55;57;92;129;2;120;44;25;16;171;175;113;56;31;78;145;179;196;81;90;165;40;185;138;14;144;62;9;15;114;186;89;183;23;137;176;80;51;118;59;115;46;0;143;117;93;140;68;139;193;41;5;42;181;159;69;108;18;22;146;34;160;48;54;177;184;43;116;65;149;123;127;162;151;133;79;63;180;135;70;154;158;53,7235135967528636183,0.001000
steepest_intra:edges_start:greedy,100,71413,22843,48570,44850,2,100;26;86;75;101;1;97;152;94;124;148;102;49;178;106;52;55;57;92;129;2;120;44;25;16;171;175;113;56;31;78;145;179;196;81;90;165;40;185;138;14;144;62;9;15;114;186;89;183;23;137;176;80;51;118;59;115;46;0;143;117;93;140;68;139;193;41;5;42;181;159;69;108;18;22;146;34;160;48;54;177;184;43;116;65;149;123;127;162;151;133;79;63;180;135;70;154;158;53;121,4671205031995782392,0.000997
steepest_intra:edges_start:greedy,101,71446,23257,48189,74750,4,101;1;152;97;26;100;121;94;124;148;102;49;178;106;52;55;57;92;129;2;120;44;25;16;171;175;113;56;31;78;145;179;196;81;90;165;40;185;138;14;144;62;9;15;114;186;89;183;23;137;176;80;51;118;59;115;46;0;143;117;93;140;68;139;193;41;5;42;181;159;69;108;18;22;146;34;160;48;54;177;10;184;43;116;65;149;123;127;162;151;133;79;63;180;135;70;154;53;86;75,2117435595335136244,0.002000
steepest_intra:edges_start:greedy,102,71246,23052,48194,89700,5,102;148;9;62;144;14;138;185;40;165;90;81;196;179;145;78;31;56;113;175;171;16;25;44;120;75;86;53;180;154;135;70;127;123;162;149;131;65;116;43;184;84;190;10;177;54;48;160;34;146;22;18;108;69;159;181;42;5;41;193;139;68;140;93;117;143;183;89;186;23;137;0;46;115;59;118;51;151;133;176;80;79;63;94;121;100;26;101;1;97;152;2;129;92;57;55;52;106;178;49,5942015833632539026,0.002000
steepest_intra:edges_start:greedy,103,70906,22933,47973,104650,6,181;34;160;48;54;177;10;190;4;112;84;184;42;43;116;65;149;123;127;162;151;133;135;70;154;180;53;121;100;26;86;75;120;44;25;16;171;175;113;56;31;78;145;179;196;81;90;165;40;185;106;178;3;14;144;62;9;148;102;49;52;55;57;92;129;82;2;101;1;97;152;124;94;63;79;80;176;137;23;186;89;183;143;117;0;51;118;59;115;46;68;139;41;193;159;69;108;18;22;146,3934580811123943926,0.003039
steepest_intra:edges_start:greedy,104,71524,22866,48658,164450,10,30;54;48;34;160;42;181;195;146;22;18;108;69;159;193;41;139;68;140;93;117;143;183;89;186;23;137;176;80;79;63;94;124;152;97;1;101;2;82;129;92;57;55;52;49;102;148;9;62;144;14;3;178;106;185;40;165;90;81;196;179;145;78;31;56;113;175;171;16;25;44;120;75;86;26;100;121;53;180;154;135;70;127;123;162;133;151;51;0;46;115;118;59;65;116;43;184;190;10;177,272834882517819648,0.003974
steepest_intra:edges_start:greedy,105,71514,22952,48562,149500,9,131;149;123;127;162;151;133;135;70;154;180;53;121;100;26;86;75;120;44;25;16;171;175;113;56;31;78;145;179;196;81;90;165;40;185;106;178;3;14;144;62;9;148;102;49;52;55;57;92;129;82;2;101;1;97;152;124;94;63;79;80;176;137;23;186;89;183;143;117;0;51;118;59;115;46;68;139;193;41;5;42;181;159;69;108;18;22;146;34;160;48;54;177;10;190;84;184;43;116;65,532104427658014887,0.003005
steepest_intra:edges_start:greedy,106,71246,23052,48194,89700,5,106;178;49;102;148;9;62;144;14;138;185;40;165;90;81;196;179;145;78;31;56;113;175;171;16;25;44;120;75;86;53;180;154;135;70;127;123;162;149;131;65;116;43;184;84;190;10;177;54;48;160;34;146;22;18;108;69;159;181;42;5;41;193;139;68;140;93;117;143;183;89;186;23;137;0;46;115;59;118;51;151;133;176;80;79;63;94;121;100;26;101;1;97;152;2;129;92;57;55;52,8400667181003750362,0.003013
steepest_intra:edges_start:greedy,107,71912,23384,48528,89700,5,58;27;90;40;185;81;196;179;145;78;31;56;113;175;171;16;25;44;120;75;86;101;1;97;26;100;53;180;154;135;70;127;123;162;149;65;116;43;184;177;54;48;160;34;146;22;18;108;69;159;181;42;5;41;193;139;68;140;93;117;143;183;89;23;137;0;46;115;59;118;51;151;133;176;80;79;63;94;152;2;129;92;57;55;52;106;178;49;102;148;9;62;144;14;138;165;39;95;7;164,3293250130823029340,0.002030
steepest_intra:edges_start:greedy,108,71643,22792,48851,104650,6,108;69;139;68;46;115;59;118;51;0;117;143;183;89;186;23;137;176;80;79;63;94;124;152;97;1;101;2;82;129;92;57;55;52;49;102;148;9;62;144;14;3;178;106;185;40;165;90;81;196;179;145;78;31;56;113;175;171;16;25;44;120;75;86;26;100;121;53;180;154;70;135;133;151;162;127;123;149;65;116;43;184;84;190;10;177;54;48;160;34;181;42;5;41;193;159;146;22;199;18,7037143927541304649,0.003030
steepest_intra:edges_start:greedy,109,70815,22215,48600,179400,11,109;118;59;65;116;43;184;112;4;190;10;177;54;48;160;34;146;22;18;108;69;159;181;42;5;41;193;139;115;46;68;117;0;143;183;89;186;23;137;176;80;79;63;94;124;152;97;1;101;2;82;129;92;57;55;52;49;102;148;9;62;144;14;3;178;106;185;40;165;90;81;196;179;145;78;31;56;113;175;171;16;25;44;120;75;86;26;100;121;53;180;154;135;70;127;123;162;133;151;51,4392830759155262004,0.004029
steepest_intra:edges_start:greedy,110,71848,23049,48799,119600,7,198;68;46;115;59;118;51;0;117;143;183;89;186;23;137;176;80;79;63;94;124;152;97;1;101;2;82;129;92;57;55;52;49;102;148;9;62;144;14;3;178;106;185;40;165;90;81;196;179;145;78;31;56;113;175;171;16;25;44;120;75;86;26;100;121;53;180;154;70;135;133;151;162;127;123;149;65;116;43;184;84;190;10;177;54;48;160;34;146;22;18;108;69;159;181;42;5;41;193;139,4945531399361820710,0.002000
steepest_intra:edges_start:greedy,111,72183,23587,48596,59800,3,167;148;9;62;102;144;14;49;178;106;165;39;95;164;27;90;81;196;40;185;52;55;57;129;92;179;145;78;31;56;113;175;171;16;25;44;120;2;152;97;1;101;75;86;26;100;121;53;158;154;70;135;180;63;79;133;151;162;127;123;149;65;116;43;184;177;54;48;160;34;146;22;18;108;69;159;181;42;5;41;193;139;68;140;93;117;143;183;89;0;46;115;59;118;51;137;176;80;94;124,4986148537769537524,0.001005
steepest_intra:edges_start:greedy,112,70846,22596,48250,149500,9,112;4;84;35;184;10;177;54;48;160;34;181;146;22;18;108;69;159;193;41;5;42;43;116;65;59;51;118;115;139;68;46;0;117;143;183;89;186;23;137;176;80;79;63;94;124;152;97;1;101;2;82;129;92;57;55;52;49;102;148;9;62;144;14;3;178;106;185;40;165;90;81;196;179;145;78;31;56;113;175;171;16;25;44;120;75;86;26;100;121;53;180;154;70;135;133;151;162;123;127,3276885924241050287,0.003999
steepest_intra:edges_start:greedy,113,71579,23307,48272,119600,7,113;56;31;78;145;92;179;196;81;90;165;40;185;106;178;3;14;144;62;9;148;102;49;52;55;57;129;2;152;97;1;101;26;100;121;94;63;79;80;176;133;151;51;118;59;115;46;0;137;23;186;89;183;143;117;93;140;68;139;193;41;5;42;181;159;69;108;18;22;146;34;160;48;54;177;10;190;84;184;43;116;65;131;149;162;123;127;70;135;154;180;53;86;75;120;44;25;16;171;175,7235559098422727062,0.003004
steepest_intra:edges_start:greedy,114,71345,22775,48570,44850,2,114;186;89;183;23;137;176;80;51;118;59;115;46;0;143;117;93;140;68;139;193;41;5;42;181;159;69;108;18;22;146;34;160;48;54;177;184;43;116;65;149;123;127;162;151;133;79;63;180;135;70;154;158;53;121;100;26;86;75;101;1;97;152;94;124;148;9;62;102;49;178;106;52;55;57;92;129;2;120;44;25;16;171;175;113;56;31;78;145;179;196;81;90;165;40;185;138;14;144;15,4933506042296807796,0.001000
steepest_intra:edges_start:greedy,115,71369,23246,48123,104650,6,115;59;118;51;0;117;143;183;89;186;23;137;176;80;79;63;94;124;152;97;1;101;2;82;129;92;57;55;52;49;102;148;9;62;144;14;3;178;106;185;40;165;90;81;196;179;145;78;31;56;113;175;171;16;25;44;120;75;86;26;100;121;53;180;154;70;135;133;151;162;127;123;149;65;116;43;184;112;4;190;10;177;54;48;160;34;146;22;18;108;69;159;181;42;5;41;193;139;68;46,8186441775676219221,0.002011
steepest_intra:edges_start:greedy,116,71369,23246,48123,104650,6,116;43;184;112;4;190;10;177;54;48;160;34;146;22;18;108;69;159;181;42;5;41;193;139;68;46;115;59;118;51;0;117;143;183;89;186;23;137;176;80;79;63;94;124;152;97;1;101;2;82;129;92;57;55;52;49;102;148;9;62;144;14;3;178;106;185;40;165;90;81;196;179;145;78;31;56;113;175;171;16;25;44;120;75;86;26;100;121;53;180;154;70;135;133;151;162;127;123;149;65,5646988309216693779,0.002002
steepest_intra:edges_start:greedy,117,70571,22366,48205,119600,7,117;0;46;68;139;115;193;41;5;42;181;159;69;108;18;22;146;34;160;48;54;177;10;190;4;112;84;184;43;116;65;59;118;51;151;133;162;123;127;70;135;154;180;53;121;100;26;86;75;120;44;25;16;171;175;113;56;31;78;145;179;196;81;90;165;40;185;106;178;3;14;144;62;9;148;102;49;52;55;57;92;129;82;2;101;1;97;152;124;94;63;79;80;176;137;23;186;89;183;143,3375639581976702775,0.002003
steepest_intra:edges_start:greedy,118,71369,23246,48123,119600,7,118;51;0;117;143;183;89;186;23;137;176;80;79;63;94;124;152;97;1;101;2;82;129;92;57;55;52;49;102;148;9;62;144;14;3;178;106;185;40;165;90;81;196;179;145;78;31;56;113;175;171;16;25;44;120;75;86;26;100;121;53;180;154;70;135;133;151;162;127;123;149;65;116;43;184;112;4;190;10;177;54;48;160;34;146;22;18;108;69;159;181;42;5;41;193;139;68;46;115;59,6239117917563735228,0.002007
steepest_intra:edges_start:greedy,119,71195,22868,48327,89700,5,119;40;185;138;14;144;62;9;148;102;49;178;106;52;55;57;92;129;2;152;97;1;101;26;100;121;94;63;79;80;176;133;151;51;118;59;115;46;0;137;23;186;89;183;143;117;93;140;68;139;193;41;5;42;181;159;69;108;18;22;146;34;160;48;54;177;10;190;184;43;116;65;131;149;162;123;127;70;135;154;180;53;86;75;120;44;25;16;171;175;113;56;31;78;145;179;196;81;90;165,3889724816199919061,0.003002
steepest_intra:edges_start:greedy,120,71382,23110,48272,119600,7,120;75;86;53;180;154;135;70;127;123;162;149;131;65;116;43;184;84;190;10;177;54;48;160;34;146;22;18;108;69;159;181;42;5;41;193;139;68;140;93;117;143;183;89;186;23;137;0;46;115;59;118;51;151;133;176;80;79;63;94;121;100;26;101;1;97;152;2;129;92;57;55;52;49;102;148;9;62;144;14;3;178;106;185;40;165;90;81;196;179;145;78;31;56;113;175;171;16;25;44,308901116646846151,0.003000
steepest_intra:edges_start:greedy,121,71530,22960,48570,44850,2,121;100;26;97;86;75;101;1;152;94;124;148;102;49;178;106;52;55;57;92;129;2;120;44;25;16;171;175;113;56;31;78;145;179;196;81;90;165;40;185;138;14;144;62;9;15;114;186;89;183;23;137;176;80;51;118;59;115;46;0;143;117;93;140;68;139;193;41;5;42;181;159;69;108;18;22;146;34;160;48;54;177;184;43;116;65;149;123;127;162;151;133;79;63;180;135;70;154;158;53,3005953461361971399,0.001729
steepest_intra:edges_start:greedy,122,72025,22815,49210,104650,6,122;176;80;79;133;151;51;118;59;115;46;0;137;23;89;183;143;117;93;140;68;139;193;41;5;42;181;159;69;108;18;22;146;34;160;48;54;177;184;43;116;65;131;149;162;123;127;70;135;154;180;158;53;121;100;26;86;75;120;44;25;16;171;175;113;56;31;78;145;179;196;81;90;165;40;185;106;178;3;14;144;62;9;148;102;49;52;55;57;92;129;82;2;101;1;97;152;124;94;63,3810194199175178507,0.003005
steepest_intra:edges_start:greedy,123,71461,22899,48562,89700,5,123;162;133;151;149;131;65;116;43;184;84;190;10;177;54;48;160;34;146;22;18;108;69;159;181;42;5;41;193;139;68;46;115;59;118;51;0;117;143;183;89;186;23;137;176;80;79;63;94;124;152;97;1;101;2;82;129;92;57;55;52;49;102;148;9;62;144;14;3;178;106;185;40;165;90;81;196;179;145;78;31;56;113;175;171;16;25;44;120;75;86;26;100;121;53;180;154;135;70;127,2385477786008024635,0.002001
steepest_intra:edges_start:greedy,124,71413,22843,48570,59800,3,124;148;102;49;178;106;52;55;57;92;129;2;120;44;25;16;171;175;113;56;31;78;145;179;196;81;90;165;40;185;138;14;144;62;9;15;114;186;89;183;23;137;176;80;51;118;59;115;46;0;143;117;93;140;68;139;193;41;5;42;181;159;69;108;18;22;146;34;160;48;54;177;184;43;116;65;149;123;127;162;151;133;79;63;180;135;70;154;158;53;121;100;26;86;75;101;1;97;152;94,3630766753175368474,0.002001
steepest_intra:edges_start:greedy,125,72614,23133,49481,119600,7,74;2;82;129;92;57;179;145;78;31;56;113;175;171;16;25;44;120;75;86;53;154;70;135;180;63;79;133;151;162;123;149;65;116;43;184;177;54;48;160;34;146;22;18;108;69;159;181;42;5;41;193;139;68;140;93;117;143;0;46;115;59;118;51;80;176;137;23;183;89;186;114;15;9;62;144;14;138;165;90;81;196;40;185;55;52;106;178;49;102;148;124;94;121;100;26;101;1;97;152,7392841362526095034,0.003000
steepest_intra:edges_start:greedy,126,71061,22454,48607,179400,11,149;123;162;151;133;135;70;154;180;53;121;100;26;86;75;120;44;25;16;171;175;113;56;31;78;145;179;196;81;90;165;40;185;106;178;3;14;144;62;9;148;102;49;52;55;57;92;129;82;2;101;1;97;152;124;94;63;79;80;176;137;23;186;89;183;143;117;0;46;68;139;115;118;51;59;65;116;43;42;5;41;193;159;69;108;18;22;146;181;34;160;48;54;177;184;35;84;4;112;131,3923562696133144197,0.003004
steepest_intra:edges_start:greedy,127,71637,23132,48505,104650,6,127;70;135;154;180;53;121;100;26;86;75;120;44;25;16;171;175;113;56;31;78;145;179;196;81;90;165;40;185;106;178;3;14;144;62;9;148;102;49;52;55;57;92;129;82;2;101;1;97;152;124;94;63;79;80;176;133;151;51;118;59;115;46;0;137;23;186;89;183;143;117;93;140;68;139;193;41;5;42;181;159;69;108;18;22;146;34;160;48;54;177;10;184;43;116;65;131;149;162;123,9063417467283367083,0.002011
steepest_intra:edges_start:greedy,128,71295,22994,48301,149500,9,3;49;14;144;102;62;9;148;167;52;55;57;92;129;2;152;97;1;101;26;100;121;94;63;79;80;176;133;151;51;118;59;115;46;0;137;23;186;89;183;143;117;93;140;68;139;193;41;5;42;181;159;69;108;18;22;146;34;160;48;54;177;10;190;184;43;116;65;131;149;162;123;127;70;135;154;180;53;86;75;120;44;25;16;171;175;113;56;31;78;145;179;196;81;90;165;40;185;106;178,4003599380633622460,0.004000
steepest_intra:edges_start:greedy,129,71382,23110,48272,119600,7,129;92;57;55;52;49;102;148;9;62;144;14;3;178;106;185;40;165;90;81;196;179;145;78;31;56;113;175;171;16;25;44;120;75;86;53;180;154;135;70;127;123;162;149;131;65;116;43;184;84;190;10;177;54;48;160;34;146;22;18;108;69;159;181;42;5;41;193;139;68;140;93;117;143;183;89;186;23;137;0;46;115;59;118;51;151;133;176;80;79;63;94;121;100;26;101;1;97;152;2,7464079361427059266,0.002007
steepest_intra:edges_start:greedy,130,71413,22843,48570,59800,3,124;148;102;49;178;106;52;55;57;92;129;2;120;44;25;16;171;175;113;56;31;78;145;179;196;81;90;165;40;185;138;14;144;62;9;15;114;186;89;183;23;137;176;80;51;118;59;115;46;0;143;117;93;140;68;139;193;41;5;42;181;159;69;108;18;22;146;34;160;48;54;177;184;43;116;65;149;123;127;162;151;133;79;63;180;135;70;154;158;53;121;100;26;86;75;101;1;97;152;94,7671547427817166121,0.001001
steepest_intra:edges_start:greedy,131,71514,22952,48562,89700,5,131;149;123;127;162;151;133;135;70;154;180;53;121;100;26;86;75;120;44;25;16;171;175;113;56;31;78;145;179;196;81;90;165;40;185;106;178;3;14;144;62;9;148;102;49;52;55;57;92;129;82;2;101;1;97;152;124;94;63;79;80;176;137;23;186;89;183;143;117;0;51;118;59;115;46;68;139;193;41;5;42;181;159;69;108;18;22;146;34;160;48;54;177;10;190;84;184;43;116;65,6449295319356303605,0.001985
steepest_intra:edges_start:greedy,132,71711,23674,48037,104650,6,21;14;138;185;40;165;90;81;196;179;145;78;31;56;113;175;171;16;25;44;120;75;86;53;180;154;135;70;127;123;162;149;131;65;116;43;184;190;10;177;54;48;160;34;146;22;18;108;69;159;181;42;5;41;193;139;68;140;93;117;143;183;89;186;23;137;0;46;115;59;118;51;151;133;176;80;79;63;94;121;100;26;101;1;97;152;2;129;92;57;55;52;106;178;49;102;148;9;62;144,3301346591965856704,0.001998
steepest_intra:edges_start:greedy,133,71637,23132,48505,104650,6,133;151;51;118;59;115;46;0;137;23;186;89;183;143;117;93;140;68;139;193;41;5;42;181;159;69;108;18;22;146;34;160;48;54;177;10;184;43;116;65;131;149;162;123;127;70;135;154;180;53;121;100;26;86;75;120;44;25;16;171;175;113;56;31;78;145;179;196;81;90;165;40;185;106;178;3;14;144;62;9;148;102;49;52;55;57;92;129;82;2;101;1;97;152;124;94;63;79;80;176,6228441352858055913,0.001998
steepest_intra:edges_start:greedy,134,71702,22637,49065,164450,10,199;18;108;69;139;68;46;115;59;118;51;0;117;143;183;89;186;23;137;176;80;79;63;94;124;152;97;1;101;2;82;129;92;57;55;52;49;102;148;9;62;144;14;3;178;106;185;40;165;90;81;196;179;145;78;31;56;113;175;171;16;25;44;120;75;86;26;100;121;53;180;154;70;135;133;151;162;127;123;149;65;116;43;184;190;10;177;54;48;160;34;181;42;5;41;193;159;195;146;22,6670681133576123691,0.003808
steepest_intra:edges_start:greedy,135,71413,22843,48570,44850,2,135;70;154;158;53;121;100;26;86;75;101;1;97;152;94;124;148;102;49;178;106;52;55;57;92;129;2;120;44;25;16;171;175;113;56;31;78;145;179;196;81;90;165;40;185;138;14;144;62;9;15;114;186;89;183;23;137;176;80;51;118;59;115;46;0;143;117;93;140;68;139;193;41;5;42;181;159;69;108;18;22;146;34;160;48;54;177;184;43;116;65;149;123;127;162;151;133;79;63;180,6661542294183705429,0.001002
steepest_intra:edges_start:greedy,136,71667,22968,48699,164450,10,158;180;154;70;135;133;151;162;127;123;149;65;116;43;184;84;190;10;177;54;48;160;34;146;22;18;108;69;159;181;42;5;41;193;139;68;46;115;59;118;51;0;117;143;183;89;186;23;137;176;80;79;63;94;124;152;97;1;101;2;82;129;92;57;55;52;49;102;148;9;62;144;14;3;178;106;185;40;165;90;81;196;179;145;78;31;56;113;175;171;16;25;44;120;75;86;26;100;121;53,7503401825535726555,0.003011
steepest_intra:edges_start:greedy,137,71413,22843,48570,44850,2,137;23;183;89;186;114;15;9;62;144;14;138;185;40;165;90;81;196;179;145;78;31;56;113;175;171;16;25;44;120;2;129;92;57;55;52;106;178;49;102;148;124;94;152;97;1;101;75;86;26;100;121;53;158;154;70;135;180;63;79;133;151;162;127;123;149;65;116;43;184;177;54;48;160;34;146;22;18;108;69;159;181;42;5;41;193;139;68;140;93;117;143;0;46;115;59;118;51;80;176,1775279060835565821,0.001000
steepest_intra:edges_start:greedy,138,71246,23052,48194,89700,5,138;14;144;62;9;148;102;49;178;106;52;55;57;92;129;2;152;97;1;101;26;100;121;94;63;79;80;176;133;151;51;118;59;115;46;0;137;23;186;89;183;143;117;93;140;68;139;193;41;5;42;181;159;69;108;18;22;146;34;160;48;54;177;10;190;84;184;43;116;65;131;149;162;123;127;70;135;154;180;53;86;75;120;44;25;16;171;175;113;56;31;78;145;179;196;81;90;165;40;185,4690582533345475693,0.001999
steepest_intra:edges_start:greedy,139,71369,23246,48123,104650,6,139;68;46;115;59;118;51;0;117;143;183;89;186;23;137;176;80;79;63;94;124;152;97;1;101;2;82;129;92;57;55;52;49;102;148;9;62;144;14;3;178;106;185;40;165;90;81;196;179;145;78;31;56;113;175;171;16;25;44;120;75;86;26;100;121;53;180;154;70;135;133;151;162;127;123;149;65;116;43;184;112;4;190;10;177;54;48;160;34;146;22;18;108;69;159;181;42;5;41;193,3222139923380985583,0.002002
steepest_intra:edges_start:greedy,140,71359,23109,48250,119600,7,140;108;69;18;22;146;159;193;41;5;42;181;34;160;48;54;177;10;190;4;112;184;43;116;65;149;123;127;162;151;133;135;70;154;180;53;121;100;26;86;75;120;44;25;16;171;175;113;56;31;78;145;179;196;81;90;165;40;185;106;178;3;14;144;62;9;148;102;49;52;55;57;92;129;82;2;101;1;97;152;124;94;63;79;80;176;137;51;118;59;115;139;68;46;0;89;183;143;117;93,5161826182751664706,0.003010
steepest_intra:edges_start:greedy,141,70792,22201,48591,149500,9,114;89;183;143;0;117;93;140;68;46;115;139;193;41;5;42;181;159;69;108;18;22;146;34;160;48;54;177;10;190;184;43;116;65;59;118;51;151;133;162;123;127;70;135;154;180;53;121;100;26;86;75;120;44;25;16;171;175;113;56;31;78;145;179;196;81;90;165;40;185;106;178;3;14;144;62;9;148;102;49;52;55;57;92;129;82;2;101;1;97;152;124;94;63;79;80;176;137;23;186,8109989617672160122,0.002999
steepest_intra:edges_start:greedy,142,71848,23049,48799,119600,7,198;139;193;41;5;42;181;159;69;108;18;22;146;34;160;48;54;177;10;190;84;184;43;116;65;149;123;127;162;151;133;135;70;154;180;53;121;100;26;86;75;120;44;25;16;171;175;113;56;31;78;145;179;196;81;90;165;40;185;106;178;3;14;144;62;9;148;102;49;52;55;57;92;129;82;2;101;1;97;152;124;94;63;79;80;176;137;23;186;89;183;143;117;0;51;118;59;115;46;68,2172728576176672536,0.002000
steepest_intra:edges_start:greedy,143,70571,22366,48205,119600,7,143;117;0;46;68;139;115;193;41;5;42;181;159;69;108;18;22;146;34;160;48;54;177;10;190;4;112;84;184;43;116;65;59;118;51;151;133;162;123;127;70;135;154;180;53;121;100;26;86;75;120;44;25;16;171;175;113;56;31;78;145;179;196;81;90;165;40;185;106;178;3;14;144;62;9;148;102;49;52;55;57;92;129;82;2;101;1;97;152;124;94;63;79;80;176;137;23;186;89;183,5377784614487389405,0.002000
steepest_intra:edges_start:greedy,144,71246,23052,48194,89700,5,144;14;138;185;40;165;90;81;196;179;145;78;31;56;113;175;171;16;25;44;120;75;86;53;180;154;135;70;127;123;162;149;131;65;116;43;184;84;190;10;177;54;48;160;34;146;22;18;108;69;159;181;42;5;41;193;139;68;140;93;117;143;183;89;186;23;137;0;46;115;59;118;51;151;133;176;80;79;63;94;121;100;26;101;1;97;152;2;129;92;57;55;52;106;178;49;102;148;9;62,6945137591380557447,0.002000
steepest_intra:edges_start:greedy,145,71382,23110,48272,119600,7,145;179;196;81;90;165;40;185;106;178;3;14;144;62;9;148;102;49;52;55;57;92;129;2;152;97;1;101;26;100;121;94;63;79;80;176;133;151;51;118;59;115;46;0;137;23;186;89;183;143;117;93;140;68;139;193;41;5;42;181;159;69;108;18;22;146;34;160;48;54;177;10;190;84;184;43;116;65;131;149;162;123;127;70;135;154;180;53;86;75;120;44;25;16;171;175;113;56;31;78,5040333225722361919,0.002003
steepest_intra:edges_start:greedy,146,70906,22933,47973,89700,5,146;181;34;160;48;54;177;10;190;4;112;84;184;42;43;116;65;149;123;127;162;151;133;135;70;154;180;53;121;100;26;86;75;120;44;25;16;171;175;113;56;31;78;145;179;196;81;90;165;40;185;106;178;3;14;144;62;9;148;102;49;52;55;57;92;129;82;2;101;1;97;152;124;94;63;79;80;176;137;23;186;89;183;143;117;0;51;118;59;115;46;68;139;41;193;159;69;108;18;22,9101559703321870948,0.002000
steepest_intra:edges_start:greedy,147,71524,22866,48658,164450,10,30;177;10;190;184;43;116;65;59;118;115;46;0;51;151;133;162;123;127;70;135;154;180;53;121;100;26;86;75;120;44;25;16;171;175;113;56;31;78;145;179;196;81;90;165;40;185;106;178;3;14;144;62;9;148;102;49;52;55;57;92;129;82;2;101;1;97;152;124;94;63;79;80;176;137;23;186;89;183;143;117;93;140;68;139;41;193;159;69;108;18;22;146;195;181;42;160;34;48;54,1602456726356580563,0.004000
steepest_intra:edges_start:greedy,148,71246,23052,48194,89700,5,148;102;49;178;106;52;55;57;92;129;2;152;97;1;101;26;100;121;94;63;79;80;176;133;151;51;118;59;115;46;0;137;23;186;89;183;143;117;93;140;68;139;193;41;5;42;181;159;69;108;18;22;146;34;160;48;54;177;10;190;84;184;43;116;65;131;149;162;123;127;70;135;154;180;53;86;75;120;44;25;16;171;175;113;56;31;78;145;179;196;81;90;165;40;185;138;14;144;62;9,3977652180762295308,0.002000
steepest_intra:edges_start:greedy,149,71369,23246,48123,104650,6,149;123;127;162;151;133;135;70;154;180;53;121;100;26;86;75;120;44;25;16;171;175;113;56;31;78;145;179;196;81;90;165;40;185;106;178;3;14;144;62;9;148;102;49;52;55;57;92;129;82;2;101;1;97;152;124;94;63;79;80;176;137;23;186;89;183;143;117;0;51;118;59;115;46;68;139;193;41;5;42;181;159;69;108;18;22;146;34;160;48;54;177;10;190;4;112;184;43;116;65,4109579277120558751,0.002011
steepest_intra:edges_start:greedy,150,72250,23212,49038,134550,8,121;53;154;70;135;180;63;79;133;151;162;123;149;65;116;43;184;177;54;48;160;34;146;22;18;108;69;159;181;42;5;41;193;139;68;140;93;117;143;0;46;115;59;118;51;80;176;137;23;183;89;186;114;15;9;62;144;14;138;165;90;81;196;40;185;55;52;106;178;49;102;148;124;94;189;100;26;97;1;152;2;82;129;92;57;179;145;78;31;56;113;175;171;16;25;44;120;75;101;86,6743160206785589970,0.003054
steepest_intra:edges_start:greedy,151,71461,22899,48562,89700,5,151;133;162;123;127;70;135;154;180;53;121;100;26;86;75;120;44;25;16;171;175;113;56;31;78;145;179;196;81;90;165;40;185;106;178;3;14;144;62;9;148;102;49;52;55;57;92;129;82;2;101;1;97;152;124;94;63;79;80;176;137;23;186;89;183;143;117;0;51;118;59;115;46;68;139;193;41;5;42;181;159;69;108;18;22;146;34;160;48;54;177;10;190;84;184;43;116;65;131;149,4191048845186519521,0.001762
steepest_intra:edges_start:greedy,152,71446,23257,48189,74750,4,152;1;101;75;86;53;154;70;135;180;63;79;133;151;162;127;123;149;65;116;43;184;10;177;54;48;160;34;146;22;18;108;69;159;181;42;5;41;193;139;68;140;93;117;143;0;46;115;59;118;51;80;176;137;23;183;89;186;114;15;9;62;144;14;138;185;40;165;90;81;196;179;145;78;31;56;113;175;171;16;25;44;120;2;129;92;57;55;52;106;178;49;102;148;124;94;121;100;26;97,804208558457417534,0.002002
steepest_intra:edges_start:greedy,153,70510,22376,48134,194350,12,93;117;0;143;183;89;186;23;137;176;80;79;63;94;124;152;97;1;101;2;82;129;92;57;55;52;49;102;148;9;62;144;14;3;178;106;185;40;165;90;81;196;179;145;78;31;56;113;175;171;16;25;44;120;75;86;26;100;121;53;180;154;135;70;127;123;162;133;151;51;118;59;65;116;43;184;112;4;190;10;177;54;48;160;34;146;22;18;108;69;159;181;42;5;41;193;139;115;46;68,443745112131388431,0.005011
steepest_intra:edges_start:greedy,154,71413,22843,48570,44850,2,154;158;53;121;100;26;86;75;101;1;97;152;94;124;148;102;49;178;106;52;55;57;92;129;2;120;44;25;16;171;175;113;56;31;78;145;179;196;81;90;165;40;185;138;14;144;62;9;15;114;186;89;183;23;137;176;80;51;118;59;115;46;0;143;117;93;140;68;139;193;41;5;42;181;159;69;108;18;22;146;34;160;48;54;177;184;43;116;65;149;123;127;162;151;133;79;63;180;135;70,1008140310697330352,0.002004
steepest_intra:edges_start:greedy,155,71711,23674,48037,104650,6,21;14;138;185;40;165;90;81;196;179;145;78;31;56;113;175;171;16;25;44;120;75;86;53;180;154;135;70;127;123;162;149;131;65;116;43;184;190;10;177;54;48;160;34;146;22;18;108;69;159;181;42;5;41;193;139;68;140;93;117;143;183;89;186;23;137;0;46;115;59;118;51;151;133;176;80;79;63;94;121;100;26;101;1;97;152;2;129;92;57;55;52;106;178;49;102;148;9;62;144,8267238234228855759,0.002229
steepest_intra:edges_start:greedy,156,71061,22454,48607,179400,11,149;123;162;151;133;135;70;154;180;53;121;100;26;86;75;120;44;25;16;171;175;113;56;31;78;145;179;196;81;90;165;40;185;106;178;3;14;144;62;9;148;102;49;52;55;57;92;129;82;2;101;1;97;152;124;94;63;79;80;176;137;23;186;89;183;143;117;0;46;68;139;115;118;51;59;65;116;43;42;5;41;193;159;69;108;18;22;146;181;34;160;48;54;177;184;35;84;4;112;131,4250245386797064830,0.004002
steepest_intra:edges_start:greedy,157,71686,23239,48447,104650,6,157;196;81;90;165;40;185;106;178;3;14;144;62;9;148;102;49;52;55;179;145;78;92;57;129;2;152;97;1;101;26;100;121;94;63;79;80;176;133;151;51;118;59;115;46;0;137;23;186;89;183;143;117;93;140;68;139;193;41;5;42;181;159;69;108;18;22;146;34;160;48;54;177;10;190;184;43;116;65;131;149;162;123;127;70;135;154;180;53;86;75;120;44;25;16;171;175;113;56;31,4179563085729838903,0.002032
steepest_intra:edges_start:greedy,158,71413,22843,48570,44850,2,158;154;70;135;180;63;79;133;151;162;127;123;149;65;116;43;184;177;54;48;160;34;146;22;18;108;69;159;181;42;5;41;193;139;68;140;93;117;143;0;46;115;59;118;51;80;176;137;23;183;89;186;114;15;9;62;144;14;138;185;40;165;90;81;196;179;145;78;31;56;113;175;171;16;25;44;120;2;129;92;57;55;52;106;178;49;102;148;124;94;152;97;1;101;75;86;26;100;121;53,2047229119307330004,0.000997
steepest_intra:edges_start:greedy,159,71359,23109,48250,119600,7,159;146;22;18;69;108;140;93;117;143;183;89;0;46;68;139;115;59;118;51;137;176;80;79;63;94;124;152;97;1;101;2;82;129;92;57;55;52;49;102;148;9;62;144;14;3;178;106;185;40;165;90;81;196;179;145;78;31;56;113;175;171;16;25;44;120;75;86;26;100;121;53;180;154;70;135;133;151;162;127;123;149;65;116;43;184;112;4;190;10;177;54;48;160;34;181;42;5;41;193,779864826295920083,0.002692
steepest_intra:edges_start:greedy,160,70906,22933,47973,89700,5,160;48;54;177;10;190;4;112;84;184;42;43;116;65;149;123;127;162;151;133;135;70;154;180;53;121;100;26;86;75;120;44;25;16;171;175;113;56;31;78;145;179;196;81;90;165;40;185;106;178;3;14;144;62;9;148;102;49;52;55;57;92;129;82;2;101;1;97;152;124;94;63;79;80;176;137;23;186;89;183;143;117;0;51;118;59;115;46;68;139;41;193;159;69;108;18;22;146;181;34,8571409777318238218,0.002032
steepest_intra:edges_start:greedy,161,71610,22824,48786,149500,9,127;162;151;133;135;70;154;180;158;53;121;100;26;86;75;120;44;25;16;171;175;113;56;31;78;145;179;196;81;90;165;40;185;106;178;3;14;144;62;9;148;102;49;52;55;57;92;129;82;2;101;1;97;152;124;94;63;79;80;176;137;23;186;89;183;143;117;0;51;118;59;115;46;68;139;193;41;5;42;181;159;69;108;18;22;146;34;160;48;54;177;10;190;184;43;116;65;131;149;123,8520831601818880801,0.004610
steepest_intra:edges_start:greedy,162,71369,23246,48123,104650,6,162;151;133;135;70;154;180;53;121;100;26;86;75;120;44;25;16;171;175;113;56;31;78;145;179;196;81;90;165;40;185;106;178;3;14;144;62;9;148;102;49;52;55;57;92;129;82;2;101;1;97;152;124;94;63;79;80;176;137;23;186;89;183;143;117;0;51;118;59;115;46;68;139;193;41;5;42;181;159;69;108;18;22;146;34;160;48;54;177;10;190;4;112;184;43;116;65;149;123;127,8289848467933609180,0.002002
steepest_intra:edges_start:greedy,163,71643,22792,48851,119600,7,69;139;68;46;115;59;118;51;0;117;143;183;89;186;23;137;176;80;79;63;94;124;152;97;1;101;2;82;129;92;57;55;52;49;102;148;9;62;144;14;3;178;106;185;40;165;90;81;196;179;145;78;31;56;113;175;171;16;25;44;120;75;86;26;100;121;53;180;154;70;135;133;151;162;127;123;149;65;116;43;184;84;190;10;177;54;48;160;34;181;42;5;41;193;159;146;22;199;18;108,2860555313811293983,0.003001
steepest_intra:edges_start:greedy,164,71912,23384,48528,59800,3,164;7;95;39;165;138;14;144;62;9;148;102;49;178;106;52;55;57;92;129;2;152;94;63;79;80;176;133;151;51;118;59;115;46;0;137;23;89;183;143;117;93;140;68;139;193;41;5;42;181;159;69;108;18;22;146;34;160;48;54;177;184;43;116;65;149;162;123;127;70;135;154;180;53;100;26;97;1;101;86;75;120;44;25;16;171;175;113;56;31;78;145;179;196;81;185;40;90;27;58,5469601952875269928,0.001602
steepest_intra:edges_start:greedy,165,71246,23052,48194,89700,5,165;40;185;138;14;144;62;9;148;102;49;178;106;52;55;57;92;129;2;152;97;1;101;26;100;121;94;63;79;80;176;133;151;51;118;59;115;46;0;137;23;186;89;183;143;117;93;140;68;139;193;41;5;42;181;159;69;108;18;22;146;34;160;48;54;177;10;190;84;184;43;116;65;131;149;162;123;127;70;135;154;180;53;86;75;120;44;25;16;171;175;113;56;31;78;145;179;196;81;90,3219827019922277453,0.001507
steepest_intra:edges_start:greedy,166,71675,23130,48545,119600,7,35;184;190;10;177;54;48;160;34;146;22;18;108;69;159;181;42;5;41;193;139;68;140;93;117;143;183;89;186;23;137;176;80;79;63;94;124;152;97;1;101;2;82;129;92;57;55;52;49;102;148;9;62;144;14;3;178;106;185;40;165;90;81;196;179;145;78;31;56;113;175;171;16;25;44;120;75;86;26;100;121;53;180;154;135;70;127;123;162;133;151;51;0;46;115;118;59;65;116;43,3454208323048642939,0.003005
steepest_intra:edges_start:greedy,167,72333,23757,48576,74750,4,167;148;9;62;102;144;14;49;178;106;165;39;95;7;164;58;27;90;81;196;40;185;52;55;57;129;92;179;145;78;31;56;113;175;171;16;25;44;120;2;75;101;1;152;97;26;100;86;53;154;70;135;180;63;79;133;151;162;127;123;149;65;116;43;184;177;54;48;160;34;146;22;18;108;69;159;181;42;5;41;193;139;68;140;93;117;143;183;89;0;46;115;59;118;51;137;176;80;94;124,3401266491343801923,0.001000
steepest_intra:edges_start:greedy,168,71611,23164,48447,149500,9,157;31;56;113;175;171;16;25;44;120;75;86;53;180;154;135;70;127;123;162;149;131;65;116;43;184;190;10;177;54;48;160;34;146;22;18;108;69;159;181;42;5;41;193;139;68;140;93;117;143;183;89;186;23;137;0;46;115;59;118;51;151;133;176;80;79;63;94;121;100;26;101;1;97;152;2;129;92;57;55;52;49;102;148;9;62;144;14;3;178;106;185;40;165;90;81;196;179;145;78,3962300041632189752,0.004000
steepest_intra:edges_start:greedy,169,71439,23112,48327,119600,7,119;40;196;81;90;165;138;14;144;62;9;148;102;49;178;106;52;55;57;92;129;2;152;97;1;101;26;100;121;94;63;79;80;176;133;151;51;118;59;115;46;0;137;23;186;89;183;143;117;93;140;68;139;193;41;5;42;181;159;69;108;18;22;146;34;160;48;54;177;10;190;184;43;116;65;131;149;162;123;127;70;135;154;180;53;86;75;120;44;25;16;171;175;113;56;31;78;145;179;185,3206298681462989770,0.003000
steepest_intra:edges_start:greedy,170,71005,22381,48624,134550,8,170;117;0;46;68;139;115;193;41;5;42;181;159;69;108;18;22;146;34;160;48;54;177;10;190;4;112;184;43;116;65;59;118;51;151;133;162;123;127;70;135;154;180;53;121;100;26;86;75;120;44;25;16;171;175;113;56;31;78;145;179;196;81;90;165;40;185;106;178;3;14;144;62;9;148;102;49;52;55;57;92;129;82;2;101;1;97;152;124;94;63;79;80;176;137;23;186;89;183;143,4503931201359530667,0.002000
steepest_intra:edges_start:greedy,171,71579,23307,48272,119600,7,171;175;113;56;31;78;145;92;179;196;81;90;165;40;185;106;178;3;14;144;62;9;148;102;49;52;55;57;129;2;152;97;1;101;26;100;121;94;63;79;80;176;133;151;51;118;59;115;46;0;137;23;186;89;183;143;117;93;140;68;139;193;41;5;42;181;159;69;108;18;22;146;34;160;48;54;177;10;190;84;184;43;116;65;131;149;162;123;127;70;135;154;180;53;86;75;120;44;25;16,2349070430711642828,0.003000
steepest_intra:edges_start:greedy,172,71364,22899,48465,119600,7,124;167;148;9;62;102;144;14;49;178;106;165;39;27;90;81;196;40;185;52;55;57;129;92;179;145;78;31;56;113;175;171;16;25;44;120;2;75;86;101;1;152;97;26;100;121;53;180;154;135;70;127;123;162;149;131;65;116;43;184;177;54;48;160;34;146;22;18;108;69;159;181;42;5;41;193;139;68;140;93;117;143;183;89;186;23;137;0;46;115;59;118;51;151;133;176;80;79;63;94,5583120576460306327,0.002000
steepest_intra:edges_start:greedy,173,71571,23001,48570,74750,4,127;135;180;63;79;133;151;162;123;149;65;116;43;184;177;54;48;160;34;146;22;18;108;69;159;181;42;5;41;193;139;68;140;93;117;143;0;46;115;59;118;51;80;176;137;23;183;89;186;114;15;9;62;144;14;138;185;40;165;90;81;196;179;145;78;31;56;113;175;171;16;25;44;120;2;129;92;57;55;52;106;178;49;102;148;124;94;152;97;1;101;75;86;26;100;121;53;158;154;70,5743398984976085004,0.002000
steepest_intra:edges_start:greedy,174,71470,23276,48194,89700,5,196;40;185;179;145;78;31;56;113;175;171;16;25;44;120;75;86;53;180;154;135;70;127;123;162;149;131;65;116;43;184;84;190;10;177;54;48;160;34;146;22;18;108;69;159;181;42;5;41;193;139;68;140;93;117;143;183;89;186;23;137;0;46;115;59;118;51;151;133;176;80;79;63;94;121;100;26;101;1;97;152;2;129;92;57;55;52;106;178;49;102;148;9;62;144;14;138;165;90;81,1459116504004079165,0.002000
steepest_intra:edges_start:greedy,175,71579,23307,48272,119600,7,175;113;56;31;78;145;92;179;196;81;90;165;40;185;106;178;3;14;144;62;9;148;102;49;52;55;57;129;2;152;97;1;101;26;100;121;94;63;79;80;176;133;151;51;118;59;115;46;0;137;23;186;89;183;143;117;93;140;68;139;193;41;5;42;181;159;69;108;18;22;146;34;160;48;54;177;10;190;84;184;43;116;65;131;149;162;123;127;70;135;154;180;53;86;75;120;44;25;16;171,4734698624233783574,0.003001
steepest_intra:edges_start:greedy,176,71461,22899,48562,89700,5,176;80;79;63;94;124;152;97;1;101;2;82;129;92;57;55;52;49;102;148;9;62;144;14;3;178;106;185;40;165;90;81;196;179;145;78;31;56;113;175;171;16;25;44;120;75;86;26;100;121;53;180;154;135;70;127;123;162;133;151;149;131;65;116;43;184;84;190;10;177;54;48;160;34;146;22;18;108;69;159;181;42;5;41;193;139;68;46;115;59;118;51;0;117;143;183;89;186;23;137,4377933149612802937,0.002000
steepest_intra:edges_start:greedy,177,71512,22948,48564,134550,8,177;54;48;34;160;42;181;195;146;22;18;108;69;159;193;41;139;68;140;93;117;143;183;89;186;23;137;176;80;79;63;94;124;152;97;1;101;2;82;129;92;57;55;52;49;102;148;9;62;144;14;3;178;106;185;40;165;90;81;196;179;145;78;31;56;113;175;171;16;25;44;120;75;86;26;100;121;53;180;154;135;70;127;123;162;133;151;51;0;46;115;118;59;65;116;43;184;84;190;10,6049072346100579497,0.004001
steepest_intra:edges_start:greedy,178,71246,23052,48194,89700,5,178;49;102;148;9;62;144;14;138;185;40;165;90;81;196;179;145;78;31;56;113;175;171;16;25;44;120;75;86;53;180;154;135;70;127;123;162;149;131;65;116;43;184;84;190;10;177;54;48;160;34;146;22;18;108;69;159;181;42;5;41;193;139;68;140;93;117;143;183;89;186;23;137;0;46;115;59;118;51;151;133;176;80;79;63;94;121;100;26;101;1;97;152;2;129;92;57;55;52;106,657255037956984014,0.003002
steepest_intra:edges_start:greedy,179,71382,23110,48272,104650,6,179;145;78;31;56;113;175;171;16;25;44;120;75;86;53;180;154;135;70;127;123;162;149;131;65;116;43;184;84;190;10;177;54;48;160;34;146;22;18;108;69;159;181;42;5;41;193;139;68;140;93;117;143;183;89;186;23;137;0;46;115;59;118;51;151;133;176;80;79;63;94;121;100;26;101;1;97;152;2;129;92;57;55;52;49;102;148;9;62;144;14;3;178;106;185;40;165;90;81;196,6161945085548968110,0.003001
steepest_intra:edges_start:greedy,180,71413,22843,48570,44850,2,180;135;70;154;158;53;121;100;26;86;75;101;1;97;152;94;124;148;102;49;178;106;52;55;57;92;129;2;120;44;25;16;171;175;113;56;31;78;145;179;196;81;90;165;40;185;138;14;144;62;9;15;114;186;89;183;23;137;176;80;51;118;59;115;46;0;143;117;93;140;68;139;193;41;5;42;181;159;69;108;18;22;146;34;160;48;54;177;184;43;116;65;149;123;127;162;151;133;79;63,3892548772958643426,0.001031
steepest_intra:edges_start:greedy,181,70906,22933,47973,89700,5,181;34;160;48;54;177;10;190;4;112;84;184;42;43;116;65;149;123;127;162;151;133;135;70;154;180;53;121;100;26;86;75;120;44;25;16;171;175;113;56;31;78;145;179;196;81;90;165;40;185;106;178;3;14;144;62;9;148;102;49;52;55;57;92;129;82;2;101;1;97;152;124;94;63;79;80;176;137;23;186;89;183;143;117;0;51;118;59;115;46;68;139;41;193;159;69;108;18;22;146,3819290911468263793,0.001990
steepest_intra:edges_start:greedy,182,71413,22843,48570,74750,4,158;154;70;135;180;63;79;133;151;162;127;123;149;65;116;43;184;177;54;48;160;34;146;22;18;108;69;159;181;42;5;41;193;139;68;140;93;117;143;0;46;115;59;118;51;80;176;137;23;183;89;186;114;15;9;62;144;14;138;185;40;165;90;81;196;179;145;78;31;56;113;175;171;16;25;44;120;2;129;92;57;55;52;106;178;49;102;148;124;94;152;97;1;101;75;86;26;100;121;53,9036954375957116786,0.001031
steepest_intra:edges_start:greedy,183,70571,22366,48205,119600,7,183;89;186;23;137;176;80;79;63;94;124;152;97;1;101;2;82;129;92;57;55;52;49;102;148;9;62;144;14;3;178;106;185;40;165;90;81;196;179;145;78;31;56;113;175;171;16;25;44;120;75;86;26;100;121;53;180;154;135;70;127;123;162;133;151;51;118;59;65;116;43;184;84;112;4;190;10;177;54;48;160;34;146;22;18;108;69;159;181;42;5;41;193;115;139;68;46;0;117;143,499123805750068562,0.002018
steepest_intra:edges_start:greedy,184,71548,23048,48500,104650,6,184;43;116;65;59;118;115;46;0;51;151;133;162;123;127;70;135;154;180;53;121;100;26;86;75;120;44;25;16;171;175;113;56;31;78;145;179;196;81;90;165;40;185;106;178;3;14;144;62;9;148;102;49;52;55;57;92;129;82;2;101;1;97;152;124;94;63;79;80;176;137;23;186;89;183;143;117;93;140;68;139;193;41;5;42;181;159;69;108;18;22;146;34;160;48;54;177;10;190;84,572302247723605851,0.002000
steepest_intra:edges_start:greedy,185,71246,23052,48194,89700,5,185;138;14;144;62;9;148;102;49;178;106;52;55;57;92;129;2;152;97;1;101;26;100;121;94;63;79;80;176;133;151;51;118;59;115;46;0;137;23;186;89;183;143;117;93;140;68;139;193;41;5;42;181;159;69;108;18;22;146;34;160;48;54;177;10;190;84;184;43;116;65;131;149;162;123;127;70;135;154;180;53;86;75;120;44;25;16;171;175;113;56;31;78;145;179;196;81;90;165;40,7815230513966305870,0.001999
steepest_intra:edges_start:greedy,186,70571,22366,48205,119600,7,186;89;183;143;117;0;46;68;139;115;193;41;5;42;181;159;69;108;18;22;146;34;160;48;54;177;10;190;4;112;84;184;43;116;65;59;118;51;151;133;162;123;127;70;135;154;180;53;121;100;26;86;75;120;44;25;16;171;175;113;56;31;78;145;179;196;81;90;165;40;185;106;178;3;14;144;62;9;148;102;49;52;55;57;92;129;82;2;101;1;97;152;124;94;63;79;80;176;137;23,6056904401062378349,0.003000
steepest_intra:edges_start:greedy,187,71509,23272,48237,104650,6,27;165;138;14;144;62;9;148;102;49;178;106;52;55;57;92;129;2;152;97;1;101;26;100;121;94;63;79;80;176;133;151;51;118;59;115;46;0;137;23;186;89;183;143;117;93;140;68;139;193;41;5;42;181;159;69;108;18;22;146;34;160;48;54;177;10;190;184;43;116;65;131;149;162;123;127;70;135;154;180;53;86;75;120;44;25;16;171;175;113;56;31;78;145;179;185;40;196;81;90,8835207441054349720,0.002000
steepest_intra:edges_start:greedy,188,71808,23361,48447,149500,9,157;31;56;113;175;171;16;25;44;120;75;86;53;180;154;135;70;127;123;162;149;131;65;116;43;184;190;10;177;54;48;160;34;146;22;18;108;69;159;181;42;5;41;193;139;68;140;93;117;143;183;89;186;23;137;0;46;115;59;118;51;151;133;176;80;79;63;94;121;100;26;101;1;97;152;2;129;57;55;52;49;102;148;9;62;144;14;3;178;106;185;40;165;90;81;196;179;92;145;78,1786393327028119987,0.003257
steepest_intra:edges_start:greedy,189,71608,22548,49060,44850,2,189;94;124;148;102;49;178;106;52;55;57;92;129;2;120;44;25;16;171;175;113;56;31;78;145;179;196;81;90;165;40;185;138;14;144;62;9;15;114;186;89;183;23;137;176;80;51;118;59;115;46;0;143;117;93;140;68;139;193;41;5;42;181;159;69;108;18;22;146;34;160;48;54;177;184;43;116;65;149;123;162;151;133;79;63;180;135;70;154;158;53;121;100;26;86;75;101;1;97;152,7235778862943072657,0.001000
steepest_intra:edges_start:greedy,190,71327,23150,48177,149500,9,190;10;177;54;48;34;160;42;181;146;22;18;108;69;159;193;41;139;68;46;115;118;59;65;116;43;184;35;131;149;123;162;133;151;51;0;117;143;183;89;23;137;176;80;79;63;94;124;152;97;1;101;2;82;129;92;57;55;52;49;102;148;9;62;144;14;3;178;106;185;40;165;90;81;196;179;145;78;31;56;113;175;171;16;25;44;120;75;86;26;100;121;53;180;154;135;70;127;112;4,3479272000808864124,0.003001
steepest_intra:edges_start:greedy,191,71848,23049,48799,119600,7,198;68;46;115;59;118;51;0;117;143;183;89;186;23;137;176;80;79;63;94;124;152;97;1;101;2;82;129;92;57;55;52;49;102;148;9;62;144;14;3;178;106;185;40;165;90;81;196;179;145;78;31;56;113;175;171;16;25;44;120;75;86;26;100;121;53;180;154;70;135;133;151;162;127;123;149;65;116;43;184;84;190;10;177;54;48;160;34;146;22;18;108;69;159;181;42;5;41;193;139,3059587510747590672,0.003000
steepest_intra:edges_start:greedy,192,71740,22893,48847,149500,9,96;5;42;181;159;69;108;18;22;146;34;160;48;54;177;10;190;184;43;116;65;59;118;115;46;0;51;151;133;162;123;127;70;135;154;180;53;121;100;26;86;75;120;44;25;16;171;175;113;56;31;78;145;179;196;81;90;165;40;185;106;178;3;14;144;62;9;148;102;49;52;55;57;92;129;82;2;101;1;97;152;124;94;63;79;80;176;137;23;186;89;183;143;117;93;140;68;139;193;41,3670953638225922300,0.003000
steepest_intra:edges_start:greedy,193,71369,23246,48123,104650,6,193;139;68;46;115;59;118;51;0;117;143;183;89;186;23;137;176;80;79;63;94;124;152;97;1;101;2;82;129;92;57;55;52;49;102;148;9;62;144;14;3;178;106;185;40;165;90;81;196;179;145;78;31;56;113;175;171;16;25;44;120;75;86;26;100;121;53;180;154;70;135;133;151;162;127;123;149;65;116;43;184;112;4;190;10;177;54;48;160;34;146;22;18;108;69;159;181;42;5;41,6522800489349635562,0.003207
steepest_intra:edges_start:greedy,194,71873,22902,48971,104650,6,194;127;123;162;133;151;149;131;65;116;43;184;190;10;177;54;48;160;34;146;22;18;108;69;159;181;42;5;41;193;139;68;46;115;59;118;51;0;117;143;183;89;186;23;137;176;80;79;63;94;124;152;97;1;101;2;82;129;92;57;55;52;49;102;148;9;62;144;14;3;178;106;185;40;165;90;81;196;179;145;78;31;56;113;175;171;16;25;44;120;75;86;26;100;121;53;180;154;70;135,5315989006975763519,0.002000
steepest_intra:edges_start:greedy,195,71156,22969,48187,104650,6,195;181;34;160;48;54;177;10;190;4;112;184;42;43;116;65;149;123;127;162;151;133;135;70;154;180;53;121;100;26;86;75;120;44;25;16;171;175;113;56;31;78;145;179;196;81;90;165;40;185;106;178;3;14;144;62;9;148;102;49;52;55;57;92;129;82;2;101;1;97;152;124;94;63;79;80;176;137;23;186;89;183;143;117;0;51;118;59;115;46;68;139;41;193;159;69;108;18;22;146,7316068985275766944,0.003002
steepest_intra:edges_start:greedy,196,71978,23329,48649,119600,7,196;81;90;165;40;185;106;178;3;14;144;62;9;148;102;49;52;55;57;129;92;179;145;78;82;2;152;97;1;101;26;100;121;94;63;79;80;176;133;151;51;118;59;115;46;0;137;23;186;89;183;143;117;93;140;68;139;193;41;5;42;181;159;69;108;18;22;146;34;160;48;54;177;10;184;43;116;65;131;149;162;123;127;70;135;154;180;53;86;75;120;44;25;16;171;175;113;56;31;157,1937405264688454987,0.001999
steepest_intra:edges_start:greedy,197,71760,22961,48799,104650,6,198;46;68;139;193;41;5;42;181;159;69;108;18;22;146;34;160;48;54;177;10;190;84;184;43;116;65;149;123;127;162;151;133;135;70;154;180;53;121;100;26;86;75;120;44;25;16;171;175;113;56;31;78;145;179;196;81;90;165;40;185;106;178;3;14;144;62;9;148;102;49;52;55;57;92;129;82;2;101;1;97;152;124;94;63;79;80;176;137;23;186;89;183;143;117;0;51;118;59;115,7554259292859319290,0.001886
steepest_intra:edges_start:greedy,198,71369,23246,48123,119600,7,68;46;115;59;118;51;0;117;143;183;89;186;23;137;176;80;79;63;94;124;152;97;1;101;2;82;129;92;57;55;52;49;102;148;9;62;144;14;3;178;106;185;40;165;90;81;196;179;145;78;31;56;113;175;171;16;25;44;120;75;86;26;100;121;53;180;154;70;135;133;151;162;127;123;149;65;116;43;184;112;4;190;10;177;54;48;160;34;146;22;18;108;69;159;181;42;5;41;193;139,8107006170999266872,0.003002
steepest_intra:edges_start:greedy,199,71188,22872,48316,164450,10,140;108;18;22;146;159;193;41;5;42;181;34;160;48;54;177;10;190;84;184;43;116;65;149;123;127;162;151;133;135;70;154;180;53;121;100;26;86;75;120;44;25;16;171;175;113;56;31;78;145;179;196;81;90;165;40;185;106;178;3;14;144;62;9;148;102;49;52;55;57;92;129;82;2;101;1;97;152;124;94;63;79;80;176;137;23;186;89;183;143;117;0;51;118;59;115;139;46;68;93,765474313614681322,0.004000
greedy_intra:nodes_start:random,0,82798,33132,49666,808317,448,151;65;116;5;42;43;112;4;10;177;184;84;35;131;149;123;127;63;121;26;100;53;180;154;70;135;162;59;115;139;41;193;181;160;34;146;22;18;117;143;0;46;118;51;183;89;144;49;196;81;90;165;39;164;21;14;138;179;145;157;31;25;44;120;75;86;189;124;148;37;102;62;9;137;176;80;94;82;78;113;175;171;16;2;101;1;97;152;57;55;52;178;106;185;119;40;92;129;79;133,7289904978382666388,0.081142
greedy_intra:nodes_start:random,1,90366,41546,48820,732947,448,179;145;78;16;44;75;86;135;127;112;4;177;184;35;123;133;94;124;178;165;90;81;113;175;171;31;25;120;167;9;62;49;3;106;185;40;92;97;26;53;180;154;149;131;65;68;117;0;89;114;15;52;55;186;23;137;46;115;116;59;151;80;176;148;37;144;21;7;164;95;14;102;51;118;139;41;181;34;160;42;43;162;100;101;1;2;82;129;152;63;79;193;159;22;18;108;93;143;183;57,59876502119870590,0.082836
greedy_intra:nodes_start:random,2,87601,37596,50005,880082,459,72;59;118;176;80;129;78;145;179;196;81;90;27;165;14;144;102;49;57;92;25;44;120;115;139;137;148;106;40;185;55;52;178;114;23;46;68;117;143;0;51;151;162;149;131;41;193;34;160;54;184;84;112;158;53;86;75;101;1;9;62;15;186;89;183;108;18;22;146;181;42;43;116;65;63;121;182;136;180;154;135;123;127;70;16;171;175;113;56;31;2;100;26;97;152;124;94;122;79;133,6849477071518771751,0.096427
greedy_intra:nodes_start:random,3,84124,34745,49379,890454,511,133;151;51;109;118;115;46;139;68;0;137;62;102;144;15;186;23;89;183;143;117;93;140;108;18;22;193;41;162;113;175;171;16;75;86;135;123;184;160;48;54;177;112;127;70;101;129;92;78;145;179;196;81;157;31;25;44;120;152;124;167;9;37;148;80;176;59;65;47;116;43;42;181;34;149;154;180;158;53;121;94;52;185;40;90;165;14;49;3;178;106;55;57;2;1;97;26;100;63;79,2586795663587584228,0.100865
greedy_intra:nodes_start:random,4,88217,39625,48592,1123447,473,89;144;102;49;176;51;72;151;100;75;120;129;92;178;14;106;2;1;97;152;186;23;137;80;122;94;124;15;62;9;148;167;57;179;145;78;31;113;175;171;16;44;86;53;131;35;184;84;4;112;123;127;135;154;180;79;133;162;65;116;42;5;139;68;93;140;108;18;22;34;181;43;149;26;101;121;115;41;193;160;54;177;70;25;196;81;90;165;40;185;52;55;63;59;118;46;0;117;143;183,3985258120671359365,0.099669
greedy_intra:nodes_start:random,5,88839,39796,49043,771763,416,119;40;44;25;120;75;70;135;151;109;0;117;143;183;89;178;106;179;31;113;196;81;90;165;92;82;78;145;49;102;9;148;137;46;68;108;18;69;139;59;118;80;79;63;100;26;1;175;171;16;112;34;146;22;159;42;184;10;177;54;160;181;193;41;115;51;66;176;162;127;123;149;43;116;65;133;2;129;57;14;144;62;15;186;23;124;94;97;101;86;53;158;154;180;121;152;167;52;55;185,5467423178896203778,0.079030
greedy_intra:nodes_start:random,6,87809,39473,48336,837898,441,93;117;143;52;78;16;171;175;113;31;196;178;3;49;102;62;9;148;137;183;89;23;186;15;144;14;165;90;81;40;185;106;167;176;159;22;34;54;177;160;43;47;131;149;162;133;124;55;179;145;25;44;120;75;86;53;118;41;193;181;42;5;59;151;79;94;152;57;92;129;2;100;127;35;184;84;112;70;101;1;97;26;51;46;68;139;115;116;65;123;135;154;180;63;122;80;0;140;18;108,1444416732027101857,0.077396
greedy_intra:nodes_start:random,7,86252,36458,49794,1293066,514,31;113;175;171;16;55;102;62;9;15;186;23;114;144;14;138;165;90;81;196;40;185;52;94;149;184;10;177;54;43;116;65;151;180;158;86;101;2;129;82;120;75;26;100;121;63;51;118;115;139;68;46;176;80;122;97;1;92;57;152;53;154;135;70;127;112;4;123;162;133;79;124;167;49;3;178;106;179;145;78;25;44;148;137;89;183;143;170;0;117;42;160;34;181;146;22;159;193;41;59,1523599048376362126,0.109418
greedy_intra:nodes_start:random,8,87279,39095,48184,751779,421,14;49;167;63;127;112;35;65;149;123;135;70;26;100;53;154;180;133;151;46;0;117;143;183;89;62;102;3;178;52;55;129;2;124;176;51;115;139;41;193;159;22;18;108;68;137;23;186;15;9;148;109;118;59;42;43;116;162;79;121;86;44;16;171;175;78;92;57;179;185;106;119;40;196;145;25;120;75;101;1;97;152;94;80;184;54;34;160;48;177;4;31;56;113;81;90;165;164;21;144,3306856388649147031,0.083494
greedy_intra:nodes_start:random,9,90957,40418,50539,1027974,492,186;15;9;148;80;112;184;10;177;54;193;41;118;51;94;124;12;137;153;0;117;143;183;144;14;138;106;178;49;102;62;176;151;162;154;180;63;122;79;133;135;70;158;86;75;44;120;2;1;101;121;136;182;189;97;26;100;53;127;123;152;129;57;55;52;92;78;175;171;16;25;149;65;116;59;167;196;81;113;31;145;179;185;40;90;165;89;139;18;22;146;34;160;181;42;43;5;115;46;23,753592555349200014,0.095355
greedy_intra:nodes_start:random,10,85712,37126,48586,1161642,529,159;69;108;18;22;146;181;139;115;176;94;1;120;25;78;145;179;92;129;2;152;57;106;138;14;49;102;148;79;133;151;162;149;47;116;65;135;70;127;123;131;43;42;160;35;180;53;121;63;80;51;46;68;117;0;143;144;3;178;90;81;196;55;52;185;165;119;40;31;56;113;175;171;16;44;75;86;112;4;154;100;26;101;97;124;23;183;89;186;15;62;9;137;59;184;177;54;34;41;193,1735374800148928228,0.107091
greedy_intra:nodes_start:random,11,88104,39881,48223,786431,434,176;137;23;89;183;186;129;145;78;31;113;175;171;16;101;1;124;0;93;140;68;118;59;131;112;4;190;10;177;184;115;46;15;62;49;106;185;119;40;196;81;90;165;143;117;139;160;48;54;30;34;22;18;159;193;41;181;42;43;79;63;94;152;82;25;44;120;75;86;53;154;135;149;47;65;116;51;167;52;55;80;151;162;133;148;9;144;14;178;57;179;92;2;97;26;100;180;70;127;123,8211918058328137557,0.076766
greedy_intra:nodes_start:random,12,82740,34462,48278,891036,448,180;135;154;53;97;1;26;100;137;23;186;114;15;185;40;165;90;81;196;113;175;31;179;55;52;106;3;178;57;2;152;167;49;14;144;102;62;9;124;94;63;80;176;51;72;127;70;86;75;120;101;121;151;149;131;65;116;43;115;41;193;139;68;0;46;118;59;129;145;78;171;16;44;25;92;148;89;183;143;117;108;69;18;159;42;160;181;22;146;34;54;177;184;84;4;112;123;162;133;79,7215920489728883312,0.085817
greedy_intra:nodes_start:random,13,87756,39014,48742,849652,482,59;43;184;160;34;41;46;9;62;129;82;2;1;97;152;167;148;124;122;79;133;151;0;117;93;108;18;69;139;68;143;183;144;14;165;119;40;90;81;196;157;16;171;175;113;31;78;94;176;193;159;22;146;181;42;116;65;131;149;123;127;70;75;120;44;25;92;57;55;52;106;121;53;154;180;63;80;137;186;23;51;118;115;54;177;4;112;135;86;100;26;102;49;3;178;185;179;145;101;162,7503662194654509911,0.087019
greedy_intra:nodes_start:random,14,84688,35866,48822,1264643,502,171;16;75;70;112;35;116;65;47;131;149;180;53;63;80;46;139;68;140;93;117;143;0;176;100;26;97;1;129;55;52;106;185;179;57;92;145;78;25;44;120;2;152;133;162;151;79;94;124;148;15;114;89;183;118;59;43;42;181;160;54;177;4;127;86;101;158;154;135;123;184;34;22;18;108;69;199;159;193;41;115;51;167;178;49;102;62;186;23;137;9;144;14;165;90;40;196;31;113;175,228967648984753582,0.102327
greedy_intra:nodes_start:random,15,89012,39795,49217,864439,459,23;115;5;42;116;133;79;122;94;2;120;44;25;78;145;179;196;81;90;49;162;149;131;47;65;59;118;51;72;151;80;55;52;106;178;148;137;0;18;22;34;54;177;160;41;193;139;46;176;63;100;26;101;1;97;152;167;62;9;124;180;135;112;184;35;121;129;92;57;185;40;119;165;14;144;102;15;89;183;143;117;68;159;146;181;43;123;127;70;154;158;53;86;75;16;171;175;113;31;186,4820894766564239414,0.080005
greedy_intra:nodes_start:random,16,84951,35831,49120,1043119,511,59;115;139;68;46;118;51;80;124;167;148;37;9;62;15;186;79;135;70;154;53;86;75;101;97;180;162;151;133;176;137;0;117;143;183;89;23;102;49;178;106;179;145;196;185;138;14;144;123;112;84;184;160;42;181;34;48;54;177;10;190;35;43;65;116;41;159;22;18;193;16;171;175;113;31;81;90;27;165;119;40;78;25;44;120;82;2;1;26;100;121;63;122;94;152;129;92;57;55;52,3879234934729448105,0.094736
greedy_intra:nodes_start:random,17,89421,40931,48490,857665,457,84;112;70;154;135;4;177;54;160;93;117;143;0;153;183;89;9;196;31;113;175;171;16;25;52;3;49;102;62;15;51;118;59;34;181;41;139;198;23;186;137;151;162;127;123;131;149;133;26;129;55;57;92;44;120;75;86;101;1;152;178;106;185;179;145;78;2;97;115;193;159;22;18;108;68;46;176;80;167;165;27;90;81;40;14;144;148;94;79;63;121;100;53;180;35;184;42;43;116;65,3874240089193965743,0.080972
greedy_intra:nodes_start:random,18,92179,38691,53488,837610,454,79;63;180;154;136;121;100;1;2;129;57;49;144;114;143;117;0;101;75;120;44;25;196;40;119;106;178;3;14;138;165;185;179;92;102;37;9;62;15;186;23;46;160;34;22;183;89;137;123;112;184;43;59;176;148;124;94;189;26;97;152;74;82;78;145;38;157;81;90;52;55;167;80;51;118;42;159;193;41;139;68;115;116;65;131;149;162;53;86;31;56;113;175;171;16;158;70;135;151;133,2483269974132662151,0.088771
greedy_intra:nodes_start:random,19,83342,31349,51993,981962,466,15;37;9;62;144;114;143;117;0;46;139;115;42;41;193;22;34;160;43;116;65;131;149;162;133;86;75;44;120;2;101;1;97;189;63;94;124;167;102;14;3;57;92;145;78;129;79;151;59;118;51;176;80;148;49;178;106;185;196;31;175;113;56;157;81;90;165;119;40;52;55;179;171;16;25;152;26;100;121;182;136;53;158;70;127;112;4;10;177;184;123;135;154;180;122;137;23;183;89;186,8868251988674570066,0.086548
greedy_intra:nodes_start:random,20,89475,39732,49743,1023815,463,165;49;167;124;189;26;100;121;63;133;149;65;116;59;118;0;117;143;183;89;114;179;31;113;175;171;16;44;120;94;80;137;23;186;15;9;62;102;144;14;138;32;52;55;57;92;129;2;101;86;70;127;177;54;34;160;184;84;112;35;43;115;51;148;185;40;119;106;178;3;152;1;97;53;180;162;41;159;193;151;79;82;78;145;176;46;139;18;22;181;42;123;135;154;75;25;196;81;90;27,604774015476515188,0.094767
greedy_intra:nodes_start:random,21,83587,34468,49119,1091292,496,139;68;46;118;59;65;131;149;123;127;151;133;79;63;121;97;26;100;158;154;70;135;162;116;41;193;115;51;167;106;178;49;102;62;9;176;80;122;94;148;15;186;89;23;137;124;152;1;75;16;171;175;113;81;90;165;119;40;185;52;179;145;78;57;14;144;183;143;0;55;196;157;31;25;44;120;82;92;129;2;101;86;53;180;42;159;18;22;146;34;160;54;177;10;190;4;112;84;184;43,5568583392453528009,0.096843
greedy_intra:nodes_start:random,22,85189,36713,48476,830711,465,138;3;178;179;31;171;16;25;44;120;129;92;57;40;185;106;152;100;53;158;180;154;135;70;127;112;4;123;133;121;26;101;175;113;56;196;81;90;27;165;144;139;181;34;160;43;42;41;193;159;146;22;18;108;117;143;0;46;115;118;176;167;52;55;63;80;137;23;183;89;186;15;62;9;51;59;65;116;184;48;54;177;35;149;131;162;151;79;86;75;78;145;2;1;97;94;124;148;49;14,5841831627268705031,0.085736
greedy_intra:nodes_start:random,23,86852,38342,48510,1028648,495,152;2;129;178;106;185;40;165;90;81;145;78;25;44;75;86;100;53;180;63;79;80;162;149;131;184;54;160;193;41;123;127;135;154;133;151;51;176;137;15;144;14;49;62;9;118;59;34;103;146;181;42;5;115;0;183;89;124;121;158;70;112;4;84;190;10;177;43;116;65;120;16;171;175;113;31;179;57;167;148;143;117;68;139;108;18;22;159;46;23;186;52;55;92;101;1;97;26;189;94,589316283719525200,0.092253
greedy_intra:nodes_start:random,24,86121,35161,50960,586050,462,89;183;46;115;65;131;149;72;151;176;148;9;62;152;1;97;26;100;53;158;180;154;42;181;159;193;41;139;80;122;63;136;101;75;120;55;52;185;40;179;145;78;157;31;56;113;175;171;16;44;25;92;57;167;137;0;143;18;22;146;34;54;177;10;190;4;112;127;135;178;106;138;14;144;15;51;118;59;116;43;160;184;123;162;133;79;12;124;94;189;121;86;2;129;196;81;90;27;165;49,2417069120159016912,0.082355
greedy_intra:nodes_start:random,25,84249,35654,48595,804950,474,65;47;131;149;162;133;151;72;59;181;34;160;177;4;112;127;75;25;78;196;40;165;39;138;14;144;178;52;55;185;106;49;102;9;137;51;118;46;139;115;5;42;116;43;184;35;123;53;100;26;97;1;2;129;92;57;179;145;31;113;175;171;16;44;120;152;94;124;148;62;15;186;89;183;23;135;70;154;180;79;63;167;21;164;27;90;81;101;86;80;176;0;143;117;108;18;22;41;193;159,5239227858696545067,0.091073
greedy_intra:nodes_start:random,26,87846,38848,48998,828682,491,120;75;101;94;124;49;102;148;137;176;151;162;123;127;70;135;133;51;115;68;117;143;0;46;118;59;65;47;131;149;121;100;26;86;53;154;180;122;80;144;14;21;164;113;175;171;16;78;92;57;55;52;81;196;129;43;160;54;177;184;42;41;193;139;23;186;89;183;108;18;22;146;34;181;116;79;63;97;1;37;9;62;167;152;2;44;25;56;31;145;179;106;178;3;165;27;90;119;40;185,4543244241945276210,0.091516
greedy_intra:nodes_start:random,27,81152,31617,49535,700447,434,56;113;81;90;27;164;7;21;3;106;178;49;62;9;15;148;124;94;63;122;79;80;176;151;51;137;23;89;0;46;68;117;143;183;144;14;138;165;175;171;16;78;25;44;120;101;1;129;92;57;55;52;91;145;82;2;152;97;26;70;4;177;54;160;34;146;22;159;193;139;115;41;181;42;43;116;118;59;65;184;84;112;127;135;133;162;149;131;123;180;154;53;86;75;179;185;119;40;196;31,7678159913375310085,0.074766
greedy_intra:nodes_start:random,28,86864,36061,50803,885262,478,116;65;162;133;63;94;122;79;151;115;41;181;184;127;135;86;75;16;171;175;113;31;78;145;179;92;129;57;167;89;183;153;0;46;176;137;148;9;62;15;186;23;114;144;14;102;49;124;26;100;101;2;120;25;44;70;112;177;54;34;160;97;1;185;40;165;106;178;52;55;152;189;121;180;154;158;53;136;80;51;118;59;47;149;123;131;43;193;159;22;18;108;140;93;143;117;68;139;5;42,2582228461082795542,0.086660
greedy_intra:nodes_start:random,29,86352,38073,48279,1000015,477,101;1;97;152;133;151;118;115;181;160;184;84;112;2;81;90;165;143;117;93;68;46;0;183;89;185;40;196;31;113;175;171;16;25;44;129;92;57;55;52;49;102;62;9;176;51;59;116;65;47;149;162;194;123;131;35;127;70;135;154;158;53;180;43;42;159;193;41;139;69;108;18;22;34;54;177;10;190;4;148;178;106;167;94;63;79;80;137;23;186;15;144;14;145;78;120;75;86;100;26,2580393509012293287,0.091582
greedy_intra:nodes_start:random,30,86913,37171,49742,722975,415,59;131;149;162;151;133;121;100;26;101;53;63;118;41;42;160;48;34;181;193;159;22;18;108;93;117;143;0;153;23;176;80;97;1;129;25;78;31;113;90;165;119;40;185;49;15;186;89;183;46;139;115;135;70;127;4;177;54;116;65;137;148;124;152;167;9;62;144;14;3;178;106;57;92;123;112;84;35;184;43;47;154;180;158;86;75;2;120;44;16;171;175;145;179;52;55;94;122;79;51,1279320222622458317,0.075018
greedy_intra:nodes_start:random,31,85649,36044,49605,785744,459,49;102;62;2;129;92;185;40;119;14;144;9;94;63;79;133;180;154;135;162;159;18;108;117;0;137;97;1;26;100;121;53;86;75;120;145;179;57;55;52;106;178;3;138;165;90;81;196;31;113;175;44;101;151;59;116;65;123;112;4;84;184;35;131;149;43;68;143;183;89;186;15;148;176;118;198;139;41;193;181;160;195;22;146;103;34;48;54;177;42;5;115;46;51;80;152;25;16;171;78,5340914968965993876,0.077763
greedy_intra:nodes_start:random,32,83700,34923,48777,812197,476,100;26;1;152;97;121;180;154;135;112;4;177;54;34;181;193;41;80;122;63;101;75;86;53;70;127;123;162;151;176;9;62;55;52;106;178;14;144;102;49;167;2;120;129;92;57;179;40;196;145;78;79;133;149;131;65;116;59;118;109;51;35;184;160;146;22;159;42;43;5;115;46;68;139;18;108;117;143;0;185;165;39;27;90;81;31;56;113;175;171;16;25;44;148;23;89;183;137;124;94,685100372231682324,0.092726
greedy_intra:nodes_start:random,33,81076,31932,49144,960201,455,86;100;26;152;185;40;90;165;144;15;186;23;118;59;65;149;190;10;177;54;48;160;34;146;181;42;43;116;151;133;180;53;158;154;135;70;127;35;184;84;4;112;123;162;79;63;80;176;51;46;198;139;68;140;93;117;143;183;89;129;92;57;55;52;9;62;49;178;106;138;14;102;148;115;5;41;193;159;22;18;108;0;137;12;124;94;97;1;101;2;44;16;171;175;113;31;145;78;120;75,1750896776750044795,0.085495
greedy_intra:nodes_start:random,34,86258,37015,49243,679824,476,137;186;114;23;0;117;143;183;89;9;62;178;106;57;92;31;25;44;120;2;97;121;53;70;127;123;160;34;22;18;139;68;46;151;75;16;171;175;113;56;81;196;52;55;179;145;78;129;152;182;63;122;94;148;102;165;90;40;185;51;59;116;65;149;131;184;48;54;177;4;112;135;80;144;14;49;167;124;189;100;26;1;101;86;158;154;180;79;133;162;41;193;159;146;181;42;43;115;118;176,5368477086995006722,0.078163
greedy_intra:nodes_start:random,35,90295,39138,51157,613294,396,122;9;62;102;39;90;81;31;16;171;175;113;40;119;165;144;15;114;186;63;180;154;135;70;75;44;25;120;80;176;18;108;143;183;89;137;195;146;22;159;139;59;151;133;158;53;121;2;82;78;145;92;129;101;86;100;26;97;1;152;19;189;124;167;49;14;138;106;185;196;179;57;23;0;117;68;46;115;118;51;148;178;52;55;94;162;123;149;42;5;41;193;181;34;160;184;43;116;65;79,6357086846745193416,0.066452
greedy_intra:nodes_start:random,36,85639,35447,50192,845862,442,178;14;138;94;116;43;160;34;42;139;68;46;51;176;137;89;183;143;0;18;22;159;193;41;115;65;149;123;135;154;158;2;129;82;44;16;171;175;113;56;25;120;75;70;112;4;10;177;54;184;162;55;57;31;157;81;90;27;196;179;145;78;92;53;180;79;133;151;59;118;80;122;63;121;100;26;97;152;1;101;86;189;124;167;49;102;62;9;37;148;15;186;23;114;144;165;40;185;52;106,8521415867233365214,0.083476
greedy_intra:nodes_start:random,37,86409,37285,49124,697508,443,27;90;81;31;196;40;119;185;106;52;55;57;2;97;26;162;65;116;43;75;44;16;171;175;113;92;137;23;143;117;108;18;22;159;193;41;42;68;0;153;183;89;186;9;129;120;25;78;145;178;49;62;176;51;80;86;101;1;152;167;148;124;94;121;53;63;79;151;118;46;139;115;59;133;180;158;154;135;194;127;123;149;35;84;184;160;34;54;177;10;4;112;70;100;102;144;14;138;165;39,6929587307286134552,0.070974
greedy_intra:nodes_start:random,38,87835,39969,47866,1004540,459,81;40;165;90;164;21;144;62;148;124;80;59;42;181;146;159;193;41;46;94;97;1;2;120;82;152;118;115;139;68;23;186;14;138;185;52;55;179;145;78;25;44;101;86;26;100;70;135;151;133;79;63;53;158;154;180;162;149;116;0;117;143;183;89;137;176;123;112;177;54;48;160;43;47;65;51;9;102;49;3;178;106;57;92;129;93;108;18;22;34;184;35;127;75;16;171;175;113;31;196,6620896577229998236,0.089654
greedy_intra:nodes_start:random,39,85143,35838,49305,665636,471,162;133;122;94;167;3;178;106;52;55;57;92;186;114;144;21;7;164;152;97;1;101;2;81;90;165;119;40;145;78;16;31;157;196;179;129;180;112;84;184;10;177;54;42;5;115;46;0;68;139;22;34;160;123;127;135;154;53;26;86;75;120;44;25;171;175;113;56;185;14;49;102;37;148;15;62;9;124;100;121;63;79;80;151;59;51;176;137;23;89;183;143;117;108;18;193;41;43;116;65,9053439263091951685,0.078230
greedy_intra:nodes_start:random,40,88855,39984,48871,1037134,496,120;94;124;183;143;41;160;54;34;18;117;0;80;133;162;123;127;70;135;121;152;92;81;90;21;144;15;114;186;89;23;137;151;112;4;190;10;177;184;43;131;149;154;100;26;97;129;145;31;56;113;175;171;16;78;82;101;1;2;57;55;52;106;178;3;138;14;102;62;9;37;148;59;193;159;22;181;42;116;65;63;185;40;165;49;167;176;51;118;115;139;68;46;79;180;53;86;75;44;25,8390485855602375602,0.095193
greedy_intra:nodes_start:random,41,84896,33023,51873,855953,452,70;135;162;123;149;131;47;65;151;79;63;121;136;180;154;158;53;100;26;86;75;101;1;49;144;14;3;178;106;56;175;113;196;40;119;57;92;129;148;9;62;89;183;143;0;117;93;108;18;22;159;193;41;118;109;51;176;137;46;68;139;115;43;105;116;59;133;97;152;55;52;167;111;124;2;82;145;179;185;165;90;81;25;120;44;16;171;31;78;94;122;80;5;42;181;34;160;184;112;127,2823637405232964997,0.083641
greedy_intra:nodes_start:random,42,89767,41686,48081,750813,433,180;154;133;151;115;41;193;42;116;65;162;97;1;101;2;120;129;92;185;165;138;14;144;21;90;40;135;127;177;54;160;34;181;86;75;16;171;175;25;44;26;100;124;148;102;49;55;57;53;70;112;4;84;184;43;149;123;152;145;78;31;113;81;196;52;106;178;3;167;94;63;122;176;137;9;62;15;186;183;143;117;46;59;118;109;51;93;140;108;18;22;146;159;139;68;0;89;23;80;79,1277634745750329679,0.082249
greedy_intra:nodes_start:random,43,91039,43466,47573,1116607,485,133;148;9;62;144;14;138;106;178;3;49;102;167;124;94;122;176;80;79;63;180;154;135;43;42;181;146;22;68;89;165;90;81;196;92;70;127;112;177;54;34;160;184;123;53;75;16;171;175;113;31;78;145;129;152;51;41;193;159;0;183;143;117;93;108;18;69;100;26;86;101;1;2;40;185;52;55;57;25;44;120;97;151;59;118;115;139;46;23;15;164;7;21;114;186;137;116;65;149;162,5412529278294081038,0.098898
greedy_intra:nodes_start:random,44,88660,38405,50255,842975,439,63;180;135;70;154;158;152;49;102;144;14;40;185;94;162;65;43;42;34;160;184;84;112;131;149;123;127;129;92;57;55;62;9;114;89;183;153;0;51;151;133;79;53;121;124;148;15;186;23;137;59;116;41;193;159;146;22;68;46;106;165;90;81;196;179;2;1;97;26;100;189;167;3;178;101;86;75;120;82;44;25;78;16;171;175;113;31;145;52;143;117;108;18;69;139;115;118;176;80;122,6404273817941368188,0.078212
greedy_intra:nodes_start:random,45,87820,40393,47427,591288,419,106;1;101;26;100;70;112;4;84;123;148;49;138;14;144;62;9;102;52;55;179;92;57;167;124;79;133;135;154;180;53;63;176;137;186;23;139;41;193;181;48;54;177;115;89;183;143;0;117;68;46;151;121;97;2;120;31;16;171;175;113;81;196;185;40;165;90;164;7;21;108;18;159;22;146;34;160;184;131;149;162;86;75;44;25;78;145;129;152;94;80;118;42;43;116;65;59;51;15;178,5907218528026937945,0.071457
greedy_intra:nodes_start:random,46,84781,36049,48732,613350,472,144;14;49;102;94;133;154;180;121;26;97;1;178;3;165;27;90;40;185;106;167;124;152;2;25;56;31;78;145;92;179;196;81;113;175;171;16;57;55;52;9;15;186;23;89;183;143;117;108;18;22;146;181;116;65;47;131;149;123;162;59;118;151;79;63;120;44;129;137;153;0;51;127;70;135;53;100;101;75;86;112;84;184;42;41;159;193;34;54;177;48;160;43;115;139;46;176;80;148;62,6288033065911719145,0.085557
greedy_intra:nodes_start:random,47,89720,39980,49740,914896,492,112;4;10;177;54;118;137;62;9;15;89;183;143;46;198;139;41;5;181;146;22;159;193;68;23;186;144;102;124;79;133;63;26;100;154;135;70;127;162;72;59;115;69;18;108;140;93;117;0;176;80;94;152;129;92;57;52;106;165;40;185;196;179;145;78;31;25;44;120;75;101;1;97;86;53;180;149;131;47;77;43;116;65;16;171;175;113;2;151;184;160;34;42;51;148;49;14;178;55;123,2112196640817581066,0.090953
greedy_intra:nodes_start:random,48,87141,35612,51529,653342,488,94;63;133;151;51;0;143;117;108;18;22;118;80;79;122;176;93;140;68;46;139;115;42;41;193;159;181;34;177;4;112;123;75;31;113;175;171;16;2;1;101;86;121;158;70;127;135;154;180;53;152;179;185;40;165;14;144;102;62;9;49;55;52;106;178;15;114;186;23;148;167;19;189;100;26;97;129;57;92;82;120;44;25;78;145;136;162;65;43;160;54;184;116;59;109;153;183;89;137;124,4182815881343796012,0.087896
greedy_intra:nodes_start:random,49,86475,35960,50515,965965,492,184;160;34;181;139;183;89;21;7;164;27;90;40;81;196;113;175;171;16;44;120;82;167;37;9;62;102;144;15;137;51;118;59;43;42;146;22;18;159;193;41;151;133;79;122;94;185;119;165;186;23;114;92;145;179;106;178;3;138;14;49;148;124;189;97;129;57;55;52;152;1;2;78;31;56;25;75;101;86;154;180;53;100;26;63;80;176;0;143;117;46;115;116;65;162;135;127;123;149;131,3996292595931073384,0.090836
greedy_intra:nodes_start:random,50,82754,32210,50544,900478,470,176;148;49;178;55;57;92;52;106;165;40;185;145;78;82;75;101;1;97;189;94;63;151;59;41;193;159;139;124;129;31;113;175;171;16;25;44;120;2;152;26;100;86;53;158;180;121;167;102;14;144;62;9;15;186;23;89;183;0;68;181;34;48;160;42;43;184;177;10;54;146;22;18;108;117;143;153;137;80;122;79;133;162;35;84;112;127;70;154;135;123;149;65;116;5;115;46;118;109;51,7104962509293349282,0.086144
greedy_intra:nodes_start:random,51,83514,33962,49552,1139085,483,23;89;183;143;0;139;159;22;18;108;68;46;59;149;131;65;116;42;193;41;115;137;15;144;39;90;165;106;178;49;102;9;62;21;7;164;14;148;133;127;112;84;184;35;123;162;151;43;160;34;181;118;51;176;80;79;63;182;121;53;158;154;70;135;180;101;31;113;175;171;16;44;75;86;100;26;97;94;124;152;1;2;129;92;179;40;119;185;57;82;120;25;78;145;157;81;196;55;52;186,6803762201933865367,0.099445
greedy_intra:nodes_start:random,52,83299,35288,48011,538475,473,27;164;21;183;89;137;176;152;57;179;196;145;92;129;1;97;53;158;180;63;80;0;117;143;23;186;15;49;178;106;52;55;78;31;113;81;14;144;62;9;148;167;124;94;122;79;133;162;127;149;131;65;116;43;42;115;46;68;198;139;41;193;181;34;160;184;35;123;135;70;154;100;26;101;86;121;151;51;118;59;159;108;18;22;54;177;4;112;75;2;120;44;25;16;171;175;185;40;165;90,4989947188171339941,0.077375
greedy_intra:nodes_start:random,53,88710,40918,47792,752505,467,146;181;160;48;54;34;22;18;69;108;93;117;0;143;183;89;31;171;16;75;70;127;123;149;116;115;139;193;41;151;133;79;94;124;9;102;14;144;51;118;59;42;43;65;162;180;86;175;113;196;81;90;165;52;55;57;152;154;135;4;177;184;84;112;63;106;185;40;119;178;3;49;62;15;137;176;80;53;97;2;92;179;145;78;25;1;26;100;101;120;44;129;167;148;114;186;23;46;68;159,3551794956683315454,0.086748
greedy_intra:nodes_start:random,54,84592,36130,48462,1037932,447,44;120;101;1;97;133;162;160;48;184;123;79;63;94;124;26;100;53;180;154;135;127;112;4;84;35;131;51;148;15;9;62;49;52;55;57;179;145;78;75;86;158;70;177;54;34;181;41;89;186;23;137;176;118;115;139;68;140;108;69;18;22;159;193;42;43;59;178;106;185;92;129;2;152;122;80;151;149;47;65;116;46;0;117;143;183;114;144;14;165;40;90;81;196;31;113;175;171;16;25,4333740309971810113,0.085742
greedy_intra:nodes_start:random,55,92514,43110,49404,760709,503,184;84;112;123;1;2;129;57;178;144;46;115;139;68;117;0;143;183;89;23;82;171;175;31;78;92;15;114;186;137;176;80;122;124;148;37;9;62;51;118;41;193;14;165;27;90;119;40;179;145;25;44;120;75;101;26;63;79;133;162;149;65;116;43;160;181;42;59;151;180;158;53;100;97;102;49;3;106;185;81;196;52;55;167;94;154;135;127;70;86;16;113;56;152;108;18;159;22;34;54,2426862984580188823,0.090947
greedy_intra:nodes_start:random,56,89801,40219,49582,940903,483,139;54;177;10;84;80;148;14;138;39;165;185;55;135;123;184;160;34;43;47;65;116;59;118;115;193;159;41;53;86;75;44;25;120;97;121;100;26;1;145;78;82;101;70;127;112;35;131;149;162;79;94;167;57;92;129;2;152;124;137;23;89;183;143;0;9;62;52;179;16;171;175;113;56;31;81;90;40;106;178;49;102;144;117;108;18;22;181;42;5;96;51;151;133;154;180;63;122;176;46,4468884070046974539,0.090145
greedy_intra:nodes_start:random,57,83329,34791,48538,926252,503,143;117;93;108;18;22;34;54;177;10;190;162;80;94;124;26;100;121;53;158;79;122;63;97;1;2;129;92;57;152;135;123;42;159;193;41;118;51;176;148;167;106;178;52;55;31;113;175;171;16;145;179;185;40;138;14;144;137;0;181;160;184;43;116;65;47;131;149;46;68;139;115;59;151;133;180;154;70;127;112;4;84;86;101;75;120;44;78;196;81;90;165;49;102;62;9;15;186;89;183,1969747968726254570,0.093819
greedy_intra:nodes_start:random,58,89276,38343,50933,881426,478,70;127;123;162;51;137;23;186;9;62;144;14;138;3;49;102;15;114;176;80;79;122;124;148;167;178;106;52;55;57;179;196;145;78;129;2;1;97;26;86;101;75;16;175;171;44;120;89;183;143;18;22;159;193;139;0;165;40;185;92;152;100;53;158;154;180;151;118;59;42;43;116;65;131;35;84;149;133;63;94;189;121;136;135;112;184;190;10;177;54;160;34;181;41;115;46;25;31;56;113,4792292305926450496,0.091109
greedy_intra:nodes_start:random,59,82873,33045,49828,718994,428,122;137;23;183;89;186;15;148;97;1;101;86;100;26;2;129;40;119;90;81;196;78;16;171;175;113;56;31;157;14;144;93;108;18;193;41;159;22;146;195;181;115;46;118;51;176;80;94;124;9;62;49;57;92;145;179;55;52;3;138;165;185;106;178;167;79;133;151;162;180;53;75;25;44;120;152;0;170;143;117;68;139;5;42;184;54;34;160;43;116;65;59;149;131;123;127;70;135;154;63,4804761359273732076,0.075350
greedy_intra:nodes_start:random,60,84635,34385,50250,1068204,470,49;52;55;196;157;31;175;113;56;81;90;27;165;152;97;26;100;101;44;16;171;25;120;121;63;122;80;51;109;118;59;116;42;41;193;159;18;108;139;115;133;180;158;53;86;75;78;145;179;92;82;2;1;154;135;149;43;184;48;54;177;112;123;162;176;137;23;183;89;186;15;148;129;57;40;119;185;106;178;167;124;94;79;151;65;160;34;181;146;22;46;0;143;114;144;14;138;102;62;9,8189918915129560044,0.091208
greedy_intra:nodes_start:random,61,83735,35161,48574,753955,470,193;159;18;69;108;140;93;68;46;151;122;94;124;152;113;56;31;78;145;55;52;178;106;165;90;81;196;175;171;16;25;44;120;75;1;97;80;176;0;117;143;183;9;102;49;3;138;14;144;62;186;89;23;137;118;65;116;42;181;22;34;160;184;48;54;177;112;162;133;79;180;135;123;127;70;154;53;100;26;63;149;131;43;5;139;115;51;148;185;119;40;179;57;92;129;2;101;86;59;41,4134230909778850513,0.083352
greedy_intra:nodes_start:random,62,85382,35768,49614,978217,502,144;14;178;106;165;40;185;145;78;25;31;113;175;171;16;44;120;2;80;46;115;109;51;79;63;121;152;167;111;124;176;181;34;160;54;177;70;86;75;101;1;97;26;100;116;42;5;68;93;117;143;0;139;41;193;159;22;18;108;183;89;23;137;15;62;9;148;94;180;135;127;112;84;184;43;47;65;59;118;72;151;133;162;123;35;131;149;154;158;53;129;92;90;81;196;179;57;55;52;49,3195911230394249447,0.090849
greedy_intra:nodes_start:random,63,83875,35683,48192,600033,447,46;68;115;193;41;96;5;42;160;43;116;65;151;79;63;180;154;131;181;22;18;69;108;117;0;143;183;89;186;144;165;90;81;92;124;94;80;176;139;159;146;34;54;162;133;100;26;2;129;97;53;135;127;123;118;59;149;35;84;184;177;10;190;4;112;70;120;25;78;145;179;57;55;52;49;62;9;14;178;3;106;185;119;40;196;31;113;175;171;16;44;75;86;101;1;152;148;23;137;51,7403990235833031322,0.081994
greedy_intra:nodes_start:random,64,83694,34334,49360,964380,504,179;196;145;78;152;46;68;140;108;18;193;5;42;181;146;22;159;41;59;53;100;26;97;63;79;51;0;117;143;183;89;186;49;3;178;106;185;40;90;165;138;14;144;102;9;62;148;124;94;80;176;137;167;52;55;31;56;113;175;171;16;70;127;112;123;135;154;133;151;118;198;139;115;116;65;149;131;35;177;54;48;34;160;184;43;47;162;180;86;75;25;44;120;101;1;2;82;129;92;57,8261216265149467860,0.094581
greedy_intra:nodes_start:random,65,86976,38445,48531,728638,438,183;89;167;57;145;179;106;52;55;92;44;120;75;51;46;68;117;143;23;186;137;59;177;54;48;34;181;41;193;159;195;146;22;18;108;69;118;151;133;180;158;154;135;70;127;123;65;43;116;15;144;21;164;27;90;129;86;53;63;79;162;149;184;160;42;115;139;102;14;138;165;196;78;31;16;171;175;113;56;81;40;185;178;49;62;9;37;148;2;1;101;100;26;97;152;124;94;80;176;0,6944093448680530341,0.081028
greedy_intra:nodes_start:random,66,79960,31144,48816,1141681,506,171;175;113;31;196;179;57;92;129;2;133;151;79;63;122;176;137;0;143;117;68;139;18;22;146;159;193;41;115;184;54;160;34;181;42;43;116;47;65;59;80;94;124;148;15;89;183;46;118;149;131;35;84;177;10;190;4;112;123;127;70;135;154;53;121;100;26;167;186;23;51;72;162;180;86;75;101;1;97;152;185;40;81;90;165;138;49;9;62;144;14;178;106;52;55;145;78;120;44;16,990083841865654342,0.098787
greedy_intra:nodes_start:random,67,87349,39446,47903,774565,441,139;18;108;93;117;176;80;171;175;113;31;49;102;62;9;186;89;183;23;137;59;116;65;35;84;184;160;181;159;193;41;46;0;143;14;106;52;57;82;120;25;55;178;3;167;152;100;53;158;154;43;42;22;146;34;54;177;112;149;151;133;26;97;1;2;129;185;165;39;164;21;144;148;124;94;180;135;70;127;123;162;79;63;40;90;81;196;179;92;145;78;16;44;75;101;86;121;51;118;115,3792186528433946386,0.077259
greedy_intra:nodes_start:random,68,84709,36676,48033,609320,427,31;56;113;175;171;16;44;70;112;4;84;184;35;162;151;176;51;149;131;65;116;59;133;152;129;92;25;120;2;75;101;1;86;53;41;193;146;22;159;139;115;118;62;49;178;196;81;90;165;106;94;122;80;79;63;180;154;135;127;123;177;54;34;160;43;42;181;18;108;117;0;143;183;89;114;186;23;68;46;137;15;9;148;124;121;26;100;97;167;102;144;14;40;185;52;55;57;179;145;78,5870728562304090869,0.080651
greedy_intra:nodes_start:random,69,89513,39352,50161,842596,437,137;23;89;183;143;0;176;94;25;16;171;175;113;56;44;75;86;100;121;182;136;80;51;59;162;151;122;124;2;78;31;196;179;145;129;57;106;178;167;152;1;97;53;158;154;135;70;133;79;63;180;127;123;149;131;42;181;159;22;146;34;160;54;184;43;116;65;47;35;112;4;84;148;15;9;62;49;185;40;90;81;52;55;92;120;101;26;41;193;139;46;144;14;165;164;21;117;68;115;118,8975257650745409705,0.081553
greedy_intra:nodes_start:random,70,89721,39024,50697,897603,485,181;42;43;65;176;57;145;31;113;78;92;129;112;4;177;54;146;22;18;108;93;117;143;183;89;114;15;186;23;118;59;72;151;133;79;94;124;148;37;102;49;52;106;178;14;144;62;9;167;152;97;26;100;121;182;137;0;68;159;193;41;116;180;53;86;158;154;135;123;149;162;63;55;185;165;40;196;175;171;16;25;44;46;198;139;115;51;80;122;189;1;2;120;75;101;70;127;184;160;34,1629264541995255351,0.095844
greedy_intra:nodes_start:random,71,81692,32222,49470,995246,538,2;129;57;62;9;15;137;51;46;139;41;193;159;18;22;146;34;160;181;42;43;149;162;151;118;59;65;116;115;68;117;0;143;183;89;23;186;92;25;78;31;145;179;185;40;119;90;27;164;21;144;14;138;165;81;196;52;55;167;124;100;26;97;152;1;101;86;75;120;44;16;171;175;113;56;157;106;178;49;148;80;194;127;70;135;154;180;158;53;121;63;122;79;133;123;112;84;184;176;94,2817687053392329947,0.091396
greedy_intra:nodes_start:random,72,86268,37444,48824,763089,437,143;183;89;186;23;176;80;122;63;121;53;180;149;131;5;181;146;159;193;41;115;79;100;26;97;189;124;167;49;14;144;62;9;51;118;46;68;137;148;185;40;196;113;175;171;16;75;127;123;35;184;112;4;190;10;177;54;43;47;162;151;59;65;116;42;160;34;22;18;139;94;152;44;25;78;145;179;52;55;57;92;129;2;178;106;165;90;81;157;31;120;1;101;86;154;70;135;133;0;117,401864997577016861,0.081673
greedy_intra:nodes_start:random,73,84188,33419,50769,852163,456,26;100;180;149;131;47;43;42;146;22;18;159;193;139;198;137;148;102;178;106;165;27;90;40;185;196;78;145;179;57;92;129;53;154;135;162;72;59;118;51;176;80;79;63;2;120;31;56;113;175;171;16;25;44;75;86;158;70;127;123;112;84;184;54;160;34;181;41;68;117;170;143;183;89;186;144;14;138;167;124;94;52;55;49;62;9;37;152;1;101;97;23;0;46;115;116;65;151;133;121,5232690795812106978,0.079662
greedy_intra:nodes_start:random,74,85561,35116,50445,951345,428,138;14;144;62;9;102;49;40;119;90;165;162;65;116;41;193;159;181;184;54;160;34;22;18;108;68;46;0;117;143;121;86;75;25;31;78;19;189;152;120;44;16;171;175;113;56;157;196;81;185;167;124;94;122;80;137;23;186;15;148;55;179;145;92;129;82;2;101;1;97;26;100;135;70;127;123;149;131;43;42;115;139;183;89;63;53;154;180;79;133;151;59;118;51;176;57;52;106;178;3,2066061499540086899,0.086084
greedy_intra:nodes_start:random,75,90471,41240,49231,751984,403,54;127;70;53;86;2;57;40;90;81;196;179;133;162;43;34;181;42;5;116;94;124;129;92;25;44;120;75;151;59;118;51;176;80;148;9;62;178;106;52;97;101;1;152;167;102;49;55;145;16;171;175;113;31;78;123;84;177;10;190;4;112;135;154;158;180;63;79;122;121;100;26;137;143;117;68;139;41;115;46;0;183;89;186;15;185;165;14;144;114;23;193;159;22;65;149;131;184;160;48,2917167075307878076,0.073767
greedy_intra:nodes_start:random,76,90138,39221,50917,606605,418,117;143;0;46;135;70;127;123;184;43;131;149;133;196;81;113;31;78;145;25;120;44;16;171;175;152;19;94;189;86;75;101;26;100;121;47;65;116;115;139;193;41;59;79;63;97;1;2;92;129;53;158;154;180;57;55;40;119;185;15;186;35;84;4;112;162;151;137;23;89;183;21;90;27;165;49;102;144;14;178;106;52;167;37;9;62;148;124;122;80;176;51;118;42;160;34;146;22;18;108,1583656396493519479,0.070743
greedy_intra:nodes_start:random,77,82425,31903,50522,1006734,523,123;149;131;43;160;34;22;193;180;158;53;137;89;183;143;117;0;176;122;94;124;148;37;9;62;144;49;102;15;114;186;23;68;41;42;184;84;112;4;10;177;54;127;70;135;154;121;152;129;179;196;81;90;138;14;178;106;55;57;92;145;78;25;82;2;1;97;26;100;86;101;75;120;44;16;171;175;113;56;31;40;165;185;52;167;189;63;79;133;80;51;46;139;115;118;59;116;65;151;162,3746692226432120697,0.094231
greedy_intra:nodes_start:random,78,84015,35122,48893,700831,479,152;148;9;62;3;178;92;78;145;196;81;31;56;113;175;171;16;75;177;54;34;160;184;112;70;86;101;2;129;25;44;120;1;53;154;135;127;123;149;162;151;133;102;49;167;94;63;122;79;80;176;137;23;89;183;143;117;0;46;5;42;41;139;68;108;18;22;159;193;181;43;65;116;115;186;114;15;144;14;138;106;52;55;185;40;165;27;90;179;57;124;51;118;59;72;180;121;100;26;97,3700231458503779342,0.087362
greedy_intra:nodes_start:random,79,84531,34164,50367,628821,435,184;160;34;22;159;193;41;15;102;49;3;106;178;144;14;185;165;39;27;90;119;40;81;196;31;113;171;175;16;25;44;78;145;179;57;92;129;120;2;97;53;180;133;151;51;46;18;108;140;68;118;162;79;63;182;121;100;26;101;75;86;158;154;80;176;94;124;152;167;148;114;186;23;89;183;153;0;143;117;139;115;112;127;70;123;65;116;5;42;43;131;149;135;1;55;52;62;9;137;59,4878894653576984054,0.075222
greedy_intra:nodes_start:random,80,85892,36125,49767,977434,494,116;5;42;43;131;149;112;4;10;177;54;159;69;108;18;22;146;34;160;184;65;51;3;178;106;40;185;52;49;102;37;148;15;9;62;144;14;138;165;90;81;196;57;55;23;89;183;143;117;193;41;59;151;133;80;176;92;145;31;113;175;171;16;44;70;127;123;162;122;94;124;111;167;152;86;158;180;100;26;97;1;101;75;2;120;25;78;129;137;0;46;139;115;118;79;63;121;53;154;135,1790559868491849795,0.092025
greedy_intra:nodes_start:random,81,82755,32451,50304,785412,460,113;175;171;16;112;184;42;160;34;22;159;41;193;18;108;140;93;117;23;186;148;37;179;145;78;31;157;196;81;90;119;40;185;55;52;165;39;138;14;3;178;106;167;124;122;80;176;46;68;139;115;43;65;116;162;133;180;154;158;53;79;137;89;183;143;0;151;135;70;127;123;131;149;59;118;51;9;62;144;102;49;57;92;129;2;1;152;94;63;121;100;26;97;101;86;75;120;44;25;56,651068586922490364,0.090996
greedy_intra:nodes_start:random,82,84805,36015,48790,648852,470,78;25;44;120;2;97;63;122;80;51;118;59;72;176;9;144;14;138;165;90;81;40;185;196;31;113;175;171;16;75;86;100;121;162;35;84;127;70;53;26;101;1;152;180;154;135;123;149;131;43;160;34;22;18;108;140;93;68;46;42;181;146;159;193;41;139;115;116;65;151;79;124;52;55;57;92;129;137;0;143;183;89;186;62;102;49;178;106;148;47;184;54;177;10;4;112;133;94;179;145,3241892229087882205,0.078773
greedy_intra:nodes_start:random,83,88366,38555,49811,878063,428,55;52;148;37;49;102;62;9;15;186;143;117;0;152;2;120;25;78;196;81;90;27;165;40;185;57;75;86;100;94;137;23;89;183;46;41;193;34;160;184;35;176;144;14;178;106;167;124;122;151;72;109;51;80;63;97;101;26;121;180;162;123;112;177;54;48;116;59;118;149;131;65;43;42;181;146;22;159;18;139;115;133;79;1;129;92;145;113;175;171;16;158;70;127;135;154;53;44;56;31,2982877678004858941,0.081103
greedy_intra:nodes_start:random,84,86485,38354,48131,729915,473,75;120;25;44;97;26;121;53;180;63;122;79;94;124;100;86;101;1;152;2;129;57;179;40;185;9;117;18;22;34;160;181;42;116;59;162;51;118;46;68;139;193;159;146;54;48;41;115;137;23;89;183;143;0;176;80;167;52;106;178;62;15;186;114;144;14;49;102;148;65;43;184;177;10;190;4;112;127;70;55;165;90;81;196;145;56;113;175;171;16;31;78;92;133;151;149;131;123;135;154,4646048532749139283,0.087738
greedy_intra:nodes_start:random,85,88980,39499,49481,670477,434,106;52;55;92;129;124;5;42;43;123;53;121;100;26;152;185;119;40;145;16;171;175;113;56;31;78;179;14;144;183;143;0;117;68;116;65;162;158;86;75;44;25;120;101;97;1;2;57;165;90;81;196;94;63;122;137;23;89;186;62;9;148;160;181;159;193;41;115;118;72;151;154;180;133;109;46;139;18;22;146;34;54;177;184;59;51;176;80;79;135;70;127;112;84;35;131;149;102;49;178,2350258019474685646,0.074180
greedy_intra:nodes_start:random,86,89520,40425,49095,863417,438,55;106;178;3;167;124;79;133;151;59;118;51;80;176;0;170;143;117;68;139;46;115;116;65;149;43;42;184;123;86;44;25;16;171;175;113;56;31;81;196;148;137;193;159;22;146;41;180;154;158;53;121;100;26;152;2;78;145;14;144;15;186;23;89;183;108;18;9;62;165;90;40;185;63;162;112;84;160;34;54;177;4;127;70;135;102;49;52;179;92;82;120;75;101;1;97;189;94;129;57,1787852508682145793,0.078338
greedy_intra:nodes_start:random,87,85116,36368,48748,1054709,507,54;30;177;10;4;70;158;53;121;94;124;152;97;1;101;26;180;162;43;42;115;118;176;9;62;144;14;3;178;106;52;55;179;185;40;165;90;81;196;31;113;175;171;16;44;89;183;0;68;18;108;93;117;143;49;57;92;145;78;120;75;86;123;149;65;116;47;131;35;184;139;46;137;148;129;82;25;2;80;51;59;151;133;79;63;154;135;127;112;84;160;181;146;22;159;193;41;195;34;48,89394666404439785,0.094097
greedy_intra:nodes_start:random,88,86716,38407,48309,896771,484,25;44;82;92;57;55;52;179;196;40;165;14;49;152;97;100;121;63;80;176;26;101;1;129;78;145;81;90;119;185;106;178;167;115;41;193;139;137;144;102;148;162;123;149;184;160;181;159;117;143;0;118;59;5;42;22;18;108;68;46;135;70;154;180;94;124;15;114;186;23;89;183;62;9;34;54;177;10;190;4;112;35;43;116;65;51;151;133;79;53;86;75;2;120;31;56;113;175;171;16,6539827868675410859,0.090509
greedy_intra:nodes_start:random,89,93032,43118,49914,685453,397,21;90;81;56;31;157;196;91;179;129;44;25;78;16;171;175;113;145;92;57;167;80;51;118;59;149;131;151;133;180;154;158;86;101;55;52;106;178;102;37;148;34;160;43;65;116;115;183;89;9;62;49;144;15;23;68;18;108;93;117;143;0;176;94;124;2;82;120;75;79;41;193;22;139;46;14;165;40;185;135;123;162;63;121;152;1;97;26;100;53;70;127;112;4;177;184;42;137;186;114,1102107159685747618,0.070505
greedy_intra:nodes_start:random,90,88233,38538,49695,852567,478,54;177;184;112;123;162;136;179;196;81;57;176;139;193;159;146;22;18;115;51;124;148;9;62;102;167;97;26;100;151;59;118;46;0;117;143;183;185;40;119;90;165;14;144;15;186;137;80;63;180;154;135;127;70;75;44;31;56;113;175;171;16;82;23;89;114;49;178;106;52;55;189;121;53;158;86;101;1;2;129;92;145;78;25;120;152;94;122;79;133;149;65;116;43;5;42;41;181;34;160,2923240441620011624,0.091769
greedy_intra:nodes_start:random,91,89437,38677,50760,885713,450,175;113;31;106;49;9;137;46;115;118;151;133;136;182;121;86;101;1;2;185;40;165;90;81;196;145;92;94;79;162;65;116;5;159;22;34;181;42;43;59;124;111;167;3;178;52;55;57;129;148;186;23;0;108;18;139;51;176;80;122;63;100;26;97;152;37;62;102;14;144;89;183;143;117;68;193;41;120;25;78;82;123;149;131;184;160;177;4;112;127;70;135;154;180;158;53;75;44;16;171,1637855044637997855,0.085564
greedy_intra:nodes_start:random,92,99035,47799,51236,806773,451,1;101;86;26;100;121;189;9;102;49;196;78;25;120;2;183;143;117;0;137;130;124;12;186;114;15;62;144;14;3;178;167;122;151;59;118;51;31;56;113;175;171;16;44;75;112;84;184;131;149;148;37;55;57;92;129;53;65;116;10;177;54;34;22;159;193;41;52;185;40;165;106;94;162;123;127;70;135;154;180;79;80;23;89;115;42;181;160;43;133;152;145;179;176;46;68;18;139;63;97,8901900721636433132,0.086872
greedy_intra:nodes_start:random,93,84224,35060,49164,1277127,505,51;151;133;63;94;124;167;62;9;37;148;15;186;23;137;80;79;180;158;53;121;97;1;92;196;81;90;165;14;102;144;73;183;89;114;49;3;152;26;100;101;2;129;57;55;52;185;40;106;178;162;42;181;34;160;54;184;43;47;65;116;115;139;108;18;68;176;120;16;171;175;113;31;145;78;25;44;75;86;154;135;70;127;123;149;131;112;4;177;22;159;193;41;59;118;46;0;143;117;93,2110161654469419115,0.101771
greedy_intra:nodes_start:random,94,89913,41033,48880,787890,421,10;190;84;183;89;23;137;176;51;59;22;18;108;93;16;171;175;113;55;52;178;106;179;145;44;25;78;196;40;119;90;27;165;14;144;148;124;94;80;42;160;48;54;184;118;9;62;102;49;3;185;81;31;120;75;101;26;100;53;63;122;79;180;154;57;92;129;2;127;112;35;41;139;198;46;115;43;116;65;47;131;149;123;162;151;133;135;70;86;1;97;152;0;143;117;68;193;181;34;177,8531814947414804631,0.076195
greedy_intra:nodes_start:random,95,88833,38133,50700,705457,447,124;148;186;23;46;193;159;93;117;143;0;153;183;89;137;51;151;162;127;123;149;59;118;189;16;171;175;113;31;40;185;52;55;57;92;82;25;44;120;75;101;86;158;180;65;116;41;139;68;140;108;18;22;42;5;115;114;15;62;9;167;152;97;26;100;121;53;154;194;131;43;160;34;54;184;84;112;78;145;179;129;2;1;70;135;133;176;102;144;14;90;165;106;178;49;80;79;122;63;94,6713540074023324879,0.077233
greedy_intra:nodes_start:random,96,85421,36267,49154,847910,433,129;25;16;171;175;78;145;55;52;167;152;97;121;53;158;180;94;124;3;106;178;49;102;148;51;5;42;181;34;22;18;68;46;118;59;43;184;84;112;4;177;54;160;185;165;90;39;138;14;144;62;9;15;186;137;23;89;183;143;117;0;176;79;70;127;123;149;131;116;65;162;151;133;135;154;86;75;101;1;26;100;189;63;115;41;193;159;139;80;2;120;44;31;56;113;196;81;40;57;92,2195477288000052578,0.083971
greedy_intra:nodes_start:random,97,83918,35134,48784,1110461,493,1;97;152;94;176;51;118;41;193;159;18;108;140;93;0;9;62;49;102;114;89;183;143;117;68;139;115;46;137;23;186;15;144;14;138;3;178;106;148;63;180;154;135;149;131;42;181;22;146;34;160;43;116;65;59;165;27;90;81;196;113;175;171;16;25;44;120;75;86;100;53;70;127;123;162;151;133;79;80;124;167;55;52;185;40;31;78;145;179;57;92;129;2;35;184;84;112;121;26;101,3139928665153327373,0.092661
greedy_intra:nodes_start:random,98,83766,34027,49739,771741,458,18;159;22;146;181;131;149;154;180;158;53;136;63;133;162;123;127;70;16;171;175;113;31;25;44;120;78;185;106;23;183;89;186;15;138;165;40;196;145;179;55;52;178;14;144;148;137;176;80;122;94;124;49;102;62;9;167;97;1;101;86;75;2;82;129;92;57;152;79;151;51;59;118;46;68;140;93;117;143;0;115;116;65;121;26;100;135;112;184;177;54;48;34;160;43;42;41;193;139;108,7815753807963569174,0.078842
greedy_intra:nodes_start:random,99,84095,35891,48204,757418,426,63;94;62;144;21;7;164;95;39;165;106;178;80;79;121;100;26;86;101;1;2;82;129;57;55;52;167;152;97;53;112;184;54;34;160;137;49;185;119;40;145;78;25;44;120;92;179;196;81;90;14;102;148;176;133;151;51;118;59;65;116;115;46;183;89;23;186;15;9;31;56;113;175;171;16;75;154;135;70;127;123;149;131;43;42;181;41;193;159;22;18;108;93;117;143;0;68;139;162;180,8176468899258666456,0.080994
greedy_intra:nodes_start:random,100,94393,44578,49815,735974,404,149;131;65;51;176;102;49;57;129;2;152;62;9;148;124;94;80;137;23;153;0;117;46;151;133;180;158;53;97;1;120;92;145;185;40;119;106;167;193;159;146;22;18;108;69;139;115;118;79;63;121;26;100;154;135;127;84;177;10;190;4;112;70;86;101;55;52;178;3;59;116;42;160;184;43;44;25;175;171;16;123;35;54;34;41;68;93;143;183;89;186;15;144;14;165;113;31;78;75;162,8952942654316830320,0.073561
greedy_intra:nodes_start:random,101,90992,40378,50614,915407,495,1;101;100;53;70;127;112;123;133;79;122;94;55;52;185;106;178;167;124;149;131;35;184;48;54;177;10;190;4;84;47;59;118;117;143;170;0;23;137;46;139;193;41;116;65;162;121;26;97;152;102;49;3;138;14;144;62;9;43;42;181;34;160;135;154;180;63;80;176;51;109;183;89;186;148;179;145;31;113;175;25;120;44;16;171;78;92;129;75;86;151;115;108;18;22;159;165;40;57;2,856032308949473771,0.088500
greedy_intra:nodes_start:random,102,86956,37500,49456,1020832,447,86;70;127;135;154;158;180;79;63;121;100;26;97;129;57;52;106;178;3;167;124;43;160;181;42;59;118;72;162;149;131;65;116;115;46;68;117;143;23;186;179;145;196;15;114;89;183;153;0;18;22;34;54;177;184;84;112;123;53;75;120;44;25;78;92;94;80;176;137;148;9;62;102;49;14;144;51;139;159;193;41;151;133;2;82;16;171;175;113;31;81;90;165;119;40;185;55;152;1;101,4113706415745052703,0.097199
greedy_intra:nodes_start:random,103,88676,38963,49713,704019,415,151;18;22;34;181;42;116;65;59;118;137;183;89;186;23;46;68;198;139;159;193;41;5;43;149;162;148;9;62;144;14;138;90;81;196;113;175;171;16;1;80;51;115;160;54;184;35;135;75;78;56;31;145;92;2;152;167;178;106;165;119;40;185;179;129;120;44;25;57;55;52;49;102;121;26;100;53;180;154;70;127;112;4;123;63;189;124;94;122;79;176;0;117;143;114;15;86;101;97;133,7381204244845026166,0.076144
greedy_intra:nodes_start:random,104,87036,37512,49524,1024603,492,81;90;165;40;185;57;92;129;152;51;109;118;46;117;143;183;89;137;176;80;151;149;131;123;135;158;75;44;25;16;171;78;120;2;97;94;122;116;43;42;181;22;159;115;144;14;178;106;52;124;184;84;112;127;70;154;180;79;133;162;65;59;63;86;101;1;26;100;53;177;54;48;160;34;41;193;199;18;108;69;139;68;0;23;186;114;15;62;9;37;148;167;102;49;55;179;145;31;175;113,7320507679077985693,0.084767
greedy_intra:nodes_start:random,105,88810,38331,50479,659364,434,167;148;37;9;62;21;7;164;90;165;106;178;49;14;144;114;139;159;22;146;181;42;43;116;92;145;78;175;171;16;44;75;86;162;59;115;0;170;143;117;68;46;51;176;80;94;124;129;57;55;15;137;118;65;149;131;123;194;135;154;180;121;1;2;52;185;40;31;120;101;26;100;53;158;70;127;112;184;41;193;160;48;177;54;34;18;108;93;183;89;186;23;151;133;79;122;63;189;97;152,8343695091988656526,0.083055
greedy_intra:nodes_start:random,106,83374,34958,48416,737675,427,57;2;94;124;167;62;144;14;102;152;86;70;127;35;184;43;65;116;42;159;193;41;131;149;135;180;154;53;63;80;46;108;18;139;115;59;118;51;133;79;122;148;9;15;176;151;162;123;112;4;190;10;177;54;160;34;22;68;117;0;143;183;89;186;23;137;100;26;97;129;92;179;196;157;31;78;145;82;1;101;75;120;185;40;165;27;90;81;25;44;16;171;175;113;49;3;178;106;52;55,2932723359146248849,0.077149
greedy_intra:nodes_start:random,107,86685,38031,48654,611365,446,81;40;165;39;138;178;167;124;94;53;180;154;158;101;2;129;92;145;78;16;171;175;113;56;31;25;44;120;75;86;100;63;79;151;162;133;26;97;1;152;49;102;62;9;176;59;42;181;160;184;177;54;48;34;18;108;93;117;0;143;183;89;46;115;118;51;137;23;186;148;189;121;135;70;127;123;65;116;146;22;159;55;52;106;185;90;27;164;14;144;80;149;131;43;41;193;139;57;179;196,5833443712035098220,0.073936
greedy_intra:nodes_start:random,108,88162,38073,50089,675396,402,80;0;117;143;183;89;93;68;46;109;51;151;162;123;127;70;135;94;97;1;2;78;145;25;120;124;116;41;193;159;18;108;23;186;15;148;137;59;131;149;133;79;31;113;175;171;16;44;75;65;43;184;54;160;34;22;181;42;5;115;139;198;118;176;167;57;82;129;92;179;185;196;81;90;165;138;102;49;52;106;178;3;9;62;144;14;119;40;55;152;101;86;26;100;121;53;154;180;63;122,378502070969602204,0.074315
greedy_intra:nodes_start:random,109,85755,34343,51412,787513,451,25;44;120;2;1;26;100;70;127;123;162;180;145;78;31;16;171;175;113;56;157;196;165;39;138;49;122;63;79;133;80;176;137;23;186;15;102;144;14;167;121;53;158;136;148;37;62;9;51;118;115;5;42;22;159;193;41;139;46;0;117;143;183;89;124;94;97;101;86;75;129;179;81;90;119;40;185;152;189;151;59;149;65;116;43;160;34;54;177;184;112;135;154;178;106;52;55;57;92;82,1637287401885245331,0.079199
greedy_intra:nodes_start:random,110,82767,33110,49657,592651,397,31;145;179;92;129;82;120;2;189;121;100;26;101;44;25;16;171;175;113;185;106;49;62;9;15;114;186;89;183;143;170;117;0;51;133;79;94;124;167;102;144;14;138;165;119;40;27;90;81;196;57;154;135;127;123;116;43;42;159;193;41;139;46;23;137;118;59;65;149;131;54;177;4;112;184;160;34;22;18;108;68;115;151;162;180;158;97;1;152;55;52;178;148;176;80;63;53;86;75;78,908631194943400399,0.069085
greedy_intra:nodes_start:random,111,87099,38011,49088,811717,477,184;112;127;70;75;44;25;92;57;148;23;137;68;139;159;193;41;16;113;175;171;120;2;121;53;154;180;63;133;79;122;94;124;129;145;78;31;196;179;52;106;178;3;165;39;164;27;90;40;185;55;135;123;59;118;46;115;116;65;43;42;160;54;34;181;195;146;22;18;108;93;51;176;80;144;14;49;102;62;114;89;183;153;0;117;143;186;15;9;167;152;97;1;101;86;100;26;151;162;149,5301250636091258807,0.090560
greedy_intra:nodes_start:random,112,86253,37121,49132,1138258,519,102;49;14;21;164;39;165;106;178;3;167;1;86;154;135;162;149;123;127;70;179;40;119;27;90;81;185;144;23;68;139;193;41;80;16;171;175;113;56;31;157;196;145;78;25;44;120;82;92;129;2;152;94;176;137;89;183;143;0;46;115;118;59;151;133;79;121;100;26;101;75;57;55;52;97;53;158;180;63;124;148;15;186;117;108;18;159;22;146;34;160;54;184;42;43;116;65;51;9;62,620523366125533585,0.107975
greedy_intra:nodes_start:random,113,88287,39897,48390,740771,437,116;43;131;149;59;118;137;23;89;186;176;133;135;70;154;180;158;53;100;101;120;44;16;175;171;78;92;129;152;97;162;123;42;22;18;108;51;80;121;86;75;25;196;81;40;185;106;178;62;15;183;143;170;0;117;68;46;139;159;34;54;177;10;4;112;127;55;52;179;145;31;56;113;124;94;184;160;181;193;41;115;9;102;49;167;148;144;14;138;165;27;90;57;2;1;26;63;79;151;65,6297562723259173723,0.074355
greedy_intra:nodes_start:random,114,89876,41462,48414,814581,470,49;62;9;176;80;79;135;70;154;180;63;122;115;139;18;22;159;193;41;68;46;23;186;148;167;152;97;26;100;1;101;75;86;121;53;133;151;0;117;143;183;89;15;55;179;31;56;113;92;35;184;42;43;116;65;2;120;175;171;16;44;25;78;145;196;81;90;164;21;14;144;137;51;118;59;149;123;162;94;124;106;178;3;138;165;119;40;185;52;160;34;54;177;10;4;112;127;158;129;57,6021065452597522507,0.083297
greedy_intra:nodes_start:random,115,89017,37057,51960,761707,470,55;167;124;12;94;121;53;180;154;135;162;151;133;178;3;14;144;62;9;102;49;8;119;40;185;179;92;57;52;106;148;0;46;139;115;80;189;97;1;101;26;100;152;186;23;137;176;122;182;136;63;79;51;118;59;65;116;184;112;127;70;86;2;165;90;27;39;138;15;89;183;143;117;18;22;181;42;43;131;149;41;193;34;160;54;123;75;16;171;175;78;145;129;120;44;25;113;56;31;196,312073287729843517,0.081612
greedy_intra:nodes_start:random,116,84381,34855,49526,679636,407,68;116;47;65;112;123;127;194;135;70;154;180;158;53;100;26;1;2;82;129;152;124;94;63;79;133;162;149;131;118;137;15;144;102;62;9;148;37;49;178;3;14;138;106;57;92;25;44;120;97;46;139;159;193;41;115;86;101;75;16;78;145;179;40;196;113;175;171;31;81;90;165;185;55;52;167;186;23;89;183;143;0;184;54;177;151;80;176;51;59;43;42;181;160;48;34;146;22;18;108,4930103363623985444,0.072157
greedy_intra:nodes_start:random,117,86139,37769,48370,773905,454,177;10;190;35;94;178;106;52;55;179;57;129;2;101;180;154;162;59;51;176;80;148;102;49;14;165;90;40;185;144;23;143;117;93;68;139;193;41;118;9;62;15;186;89;183;46;115;43;116;65;131;149;152;92;145;78;75;86;158;53;97;1;120;25;31;113;175;171;16;44;133;151;79;63;121;100;26;137;0;140;108;69;18;159;22;146;195;181;42;123;135;70;127;112;4;84;184;160;34;54,8440803277118629428,0.081698
greedy_intra:nodes_start:random,118,87012,36519,50493,809093,459,180;100;26;94;124;55;52;185;40;90;27;39;165;106;57;92;145;78;129;2;79;133;151;118;59;116;65;149;131;195;146;22;159;193;139;143;183;144;14;3;178;49;176;137;23;186;62;9;148;167;152;97;101;1;120;44;171;175;16;75;86;121;63;80;51;68;93;117;170;0;46;115;43;177;54;42;5;96;41;181;34;160;48;184;123;162;196;81;113;31;25;53;158;70;127;112;4;84;135;154,1180309344604197511,0.084766
greedy_intra:nodes_start:random,119,85317,36285,49032,959378,443,135;123;35;184;84;86;26;100;53;133;151;72;59;118;0;117;93;108;69;18;22;159;193;65;162;154;180;63;122;148;15;144;14;138;165;40;90;81;196;145;78;75;101;1;97;152;89;183;143;68;139;115;116;51;80;120;44;25;16;171;175;113;56;31;179;57;55;52;106;178;3;9;62;102;49;185;92;129;2;79;149;131;42;41;46;137;23;186;124;94;176;47;43;160;34;54;177;112;127;70,8243991424407775238,0.082287
greedy_intra:nodes_start:random,120,91233,41584,49649,798704,448,51;193;159;22;41;115;97;1;101;86;26;100;80;117;93;140;108;18;69;163;139;68;46;59;72;162;135;70;154;180;63;79;133;151;47;131;149;53;2;78;31;196;145;82;75;127;177;54;34;160;184;84;112;123;14;165;90;40;185;52;179;92;44;25;113;175;171;16;120;43;42;116;65;118;23;186;15;9;62;144;114;89;183;143;0;137;167;55;57;129;152;94;124;148;102;49;3;178;106;176,4335354466420846136,0.077425
greedy_intra:nodes_start:random,121,89389,40988,48401,1203776,500,186;15;57;179;55;52;185;165;90;119;40;106;178;148;137;115;41;193;139;117;0;151;133;135;127;123;149;131;184;35;70;16;171;175;113;56;31;80;160;34;54;177;112;158;100;152;167;49;102;62;9;176;51;59;118;46;68;108;18;22;146;43;154;53;86;75;120;44;25;78;145;196;81;138;14;144;124;94;79;63;121;26;97;1;92;129;82;2;101;180;162;65;116;42;181;159;143;183;89;23,5155624079287635602,0.095588
greedy_intra:nodes_start:random,122,84814,36534,48280,1158055,513,135;75;44;25;16;171;175;113;31;176;51;59;65;116;43;181;159;193;41;46;9;62;102;49;14;144;15;137;115;5;42;160;34;146;22;0;183;89;114;186;23;143;117;93;108;18;139;118;80;100;26;97;101;86;154;149;131;112;4;190;10;177;54;184;151;79;63;182;121;53;158;180;94;124;148;178;196;81;90;165;40;185;106;52;55;179;57;152;1;2;129;92;145;78;120;133;162;123;127;70,715919605918399072,0.101042
greedy_intra:nodes_start:random,123,88679,36808,51871,858060,457,196;81;113;175;171;31;78;176;46;0;117;143;183;89;23;186;15;148;124;94;122;79;63;121;100;26;97;101;1;152;178;3;49;102;9;137;51;118;115;139;68;140;108;18;22;159;193;41;160;184;112;44;16;25;120;75;70;135;80;37;62;144;14;138;165;90;119;40;185;179;92;82;2;86;158;53;129;57;55;52;106;167;136;180;154;65;116;43;42;59;72;162;151;149;131;123;127;133;189;145,3133269761287157206,0.086455
greedy_intra:nodes_start:random,124,92564,42821,49743,1232120,469,193;159;22;18;108;68;137;52;55;179;57;167;140;93;117;143;186;114;144;102;62;118;54;177;112;123;127;70;86;101;2;120;82;129;92;138;14;49;3;178;152;63;162;149;42;181;34;160;75;44;16;171;175;25;97;121;133;151;79;122;80;23;89;183;0;46;115;65;131;35;184;43;116;59;51;176;106;185;165;40;196;113;31;78;145;1;26;100;53;158;154;135;180;94;124;148;9;15;139;41,709104798776726570,0.107881
greedy_intra:nodes_start:random,125,89235,40274,48961,1016550,530,31;113;175;171;16;75;86;101;2;57;52;55;167;124;152;129;92;179;185;40;165;106;97;180;127;112;184;177;54;160;43;65;133;79;151;72;59;41;193;117;0;143;183;89;186;15;62;9;148;189;53;158;154;135;70;123;116;159;22;146;34;181;42;5;115;137;23;114;21;90;81;196;145;1;26;100;121;162;149;131;51;176;49;102;144;14;178;25;44;120;63;80;118;139;18;68;46;94;82;78,8044822637711996169,0.096560
greedy_intra:nodes_start:random,126,84644,35381,49263,757940,474,119;165;14;144;15;80;133;151;162;149;131;65;116;59;51;176;137;23;186;114;178;3;49;102;62;9;148;37;167;57;92;25;16;171;196;81;90;106;124;94;79;63;26;97;1;152;118;43;42;18;22;146;181;160;184;35;123;44;175;113;56;31;157;179;145;78;82;120;2;75;101;86;53;180;115;46;68;117;143;183;89;153;0;139;41;193;159;34;54;177;112;127;70;135;154;129;55;52;185;40,73761327848569339,0.082604
greedy_intra:nodes_start:random,127,85206,36620,48586,834489,490,68;46;137;167;52;55;53;154;70;135;180;121;148;9;15;186;89;183;115;139;193;41;131;149;151;80;122;124;94;63;79;65;43;160;34;48;54;177;10;184;84;112;127;123;162;97;82;92;179;81;90;119;185;106;178;62;23;108;18;22;181;42;116;133;100;26;86;75;120;44;25;78;145;31;16;171;175;113;196;40;165;14;144;102;49;57;129;2;101;1;152;189;176;51;59;118;0;143;117;93,7726205824757476502,0.088053
greedy_intra:nodes_start:random,128,87812,37664,50148,881841,474,171;175;113;31;145;137;193;159;22;41;65;149;127;180;53;100;26;101;2;57;55;52;106;178;167;124;94;152;129;92;82;1;97;189;79;133;162;123;112;184;43;116;59;151;80;176;51;46;68;18;108;93;117;23;148;37;49;3;14;138;165;119;40;81;90;21;144;102;62;9;15;186;122;63;121;86;120;44;25;78;196;185;114;89;183;153;143;0;139;181;34;160;42;115;118;135;70;154;75;16,8537965509491075723,0.089800
greedy_intra:nodes_start:random,129,91511,42309,49202,903376,448,14;165;90;40;180;154;158;53;189;124;102;144;49;167;152;97;1;129;92;78;145;179;185;196;31;113;175;171;94;176;0;117;143;183;89;137;79;80;122;63;121;100;26;178;106;52;55;57;2;101;86;51;46;139;159;193;41;42;43;116;75;120;25;16;44;70;112;84;35;131;65;59;23;186;15;62;9;148;115;5;181;160;184;123;127;135;133;162;72;118;68;108;18;22;146;34;54;177;149;151,3010761444243341204,0.088138
greedy_intra:nodes_start:random,130,87065,37909,49156,741792,450,139;193;41;42;115;80;124;148;9;62;152;97;26;1;101;86;100;53;176;0;117;68;46;63;180;154;75;120;44;25;82;2;43;181;159;22;146;160;184;84;112;79;122;94;102;49;3;178;106;52;55;57;92;129;78;31;56;113;175;171;16;167;23;143;183;89;144;165;90;40;196;145;179;185;14;15;186;137;118;116;47;65;59;109;51;151;133;162;135;70;127;123;149;35;177;54;48;34;18;108,2913030969640975082,0.076942
greedy_intra:nodes_start:random,131,87547,38891,48656,797448,443,178;179;145;78;55;52;196;81;31;113;175;171;16;25;44;120;2;152;115;46;68;117;143;0;176;1;97;189;122;80;151;133;79;63;94;124;37;9;62;15;186;23;137;183;89;114;57;92;129;184;160;34;181;159;193;41;5;42;43;180;53;121;167;14;165;90;40;185;106;51;118;59;149;131;127;70;135;154;86;75;101;26;100;162;65;116;139;108;18;22;146;54;177;4;112;123;148;144;102;49,1416377351708765040,0.077405
greedy_intra:nodes_start:random,132,90935,41169,49766,1009161,470,46;139;115;116;65;35;112;4;177;54;34;48;184;151;145;78;113;56;31;179;57;63;79;133;180;154;135;162;149;131;123;127;70;53;2;129;82;120;1;97;189;124;148;14;144;89;0;93;140;108;18;22;193;41;3;178;106;185;165;40;81;196;52;55;94;122;80;176;51;118;42;160;43;59;175;171;16;75;101;86;100;26;152;167;49;102;62;9;15;114;23;186;92;25;44;137;183;143;117;68,6188911222146092288,0.088329
greedy_intra:nodes_start:random,133,84093,34832,49261,974033,476,49;3;178;106;97;26;189;46;68;108;18;22;146;159;139;117;0;143;183;89;23;137;176;63;121;86;101;82;145;179;185;52;55;57;92;129;1;100;53;162;59;118;51;80;79;122;94;124;152;2;120;44;25;78;90;164;21;144;148;167;135;127;123;149;131;65;43;160;34;54;184;84;112;70;154;158;180;133;151;115;41;193;42;116;75;16;171;175;113;31;157;196;81;40;119;165;14;102;62;9,3731793668902789980,0.088867
greedy_intra:nodes_start:random,134,88191,39274,48917,1022850,482,80;79;122;94;124;186;23;89;183;0;46;118;51;63;121;26;100;158;180;151;59;65;131;149;162;154;75;78;145;179;14;102;15;114;41;193;159;146;181;42;144;21;164;90;81;40;119;165;185;101;86;70;135;53;152;49;178;106;52;55;57;2;1;97;129;92;196;31;56;113;175;171;16;25;44;120;167;62;9;148;133;123;127;112;184;43;47;116;115;139;108;18;22;34;160;68;117;143;137;176,5150375430505383044,0.083413
greedy_intra:nodes_start:random,135,88752,40246,48506,636839,471,22;18;108;139;46;118;151;180;53;100;97;152;129;92;145;179;49;186;23;68;93;117;0;143;183;89;167;82;44;25;113;175;171;16;75;86;121;122;79;133;162;43;42;181;159;193;59;63;26;101;1;2;57;55;165;90;81;31;78;120;154;70;123;84;160;34;54;177;4;112;127;135;94;124;148;9;15;137;176;51;115;41;5;116;65;80;52;185;40;106;178;3;14;144;62;149;131;35;184;146,2461845245991207724,0.077157
greedy_intra:nodes_start:random,136,84406,34634,49772,737509,443,26;80;176;118;43;184;160;54;177;10;190;4;84;35;112;127;70;154;180;162;59;115;139;41;193;181;34;146;22;159;42;116;65;97;1;101;129;57;55;52;106;178;3;49;62;15;183;153;0;143;117;68;46;144;14;138;102;9;137;149;131;123;135;53;86;121;63;79;94;124;152;16;171;175;113;31;196;145;78;25;44;120;75;2;92;179;40;90;165;185;167;148;186;23;89;51;72;151;133;100,5567575926962551638,0.074240
greedy_intra:nodes_start:random,137,90032,39597,50435,690524,437,75;86;158;154;180;79;0;117;143;176;80;122;2;120;44;25;78;196;81;90;165;178;106;185;40;138;14;137;41;193;183;89;144;102;152;97;26;100;53;162;149;131;184;84;112;123;127;70;135;133;151;118;115;5;42;43;116;65;63;182;121;101;1;189;94;124;23;186;15;9;62;113;175;171;16;51;46;68;139;108;18;159;22;146;34;160;59;148;49;3;52;55;179;145;157;56;31;92;57;129,3741282733405613672,0.074823
greedy_intra:nodes_start:random,138,92779,42667,50112,891345,496,97;1;101;2;129;92;120;75;86;100;26;94;122;80;93;140;108;69;18;159;5;151;133;154;180;53;121;152;55;52;167;124;42;34;160;43;116;148;9;62;144;106;178;183;22;146;181;44;25;78;145;57;185;49;102;14;165;40;31;113;175;171;16;143;117;0;51;109;118;59;115;41;193;139;198;68;46;123;127;70;135;79;176;186;23;137;65;184;48;54;177;10;190;4;112;35;131;149;162;63,2105105841601411655,0.090808
greedy_intra:nodes_start:random,139,84250,35362,48888,958671,500,2;129;57;167;148;37;49;14;165;40;90;81;196;185;106;178;52;55;179;92;145;78;31;113;175;171;16;44;120;75;162;65;116;43;42;160;48;35;94;9;62;15;186;89;183;143;0;23;137;46;18;22;146;159;68;117;114;144;102;152;1;97;26;63;79;149;131;123;135;154;70;127;112;4;10;177;184;47;59;51;176;80;133;151;72;118;115;139;193;41;5;181;34;54;84;180;53;100;86;101,5378946009339943481,0.094988
greedy_intra:nodes_start:random,140,86850,37629,49221,774796,426,145;92;179;52;14;49;102;26;100;86;129;57;55;62;9;114;186;15;144;165;40;185;106;178;167;116;42;181;22;146;34;160;54;177;184;43;65;149;131;112;4;84;35;59;118;51;176;80;122;63;53;158;180;154;135;70;121;124;148;23;89;183;143;139;18;159;123;127;162;133;79;152;78;157;81;90;27;196;25;120;2;151;5;41;193;115;46;0;137;94;97;1;101;75;44;16;171;175;113;31,502119042696355693,0.080486
greedy_intra:nodes_start:random,141,87579,38758,48821,823076,479,198;46;176;80;122;94;124;44;25;16;171;175;113;31;145;78;120;75;35;184;177;54;34;146;22;18;108;186;15;49;3;178;52;55;57;129;2;152;167;9;62;144;14;165;90;81;106;148;23;140;93;117;143;183;89;137;84;4;112;70;158;53;26;86;101;1;92;40;185;97;100;121;151;65;116;43;160;42;59;118;5;115;41;193;159;181;149;162;133;79;63;180;154;135;127;123;51;0;68;139,3844379439903511926,0.088287
greedy_intra:nodes_start:random,142,87809,38726,49083,805821,461,48;54;177;184;42;43;116;59;80;167;55;16;171;175;113;56;31;25;44;100;53;158;154;180;162;65;41;193;159;22;18;108;139;46;148;178;3;138;14;144;15;186;23;89;0;117;143;183;49;106;81;196;120;75;86;101;1;97;152;94;124;9;62;137;93;140;68;51;176;52;165;90;40;185;122;133;149;131;123;127;70;135;121;26;2;129;92;57;179;145;78;82;63;79;151;118;115;181;34;160,2460982544378849154,0.086561
greedy_intra:nodes_start:random,143,86084,36960,49124,557258,423,80;176;137;79;63;136;53;158;154;70;135;180;152;185;40;14;144;186;89;183;143;23;148;124;94;189;26;100;86;101;75;2;120;44;16;171;175;113;31;179;55;52;178;106;165;90;81;196;145;78;92;57;129;108;18;193;41;42;43;5;115;139;68;117;0;51;151;149;131;65;59;118;72;123;127;112;4;84;184;177;54;48;34;160;46;15;102;49;62;9;159;22;146;181;116;162;133;121;1;97,7980777826090383674,0.068906
greedy_intra:nodes_start:random,144,90953,40647,50306,893356,448,97;100;63;79;176;137;186;23;41;193;22;34;54;177;10;101;1;129;57;14;144;102;62;9;15;114;46;139;115;118;53;86;75;44;16;171;175;25;120;26;158;70;135;154;180;122;80;51;59;65;149;131;84;4;112;127;123;35;184;160;42;43;116;106;185;165;39;27;90;81;113;56;31;78;89;183;143;117;0;124;152;2;82;179;40;119;196;145;92;167;94;133;162;151;148;49;3;178;52;55,9074294137964162542,0.085455
greedy_intra:nodes_start:random,145,88045,38218,49827,610614,412,178;94;79;80;0;117;46;115;137;23;89;183;143;93;68;139;146;103;34;181;42;59;51;176;49;14;138;106;185;40;165;90;81;196;171;16;25;44;167;148;152;97;26;100;86;2;82;120;75;101;1;124;186;15;144;102;62;9;180;127;112;4;84;123;133;63;179;145;175;113;56;31;78;108;18;22;159;193;41;160;184;43;105;116;65;47;131;149;162;151;135;70;154;158;53;129;92;57;55;52,4232302677999376877,0.077068
greedy_intra:nodes_start:random,146,82487,33344,49143,885416,509,40;185;183;68;139;198;115;151;79;63;121;97;152;1;26;100;101;75;86;180;53;129;92;55;178;106;52;57;179;145;78;31;56;16;171;175;113;81;90;21;144;186;23;118;59;46;0;143;117;93;140;108;18;34;160;184;131;149;162;133;135;127;123;112;4;190;10;177;54;48;41;193;159;22;146;181;42;5;43;116;65;154;120;44;25;2;124;94;122;80;176;51;109;137;148;9;62;49;14;165,3435205454831032186,0.094127
greedy_intra:nodes_start:random,147,87028,37315,49713,815059,469,49;14;144;51;118;184;84;190;10;177;22;146;34;30;54;48;160;181;43;42;5;41;193;159;139;68;46;162;135;70;127;112;116;115;137;9;62;15;183;143;117;93;140;0;89;148;113;175;171;16;120;63;59;65;131;149;123;154;180;53;121;189;152;185;40;165;90;31;78;25;44;75;101;1;2;145;179;92;129;97;26;100;86;57;55;52;106;178;102;186;23;176;80;151;133;79;122;94;124;167,3603572344621795607,0.087317
greedy_intra:nodes_start:random,148,79677,30353,49324,1397520,573,18;108;117;0;143;183;89;114;186;23;137;94;189;97;1;101;179;196;81;119;165;27;90;40;185;62;9;148;124;26;100;121;135;123;181;22;146;34;160;149;162;79;122;63;180;154;158;53;152;167;49;144;14;3;178;106;52;55;57;92;145;78;31;56;113;175;171;16;25;44;120;129;2;75;86;70;127;112;177;54;184;84;35;131;65;116;43;42;41;193;68;46;59;51;176;80;133;151;115;139,5312830896998290276,0.118223
greedy_intra:nodes_start:random,149,89856,40208,49648,686094,450,16;171;175;113;40;119;106;151;162;133;79;94;55;52;108;18;22;146;34;54;177;112;70;158;86;101;75;2;129;92;57;167;124;176;137;183;89;23;78;145;185;165;14;49;178;1;26;100;53;154;135;180;63;97;152;62;9;148;51;118;59;41;193;159;43;116;47;131;149;65;115;139;68;170;143;117;93;140;0;153;46;5;42;160;48;184;123;80;15;144;21;90;81;196;157;31;82;120;44;25,8729411521670061665,0.077633
greedy_intra:nodes_start:random,150,86353,36463,49890,701319,457,82;92;179;40;185;89;183;143;139;115;41;193;195;181;160;177;10;54;48;34;146;22;18;159;42;43;116;65;162;154;1;2;196;81;90;165;137;51;151;133;180;53;101;44;25;56;113;175;171;16;75;135;123;149;131;184;112;127;70;86;120;78;31;157;145;152;189;124;94;80;176;0;117;46;118;59;79;63;136;182;121;100;26;97;167;148;49;102;62;9;15;114;144;14;106;178;52;55;57;129,3370180042368900460,0.074806
greedy_intra:nodes_start:random,151,82773,33404,49369,893263,409,183;143;0;117;68;41;193;22;146;43;131;149;123;135;154;158;86;75;2;129;92;57;55;179;145;25;44;120;94;63;79;80;176;51;118;46;115;116;65;151;121;97;152;185;165;40;31;56;113;175;171;16;78;52;106;178;3;49;167;148;124;133;162;4;112;127;70;101;1;26;100;53;180;139;108;18;159;181;5;42;184;160;34;54;177;10;190;84;59;137;23;15;9;62;102;14;144;114;186;89,973183138897129442,0.079889
greedy_intra:nodes_start:random,152,83860,35027,48833,600234,442,180;53;2;129;78;16;171;175;113;56;31;196;145;55;52;57;92;82;44;25;120;75;154;135;123;65;115;89;186;23;15;62;102;40;185;106;178;49;167;152;97;1;101;86;26;100;121;133;151;116;43;42;159;193;41;139;46;68;143;183;21;164;27;90;39;165;138;14;144;9;148;124;162;54;160;34;146;22;18;108;93;117;0;137;94;63;122;59;118;51;176;80;79;70;127;112;84;184;131;149,2434165828168522056,0.071102
greedy_intra:nodes_start:random,153,91449,41275,50174,817168,437,94;124;167;57;92;129;2;101;1;106;178;49;102;186;23;137;176;148;52;55;179;145;78;184;160;34;146;181;43;47;131;149;65;59;118;72;151;162;123;4;112;70;75;171;175;113;31;40;165;185;97;26;100;63;79;133;51;46;0;143;117;93;140;68;80;152;120;25;16;44;86;53;116;42;5;41;193;159;22;18;108;139;115;183;89;114;64;15;9;62;144;14;154;135;35;54;177;84;127;180,4086396156848569971,0.089253
greedy_intra:nodes_start:random,154,87391,38242,49149,746828,457,43;115;68;117;143;183;89;80;79;63;121;26;101;1;97;124;148;137;18;108;93;186;144;14;138;102;9;176;51;198;139;41;193;159;22;146;34;160;48;190;10;177;54;42;15;62;49;178;165;90;81;31;113;175;171;16;57;55;23;0;46;118;59;72;151;152;92;78;145;196;40;185;106;52;94;133;162;123;127;70;75;44;25;120;2;86;100;53;158;180;154;135;112;84;184;131;149;47;65;116,1841438501001968743,0.083126
greedy_intra:nodes_start:random,155,86318,36261,50057,642335,455,90;165;40;179;145;92;57;124;94;122;79;133;177;54;160;181;42;51;12;167;178;106;185;52;55;49;102;144;62;9;148;15;46;68;117;0;143;183;89;186;23;137;176;80;63;121;53;180;151;59;116;65;47;43;5;139;115;118;56;113;175;171;16;75;41;193;22;146;34;184;131;149;162;123;127;70;135;154;100;26;86;1;101;120;44;25;78;31;157;81;196;129;2;97;152;14;21;7;164;27,5925477750517139578,0.075094
greedy_intra:nodes_start:random,156,89005,37818,51187,945594,468,40;165;138;14;57;92;129;1;97;189;19;152;82;145;78;25;75;70;112;4;177;54;184;35;167;178;106;52;55;124;94;122;79;133;162;151;72;51;148;9;62;15;186;89;183;137;176;80;63;182;121;86;120;44;16;31;157;196;90;81;56;113;175;171;131;43;42;181;160;34;22;18;159;193;41;139;118;59;115;46;49;144;143;0;116;65;149;123;127;135;154;180;158;53;100;26;101;2;179;185,1054166544494524982,0.091225
greedy_intra:nodes_start:random,157,84248,34132,50116,1022608,498,41;193;159;22;139;68;117;143;0;51;151;162;112;4;84;35;135;63;167;106;52;55;92;57;49;102;15;89;183;46;181;34;160;42;116;65;47;184;177;54;48;43;77;149;131;123;127;70;154;121;178;39;90;81;113;175;171;16;44;120;2;129;185;40;119;165;138;14;144;62;9;148;152;97;94;124;186;23;137;176;80;79;86;75;25;145;179;196;31;78;1;101;26;100;53;158;180;133;59;115,8559278949389860551,0.093711
greedy_intra:nodes_start:random,158,84590,34877,49713,798114,414,133;154;135;70;127;123;112;4;190;10;177;54;48;23;186;114;15;62;9;148;124;94;121;100;26;189;102;49;167;152;2;129;92;57;55;52;81;90;165;40;185;63;122;80;51;59;131;149;43;42;181;22;146;34;160;184;65;144;14;3;178;106;97;1;101;86;75;120;44;25;16;171;175;113;31;196;179;145;78;53;158;180;79;176;137;0;139;193;41;116;162;151;118;115;46;68;117;143;183;89,6669348961608698675,0.080383
greedy_intra:nodes_start:random,159,87655,37665,49990,941975,491,97;1;2;120;25;44;75;101;86;180;133;59;115;41;193;108;18;22;159;139;23;186;51;118;5;42;184;177;10;4;112;129;92;57;40;185;52;55;181;34;160;43;116;151;145;78;16;171;175;113;31;81;90;165;106;178;49;15;89;183;143;0;46;68;140;93;117;137;12;124;100;26;152;167;14;144;62;9;148;176;72;65;47;131;149;162;123;127;70;135;154;158;53;121;189;94;122;80;79;63,360097633628589301,0.089837
greedy_intra:nodes_start:random,160,88664,39447,49217,805582,468,146;181;123;127;135;154;86;75;16;175;113;81;90;165;57;1;97;79;151;118;46;198;115;116;47;131;149;162;133;122;124;62;9;148;94;63;180;158;53;101;2;55;52;14;144;186;23;137;183;143;0;43;184;48;160;41;139;68;93;117;176;80;152;129;92;179;185;40;196;145;120;44;25;78;171;31;106;178;49;51;59;5;193;159;69;108;18;22;34;54;177;4;112;70;100;26;121;65;42;195,3784287823708099503,0.089988
greedy_intra:nodes_start:random,161,88081,39225,48856,659370,436,22;146;181;59;51;176;80;44;25;92;89;183;143;0;46;115;116;65;162;53;86;75;101;121;79;151;149;131;184;48;160;42;43;133;120;16;171;175;113;31;78;49;14;39;27;90;185;55;167;148;124;94;26;97;152;144;21;164;165;119;40;81;196;145;179;52;106;3;178;57;129;2;1;100;158;70;112;4;177;54;34;193;41;137;15;62;9;122;63;180;154;135;127;123;139;68;93;140;108;18,3899650265583337091,0.076812
greedy_intra:nodes_start:random,162,85700,35013,50687,744454,411,131;43;42;5;116;162;151;80;63;26;101;97;189;124;94;122;79;133;112;4;10;177;54;48;34;22;193;41;152;44;25;16;171;175;113;106;178;52;129;2;1;100;154;135;70;127;123;184;160;118;137;9;167;179;145;78;31;196;81;90;138;14;144;23;46;115;139;68;117;0;143;183;89;186;15;148;53;158;180;136;121;86;75;120;82;92;57;55;185;40;119;165;49;102;62;176;51;59;65;149,6365866412915070204,0.079910
greedy_intra:nodes_start:random,163,84702,35329,49373,914947,481,123;133;26;1;2;120;44;25;16;171;175;113;31;78;145;179;57;55;52;106;178;14;165;90;81;196;40;185;167;124;63;135;127;70;129;92;49;144;108;18;22;115;118;109;51;176;80;148;9;62;152;97;100;53;158;182;136;180;154;121;189;94;137;23;186;89;183;143;0;117;181;34;160;131;149;162;86;75;101;79;151;59;43;42;5;41;193;159;139;68;46;116;65;35;184;54;177;10;4;112,4286780083326806187,0.089843
greedy_intra:nodes_start:random,164,87509,36963,50546,892642,483,57;31;113;175;171;16;44;75;86;101;97;1;2;120;25;78;145;179;92;129;26;100;121;53;158;136;63;79;178;106;185;40;138;14;144;89;183;143;0;46;115;5;181;34;160;190;10;177;54;48;184;151;80;176;9;62;102;49;37;12;94;124;167;3;165;90;164;21;139;193;159;22;18;108;41;42;43;51;186;15;52;55;152;180;154;194;162;118;59;116;65;149;123;127;135;70;133;137;23;148,752036282018624998,0.090232
greedy_intra:nodes_start:random,165,93263,43863,49400,592880,406,185;165;14;144;15;118;116;131;149;162;133;151;18;22;159;193;41;139;49;178;55;57;101;100;180;123;184;160;34;181;167;52;40;90;81;31;56;113;175;44;120;75;86;26;124;137;23;89;183;46;115;5;42;43;59;51;176;9;62;148;80;65;47;35;112;127;79;63;53;158;154;135;70;4;10;177;30;54;84;121;152;129;92;145;78;171;16;2;1;97;189;94;0;93;140;117;143;186;102;106,6827878121497646101,0.068615
greedy_intra:nodes_start:random,166,86175,36980,49195,676335,484,106;167;94;63;122;79;149;131;43;65;133;1;44;25;78;145;179;178;3;49;14;144;62;9;80;123;112;4;177;54;181;42;5;69;108;18;193;41;159;195;22;146;34;160;184;127;70;135;194;162;151;72;118;51;176;148;55;57;120;75;86;101;97;26;100;180;154;53;129;92;196;81;90;2;152;124;137;0;117;143;183;89;46;139;115;116;59;23;186;15;102;52;16;175;171;113;31;185;40;165,2288854626490192350,0.084420
greedy_intra:nodes_start:random,167,88161,39051,49110,720835,441,113;175;171;16;44;25;179;40;119;185;167;162;149;160;184;84;112;75;120;129;92;57;55;52;106;178;14;144;49;102;62;9;79;127;123;176;137;23;0;93;108;18;69;139;51;80;63;121;1;165;90;81;196;145;78;2;152;124;94;53;158;154;135;70;131;43;42;181;146;22;159;193;41;115;116;47;65;59;118;46;68;117;143;183;148;97;101;86;26;100;180;133;151;72;5;34;54;177;31;56,6344090511068353953,0.081388
greedy_intra:nodes_start:random,168,83759,35748,48011,646794,429,40;185;31;25;120;82;2;1;86;70;190;10;177;54;184;160;34;146;22;181;133;63;94;124;106;178;3;176;43;42;5;41;193;159;139;135;154;180;79;80;51;59;116;65;131;149;162;151;118;115;46;68;18;108;117;0;143;183;89;102;49;14;144;62;9;15;186;23;137;148;167;52;55;57;179;145;78;92;129;152;97;53;127;112;4;84;123;100;26;101;75;44;16;171;175;113;81;90;27;165,3330241513009391280,0.077904
greedy_intra:nodes_start:random,169,88360,39416,48944,734965,448,148;124;162;149;65;184;35;123;127;135;154;94;167;49;3;178;106;152;26;86;101;2;129;92;179;145;78;16;31;196;9;89;183;23;137;176;51;109;198;139;41;5;43;42;181;34;146;22;159;193;68;143;0;46;116;160;54;177;112;70;53;52;185;40;119;62;117;108;18;115;118;59;151;186;15;144;165;90;81;113;175;171;25;44;120;75;158;180;133;80;79;63;121;100;97;1;57;55;14;102,2554999850896566323,0.080840
greedy_intra:nodes_start:random,170,88902,39471,49431,704956,428,143;117;93;139;159;193;41;46;94;152;129;55;52;179;145;78;120;2;1;97;79;151;72;59;5;42;160;54;177;10;190;185;40;90;27;165;49;186;23;0;68;115;176;80;63;53;180;154;70;84;35;131;149;51;137;109;118;65;116;43;123;162;133;100;26;101;75;44;16;171;175;113;31;25;86;158;135;127;112;4;184;34;22;18;108;89;15;9;62;102;144;14;138;3;178;106;57;92;148;183,3031267993218791712,0.077437
greedy_intra:nodes_start:random,171,88112,37378,50734,692007,445,14;144;102;9;79;133;123;35;184;84;112;127;70;135;154;121;97;2;129;57;55;52;15;186;89;183;143;117;0;23;62;49;3;106;178;37;148;152;101;75;86;65;42;181;34;160;43;131;149;162;151;196;81;90;27;165;138;94;80;176;51;118;59;116;41;159;22;18;193;139;115;46;137;185;179;92;120;1;26;100;53;158;180;63;122;12;124;167;145;78;31;56;25;44;16;171;175;113;40;119,4979866793396578714,0.078736
greedy_intra:nodes_start:random,172,90518,40939,49579,747959,471,149;65;59;151;133;136;121;97;152;167;49;102;9;116;43;47;131;127;70;120;78;145;92;148;23;0;143;183;89;186;144;14;1;101;86;26;100;176;117;108;18;22;159;193;115;79;63;53;158;180;162;35;184;48;160;181;42;80;94;124;57;196;81;90;165;52;55;129;2;112;4;10;177;54;34;41;139;68;46;118;109;51;137;15;62;178;106;185;40;31;113;175;171;16;44;75;154;135;123;24,1384663056002198826,0.085850
greedy_intra:nodes_start:random,173,89623,39830,49793,696918,432,14;49;102;137;116;65;59;51;176;167;178;106;40;185;52;55;80;151;160;54;184;127;70;75;44;16;171;175;113;31;78;25;120;86;121;63;122;94;152;2;129;57;92;145;90;165;144;0;46;68;139;41;181;34;42;5;43;47;77;35;84;131;149;194;154;180;133;162;123;177;10;4;112;135;158;53;148;9;62;15;186;89;23;124;97;1;101;26;100;79;118;115;193;159;22;18;108;117;143;183,8876049371024961437,0.079243
greedy_intra:nodes_start:random,174,86844,38124,48720,657207,430,53;121;167;178;106;165;90;40;185;52;115;68;93;117;0;46;139;22;146;34;177;4;112;162;133;79;176;80;122;2;129;57;92;145;78;25;120;135;123;35;184;160;181;42;43;131;149;5;193;18;108;140;143;144;14;49;9;148;124;94;26;100;86;75;101;1;152;97;158;154;70;127;84;54;48;159;41;116;65;63;44;16;171;175;113;31;179;55;62;15;186;89;183;23;137;51;118;59;151;180,1283476148842673704,0.077883
greedy_intra:nodes_start:random,175,87948,39642,48306,938955,478,1;2;82;129;152;35;184;177;54;160;34;181;42;116;92;145;196;81;90;165;14;102;148;79;151;65;149;162;133;63;94;55;185;40;119;49;167;180;154;135;123;59;118;51;80;124;78;31;16;171;175;113;56;157;179;52;106;3;178;57;25;44;120;70;127;112;115;46;68;117;0;143;183;89;114;144;62;9;15;186;23;137;176;93;140;108;18;139;41;193;159;22;43;53;100;26;86;75;101;97,9074912575318042181,0.089402
greedy_intra:nodes_start:random,176,86887,37942,48945,771413,444,5;181;34;160;42;43;47;133;136;121;26;97;152;167;49;102;15;186;23;137;148;55;52;178;106;165;90;164;7;21;144;62;9;135;70;127;112;84;35;123;180;100;1;2;129;92;57;94;80;176;0;143;18;22;54;177;10;184;131;149;65;115;41;193;159;139;46;183;89;14;185;40;81;196;179;145;78;82;25;44;120;75;101;86;53;158;154;162;59;118;51;63;16;171;175;113;31;79;151;116,4219346128179102889,0.074522
greedy_intra:nodes_start:random,177,90055,39561,50494,520944,420,129;82;120;1;101;86;53;180;154;158;100;26;152;15;186;89;183;143;0;176;80;151;51;109;59;149;131;43;160;48;34;181;193;22;18;108;117;23;144;165;90;40;138;14;102;49;3;178;106;37;9;62;55;52;185;179;92;2;97;121;63;133;46;198;115;118;122;94;124;167;57;145;78;25;75;135;70;127;65;116;112;4;177;54;184;123;162;44;16;171;175;113;31;79;42;41;139;68;137;148,250840256059906765,0.071339
greedy_intra:nodes_start:random,178,90230,40773,49457,745565,440,22;159;176;97;1;101;75;86;180;118;46;69;18;108;140;93;68;139;42;5;59;80;94;152;120;44;25;16;78;145;23;183;89;186;15;57;55;52;138;14;144;148;124;79;123;112;4;177;54;43;133;63;100;26;2;92;179;40;165;185;129;53;158;154;135;70;127;149;131;47;65;116;115;41;193;181;160;184;84;35;162;151;51;0;117;143;137;9;62;49;178;106;196;31;113;175;171;34;103;146,2560802241190657084,0.081688
greedy_intra:nodes_start:random,179,86233,36649,49584,952619,467,25;44;78;145;129;2;121;133;151;115;41;193;159;22;18;108;117;143;57;92;120;101;152;124;137;23;186;144;14;165;90;40;185;52;55;46;139;68;0;183;89;114;178;106;49;102;37;148;9;62;15;176;51;59;116;65;131;149;162;80;122;94;97;1;86;26;100;53;154;135;123;35;184;48;34;30;54;177;10;190;160;181;42;43;79;63;136;180;84;4;112;127;70;158;75;16;171;175;113;31,1162406995093715664,0.090132
greedy_intra:nodes_start:random,180,86695,38001,48694,845397,483,129;92;57;55;94;79;133;149;131;184;42;43;118;137;62;106;185;40;165;90;81;196;31;78;120;75;70;4;10;177;54;48;34;160;84;112;102;49;3;138;14;144;186;23;0;68;41;193;159;22;18;108;139;115;51;176;80;124;167;178;52;179;145;25;44;16;171;175;113;86;53;154;135;127;123;46;117;143;183;89;15;9;148;152;97;26;100;121;182;63;151;59;116;65;47;162;180;101;1;2,6401816225529494420,0.091425
greedy_intra:nodes_start:random,181,80945,31717,49228,724654,428,14;124;94;136;158;53;121;100;26;97;152;167;148;9;62;15;186;23;89;183;143;0;51;80;176;137;144;102;49;178;52;55;57;179;196;40;185;106;2;75;86;101;1;120;82;129;92;145;78;25;44;189;63;118;59;5;42;160;184;43;115;139;46;68;117;93;108;18;22;159;193;41;181;34;54;177;10;4;112;84;35;149;151;79;133;162;116;65;123;127;135;154;180;16;171;113;175;31;90;165,2201861486930246624,0.072211
greedy_intra:nodes_start:random,182,89970,37645,52325,806174,446,75;158;70;127;149;46;117;143;183;114;144;21;164;90;39;138;14;102;62;51;116;65;151;133;49;3;178;106;185;52;55;167;124;79;80;176;137;148;171;175;113;196;40;119;165;81;56;16;44;120;2;94;122;63;182;121;100;26;1;101;86;53;180;154;135;43;42;41;115;118;59;162;123;112;184;160;34;22;193;139;0;89;23;186;15;9;57;92;82;129;152;19;189;97;145;179;157;31;78;25,3063349062277881055,0.077631
greedy_intra:nodes_start:random,183,86620,37937,48683,930896,452,94;176;51;139;41;115;116;47;149;131;5;42;184;35;190;10;177;54;34;181;59;79;152;2;120;44;16;171;175;113;56;31;196;81;90;165;40;185;106;75;70;127;135;154;53;180;162;193;159;22;18;108;117;49;178;3;14;144;183;143;0;153;89;186;23;46;68;114;15;62;9;167;100;26;97;1;101;86;63;133;151;65;43;160;48;84;4;112;123;80;137;148;52;55;57;92;145;78;25;129,6955117620469127012,0.084211
greedy_intra:nodes_start:random,184,86625,36995,49630,708490,473,46;186;114;137;162;112;4;177;54;160;184;131;149;65;116;59;62;144;49;14;165;185;106;3;178;52;179;31;56;113;171;175;16;75;151;118;115;193;41;96;5;42;43;123;127;70;180;135;133;79;63;182;121;100;26;86;101;124;23;89;183;143;117;93;0;148;120;44;25;92;57;167;94;154;158;53;78;145;196;81;90;40;55;129;2;1;97;152;80;176;51;68;18;22;146;34;181;195;159;139,7804447363546976698,0.090539
greedy_intra:nodes_start:random,185,85678,37280,48398,710025,453,68;93;117;0;143;183;15;178;106;52;55;167;123;84;177;10;190;4;112;127;70;63;97;101;1;49;62;9;37;148;176;65;47;116;59;51;137;23;89;186;57;179;92;129;2;152;124;94;162;35;184;54;48;115;139;193;41;131;149;135;154;180;53;100;26;86;75;120;16;171;175;113;31;44;25;78;145;185;40;90;27;165;14;144;108;18;159;22;146;34;160;181;42;43;80;79;133;151;118;46,1182930956429972989,0.075458
greedy_intra:nodes_start:random,186,83712,35754,47958,957979,472,171;16;25;44;63;133;180;158;53;75;120;2;1;97;94;124;152;101;86;100;26;129;92;57;55;179;145;78;31;196;81;90;165;40;185;52;106;178;3;49;62;9;137;118;59;46;140;93;117;143;183;89;114;15;186;23;0;68;139;115;42;160;48;34;181;146;22;159;65;162;151;123;112;4;177;54;184;43;149;127;135;70;154;121;167;148;102;14;144;176;51;116;41;193;18;108;80;79;113;175,2421879688114978425,0.090448
greedy_intra:nodes_start:random,187,87703,39744,47959,828067,447,116;43;42;181;22;146;34;160;184;131;149;124;167;178;106;94;63;112;4;10;177;54;84;35;59;62;9;148;176;80;122;79;133;151;118;115;139;68;46;51;86;75;101;1;100;26;97;152;55;52;165;27;90;81;145;78;16;171;175;113;31;196;40;185;179;120;70;127;123;194;135;154;137;186;23;117;108;18;159;193;41;0;143;183;89;15;102;44;25;92;14;144;49;57;129;2;53;180;162;65,6621359719917298329,0.080142
greedy_intra:nodes_start:random,188,86104,34880,51224,731157,454,90;81;196;171;16;44;25;78;31;56;113;175;120;75;152;148;9;62;102;144;15;114;59;65;47;116;46;0;143;139;115;149;123;135;154;158;100;97;1;2;55;52;57;129;92;145;179;40;119;185;106;178;124;94;79;133;162;131;43;5;42;181;160;127;70;86;101;26;63;41;193;22;34;54;177;4;112;84;35;184;118;183;89;186;23;137;176;122;80;51;72;151;180;53;121;189;167;49;14;165,7414898522164121820,0.084762
greedy_intra:nodes_start:random,189,87575,37525,50050,952305,453,129;44;25;145;179;102;62;9;23;89;183;143;0;68;198;115;5;42;116;65;149;162;79;63;94;185;40;165;90;31;78;1;97;26;80;46;139;41;193;181;43;123;194;127;112;84;184;160;34;22;159;18;108;93;117;144;14;138;52;55;57;152;4;177;54;59;176;148;15;114;186;137;51;109;118;151;133;135;70;180;154;158;53;136;121;100;86;101;75;16;171;175;113;120;2;167;49;178;106;92,8178007940436355880,0.082475
greedy_intra:nodes_start:random,190,86433,35614,50819,777215,441,86;75;44;25;92;106;3;178;55;57;129;82;97;189;94;12;148;37;124;152;2;120;78;16;171;175;113;56;31;157;179;52;49;167;1;101;26;100;121;63;51;118;59;42;5;181;34;160;54;177;184;162;151;133;80;15;9;62;102;14;144;186;23;117;18;22;159;43;149;123;65;116;115;41;193;139;46;137;185;40;90;27;164;95;39;165;119;81;196;145;53;180;154;135;79;176;0;143;183;89,1034665544961618063,0.086887
greedy_intra:nodes_start:random,191,86231,37157,49074,753951,422,180;154;70;127;112;84;35;131;149;43;184;160;48;177;54;34;146;22;18;108;117;0;189;100;86;101;1;129;57;49;102;62;9;80;51;59;42;116;65;162;133;121;26;97;124;23;186;15;144;14;31;175;113;56;157;196;81;90;27;165;179;145;78;25;92;55;52;185;40;106;178;148;176;46;115;118;94;152;2;120;44;171;16;75;158;135;123;41;193;159;139;143;183;89;137;151;79;122;63;53,7882785573925213538,0.074809
greedy_intra:nodes_start:random,192,88745,40744,48001,782919,479,129;97;121;51;118;115;139;22;159;193;41;42;43;184;10;177;54;160;34;146;18;108;140;93;117;68;46;15;62;3;178;106;185;14;144;9;148;137;176;80;180;154;135;70;127;123;149;162;26;1;57;55;52;49;102;167;101;86;75;44;120;2;152;94;124;186;23;89;0;143;183;21;164;90;165;59;116;65;78;113;175;171;16;25;100;63;79;151;133;158;53;92;179;40;81;196;157;56;31;145,5164627581391073007,0.083587
greedy_intra:nodes_start:random,193,81915,32673,49242,826549,495,186;9;62;102;49;167;148;94;122;80;0;143;117;18;159;193;41;68;183;89;114;15;144;14;138;185;40;90;165;106;178;52;55;57;92;179;31;78;145;129;82;120;2;152;124;176;118;59;162;123;112;177;48;160;42;43;65;116;5;181;22;34;30;54;184;35;127;70;135;154;180;158;53;79;133;51;46;139;115;151;63;121;97;1;101;44;16;171;175;113;56;81;196;25;75;86;100;26;137;23,2366752620308451244,0.089567
greedy_intra:nodes_start:random,194,87859,39044,48815,829407,470,148;102;49;106;119;40;185;52;55;26;100;53;180;135;123;43;184;54;177;4;112;127;70;154;44;25;171;16;86;139;41;193;22;146;34;160;42;116;65;133;79;23;89;183;143;0;46;176;80;94;2;82;120;75;101;1;97;152;167;178;165;90;81;157;56;113;175;31;196;138;14;144;62;9;15;114;186;137;51;118;59;151;63;129;92;78;145;179;57;124;162;149;131;47;115;68;117;93;108;18,8443370971555499439,0.088680
greedy_intra:nodes_start:random,195,85105,33911,51194,759551,427,154;180;53;100;26;179;185;40;165;39;27;90;81;31;56;113;175;171;16;78;145;25;86;121;63;133;79;14;138;106;178;167;137;46;68;117;170;143;183;89;51;43;184;160;34;54;177;4;112;70;158;152;57;55;52;92;129;2;1;97;101;75;44;120;124;94;80;151;162;149;47;65;116;42;41;193;22;18;0;23;186;15;9;62;144;155;102;49;37;148;176;72;59;118;139;115;131;123;127;135,1774939020333053606,0.077044
greedy_intra:nodes_start:random,196,86037,37126,48911,1102212,545,94;180;154;158;53;196;81;90;165;40;185;179;145;92;129;97;151;72;59;123;127;135;75;44;25;120;2;152;167;148;37;14;144;15;137;176;80;122;63;79;133;162;149;65;116;43;42;181;159;193;41;139;108;18;22;146;34;177;10;4;112;70;100;26;86;101;1;57;55;52;106;178;3;49;102;9;62;143;170;0;117;68;46;51;124;78;31;113;175;171;16;184;54;160;115;118;183;89;23;186,2837399748293152596,0.109333
greedy_intra:nodes_start:random,197,87891,39120,48771,784036,484,139;41;193;108;18;22;181;42;116;78;175;171;16;44;86;100;26;1;101;75;120;25;113;31;49;14;165;90;40;185;106;3;178;52;55;179;145;92;152;115;159;146;34;48;54;177;10;4;112;123;127;70;148;9;62;144;102;124;94;122;0;117;143;15;167;57;129;2;97;35;184;160;43;65;131;149;151;133;79;80;176;137;183;89;114;186;23;51;118;59;162;135;154;180;158;53;121;63;46;68,3072623407728245990,0.084750
greedy_intra:nodes_start:random,198,87365,37387,49978,846622,468,146;22;18;159;193;41;115;137;23;186;114;144;21;7;164;14;178;49;102;118;59;149;123;180;53;100;26;97;1;2;129;57;55;52;15;46;68;139;5;42;184;112;127;70;158;92;145;31;56;113;175;171;16;196;40;165;27;90;81;78;25;44;120;75;101;86;121;182;63;94;124;167;62;9;37;148;79;80;176;51;0;117;143;183;89;151;133;162;194;135;154;152;179;185;106;65;116;43;160;34,3402442841367303357,0.084145
greedy_intra:nodes_start:random,199,86811,37040,49771,997707,469,51;44;25;31;157;81;196;78;120;75;158;154;180;53;100;26;86;101;1;97;80;176;137;23;186;57;92;129;2;63;151;162;127;70;135;133;79;122;94;152;55;52;106;178;49;89;183;143;0;117;68;139;18;159;193;41;5;42;43;116;59;118;16;171;175;113;14;144;62;15;114;148;37;9;102;165;90;40;185;179;145;82;121;123;112;160;181;22;146;103;34;54;177;184;131;149;65;115;198;46,534393455117637706,0.092527
greedy_intra:nodes_start:greedy,0,70693,22488,48205,55513,4,0;117;143;183;89;186;23;137;176;80;79;63;94;124;152;97;1;101;2;120;82;129;92;57;55;52;49;102;148;9;62;144;14;3;178;106;185;40;165;90;81;196;179;145;78;31;56;113;175;171;16;25;44;75;86;26;100;121;53;180;154;135;70;127;123;162;133;151;51;118;59;65;116;43;184;84;112;4;190;10;177;54;48;160;34;146;22;18;108;69;159;181;42;5;193;41;115;139;68;46,2591166406018146370,0.002003
greedy_intra:nodes_start:greedy,1,71783,23594,48189,17144,2,1;101;75;86;53;154;70;135;180;63;79;133;51;118;59;115;46;0;143;117;93;140;68;139;193;41;5;42;181;159;69;108;18;22;146;34;160;48;54;177;10;184;43;116;65;149;123;127;162;151;80;176;137;23;183;89;186;114;15;9;62;144;14;138;165;40;185;90;81;196;179;145;78;31;56;113;175;171;16;25;44;120;2;129;92;57;55;52;106;178;49;102;148;124;94;121;100;26;97;152,700415742111978565,0.001001
greedy_intra:nodes_start:greedy,2,71675,23535,48140,30719,4,2;129;57;92;55;52;49;102;148;9;62;144;14;3;178;106;185;40;165;90;81;196;179;145;78;31;56;113;175;171;16;25;44;120;75;86;26;124;94;63;79;80;176;133;151;51;118;59;115;46;0;137;23;186;89;183;143;117;93;140;68;139;193;41;5;42;181;159;69;108;18;22;146;34;160;48;54;177;10;190;84;184;43;116;65;131;149;162;123;127;70;135;154;180;53;100;101;1;97;152,8272581189308659060,0.001001
greedy_intra:nodes_start:greedy,3,71455,23393,48062,14138,2,138;14;144;62;9;148;102;49;178;106;52;55;57;92;129;2;152;97;1;101;100;53;180;154;135;70;127;123;162;149;131;65;116;43;184;84;190;10;177;54;48;160;34;146;22;18;108;69;159;181;42;5;41;193;139;68;140;93;117;143;183;89;186;23;137;0;46;115;59;118;51;151;133;176;80;79;63;94;124;26;86;75;120;44;25;16;171;175;113;56;31;78;145;179;196;81;90;185;40;165,3474639900022946517,0.001000
greedy_intra:nodes_start:greedy,4,71499,23322,48177,65766,6,4;190;10;177;54;48;34;160;42;181;146;22;18;108;69;159;193;41;139;68;46;115;118;59;116;65;43;184;35;131;149;123;162;133;151;51;0;117;143;183;89;23;137;176;80;79;63;94;124;152;97;1;101;2;120;82;129;92;57;55;52;49;102;148;9;62;144;14;3;178;106;185;40;165;90;81;196;179;145;78;31;56;113;175;171;16;25;44;75;86;26;100;121;53;180;154;135;70;127;112,3215865573165034933,0.002028
greedy_intra:nodes_start:greedy,5,71299,23176,48123,40788,5,5;43;116;65;149;123;127;162;151;133;135;70;154;180;53;121;100;26;86;75;44;25;16;171;175;113;56;31;78;145;179;196;81;90;165;40;185;106;178;3;14;144;62;9;148;102;49;52;55;57;92;129;82;120;2;101;1;97;152;124;94;63;79;80;176;137;23;186;89;183;143;117;0;51;118;59;115;46;68;139;41;193;159;69;108;18;22;146;181;34;160;48;54;177;10;4;112;84;184;42,4563628207672327763,0.001030
greedy_intra:nodes_start:greedy,6,71765,23195,48570,48718,5,180;158;53;121;100;26;86;75;101;1;97;152;94;124;148;102;49;178;106;52;55;57;92;129;2;120;44;25;16;171;175;113;56;31;78;145;179;196;81;90;40;185;165;138;14;144;62;9;15;114;186;89;183;23;137;176;80;151;162;127;123;149;65;116;43;184;177;54;48;160;34;146;22;18;108;69;159;181;42;5;41;193;139;68;140;93;117;143;0;46;115;59;118;51;133;79;63;154;70;135,5916197946975709375,0.001941
greedy_intra:nodes_start:greedy,7,72338,24373,47965,60084,6,7;21;144;62;9;148;102;14;49;178;106;52;55;185;165;40;179;145;78;92;57;129;2;101;1;97;26;100;53;180;154;135;70;127;123;162;149;65;116;43;184;177;54;48;160;34;146;22;18;108;69;159;181;42;5;41;193;139;68;140;93;117;143;183;89;23;137;0;46;115;59;118;51;151;133;176;80;79;63;94;124;152;86;75;120;44;25;16;171;175;113;56;31;157;196;81;90;27;95;164,4950883280872385992,0.003970
greedy_intra:nodes_start:greedy,8,71546,23349,48197,55441,7,39;165;40;185;90;81;196;179;145;78;31;56;113;175;171;16;25;44;120;75;86;152;124;94;63;79;80;176;133;151;51;118;59;115;46;0;137;23;186;89;183;143;117;93;140;68;139;193;41;5;42;181;159;69;108;18;22;146;34;160;48;54;177;10;190;184;43;116;65;131;149;162;123;127;70;135;154;180;53;100;26;97;1;101;2;129;92;57;55;52;106;178;49;102;148;9;62;144;14;138,2954085864457347302,0.002983
greedy_intra:nodes_start:greedy,9,71408,23346,48062,56393,4,9;148;102;49;178;106;52;55;57;92;129;2;101;1;97;26;100;53;180;154;135;70;127;123;162;149;131;65;116;43;184;84;190;10;177;54;48;160;34;146;22;18;108;69;159;181;42;5;41;193;139;68;140;93;117;143;183;89;186;23;137;0;46;115;59;118;51;151;133;176;80;79;63;94;124;152;86;75;120;44;25;16;171;175;113;56;31;78;145;179;196;81;90;185;40;165;138;14;144;62,5708743435876740308,0.002966
greedy_intra:nodes_start:greedy,10,71443,23266,48177,80044,7,10;190;4;112;127;70;135;154;180;53;121;100;26;86;75;44;25;16;171;175;113;56;31;78;145;179;196;81;90;165;40;185;106;178;3;14;144;62;9;148;102;49;52;55;57;92;129;82;120;2;101;1;97;152;124;94;63;79;80;176;137;23;89;183;143;117;0;51;151;133;162;123;149;131;35;184;43;116;65;59;118;115;46;68;139;41;193;159;69;108;18;22;146;181;42;160;34;48;54;177,5561222019387926557,0.003992
greedy_intra:nodes_start:greedy,11,72083,23758,48325,27283,4,149;35;84;4;112;127;123;162;151;133;135;70;154;180;53;121;100;26;86;75;44;25;16;171;175;113;56;31;78;145;179;196;81;90;165;40;185;106;178;3;14;144;62;9;148;102;49;52;55;92;57;129;82;120;2;101;1;97;152;124;94;63;79;80;176;137;23;186;89;183;143;117;0;51;118;59;115;139;68;46;65;116;43;42;5;41;193;159;69;108;18;22;146;181;34;160;48;54;177;184,4225585558134708477,0.001612
greedy_intra:nodes_start:greedy,12,72443,23476,48967,13439,2,124;94;152;97;1;101;2;120;82;129;57;92;179;145;78;31;56;113;175;171;16;25;44;75;86;26;100;121;53;158;154;70;135;180;63;79;133;51;118;59;115;46;0;143;117;93;140;68;139;193;41;5;42;181;159;69;108;18;22;146;34;160;48;54;177;184;43;116;65;149;123;162;151;80;176;137;23;183;89;186;114;15;9;62;144;14;138;165;90;81;196;40;185;55;52;106;178;49;102;148,1357163041760525070,0.000853
greedy_intra:nodes_start:greedy,13,72000,23685,48315,74422,8,31;157;78;145;92;179;196;81;90;40;165;185;106;178;3;14;144;62;9;148;102;49;52;55;57;129;2;101;1;97;26;100;53;180;154;135;70;127;123;162;149;131;65;116;43;184;190;10;177;54;48;160;34;146;22;18;108;69;159;181;42;5;41;193;139;68;140;93;117;143;183;89;186;23;137;0;46;115;59;118;51;151;133;176;80;79;63;94;124;152;86;75;120;44;25;16;171;175;113;56,2543825641018040837,0.003707
greedy_intra:nodes_start:greedy,14,71346,23284,48062,54223,6,14;144;62;9;148;102;49;178;106;52;55;57;92;129;2;101;1;97;26;100;53;180;154;135;70;127;123;162;149;131;65;116;43;184;84;190;10;177;54;48;160;34;146;22;18;108;69;159;181;42;5;41;193;139;68;140;93;117;143;183;89;186;23;137;0;46;115;59;118;51;151;133;176;80;79;63;94;124;152;86;75;120;44;25;16;171;175;113;56;31;78;145;179;196;81;90;40;185;165;138,7375795276268201580,0.003000
greedy_intra:nodes_start:greedy,15,71425,23403,48022,63530,5,15;144;14;138;165;185;40;90;81;196;179;145;78;31;56;113;175;171;16;25;44;120;75;86;152;124;94;63;79;80;176;133;151;51;118;59;115;46;0;137;23;186;89;183;143;117;93;140;68;139;193;41;5;42;181;159;69;108;18;22;146;34;160;48;54;177;10;190;184;43;116;65;131;149;162;123;127;70;135;154;180;53;100;26;97;1;101;2;129;92;57;55;52;106;178;49;102;62;9;148,759562554395672125,0.002000
greedy_intra:nodes_start:greedy,16,71640,23500,48140,67060,7,16;25;44;120;75;86;101;124;94;63;79;80;176;133;151;51;118;59;115;46;0;137;23;186;89;183;143;117;93;140;68;139;193;41;5;42;181;159;69;108;18;22;146;34;160;48;54;177;10;190;84;184;43;116;65;131;149;162;123;127;70;135;154;180;53;100;26;97;1;152;2;129;57;55;52;49;102;148;9;62;144;14;3;178;106;185;40;165;90;81;196;179;92;145;78;31;56;113;175;171,4121027139422772788,0.003000
greedy_intra:nodes_start:greedy,17,73027,24197,48830,58126,9,196;81;119;90;27;58;164;7;95;39;165;40;185;106;178;3;14;144;62;9;148;102;49;52;55;57;129;92;179;145;78;82;2;152;97;26;86;53;180;154;135;70;127;123;162;149;65;116;43;184;177;54;48;160;34;146;22;18;108;159;181;42;41;193;139;68;140;93;117;143;183;89;23;137;0;46;115;59;118;51;151;133;176;80;79;63;94;1;101;75;120;44;25;16;171;175;113;56;31;157,872154167303894751,0.002998
greedy_intra:nodes_start:greedy,18,71858,23608,48250,22998,3,18;22;146;159;193;41;5;42;181;34;160;48;54;177;10;4;112;84;184;43;116;65;149;123;127;162;151;133;135;70;154;180;53;121;100;26;86;75;44;25;16;171;175;113;56;31;78;145;179;196;81;90;40;165;185;106;178;3;14;144;62;9;148;102;49;52;55;92;57;129;82;120;2;101;1;97;152;124;94;63;79;80;176;137;51;118;59;115;139;46;68;0;89;183;143;117;93;140;108;69,6540296355183940450,0.001000
greedy_intra:nodes_start:greedy,19,71828,22768,49060,31508,2,189;94;124;148;102;49;178;106;52;55;57;92;129;2;120;44;25;16;171;175;113;56;31;78;145;179;196;81;90;165;40;185;138;14;144;62;9;15;114;186;89;183;23;137;176;80;151;162;123;149;65;116;43;184;177;54;48;160;34;146;22;18;108;69;159;181;42;5;41;193;139;68;140;93;117;143;0;46;115;59;118;51;133;79;63;180;135;70;154;158;53;121;100;26;86;75;101;1;97;152,1043308163139096559,0.001028
greedy_intra:nodes_start:greedy,20,72051,23073,48978,43302,4,199;22;146;159;193;41;5;42;181;34;160;48;54;177;10;190;84;184;43;116;65;149;123;127;162;151;133;135;70;154;180;53;121;100;26;86;75;44;25;16;171;175;113;56;31;78;145;179;196;81;90;40;165;185;106;178;3;14;144;62;9;148;102;49;52;55;57;92;129;82;120;2;101;1;97;152;124;94;63;79;80;176;137;51;118;59;115;139;68;46;0;89;183;143;117;93;140;108;69;18,7086927615831718440,0.002476
greedy_intra:nodes_start:greedy,21,71811,23906,47905,63091,5,21;14;138;165;185;40;90;81;196;179;145;78;31;56;113;175;171;16;25;44;120;75;86;152;124;94;63;79;80;176;133;151;51;118;59;115;46;0;137;23;186;89;183;143;117;93;140;68;139;193;41;5;42;181;159;69;108;18;22;146;34;160;48;54;177;10;190;184;43;116;65;131;149;162;123;127;70;135;154;180;53;100;26;97;1;101;2;129;92;57;55;52;106;178;49;102;148;9;62;144,3391849348646965779,0.002032
greedy_intra:nodes_start:greedy,22,71169,23196,47973,24129,2,22;146;181;34;160;48;54;177;10;190;4;112;84;184;42;43;116;65;149;123;127;162;151;133;135;70;154;180;53;121;100;26;86;75;44;25;16;171;175;113;56;31;78;145;179;196;81;90;40;165;185;106;178;3;14;144;62;9;148;102;49;52;55;57;92;129;82;120;2;101;1;97;152;124;94;63;79;80;176;137;23;186;89;183;143;117;0;51;118;59;115;46;68;139;41;193;159;69;108;18,6018138885534174831,0.001030
greedy_intra:nodes_start:greedy,23,71035,22830,48205,39311,3,23;137;176;80;79;63;94;124;152;97;1;101;2;120;82;129;57;92;55;52;49;102;148;9;62;144;14;3;178;106;185;165;40;90;81;196;179;145;78;31;56;113;175;171;16;25;44;75;86;26;100;121;53;180;154;135;70;127;123;162;133;151;51;118;59;65;116;43;184;84;112;4;190;10;177;54;48;160;34;146;22;18;108;69;159;181;42;5;41;193;115;139;68;46;0;117;143;183;89;186,5668756875585753905,0.000999
greedy_intra:nodes_start:greedy,24,71659,23097,48562,41656,5,131;149;65;116;43;184;84;190;10;177;54;48;160;34;146;22;18;108;69;159;181;42;5;41;193;139;68;46;115;59;118;51;0;117;143;183;89;186;23;137;176;80;79;63;94;124;152;97;1;101;2;120;82;129;92;57;55;52;49;102;148;9;62;144;14;3;178;106;185;40;165;90;81;196;179;145;78;31;56;113;175;171;16;25;44;75;86;26;100;121;53;180;154;70;135;133;151;162;127;123,1719121178229390291,0.001928
greedy_intra:nodes_start:greedy,25,71621,23481,48140,32216,4,25;44;120;75;86;26;124;94;63;79;80;176;133;151;51;118;59;115;46;0;137;23;186;89;183;143;117;93;140;68;139;193;41;5;42;181;159;69;108;18;22;146;34;160;48;54;177;10;190;84;184;43;116;65;131;149;162;123;127;70;135;154;180;53;100;101;1;97;152;2;129;92;57;55;52;49;102;148;9;62;144;14;3;178;106;185;165;40;90;81;196;179;145;78;31;56;113;175;171;16,3953254481795074573,0.002663
greedy_intra:nodes_start:greedy,26,71474,23448,48026,24571,1,26;97;1;101;75;86;53;154;70;135;180;63;79;133;51;118;59;115;46;0;143;117;93;140;68;139;193;41;5;42;181;159;69;108;18;22;146;34;160;48;54;177;10;190;184;43;116;65;149;123;127;162;151;80;176;137;23;183;89;186;114;15;9;62;144;14;138;185;40;165;90;81;196;179;145;78;31;56;113;175;171;16;25;44;120;2;129;92;57;55;52;106;178;49;102;148;124;94;152;100,6779191630364082539,0.002022
greedy_intra:nodes_start:greedy,27,72157,23629,48528,13825,1,27;58;164;7;95;39;165;138;14;144;62;9;148;102;49;178;106;52;55;57;92;129;2;152;97;1;101;100;53;180;154;135;70;127;123;162;149;65;116;43;184;177;54;48;160;34;146;22;18;108;69;159;181;42;5;41;193;139;68;140;93;117;143;183;89;23;137;0;46;115;59;118;51;151;133;176;80;79;63;94;26;86;75;120;44;25;16;171;175;113;56;31;78;145;179;196;81;185;40;90,5330233146882082228,0.000000
greedy_intra:nodes_start:greedy,28,71757,23150,48607,65626,7,35;43;116;65;131;149;123;127;162;151;133;135;70;154;180;53;121;100;26;86;75;44;25;16;171;175;113;56;31;78;145;179;196;81;90;165;40;185;106;178;3;14;144;62;9;148;102;49;52;55;57;92;129;82;120;2;101;1;97;152;124;94;63;79;80;176;137;23;186;89;183;143;117;0;51;118;59;115;46;68;139;193;41;5;42;181;159;69;108;18;22;146;34;160;48;54;177;10;190;184,6137738658643965870,0.002999
greedy_intra:nodes_start:greedy,29,71753,23146,48607,46003,5,149;112;4;84;35;184;177;54;48;160;34;181;146;22;18;108;69;159;193;41;5;42;43;116;65;46;68;139;115;59;118;51;0;117;143;183;89;186;23;137;176;80;79;63;94;124;152;97;1;101;2;120;82;129;92;57;55;52;49;102;148;9;62;144;14;3;178;106;185;40;165;90;81;196;179;145;78;31;56;113;175;171;16;25;44;75;86;26;100;121;53;180;154;70;135;133;151;162;123;131,4072784101784262807,0.001973
greedy_intra:nodes_start:greedy,30,71703,23139,48564,56915,6,48;54;177;10;190;84;184;43;116;65;59;118;115;46;0;51;151;133;162;123;127;70;135;154;180;53;121;100;26;86;75;44;25;16;171;175;113;56;31;78;145;179;196;81;90;165;40;185;106;178;3;14;144;62;9;148;102;49;52;55;57;92;129;82;120;2;101;1;97;152;124;94;63;79;80;176;137;23;186;89;183;143;117;93;140;68;139;193;41;159;69;108;18;22;146;195;181;42;160;34,5453105237683815007,0.002000
greedy_intra:nodes_start:greedy,31,71934,23794,48140,20055,3,31;145;78;92;179;196;81;90;40;165;185;106;178;3;14;144;62;9;148;102;49;52;55;57;129;2;152;97;1;101;100;53;180;154;135;70;127;123;162;149;131;65;116;43;184;84;190;10;177;54;48;160;34;146;22;18;108;69;159;181;42;5;41;193;139;68;140;93;117;143;183;89;186;23;137;0;46;115;59;118;51;151;133;176;80;79;63;94;124;26;86;75;120;44;25;16;171;175;113;56,2248578994100867266,0.001403
greedy_intra:nodes_start:greedy,32,71307,23245,48062,61011,9,138;14;144;62;9;148;102;49;178;106;52;55;57;92;129;2;152;1;97;26;100;53;180;154;135;70;127;123;162;149;131;65;116;43;184;84;190;10;177;54;48;160;34;146;22;18;108;69;159;181;42;5;41;193;139;68;140;93;117;143;183;89;186;23;137;0;46;115;59;118;51;151;133;176;80;79;63;94;124;101;86;75;120;44;25;16;171;175;113;56;31;78;145;179;196;81;90;165;40;185,9189068156101838117,0.003000
greedy_intra:nodes_start:greedy,33,71463,23063,48400,59864,9,37;102;49;178;106;52;55;57;92;129;2;152;1;97;26;100;53;180;154;135;70;127;123;162;149;131;65;116;43;184;190;10;177;54;48;160;34;146;22;18;108;69;159;181;42;5;41;193;139;68;140;93;117;143;183;89;186;23;137;0;46;115;59;118;51;151;133;176;80;79;63;94;124;101;86;75;120;44;25;16;171;175;113;56;31;78;145;179;196;81;90;165;40;185;138;14;144;62;9;148,7151752483984991012,0.002999
greedy_intra:nodes_start:greedy,34,71022,23049,47973,41938,3,34;181;146;22;18;108;69;159;193;41;139;68;46;115;59;118;51;0;117;143;183;89;186;23;137;176;80;79;63;94;124;152;97;1;101;2;120;82;129;92;57;55;52;49;102;148;9;62;144;14;3;178;106;185;40;165;90;81;196;179;145;78;31;56;113;175;171;16;25;44;75;86;26;100;121;53;180;154;70;135;133;151;162;127;123;149;65;116;43;42;184;84;112;4;190;10;177;54;48;160,279842663369192377,0.002190
greedy_intra:nodes_start:greedy,35,71843,23593,48250,15860,2,35;84;4;112;127;123;162;151;133;135;70;154;180;53;121;100;26;86;75;44;25;16;171;175;113;56;31;78;145;179;196;81;90;40;165;185;106;178;3;14;144;62;9;148;102;49;52;55;92;57;129;82;120;2;101;1;97;152;124;94;63;79;80;176;137;23;186;89;183;143;117;0;51;118;59;115;139;68;46;65;116;43;42;5;41;193;159;69;108;18;22;146;181;34;160;48;54;177;10;184,2073699447086024316,0.000000
greedy_intra:nodes_start:greedy,36,72215,23047,49168,34319,3,36;108;69;18;22;146;159;193;41;5;42;181;34;160;48;54;177;10;190;84;184;43;116;65;149;123;127;162;151;133;135;70;154;180;53;121;100;26;86;75;44;25;16;171;175;113;56;31;78;145;179;196;81;90;40;165;185;106;178;3;14;144;62;9;148;102;49;52;55;57;92;129;82;120;2;101;1;97;152;124;94;63;79;80;176;137;51;118;59;115;139;68;46;0;89;183;143;117;93;140,6214245673413571806,0.001008
greedy_intra:nodes_start:greedy,37,71502,23102,48400,60003,5,37;102;49;178;106;52;55;57;92;129;2;101;1;97;26;100;53;180;154;135;70;127;123;162;149;131;65;116;43;184;190;10;177;54;48;160;34;146;22;18;108;69;159;181;42;5;41;193;139;68;140;93;117;143;183;89;186;23;137;0;46;115;59;118;51;151;133;176;80;79;63;94;124;152;86;75;120;44;25;16;171;175;113;56;31;78;145;179;196;81;90;40;185;165;138;14;144;62;9;148,1165380096058084196,0.002972
greedy_intra:nodes_start:greedy,38,71869,23554,48315,57398,7,157;78;145;92;179;196;81;90;165;40;185;106;178;3;14;144;62;9;148;102;49;52;55;57;129;2;152;1;97;26;100;53;180;154;135;70;127;123;162;149;131;65;116;43;184;190;10;177;54;48;160;34;146;22;18;108;69;159;181;42;5;41;193;139;68;140;93;117;143;183;89;186;23;137;0;46;115;59;118;51;151;133;176;80;79;63;94;124;101;86;75;120;44;25;16;171;175;113;56;31,8555470255915505919,0.003002
greedy_intra:nodes_start:greedy,39,72030,23824,48206,24439,2,39;95;7;164;27;90;40;185;81;196;179;145;78;31;56;113;175;171;16;25;44;120;75;86;26;124;94;63;79;80;176;133;151;51;118;59;115;46;0;137;23;89;183;143;117;93;140;68;139;193;41;5;42;181;159;69;108;18;22;146;34;160;48;54;177;184;43;116;65;149;162;123;127;70;135;154;180;53;100;101;1;97;152;2;129;92;57;55;52;106;178;49;102;148;9;62;144;14;138;165,7499434197877688194,0.001147
greedy_intra:nodes_start:greedy,40,71391,23329,48062,49941,4,185;165;138;14;144;62;9;148;102;49;178;106;52;55;57;92;129;2;152;97;1;26;100;53;180;154;135;70;127;123;162;149;131;65;116;43;184;84;190;10;177;54;48;160;34;146;22;18;108;69;159;181;42;5;41;193;139;68;140;93;117;143;183;89;186;23;137;0;46;115;59;118;51;151;133;176;80;79;63;94;124;101;86;75;120;44;25;16;171;175;113;56;31;78;145;179;196;81;90;40,1294747614712392299,0.002000
greedy_intra:nodes_start:greedy,41,71632,23509,48123,32307,3,41;5;42;181;159;69;108;18;22;146;34;160;48;54;177;10;190;4;112;184;43;116;65;149;123;127;162;151;133;135;70;154;180;53;121;100;26;86;75;44;25;16;171;175;113;56;31;78;145;179;196;81;90;40;165;185;106;178;3;14;144;62;9;148;102;49;52;55;57;92;129;82;120;2;101;1;97;152;124;94;63;79;80;176;137;23;186;89;183;143;117;0;51;118;59;115;46;68;139;193,8982355972883537773,0.001115
greedy_intra:nodes_start:greedy,42,71489,23366,48123,44521,5,42;5;41;193;139;68;46;115;59;118;51;0;117;143;183;89;186;23;137;176;80;79;63;94;124;152;97;1;101;2;120;82;129;92;57;55;52;49;102;148;9;62;144;14;3;178;106;185;40;165;90;81;196;179;145;78;31;56;113;175;171;16;25;44;75;86;26;100;121;53;180;154;70;135;133;151;162;127;123;149;65;116;43;184;84;112;4;10;177;54;48;160;34;146;22;18;108;69;159;181,4203892906909418893,0.002000
greedy_intra:nodes_start:greedy,43,71664,23164,48500,50804,4,43;116;65;59;118;115;46;0;51;151;133;162;123;127;70;135;154;180;53;121;100;26;86;75;44;25;16;171;175;113;56;31;78;145;179;196;81;90;165;40;185;106;178;3;14;144;62;9;148;102;49;52;55;57;92;129;82;120;2;101;1;97;152;124;94;63;79;80;176;137;23;186;89;183;143;117;93;140;68;139;193;41;5;42;181;159;69;108;18;22;146;34;160;48;54;177;10;190;84;184,8421209759357588007,0.003008
greedy_intra:nodes_start:greedy,44,71474,23334,48140,39069,5,44;25;16;171;175;113;56;31;78;145;179;196;81;90;165;40;185;106;178;3;14;144;62;9;148;102;49;52;55;57;92;129;2;152;97;1;101;100;53;180;154;135;70;127;123;162;149;131;65;116;43;184;84;190;10;177;54;48;160;34;146;22;18;108;69;159;181;42;5;41;193;139;68;140;93;117;143;183;89;186;23;137;0;46;115;59;118;51;151;133;176;80;79;63;94;124;26;86;75;120,3049532260065405206,0.001979
greedy_intra:nodes_start:greedy,45,72265,23703,48562,79848,8,133;162;127;70;135;154;180;53;121;100;26;86;75;44;25;16;171;175;113;56;31;78;145;179;196;81;90;40;165;185;106;178;3;14;144;62;9;148;102;49;52;55;57;92;129;82;120;2;101;1;97;152;124;94;63;79;80;176;137;23;186;89;183;143;117;0;51;118;59;115;46;68;139;193;41;5;42;181;159;69;108;18;22;146;34;160;48;54;177;10;190;84;184;43;116;65;131;123;149;151,5221863089755930987,0.003000
greedy_intra:nodes_start:greedy,46,71837,23714,48123,20956,3,46;115;59;118;51;0;117;143;183;89;186;23;137;176;80;79;63;94;124;152;97;1;101;2;120;82;129;57;92;55;52;49;102;148;9;62;144;14;3;178;106;185;165;40;90;81;196;179;145;78;31;56;113;175;171;16;25;44;75;86;26;100;121;53;180;154;70;135;133;151;162;127;123;149;65;116;43;184;84;112;4;10;177;54;48;160;34;146;22;18;108;69;159;181;42;5;41;193;139;68,6773627508307068716,0.001000
greedy_intra:nodes_start:greedy,47,71885,23153,48732,33505,3,47;116;43;184;84;190;10;177;54;48;160;34;146;22;18;108;69;159;181;42;5;41;193;139;68;46;115;118;59;51;0;117;143;183;89;186;23;137;176;80;79;63;94;124;152;97;1;101;2;120;82;129;92;57;55;52;49;102;148;9;62;144;14;3;178;106;185;40;165;90;81;196;179;145;78;31;56;113;175;171;16;25;44;75;86;26;100;121;53;180;154;70;135;133;151;162;127;123;149;65,2411933787810539054,0.001649
greedy_intra:nodes_start:greedy,48,71775,23211,48564,57305,5,48;34;160;42;181;195;146;22;18;108;69;159;193;41;139;68;140;93;117;143;183;89;186;23;137;176;80;79;63;94;124;152;97;1;101;2;120;82;129;92;57;55;52;49;102;148;9;62;144;14;3;178;106;185;165;40;90;81;196;179;145;78;31;56;113;175;171;16;25;44;75;86;26;100;121;53;180;154;135;70;127;123;162;133;151;51;0;46;115;118;59;65;116;43;184;84;190;10;177;54,6685998926199280203,0.002186
greedy_intra:nodes_start:greedy,49,71336,23274,48062,45065,4,49;178;106;52;55;57;92;129;2;152;97;1;26;100;53;180;154;135;70;127;123;162;149;131;65;116;43;184;84;190;10;177;54;48;160;34;146;22;18;108;69;159;181;42;5;41;193;139;68;140;93;117;143;183;89;186;23;137;0;46;115;59;118;51;151;133;176;80;79;63;94;124;101;86;75;120;44;25;16;171;175;113;56;31;78;145;179;196;81;90;165;40;185;138;14;144;62;9;148;102,6938793179784292037,0.002169
greedy_intra:nodes_start:greedy,50,72007,23692,48315,80492,9,56;175;171;16;25;44;120;75;86;101;124;94;63;79;80;176;133;151;51;118;59;115;46;0;137;23;186;89;183;143;117;93;140;68;139;193;41;5;42;181;159;69;108;18;22;146;34;160;48;54;177;10;190;184;43;116;65;131;149;162;123;127;70;135;154;180;53;100;26;1;97;152;2;129;57;55;52;49;102;148;9;62;144;14;3;178;106;185;40;165;90;81;196;179;92;145;78;157;31;113,4093550237950270242,0.003825
greedy_intra:nodes_start:greedy,51,71837,23714,48123,28976,3,51;118;59;115;46;68;139;193;41;5;42;181;159;69;108;18;22;146;34;160;48;54;177;10;4;112;84;184;43;116;65;149;123;127;162;151;133;135;70;154;180;53;121;100;26;86;75;44;25;16;171;175;113;56;31;78;145;179;196;81;90;40;165;185;106;178;3;14;144;62;9;148;102;49;52;55;92;57;129;82;120;2;101;1;97;152;124;94;63;79;80;176;137;23;186;89;183;143;117;0,2214964985050130743,0.001971
greedy_intra:nodes_start:greedy,52,71336,23274,48062,52576,4,52;106;178;49;102;148;9;62;144;14;138;185;40;165;90;81;196;179;145;78;31;56;113;175;171;16;25;44;120;75;86;101;124;94;63;79;80;176;133;151;51;118;59;115;46;0;137;23;186;89;183;143;117;93;140;68;139;193;41;5;42;181;159;69;108;18;22;146;34;160;48;54;177;10;190;84;184;43;116;65;131;149;162;123;127;70;135;154;180;53;100;26;1;97;152;2;129;92;57;55,317959780593597200,0.002983
greedy_intra:nodes_start:greedy,53,71633,23063,48570,23212,1,53;158;154;70;135;180;63;79;133;51;118;59;115;46;0;143;117;93;140;68;139;193;41;5;42;181;159;69;108;18;22;146;34;160;48;54;177;184;43;116;65;149;123;127;162;151;80;176;137;23;183;89;186;114;15;9;62;144;14;138;185;40;165;90;81;196;179;145;78;31;56;113;175;171;16;25;44;120;2;129;92;57;55;52;106;178;49;102;148;124;94;152;97;1;101;75;86;26;100;121,8566216650145491468,0.002011
greedy_intra:nodes_start:greedy,54,71940,23376,48564,50610,4,54;48;34;160;181;42;195;146;22;18;108;69;159;193;41;139;68;140;93;117;143;183;89;186;23;137;176;80;79;63;94;124;152;97;1;101;2;120;82;129;92;57;55;52;49;102;148;9;62;144;14;3;178;106;185;165;40;90;81;196;179;145;78;31;56;113;175;171;16;25;44;75;86;26;100;121;53;180;154;135;70;127;123;162;133;151;51;0;46;115;118;59;65;116;43;184;84;190;10;177,5961409373201461300,0.002682
greedy_intra:nodes_start:greedy,55,71460,23398,48062,40055,3,55;52;178;106;49;102;148;9;62;144;14;138;165;185;40;90;81;196;179;145;78;31;56;113;175;171;16;25;44;120;75;86;26;124;94;63;79;80;176;133;151;51;118;59;115;46;0;137;23;186;89;183;143;117;93;140;68;139;193;41;5;42;181;159;69;108;18;22;146;34;160;48;54;177;10;190;84;184;43;116;65;131;149;162;123;127;70;135;154;180;53;100;101;1;97;152;2;129;92;57,1043495884972649432,0.001999
greedy_intra:nodes_start:greedy,56,71787,23647,48140,34565,3,56;31;145;78;92;179;196;81;90;165;40;185;106;178;3;14;144;62;9;148;102;49;52;55;57;129;2;152;97;1;101;100;53;180;154;135;70;127;123;162;149;131;65;116;43;184;84;190;10;177;54;48;160;34;146;22;18;108;69;159;181;42;5;41;193;139;68;140;93;117;143;183;89;186;23;137;0;46;115;59;118;51;151;133;176;80;79;63;94;124;26;86;75;120;44;25;16;171;175;113,1743485808115984276,0.002005
greedy_intra:nodes_start:greedy,57,71472,23332,48140,40376,4,57;55;52;49;102;148;9;62;144;14;3;178;106;185;40;165;90;81;196;179;145;78;31;56;113;175;171;16;25;44;120;75;86;101;124;94;63;79;80;176;133;151;51;118;59;115;46;0;137;23;186;89;183;143;117;93;140;68;139;193;41;5;42;181;159;69;108;18;22;146;34;160;48;54;177;10;190;84;184;43;116;65;131;149;162;123;127;70;135;154;180;53;100;26;1;97;152;2;129;92,2859181503423413380,0.001002
greedy_intra:nodes_start:greedy,58,72466,24179,48287,34388,3,58;95;27;90;81;196;157;31;56;113;175;171;16;25;44;120;75;86;26;94;63;79;80;176;133;151;51;118;59;115;46;0;137;23;89;183;143;117;93;140;68;139;193;41;5;42;181;159;69;108;18;22;146;34;160;48;54;177;184;43;116;65;149;162;123;127;70;135;154;180;53;100;101;1;97;152;2;129;57;92;78;145;179;40;165;185;55;52;106;178;14;49;102;148;9;62;144;21;7;164,4976530592960173695,0.002000
greedy_intra:nodes_start:greedy,59,71636,23513,48123,34782,4,59;115;46;68;139;193;41;5;42;181;159;69;108;18;22;146;34;160;48;54;177;10;4;112;84;184;43;116;65;149;123;127;162;151;133;135;70;154;180;53;121;100;26;86;75;44;25;16;171;175;113;56;31;78;145;179;196;81;90;40;165;185;106;178;3;14;144;62;9;148;102;49;52;55;57;92;129;82;120;2;101;1;97;152;124;94;63;79;80;176;137;23;186;89;183;143;117;0;51;118,5378952632624982738,0.000970
greedy_intra:nodes_start:greedy,60,71636,23513,48123,63504,8,115;46;68;139;193;41;5;42;181;159;69;108;18;22;146;34;160;48;54;177;10;4;112;84;184;43;116;65;149;123;127;162;151;133;135;70;154;180;53;121;100;26;86;75;44;25;16;171;175;113;56;31;78;145;179;196;81;90;40;165;185;106;178;3;14;144;62;9;148;102;49;52;55;57;92;129;82;120;2;101;1;97;152;124;94;63;79;80;176;137;23;186;89;183;143;117;0;51;118;59,7010387096770018369,0.003001
greedy_intra:nodes_start:greedy,61,71532,23510,48022,30407,4,15;144;14;138;165;40;185;90;81;196;179;145;78;31;56;113;175;171;16;25;44;120;75;86;101;124;94;63;79;80;176;133;151;51;118;59;115;46;0;137;23;186;89;183;143;117;93;140;68;139;193;41;5;42;181;159;69;108;18;22;146;34;160;48;54;177;10;190;184;43;116;65;131;149;162;123;127;70;135;154;180;53;100;26;1;97;152;2;129;92;57;55;52;106;178;49;102;62;9;148,6791770092284733065,0.001002
greedy_intra:nodes_start:greedy,62,71362,23300,48062,54380,5,62;144;14;138;165;185;40;90;81;196;179;145;78;31;56;113;175;171;16;25;44;120;75;86;101;124;94;63;79;80;176;133;151;51;118;59;115;46;0;137;23;186;89;183;143;117;93;140;68;139;193;41;5;42;181;159;69;108;18;22;146;34;160;48;54;177;10;190;84;184;43;116;65;131;149;162;123;127;70;135;154;180;53;100;26;97;1;152;2;129;92;57;55;52;106;178;49;102;148;9,3733185697974906459,0.002021
greedy_intra:nodes_start:greedy,63,71633,23063,48570,23764,1,63;180;135;70;154;158;53;121;100;26;86;75;101;1;97;152;94;124;148;102;49;178;106;52;55;57;92;129;2;120;44;25;16;171;175;113;56;31;78;145;179;196;81;90;165;40;185;138;14;144;62;9;15;114;186;89;183;23;137;176;80;151;162;127;123;149;65;116;43;184;177;54;48;160;34;146;22;18;108;69;159;181;42;5;41;193;139;68;140;93;117;143;0;46;115;59;118;51;133;79,1032287675849762938,0.000989
greedy_intra:nodes_start:greedy,64,72373,22854,49519,12480,0,64;114;186;89;183;23;137;176;80;151;162;123;149;65;116;43;184;177;54;48;160;34;146;22;18;108;69;159;181;42;5;41;193;139;68;140;93;117;143;0;46;115;59;118;51;133;79;63;180;135;70;154;158;53;121;100;26;86;75;101;1;97;152;94;124;148;9;62;102;49;178;106;52;55;57;92;129;2;120;44;25;16;171;175;113;56;31;78;145;179;196;81;90;185;40;165;138;14;144;15,471638117000419432,0.001004
greedy_intra:nodes_start:greedy,65,71489,23366,48123,48347,5,65;149;123;127;162;151;133;135;70;154;180;53;121;100;26;86;75;44;25;16;171;175;113;56;31;78;145;179;196;81;90;165;40;185;106;178;3;14;144;62;9;148;102;49;52;55;57;92;129;82;120;2;101;1;97;152;124;94;63;79;80;176;137;23;186;89;183;143;117;0;51;118;59;115;46;68;139;193;41;5;42;181;159;69;108;18;22;146;34;160;48;54;177;10;4;112;84;184;43;116,6442288092187496513,0.003132
greedy_intra:nodes_start:greedy,66,72477,23987,48490,33689,3,23;51;118;59;115;46;0;89;183;143;117;93;140;68;139;193;41;5;42;181;159;69;108;18;22;146;34;160;48;54;177;10;190;84;184;43;116;65;149;123;127;162;151;133;135;70;154;180;53;121;100;26;86;75;44;25;16;171;175;113;56;31;78;145;179;196;81;90;40;165;185;106;178;3;14;144;62;9;148;102;49;52;55;57;92;129;82;120;2;101;1;97;152;124;94;63;79;80;176;137,7752695109792719224,0.001999
greedy_intra:nodes_start:greedy,67,72416,23248,49168,23667,3,36;108;69;18;22;146;159;193;41;5;42;181;34;160;48;54;177;10;190;84;184;43;116;65;149;123;127;162;151;133;135;70;154;180;53;121;100;26;86;75;44;25;16;171;175;113;56;31;78;145;179;196;81;90;40;165;185;106;178;3;14;144;62;9;148;102;49;52;55;92;57;129;82;120;2;101;1;97;152;124;94;63;79;80;176;137;51;118;59;115;139;68;46;0;89;183;143;117;93;140,4661577089083167650,0.002002
greedy_intra:nodes_start:greedy,68,71485,23362,48123,28478,4,68;46;115;59;118;51;0;117;143;183;89;186;23;137;176;80;79;63;94;124;152;97;1;101;2;120;82;129;92;57;55;52;49;102;148;9;62;144;14;3;178;106;185;40;165;90;81;196;179;145;78;31;56;113;175;171;16;25;44;75;86;26;100;121;53;180;154;70;135;133;151;162;127;123;149;65;116;43;184;112;4;190;10;177;54;48;160;34;146;22;18;108;69;159;181;42;5;41;193;139,1306179128258008219,0.003234
greedy_intra:nodes_start:greedy,69,72107,23256,48851,26909,2,69;108;18;199;22;146;159;193;41;5;42;181;34;160;48;54;177;10;190;84;184;43;116;65;149;123;127;162;151;133;135;70;154;180;53;121;100;26;86;75;44;25;16;171;175;113;56;31;78;145;179;196;81;90;40;165;185;106;178;3;14;144;62;9;148;102;49;52;55;92;57;129;82;120;2;101;1;97;152;124;94;63;79;80;176;137;23;186;89;183;143;117;0;51;118;59;115;46;68;139,6501977173553262571,0.002036
greedy_intra:nodes_start:greedy,70,71750,23180,48570,12460,0,70;154;158;53;121;100;26;86;75;101;1;97;152;94;124;148;102;49;178;106;52;55;57;92;129;2;120;44;25;16;171;175;113;56;31;78;145;179;196;81;90;185;40;165;138;14;144;62;9;15;114;186;89;183;23;137;176;80;151;162;127;123;149;65;116;43;184;177;54;48;160;34;146;22;18;108;69;159;181;42;5;41;193;139;68;140;93;117;143;0;46;115;59;118;51;133;79;63;180;135,8332255636900323994,0.001008
greedy_intra:nodes_start:greedy,71,72157,23629,48528,15036,1,58;164;7;95;39;165;138;14;144;62;9;148;102;49;178;106;52;55;57;92;129;2;152;97;1;101;100;53;180;154;135;70;127;123;162;149;65;116;43;184;177;54;48;160;34;146;22;18;108;69;159;181;42;5;41;193;139;68;140;93;117;143;183;89;23;137;0;46;115;59;118;51;151;133;176;80;79;63;94;26;86;75;120;44;25;16;171;175;113;56;31;78;145;179;196;81;185;40;90;27,6130559574442174846,0.001000
greedy_intra:nodes_start:greedy,72,72104,23234,48870,44436,4,109;51;0;117;143;183;89;186;23;137;176;80;79;63;94;124;152;97;1;101;2;120;82;129;57;92;55;52;49;102;148;9;62;144;14;3;178;106;185;40;165;90;81;196;179;145;78;31;56;113;175;171;16;25;44;75;86;26;100;121;53;180;154;70;135;133;151;162;127;123;149;65;116;43;184;84;190;10;177;54;48;160;34;146;22;18;108;69;159;181;42;5;41;193;139;68;46;115;59;118,1506277716562899431,0.002000
greedy_intra:nodes_start:greedy,73,71941,23828,48113,58601,7,114;15;148;9;62;102;49;178;106;52;55;57;92;129;2;152;1;97;26;100;53;180;154;135;70;127;123;162;149;131;65;116;43;184;10;177;54;48;160;34;146;22;18;108;69;159;181;42;5;41;193;139;68;140;93;117;143;183;89;186;23;137;0;46;115;59;118;51;151;133;176;80;79;63;94;124;101;86;75;120;44;25;16;171;175;113;56;31;78;145;179;196;81;90;185;40;165;138;14;144,551816413419928773,0.003001
greedy_intra:nodes_start:greedy,74,72074,23433,48641,30906,3,97;1;101;75;86;53;154;70;135;180;63;79;133;51;118;59;115;46;0;143;117;93;140;68;139;193;41;5;42;181;159;69;108;18;22;146;34;160;48;54;177;184;43;116;65;149;123;127;162;151;80;176;137;23;183;89;186;114;15;9;62;144;14;138;185;40;165;90;81;196;179;145;78;31;56;113;175;171;16;25;44;120;2;129;92;57;55;52;106;178;49;102;148;124;94;189;100;26;121;152,6222134420678348788,0.001000
greedy_intra:nodes_start:greedy,75,71777,23435,48342,34949,4,75;44;25;16;171;175;113;56;31;78;145;179;196;81;90;165;40;185;106;178;3;14;144;62;9;148;102;49;52;55;57;92;129;82;120;2;152;97;1;101;100;53;180;154;135;70;127;123;162;149;131;65;116;43;184;190;10;177;54;48;160;34;146;22;18;108;69;159;181;42;5;41;193;139;68;140;93;117;143;183;89;186;23;137;0;46;115;59;118;51;151;133;176;80;79;63;94;124;26;86,5819141626333430652,0.001996
greedy_intra:nodes_start:greedy,76,72390,23564,48826,42410,5,153;176;80;151;162;127;123;149;65;116;43;184;10;177;54;48;160;34;146;22;18;108;69;159;181;42;5;41;193;139;68;46;115;59;118;51;133;79;63;180;135;70;154;158;53;121;100;26;86;75;101;1;97;152;94;124;148;102;49;178;106;52;55;57;92;129;2;120;44;25;16;171;175;113;56;31;78;145;179;196;81;90;40;185;165;138;14;144;62;9;15;114;186;137;23;89;183;143;117;0,6681549620176593652,0.002000
greedy_intra:nodes_start:greedy,77,71717,23299,48418,54777,6,116;43;184;190;10;177;54;48;160;34;146;22;18;108;69;159;181;42;5;41;193;139;68;140;93;117;143;183;89;186;23;137;176;80;79;63;94;124;152;97;1;101;2;120;82;129;92;57;55;52;49;102;148;9;62;144;14;3;178;106;185;40;165;90;81;196;179;145;78;31;56;113;175;171;16;25;44;75;86;26;100;121;53;180;154;135;70;127;123;162;133;151;51;0;46;115;118;59;149;65,461954519868802436,0.002972
greedy_intra:nodes_start:greedy,78,71427,23287,48140,77616,7,78;31;56;113;175;171;16;25;44;120;75;86;152;124;94;63;79;80;176;133;151;51;118;59;115;46;0;137;23;186;89;183;143;117;93;140;68;139;193;41;5;42;181;159;69;108;18;22;146;34;160;48;54;177;10;190;84;184;43;116;65;131;149;162;123;127;70;135;154;180;53;100;26;97;1;101;2;129;92;57;55;52;49;102;148;9;62;144;14;3;178;106;185;40;165;90;81;196;179;145,4079917341471027687,0.003516
greedy_intra:nodes_start:greedy,79,72114,23228,48886,34195,2,79;80;176;133;151;51;118;59;115;46;0;137;23;186;89;183;143;117;93;140;68;139;193;41;5;42;181;159;69;108;18;22;146;34;160;48;54;177;184;43;116;65;131;149;162;123;127;70;135;180;154;158;53;121;100;26;86;75;44;25;16;171;175;113;56;31;78;145;179;196;81;90;40;165;185;106;178;3;14;144;62;9;148;102;49;52;55;57;92;129;82;120;2;101;1;97;152;124;94;63,3445589356060664517,0.001025
greedy_intra:nodes_start:greedy,80,71925,23363,48562,15387,1,80;79;63;94;124;152;97;1;101;2;120;82;129;57;92;55;52;49;102;148;9;62;144;14;3;178;106;185;165;40;90;81;196;179;145;78;31;56;113;175;171;16;25;44;75;86;26;100;121;53;180;154;135;70;127;123;162;133;151;149;131;65;116;43;184;84;190;10;177;54;48;160;34;146;22;18;108;69;159;181;42;5;41;193;139;68;46;115;59;118;51;0;117;143;183;89;186;23;137;176,5887078633297928484,0.001000
greedy_intra:nodes_start:greedy,81,71560,23498,48062,27296,2,81;196;40;185;179;145;78;31;56;113;175;171;16;25;44;120;75;86;101;124;94;63;79;80;176;133;151;51;118;59;115;46;0;137;23;186;89;183;143;117;93;140;68;139;193;41;5;42;181;159;69;108;18;22;146;34;160;48;54;177;10;190;84;184;43;116;65;131;149;162;123;127;70;135;154;180;53;100;26;1;97;152;2;129;92;57;55;52;106;178;49;102;148;9;62;144;14;138;165;90,6368540816417555887,0.002002
greedy_intra:nodes_start:greedy,82,71805,23463,48342,45833,5,82;2;75;86;26;124;94;63;79;80;176;133;151;51;118;59;115;46;0;137;23;186;89;183;143;117;93;140;68;139;193;41;5;42;181;159;69;108;18;22;146;34;160;48;54;177;10;190;184;43;116;65;131;149;162;123;127;70;135;154;180;53;100;101;1;97;152;129;92;57;55;52;49;102;148;9;62;144;14;3;178;106;185;40;165;90;81;196;179;145;78;31;56;113;175;171;16;25;44;120,5073937643583626794,0.003001
greedy_intra:nodes_start:greedy,83,71267,22971,48296,37136,5,114;89;183;143;117;0;46;68;139;193;41;115;5;42;181;159;69;108;18;22;146;34;160;48;54;177;10;4;112;84;184;43;116;65;59;118;51;151;133;162;123;127;70;135;154;180;53;121;100;26;86;75;44;25;16;171;175;113;56;31;78;145;179;196;81;90;40;165;185;106;178;3;14;144;62;9;148;102;49;52;55;57;92;129;82;120;2;101;1;97;152;124;94;63;79;80;176;137;23;186,895551421460518301,0.003001
greedy_intra:nodes_start:greedy,84,71843,23593,48250,13855,2,84;4;112;127;123;162;151;133;135;70;154;180;53;121;100;26;86;75;44;25;16;171;175;113;56;31;78;145;179;196;81;90;40;165;185;106;178;3;14;144;62;9;148;102;49;52;55;92;57;129;82;120;2;101;1;97;152;124;94;63;79;80;176;137;23;186;89;183;143;117;0;51;118;59;115;139;68;46;65;116;43;42;5;41;193;159;69;108;18;22;146;181;34;160;48;54;177;10;184;35,3720018390433719191,0.001125
greedy_intra:nodes_start:greedy,85,71988,23673,48315,61368,7,157;145;179;196;81;90;165;40;185;106;178;3;14;144;62;9;148;102;49;52;55;57;92;129;2;152;1;97;26;100;53;180;154;135;70;127;123;162;149;131;65;116;43;184;190;10;177;54;48;160;34;146;22;18;108;69;159;181;42;5;41;193;139;68;140;93;117;143;183;89;186;23;137;0;46;115;59;118;51;151;133;176;80;79;63;94;124;101;86;75;120;44;25;78;31;16;171;175;113;56,6885308124541297757,0.003003
greedy_intra:nodes_start:greedy,86,71688,23118,48570,24440,1,86;75;101;1;97;152;94;124;148;102;49;178;106;52;55;57;92;129;2;120;44;25;16;171;175;113;56;31;78;145;179;196;81;90;40;185;165;138;14;144;62;9;15;114;186;89;183;23;137;176;80;151;162;127;123;149;65;116;43;184;177;54;48;160;34;146;22;18;108;69;159;181;42;5;41;193;139;68;140;93;117;143;0;46;115;59;118;51;133;79;63;180;135;70;154;158;53;121;100;26,110018774242342423,0.001001
greedy_intra:nodes_start:greedy,87,72481,23401,49080,56238,8,74;2;120;82;129;92;57;55;52;49;102;148;9;62;144;14;3;178;106;185;40;165;90;81;196;179;145;78;31;56;113;175;171;16;25;44;75;86;26;124;94;63;79;80;176;133;151;51;118;59;115;46;0;137;23;186;89;183;143;117;93;140;68;139;193;41;5;42;181;159;69;108;18;22;146;34;160;48;54;177;10;184;43;116;65;131;149;162;123;127;70;135;154;180;53;100;101;1;97;152,4341473451858352502,0.003998
greedy_intra:nodes_start:greedy,88,71948,23606,48342,84203,9,25;44;82;120;75;86;101;124;94;63;79;80;176;133;151;51;118;59;115;46;0;137;23;186;89;183;143;117;93;140;68;139;193;41;5;42;181;159;69;108;18;22;146;34;160;48;54;177;10;190;184;43;116;65;131;149;162;123;127;70;135;154;180;53;100;26;1;97;152;2;129;57;55;52;49;102;148;9;62;144;14;3;178;106;185;40;165;90;81;196;179;92;145;78;31;56;113;175;171;16,3968840794443422035,0.004000
greedy_intra:nodes_start:greedy,89,71111,22611,48500,20026,3,89;186;23;137;176;80;79;63;94;124;152;97;1;101;2;120;82;129;57;92;55;52;49;102;148;9;62;144;14;3;178;106;185;165;40;90;81;196;179;145;78;31;56;113;175;171;16;25;44;75;86;26;100;121;53;180;154;135;70;127;123;162;133;151;51;118;59;65;116;43;184;84;190;10;177;54;48;160;34;146;22;18;108;69;159;181;42;5;193;41;139;115;46;68;140;93;117;0;143;183,5893570173597900325,0.001000
greedy_intra:nodes_start:greedy,90,71346,23284,48062,56883,5,185;40;90;81;196;179;145;78;31;56;113;175;171;16;25;44;120;75;86;152;124;94;63;79;80;176;133;151;51;118;59;115;46;0;137;23;186;89;183;143;117;93;140;68;139;193;41;5;42;181;159;69;108;18;22;146;34;160;48;54;177;10;190;84;184;43;116;65;131;149;162;123;127;70;135;154;180;53;100;26;97;1;101;2;129;92;57;55;52;106;178;49;102;148;9;62;144;14;138;165,7033126558011835821,0.002000
greedy_intra:nodes_start:greedy,91,71767,23452,48315,54807,6,157;179;145;78;31;56;113;175;171;16;25;44;120;75;86;101;124;94;63;79;80;176;133;151;51;118;59;115;46;0;137;23;186;89;183;143;117;93;140;68;139;193;41;5;42;181;159;69;108;18;22;146;34;160;48;54;177;10;190;184;43;116;65;131;149;162;123;127;70;135;154;180;53;100;26;97;1;152;2;129;92;57;55;52;49;102;148;9;62;144;14;3;178;106;185;40;165;90;81;196,2389512008325615555,0.002000
greedy_intra:nodes_start:greedy,92,71474,23334,48140,35103,5,57;55;52;49;102;148;9;62;144;14;3;178;106;185;40;165;90;81;196;179;145;78;31;56;113;175;171;16;25;44;120;75;86;26;124;94;63;79;80;176;133;151;51;118;59;115;46;0;137;23;186;89;183;143;117;93;140;68;139;193;41;5;42;181;159;69;108;18;22;146;34;160;48;54;177;10;190;84;184;43;116;65;131;149;162;123;127;70;135;154;180;53;100;101;1;97;152;2;129;92,920686499856559757,0.001716
greedy_intra:nodes_start:greedy,93,71657,23407,48250,19619,4,93;140;108;69;18;22;146;159;193;41;5;42;181;34;160;48;54;177;10;4;112;84;184;43;116;65;149;123;127;162;151;133;135;70;154;180;53;121;100;26;86;75;44;25;16;171;175;113;56;31;78;145;179;196;81;90;40;165;185;106;178;3;14;144;62;9;148;102;49;52;55;57;92;129;82;120;2;101;1;97;152;124;94;63;79;80;176;137;51;118;59;115;139;46;68;0;89;183;143;117,3593215387702094264,0.001901
greedy_intra:nodes_start:greedy,94,71688,23118,48570,24636,1,94;152;97;1;101;75;86;26;100;121;53;158;154;70;135;180;63;79;133;51;118;59;115;46;0;143;117;93;140;68;139;193;41;5;42;181;159;69;108;18;22;146;34;160;48;54;177;184;43;116;65;149;123;127;162;151;80;176;137;23;183;89;186;114;15;9;62;144;14;138;165;185;40;90;81;196;179;145;78;31;56;113;175;171;16;25;44;120;2;129;92;57;55;52;106;178;49;102;148;124,2652840311812218508,0.001164
greedy_intra:nodes_start:greedy,95,72157,23629,48528,19264,1,95;7;164;58;27;90;40;185;81;196;179;145;78;31;56;113;175;171;16;25;44;120;75;86;26;94;63;79;80;176;133;151;51;118;59;115;46;0;137;23;89;183;143;117;93;140;68;139;193;41;5;42;181;159;69;108;18;22;146;34;160;48;54;177;184;43;116;65;149;162;123;127;70;135;154;180;53;100;101;1;97;152;2;129;92;57;55;52;106;178;49;102;148;9;62;144;14;138;165;39,2931806179637910135,0.001002
greedy_intra:nodes_start:greedy,96,71647,23524,48123,27982,4,5;43;116;65;149;123;127;162;151;133;135;70;154;180;53;121;100;26;86;75;44;25;16;171;175;113;56;31;78;145;179;196;81;90;40;165;185;106;178;3;14;144;62;9;148;102;49;52;55;92;57;129;82;120;2;101;1;97;152;124;94;63;79;80;176;137;23;186;89;183;143;117;0;51;118;59;115;46;68;139;41;193;159;69;108;18;22;146;181;34;160;48;54;177;10;4;112;84;184;42,501610559608612671,0.001000
greedy_intra:nodes_start:greedy,97,71721,23532,48189,30242,3,97;152;1;101;75;86;53;154;70;135;180;63;79;133;51;118;59;115;46;0;143;117;93;140;68;139;193;41;5;42;181;159;69;108;18;22;146;34;160;48;54;177;10;184;43;116;65;149;123;127;162;151;80;176;137;23;183;89;186;114;15;9;62;144;14;138;165;185;40;90;81;196;179;145;78;31;56;113;175;171;16;25;44;120;2;129;92;57;55;52;106;178;49;102;148;124;94;121;100;26,4286061824677970674,0.001999
greedy_intra:nodes_start:greedy,98,72707,24102,48605,46303,5,81;40;90;27;164;39;165;119;185;106;178;3;14;144;62;9;148;102;49;52;55;57;129;92;179;145;78;82;2;152;97;1;101;100;53;180;154;135;70;127;123;162;149;65;116;43;184;177;54;48;160;34;146;22;18;108;69;159;181;42;5;41;193;139;68;140;93;117;143;183;89;23;137;0;46;115;59;118;51;151;133;176;80;79;63;94;26;86;75;120;44;25;16;171;175;113;56;31;157;196,8206999864060363346,0.002515
greedy_intra:nodes_start:greedy,99,71750,23180,48570,61480,6,121;100;26;97;86;75;101;1;152;94;124;148;102;49;178;106;52;55;57;92;129;2;120;44;25;16;171;175;113;56;31;78;145;179;196;81;90;165;40;185;138;14;144;62;9;15;114;186;89;183;23;137;176;80;151;162;127;123;149;65;116;43;184;177;54;48;160;34;146;22;18;108;69;159;181;42;5;41;193;139;68;140;93;117;143;0;46;115;59;118;51;133;79;63;180;135;70;154;158;53,9174424318682639994,0.002971
greedy_intra:nodes_start:greedy,100,71750,23180,48570,12460,0,100;26;86;75;101;1;97;152;94;124;148;102;49;178;106;52;55;57;92;129;2;120;44;25;16;171;175;113;56;31;78;145;179;196;81;90;185;40;165;138;14;144;62;9;15;114;186;89;183;23;137;176;80;151;162;127;123;149;65;116;43;184;177;54;48;160;34;146;22;18;108;69;159;181;42;5;41;193;139;68;140;93;117;143;0;46;115;59;118;51;133;79;63;180;135;70;154;158;53;121,2144787854633467346,0.000999
greedy_intra:nodes_start:greedy,101,71721,23532,48189,41997,3,101;1;152;97;26;100;121;94;124;148;102;49;178;106;52;55;57;92;129;2;120;44;25;16;171;175;113;56;31;78;145;179;196;81;90;40;185;165;138;14;144;62;9;15;114;186;89;183;23;137;176;80;151;162;127;123;149;65;116;43;184;10;177;54;48;160;34;146;22;18;108;69;159;181;42;5;41;193;139;68;140;93;117;143;0;46;115;59;118;51;133;79;63;180;135;70;154;53;86;75,727665043780176818,0.001000
greedy_intra:nodes_start:greedy,102,71338,23276,48062,31422,2,102;148;9;62;144;14;138;185;40;165;90;81;196;179;145;78;31;56;113;175;171;16;25;44;120;75;86;26;124;94;63;79;80;176;133;151;51;118;59;115;46;0;137;23;186;89;183;143;117;93;140;68;139;193;41;5;42;181;159;69;108;18;22;146;34;160;48;54;177;10;190;84;184;43;116;65;131;149;162;123;127;70;135;154;180;53;100;101;1;97;152;2;129;92;57;55;52;106;178;49,3980050569683137882,0.001001
greedy_intra:nodes_start:greedy,103,71169,23196,47973,29972,3,181;34;160;48;54;177;10;190;4;112;84;184;42;43;116;65;149;123;127;162;151;133;135;70;154;180;53;121;100;26;86;75;44;25;16;171;175;113;56;31;78;145;179;196;81;90;40;165;185;106;178;3;14;144;62;9;148;102;49;52;55;57;92;129;82;120;2;101;1;97;152;124;94;63;79;80;176;137;23;186;89;183;143;117;0;51;118;59;115;46;68;139;41;193;159;69;108;18;22;146,5749338101999656428,0.000992
greedy_intra:nodes_start:greedy,104,71857,23199,48658,71528,11,30;54;48;160;34;181;42;195;146;22;18;108;69;159;193;41;139;68;140;93;117;143;183;89;186;23;137;176;80;79;63;94;124;152;97;1;101;2;120;82;129;92;57;55;52;49;102;148;9;62;144;14;3;178;106;185;165;40;90;81;196;179;145;78;31;56;113;175;171;16;25;44;75;86;26;100;121;53;180;154;135;70;127;123;162;133;151;51;0;46;115;118;59;65;116;43;184;190;10;177,1951326098097795064,0.004975
greedy_intra:nodes_start:greedy,105,72027,23295,48732,46454,4,47;116;43;184;84;190;10;177;54;48;160;34;146;22;18;108;69;159;181;42;5;41;193;139;68;46;115;59;118;51;0;117;143;183;89;186;23;137;176;80;79;63;94;124;152;97;1;101;2;120;82;129;57;92;55;52;49;102;148;9;62;144;14;3;178;106;185;40;165;90;81;196;179;145;78;31;56;113;175;171;16;25;44;75;86;26;100;121;53;180;154;70;135;133;151;162;127;123;149;65,5838031472831361477,0.002184
greedy_intra:nodes_start:greedy,106,71362,23300,48062,58233,5,106;178;49;102;148;9;62;144;14;138;165;185;40;90;81;196;179;145;78;31;56;113;175;171;16;25;44;120;75;86;101;124;94;63;79;80;176;133;151;51;118;59;115;46;0;137;23;186;89;183;143;117;93;140;68;139;193;41;5;42;181;159;69;108;18;22;146;34;160;48;54;177;10;190;84;184;43;116;65;131;149;162;123;127;70;135;154;180;53;100;26;97;1;152;2;129;92;57;55;52,1437018127292523145,0.001990
greedy_intra:nodes_start:greedy,107,72157,23629,48528,20300,3,27;58;164;7;95;39;165;138;14;144;62;9;148;102;49;178;106;52;55;57;92;129;2;152;97;1;101;100;53;180;154;135;70;127;123;162;149;65;116;43;184;177;54;48;160;34;146;22;18;108;69;159;181;42;5;41;193;139;68;140;93;117;143;183;89;23;137;0;46;115;59;118;51;151;133;176;80;79;63;94;26;86;75;120;44;25;16;171;175;113;56;31;78;145;179;196;81;185;40;90,7746273396024958305,0.001992
greedy_intra:nodes_start:greedy,108,71960,23109,48851,32871,3,108;69;139;68;46;115;59;118;51;0;117;143;183;89;186;23;137;176;80;79;63;94;124;152;97;1;101;2;120;82;129;57;92;55;52;49;102;148;9;62;144;14;3;178;106;185;40;165;90;81;196;179;145;78;31;56;113;175;171;16;25;44;75;86;26;100;121;53;180;154;70;135;133;151;162;127;123;149;65;116;43;184;84;190;10;177;54;48;160;34;181;42;5;41;193;159;146;22;199;18,4242481452300727935,0.002608
greedy_intra:nodes_start:greedy,109,72148,23548,48600,26696,3,109;118;115;46;68;139;193;41;5;42;181;159;69;108;18;22;146;34;160;48;54;177;10;112;4;84;184;43;116;65;59;151;133;162;123;127;70;135;154;180;53;121;100;26;86;75;44;25;16;171;175;113;56;31;78;145;179;196;81;90;40;165;185;106;178;3;14;144;62;9;148;102;49;52;55;92;57;129;82;120;2;101;1;97;152;124;94;63;79;80;176;137;23;186;89;183;143;117;0;51,4038081849693554272,0.002014
greedy_intra:nodes_start:greedy,110,71964,23165,48799,79412,7,139;193;41;5;42;181;159;69;108;18;22;146;34;160;48;54;177;10;190;84;184;43;116;65;149;123;127;162;151;133;135;70;154;180;53;121;100;26;86;75;44;25;16;171;175;113;56;31;78;145;179;196;81;90;165;40;185;106;178;3;14;144;62;9;148;102;49;52;55;57;92;129;82;120;2;101;1;97;152;124;94;63;79;80;176;137;23;186;89;183;143;117;0;51;118;59;115;46;68;198,572466562413035563,0.003007
greedy_intra:nodes_start:greedy,111,72508,23912,48596,29264,3,167;148;9;62;102;144;14;49;178;106;165;39;95;164;27;90;81;196;40;185;52;55;57;129;92;179;145;78;31;56;113;175;171;16;25;44;120;2;152;97;1;101;75;86;26;100;121;53;158;154;70;135;180;63;79;133;51;118;59;115;46;0;89;183;143;117;93;140;68;139;193;41;5;42;181;159;69;108;18;22;146;34;160;48;54;177;184;43;116;65;149;123;127;162;151;80;176;137;94;124,2449908440940766568,0.001000
greedy_intra:nodes_start:greedy,112,71495,23245,48250,45806,4,112;4;84;35;184;10;177;54;48;160;34;181;146;22;18;108;69;159;193;41;5;42;43;116;65;46;68;139;115;59;118;51;0;117;143;183;89;186;23;137;176;80;79;63;94;124;152;97;1;101;2;120;82;129;92;57;55;52;49;102;148;9;62;144;14;3;178;106;185;40;165;90;81;196;179;145;78;31;56;113;175;171;16;25;44;75;86;26;100;121;53;180;154;70;135;133;151;162;123;127,7563156933790525464,0.002793
greedy_intra:nodes_start:greedy,113,71640,23500,48140,65548,7,113;56;31;78;145;92;179;196;81;90;165;40;185;106;178;3;14;144;62;9;148;102;49;52;55;57;129;2;152;1;97;26;100;53;180;154;135;70;127;123;162;149;131;65;116;43;184;84;190;10;177;54;48;160;34;146;22;18;108;69;159;181;42;5;41;193;139;68;140;93;117;143;183;89;186;23;137;0;46;115;59;118;51;151;133;176;80;79;63;94;124;101;86;75;120;44;25;16;171;175,7282149222491657039,0.003004
greedy_intra:nodes_start:greedy,114,71682,23112,48570,12464,0,114;186;89;183;23;137;176;80;151;162;127;123;149;65;116;43;184;177;54;48;160;34;146;22;18;108;69;159;181;42;5;41;193;139;68;140;93;117;143;0;46;115;59;118;51;133;79;63;180;135;70;154;158;53;121;100;26;86;75;101;1;97;152;94;124;148;9;62;102;49;178;106;52;55;57;92;129;2;120;44;25;16;171;175;113;56;31;78;145;179;196;81;90;185;40;165;138;14;144;15,6416401519109565773,0.001000
greedy_intra:nodes_start:greedy,115,71485,23362,48123,37097,4,115;59;118;51;0;117;143;183;89;186;23;137;176;80;79;63;94;124;152;97;1;101;2;120;82;129;92;57;55;52;49;102;148;9;62;144;14;3;178;106;185;40;165;90;81;196;179;145;78;31;56;113;175;171;16;25;44;75;86;26;100;121;53;180;154;70;135;133;151;162;127;123;149;65;116;43;184;112;4;190;10;177;54;48;160;34;146;22;18;108;69;159;181;42;5;41;193;139;68;46,4559814795201028920,0.002589
greedy_intra:nodes_start:greedy,116,71833,23710,48123,19456,2,116;43;184;112;4;190;10;177;54;48;160;34;146;22;18;108;69;159;181;42;5;41;193;139;68;46;115;59;118;51;0;117;143;183;89;186;23;137;176;80;79;63;94;124;152;97;1;101;2;120;82;129;57;92;55;52;49;102;148;9;62;144;14;3;178;106;185;165;40;90;81;196;179;145;78;31;56;113;175;171;16;25;44;75;86;26;100;121;53;180;154;70;135;133;151;162;127;123;149;65,3766366793959573356,0.002015
greedy_intra:nodes_start:greedy,117,70687,22482,48205,58128,5,117;0;46;68;139;115;193;41;5;42;181;159;69;108;18;22;146;34;160;48;54;177;10;190;4;112;84;184;43;116;65;59;118;51;151;133;162;123;127;70;135;154;180;53;121;100;26;86;75;44;25;16;171;175;113;56;31;78;145;179;196;81;90;165;40;185;106;178;3;14;144;62;9;148;102;49;52;55;57;92;129;82;120;2;101;1;97;152;124;94;63;79;80;176;137;23;186;89;183;143,3407719866522451005,0.003462
greedy_intra:nodes_start:greedy,118,71837,23714,48123,37127,4,59;115;46;68;139;193;41;5;42;181;159;69;108;18;22;146;34;160;48;54;177;10;4;112;84;184;43;116;65;149;123;127;162;151;133;135;70;154;180;53;121;100;26;86;75;44;25;16;171;175;113;56;31;78;145;179;196;81;90;40;165;185;106;178;3;14;144;62;9;148;102;49;52;55;92;57;129;82;120;2;101;1;97;152;124;94;63;79;80;176;137;23;186;89;183;143;117;0;51;118,7849370341331575704,0.002443
greedy_intra:nodes_start:greedy,119,71397,23202,48195,36166,3,119;185;40;90;81;196;179;145;78;31;56;113;175;171;16;25;44;120;75;86;101;124;94;63;79;80;176;133;151;51;118;59;115;46;0;137;23;186;89;183;143;117;93;140;68;139;193;41;5;42;181;159;69;108;18;22;146;34;160;48;54;177;10;190;184;43;116;65;131;149;162;123;127;70;135;154;180;53;100;26;1;97;152;2;129;92;57;55;52;106;178;49;102;148;9;62;144;14;138;165,5310951941242309529,0.002193
greedy_intra:nodes_start:greedy,120,71472,23332,48140,49199,5,120;75;86;101;124;94;63;79;80;176;133;151;51;118;59;115;46;0;137;23;186;89;183;143;117;93;140;68;139;193;41;5;42;181;159;69;108;18;22;146;34;160;48;54;177;10;190;84;184;43;116;65;131;149;162;123;127;70;135;154;180;53;100;26;1;97;152;2;129;92;57;55;52;49;102;148;9;62;144;14;3;178;106;185;40;165;90;81;196;179;145;78;31;56;113;175;171;16;25;44,3554338188549597242,0.003002
greedy_intra:nodes_start:greedy,121,71867,23297,48570,12519,0,121;100;26;97;86;75;101;1;152;94;124;148;102;49;178;106;52;55;57;92;129;2;120;44;25;16;171;175;113;56;31;78;145;179;196;81;90;185;40;165;138;14;144;62;9;15;114;186;89;183;23;137;176;80;151;162;127;123;149;65;116;43;184;177;54;48;160;34;146;22;18;108;69;159;181;42;5;41;193;139;68;140;93;117;143;0;46;115;59;118;51;133;79;63;180;135;70;154;158;53,7433739621976413133,0.000000
greedy_intra:nodes_start:greedy,122,72141,22931,49210,51627,4,122;176;80;79;133;151;51;118;59;115;46;0;137;23;89;183;143;117;93;140;68;139;193;41;5;42;181;159;69;108;18;22;146;34;160;48;54;177;184;43;116;65;131;149;162;123;127;70;135;154;180;158;53;121;100;26;86;75;44;25;16;171;175;113;56;31;78;145;179;196;81;90;165;40;185;106;178;3;14;144;62;9;148;102;49;52;55;57;92;129;82;120;2;101;1;97;152;124;94;63,9142543097848047382,0.002969
greedy_intra:nodes_start:greedy,123,71925,23363,48562,12934,1,123;162;133;151;149;131;65;116;43;184;84;190;10;177;54;48;160;34;146;22;18;108;69;159;181;42;5;41;193;139;68;46;115;59;118;51;0;117;143;183;89;186;23;137;176;80;79;63;94;124;152;97;1;101;2;120;82;129;57;92;55;52;49;102;148;9;62;144;14;3;178;106;185;165;40;90;81;196;179;145;78;31;56;113;175;171;16;25;44;75;86;26;100;121;53;180;154;135;70;127,6313303693587285013,0.001919
greedy_intra:nodes_start:greedy,124,71688,23118,48570,34506,2,94;152;97;1;101;75;86;26;100;121;53;158;154;70;135;180;63;79;133;51;118;59;115;46;0;143;117;93;140;68;139;193;41;5;42;181;159;69;108;18;22;146;34;160;48;54;177;184;43;116;65;149;123;127;162;151;80;176;137;23;183;89;186;114;15;9;62;144;14;138;165;185;40;90;81;196;179;145;78;31;56;113;175;171;16;25;44;120;2;129;92;57;55;52;106;178;49;102;148;124,9160410389630076226,0.002333
greedy_intra:nodes_start:greedy,125,72950,23469,49481,44624,5,74;2;120;82;129;92;57;179;145;78;31;56;113;175;171;16;25;44;75;86;53;154;70;135;180;63;79;133;51;118;59;115;46;0;143;117;93;140;68;139;193;41;5;42;181;159;69;108;18;22;146;34;160;48;54;177;184;43;116;65;149;123;162;151;80;176;137;23;183;89;186;114;15;9;62;144;14;138;165;90;81;196;40;185;55;52;106;178;49;102;148;124;94;121;100;26;101;1;97;152,2464438592964635952,0.002971
greedy_intra:nodes_start:greedy,126,71710,23103,48607,71437,8,131;112;4;84;35;184;177;54;48;160;34;181;146;22;18;108;69;159;193;41;5;42;43;116;65;46;68;139;115;59;118;51;0;117;143;183;89;186;23;137;176;80;79;63;94;124;152;97;1;101;2;120;82;129;92;57;55;52;49;102;148;9;62;144;14;3;178;106;185;40;165;90;81;196;179;145;78;31;56;113;175;171;16;25;44;75;86;26;100;121;53;180;154;70;135;133;151;162;123;149,5600490266784193442,0.003003
greedy_intra:nodes_start:greedy,127,71954,23449,48505,30317,3,127;70;135;154;180;53;121;100;26;86;75;44;25;16;171;175;113;56;31;78;145;179;196;81;90;165;40;185;106;178;3;14;144;62;9;148;102;49;52;55;92;57;129;82;120;2;101;1;97;152;124;94;63;79;80;176;133;151;51;118;59;115;46;0;137;23;186;89;183;143;117;93;140;68;139;193;41;5;42;181;159;69;108;18;22;146;34;160;48;54;177;10;184;43;116;65;131;149;162;123,6094770723947136803,0.002003
greedy_intra:nodes_start:greedy,128,71574,23405,48169,102006,10,3;167;148;9;62;102;144;14;49;178;106;185;40;165;90;81;196;179;145;78;31;56;113;175;171;16;25;44;120;75;86;152;124;94;63;79;80;176;133;151;51;118;59;115;46;0;137;23;186;89;183;143;117;93;140;68;139;193;41;5;42;181;159;69;108;18;22;146;34;160;48;54;177;10;190;184;43;116;65;131;149;162;123;127;70;135;154;180;53;100;26;97;1;101;2;129;92;57;55;52,7031603949021539258,0.003973
greedy_intra:nodes_start:greedy,129,71822,23682,48140,29021,3,129;57;92;55;52;49;102;148;9;62;144;14;3;178;106;185;165;40;90;81;196;179;145;78;31;56;113;175;171;16;25;44;120;75;86;26;124;94;63;79;80;176;133;151;51;118;59;115;46;0;137;23;186;89;183;143;117;93;140;68;139;193;41;5;42;181;159;69;108;18;22;146;34;160;48;54;177;10;190;84;184;43;116;65;131;149;162;123;127;70;135;154;180;53;100;101;1;97;152;2,2770194038230660042,0.001998
greedy_intra:nodes_start:greedy,130,71688,23118,48570,33715,4,124;148;102;49;178;106;52;55;57;92;129;2;120;44;25;16;171;175;113;56;31;78;145;179;196;81;90;40;185;165;138;14;144;62;9;15;114;186;89;183;23;137;176;80;151;162;127;123;149;65;116;43;184;177;54;48;160;34;146;22;18;108;69;159;181;42;5;41;193;139;68;140;93;117;143;0;46;115;59;118;51;133;79;63;180;135;70;154;158;53;121;100;26;86;75;101;1;97;152;94,650689365425326941,0.001999
greedy_intra:nodes_start:greedy,131,71630,23068,48562,41193,3,131;149;123;127;162;151;133;135;70;154;180;53;121;100;26;86;75;44;25;16;171;175;113;56;31;78;145;179;196;81;90;165;40;185;106;178;3;14;144;62;9;148;102;49;52;55;57;92;129;82;120;2;101;1;97;152;124;94;63;79;80;176;137;23;186;89;183;143;117;0;51;118;59;115;46;68;139;193;41;5;42;181;159;69;108;18;22;146;34;160;48;54;177;10;190;84;184;43;116;65,7154010421781590620,0.002000
greedy_intra:nodes_start:greedy,132,71856,23951,47905,47814,6,21;14;138;165;185;40;90;81;196;179;145;78;31;56;113;175;171;16;25;44;120;75;86;101;124;94;63;79;80;176;133;151;51;118;59;115;46;0;137;23;186;89;183;143;117;93;140;68;139;193;41;5;42;181;159;69;108;18;22;146;34;160;48;54;177;10;190;184;43;116;65;131;149;162;123;127;70;135;154;180;53;100;26;1;97;152;2;129;92;57;55;52;106;178;49;102;148;9;62;144,307685463543057234,0.003000
greedy_intra:nodes_start:greedy,133,71753,23248,48505,52019,4,133;151;51;118;59;115;46;0;137;23;186;89;183;143;117;93;140;68;139;193;41;5;42;181;159;69;108;18;22;146;34;160;48;54;177;10;184;43;116;65;131;149;162;123;127;70;135;154;180;53;121;100;26;86;75;44;25;16;171;175;113;56;31;78;145;179;196;81;90;165;40;185;106;178;3;14;144;62;9;148;102;49;52;55;57;92;129;82;120;2;101;1;97;152;124;94;63;79;80;176,4990941367865824304,0.002000
greedy_intra:nodes_start:greedy,134,72153,23088,49065,51406,6,199;108;18;69;139;68;46;115;59;118;51;0;117;143;183;89;186;23;137;176;80;79;63;94;124;152;97;1;101;2;120;82;129;92;57;55;52;49;102;148;9;62;144;14;3;178;106;185;40;165;90;81;196;179;145;78;31;56;113;175;171;16;25;44;75;86;26;100;121;53;180;154;70;135;133;151;162;127;123;149;65;116;43;184;190;10;177;54;48;160;34;181;42;5;41;193;195;146;22;159,4801131698494006120,0.002000
greedy_intra:nodes_start:greedy,135,71688,23118,48570,23206,1,135;70;154;158;53;121;100;26;86;75;101;1;97;152;94;124;148;102;49;178;106;52;55;57;92;129;2;120;44;25;16;171;175;113;56;31;78;145;179;196;81;90;40;185;165;138;14;144;62;9;15;114;186;89;183;23;137;176;80;151;162;127;123;149;65;116;43;184;177;54;48;160;34;146;22;18;108;69;159;181;42;5;41;193;139;68;140;93;117;143;0;46;115;59;118;51;133;79;63;180,481140335940857186,0.000999
greedy_intra:nodes_start:greedy,136,72020,23321,48699,64357,6,53;121;100;26;86;75;44;25;16;171;175;113;56;31;78;145;179;196;81;90;40;165;185;106;178;3;14;144;62;9;148;102;49;52;55;57;92;129;82;120;2;101;1;97;152;124;94;63;79;80;176;137;23;186;89;183;143;117;0;51;118;59;115;46;68;139;193;41;5;42;181;159;69;108;18;22;146;34;160;48;54;177;10;190;84;184;43;116;65;149;123;127;162;151;133;135;70;180;154;158,3996939234401102875,0.003042
greedy_intra:nodes_start:greedy,137,71633,23063,48570,25003,1,137;23;183;89;186;114;15;9;62;144;14;138;185;40;165;90;81;196;179;145;78;31;56;113;175;171;16;25;44;120;2;129;92;57;55;52;106;178;49;102;148;124;94;152;97;1;101;75;86;26;100;121;53;158;154;70;135;180;63;79;133;51;118;59;115;46;0;143;117;93;140;68;139;193;41;5;42;181;159;69;108;18;22;146;34;160;48;54;177;184;43;116;65;149;123;127;162;151;80;176,4412538307942605304,0.001046
greedy_intra:nodes_start:greedy,138,71336,23274,48062,46590,4,138;14;144;62;9;148;102;49;178;106;52;55;57;92;129;2;152;97;1;26;100;53;180;154;135;70;127;123;162;149;131;65;116;43;184;84;190;10;177;54;48;160;34;146;22;18;108;69;159;181;42;5;41;193;139;68;140;93;117;143;183;89;186;23;137;0;46;115;59;118;51;151;133;176;80;79;63;94;124;101;86;75;120;44;25;16;171;175;113;56;31;78;145;179;196;81;90;165;40;185,2656016470343035772,0.002003
greedy_intra:nodes_start:greedy,139,71690,23567,48123,46605,4,139;68;46;115;59;118;51;0;117;143;183;89;186;23;137;176;80;79;63;94;124;152;97;1;101;2;120;82;129;57;92;55;52;49;102;148;9;62;144;14;3;178;106;185;40;165;90;81;196;179;145;78;31;56;113;175;171;16;25;44;75;86;26;100;121;53;180;154;70;135;133;151;162;127;123;149;65;116;43;184;84;112;4;10;177;54;48;160;34;146;22;18;108;69;159;181;42;5;41;193,2579038503296946278,0.002996
greedy_intra:nodes_start:greedy,140,71854,23604,48250,17102,2,140;108;69;18;22;146;159;193;41;5;42;181;34;160;48;54;177;10;190;4;112;184;43;116;65;149;123;127;162;151;133;135;70;154;180;53;121;100;26;86;75;44;25;16;171;175;113;56;31;78;145;179;196;81;90;40;165;185;106;178;3;14;144;62;9;148;102;49;52;55;92;57;129;82;120;2;101;1;97;152;124;94;63;79;80;176;137;51;118;59;115;139;46;68;0;89;183;143;117;93,8094628380023804965,0.001999
greedy_intra:nodes_start:greedy,141,71015,22424,48591,73303,8,186;114;23;89;183;143;0;117;93;140;68;46;115;139;193;41;5;42;181;159;69;108;18;22;146;34;160;48;54;177;10;190;184;43;116;65;59;118;51;151;133;162;123;127;70;135;154;180;53;121;100;26;86;75;44;25;16;171;175;113;56;31;78;145;179;196;81;90;165;40;185;106;178;3;14;144;62;9;148;102;49;52;55;57;92;129;82;120;2;101;1;97;152;124;94;63;79;80;176;137,2344747635632583211,0.003974
greedy_intra:nodes_start:greedy,142,71964,23165,48799,64115,6,139;198;68;46;115;59;118;51;0;117;143;183;89;186;23;137;176;80;79;63;94;124;152;97;1;101;2;120;82;129;92;57;55;52;49;102;148;9;62;144;14;3;178;106;185;40;165;90;81;196;179;145;78;31;56;113;175;171;16;25;44;75;86;26;100;121;53;180;154;70;135;133;151;162;127;123;149;65;116;43;184;84;190;10;177;54;48;160;34;146;22;18;108;69;159;181;42;5;41;193,9015908923429119543,0.002000
greedy_intra:nodes_start:greedy,143,70840,22635,48205,42512,3,143;117;0;46;68;139;115;41;193;5;42;181;159;69;108;18;22;146;34;160;48;54;177;10;190;4;112;84;184;43;116;65;59;118;51;151;133;162;123;127;70;135;154;180;53;121;100;26;86;75;44;25;16;171;175;113;56;31;78;145;179;196;81;90;40;165;185;106;178;3;14;144;62;9;148;102;49;52;55;57;92;129;82;120;2;101;1;97;152;124;94;63;79;80;176;137;23;186;89;183,5034699481675822214,0.001999
greedy_intra:nodes_start:greedy,144,71338,23276,48062,27094,2,144;14;138;185;40;165;90;81;196;179;145;78;31;56;113;175;171;16;25;44;120;75;86;26;124;94;63;79;80;176;133;151;51;118;59;115;46;0;137;23;186;89;183;143;117;93;140;68;139;193;41;5;42;181;159;69;108;18;22;146;34;160;48;54;177;10;190;84;184;43;116;65;131;149;162;123;127;70;135;154;180;53;100;101;1;97;152;2;129;92;57;55;52;106;178;49;102;148;9;62,1324070053971225056,0.000998
greedy_intra:nodes_start:greedy,145,71675,23535,48140,28882,3,145;179;196;81;90;165;40;185;106;178;3;14;144;62;9;148;102;49;52;55;92;57;129;2;152;97;1;101;100;53;180;154;135;70;127;123;162;149;131;65;116;43;184;84;190;10;177;54;48;160;34;146;22;18;108;69;159;181;42;5;41;193;139;68;140;93;117;143;183;89;186;23;137;0;46;115;59;118;51;151;133;176;80;79;63;94;124;26;86;75;120;44;25;16;171;175;113;56;31;78,8950958034725037369,0.001000
greedy_intra:nodes_start:greedy,146,71370,23397,47973,12899,1,146;181;34;160;48;54;177;10;190;4;112;84;184;42;43;116;65;149;123;127;162;151;133;135;70;154;180;53;121;100;26;86;75;44;25;16;171;175;113;56;31;78;145;179;196;81;90;40;165;185;106;178;3;14;144;62;9;148;102;49;52;55;92;57;129;82;120;2;101;1;97;152;124;94;63;79;80;176;137;23;186;89;183;143;117;0;51;118;59;115;46;68;139;41;193;159;69;108;18;22,7703072762619696933,0.001000
greedy_intra:nodes_start:greedy,147,71640,22982,48658,64722,8,30;177;10;190;184;43;116;65;59;118;115;46;0;51;151;133;162;123;127;70;135;154;180;53;121;100;26;86;75;44;25;16;171;175;113;56;31;78;145;179;196;81;90;165;40;185;106;178;3;14;144;62;9;148;102;49;52;55;57;92;129;82;120;2;101;1;97;152;124;94;63;79;80;176;137;23;186;89;183;143;117;93;140;68;139;41;193;159;69;108;18;22;146;195;181;42;160;34;48;54,5251903673008243714,0.003000
greedy_intra:nodes_start:greedy,148,71336,23274,48062,37848,3,148;102;49;178;106;52;55;57;92;129;2;152;97;1;26;100;53;180;154;135;70;127;123;162;149;131;65;116;43;184;84;190;10;177;54;48;160;34;146;22;18;108;69;159;181;42;5;41;193;139;68;140;93;117;143;183;89;186;23;137;0;46;115;59;118;51;151;133;176;80;79;63;94;124;101;86;75;120;44;25;16;171;175;113;56;31;78;145;179;196;81;90;165;40;185;138;14;144;62;9,8288374945853910061,0.002004
greedy_intra:nodes_start:greedy,149,71686,23563,48123,29711,3,149;123;127;162;151;133;135;70;154;180;53;121;100;26;86;75;44;25;16;171;175;113;56;31;78;145;179;196;81;90;165;40;185;106;178;3;14;144;62;9;148;102;49;52;55;92;57;129;82;120;2;101;1;97;152;124;94;63;79;80;176;137;23;186;89;183;143;117;0;51;118;59;115;46;68;139;193;41;5;42;181;159;69;108;18;22;146;34;160;48;54;177;10;190;4;112;184;43;116;65,1338183518796009435,0.001000
greedy_intra:nodes_start:greedy,150,72647,23609,49038,72904,6,86;75;44;25;16;171;175;113;56;31;78;145;179;57;92;129;82;120;2;152;1;97;26;100;189;94;124;148;102;49;178;106;52;55;185;40;196;81;90;165;138;14;144;62;9;15;114;186;89;183;23;137;176;80;151;162;123;149;65;116;43;184;177;54;48;160;34;146;22;18;108;69;159;181;42;5;41;193;139;68;140;93;117;143;0;46;115;59;118;51;133;79;63;180;135;70;154;53;121;101,8766687740224576041,0.002998
greedy_intra:nodes_start:greedy,151,71577,23015,48562,34976,3,151;133;162;123;127;70;135;154;180;53;121;100;26;86;75;44;25;16;171;175;113;56;31;78;145;179;196;81;90;165;40;185;106;178;3;14;144;62;9;148;102;49;52;55;57;92;129;82;120;2;101;1;97;152;124;94;63;79;80;176;137;23;186;89;183;143;117;0;51;118;59;115;46;68;139;193;41;5;42;181;159;69;108;18;22;146;34;160;48;54;177;10;190;84;184;43;116;65;131;149,7045212069674640180,0.001639
greedy_intra:nodes_start:greedy,152,71783,23594,48189,19845,2,152;1;101;75;86;53;154;70;135;180;63;79;133;51;118;59;115;46;0;143;117;93;140;68;139;193;41;5;42;181;159;69;108;18;22;146;34;160;48;54;177;10;184;43;116;65;149;123;127;162;151;80;176;137;23;183;89;186;114;15;9;62;144;14;138;165;40;185;90;81;196;179;145;78;31;56;113;175;171;16;25;44;120;2;129;92;57;55;52;106;178;49;102;148;124;94;121;100;26;97,7102952588519193022,0.001973
greedy_intra:nodes_start:greedy,153,71380,22756,48624,43959,6,0;117;170;143;183;89;186;23;137;176;80;79;63;94;124;152;97;1;101;2;120;82;129;57;92;55;52;49;102;148;9;62;144;14;3;178;106;185;40;165;90;81;196;179;145;78;31;56;113;175;171;16;25;44;75;86;26;100;121;53;180;154;135;70;127;123;162;133;151;51;118;59;65;116;43;184;112;4;190;10;177;54;48;160;34;146;22;18;108;69;159;181;42;5;115;41;193;139;68;46,7154673804456272767,0.003000
greedy_intra:nodes_start:greedy,154,71633,23063,48570,22752,1,154;158;53;121;100;26;86;75;101;1;97;152;94;124;148;102;49;178;106;52;55;57;92;129;2;120;44;25;16;171;175;113;56;31;78;145;179;196;81;90;165;40;185;138;14;144;62;9;15;114;186;89;183;23;137;176;80;151;162;127;123;149;65;116;43;184;177;54;48;160;34;146;22;18;108;69;159;181;42;5;41;193;139;68;140;93;117;143;0;46;115;59;118;51;133;79;63;180;135;70,420496878375978895,0.000000
greedy_intra:nodes_start:greedy,155,71856,23951,47905,51223,5,21;14;138;165;185;40;90;81;196;179;145;78;31;56;113;175;171;16;25;44;120;75;86;101;124;94;63;79;80;176;133;151;51;118;59;115;46;0;137;23;186;89;183;143;117;93;140;68;139;193;41;5;42;181;159;69;108;18;22;146;34;160;48;54;177;10;190;184;43;116;65;131;149;162;123;127;70;135;154;180;53;100;26;1;97;152;2;129;92;57;55;52;106;178;49;102;148;9;62;144,6270862319219336740,0.002000
greedy_intra:nodes_start:greedy,156,72101,23494,48607,29675,3,149;112;4;84;35;184;177;54;48;160;34;181;146;22;18;108;69;159;193;41;5;42;43;116;65;46;68;139;115;59;118;51;0;117;143;183;89;186;23;137;176;80;79;63;94;124;152;97;1;101;2;120;82;129;57;92;55;52;49;102;148;9;62;144;14;3;178;106;185;165;40;90;81;196;179;145;78;31;56;113;175;171;16;25;44;75;86;26;100;121;53;180;154;70;135;133;151;162;123;131,4953584421417546359,0.000999
greedy_intra:nodes_start:greedy,157,71923,23608,48315,31071,3,157;196;81;90;40;165;185;106;178;3;14;144;62;9;148;102;49;52;55;179;145;78;92;57;129;2;152;97;1;26;100;53;180;154;135;70;127;123;162;149;131;65;116;43;184;190;10;177;54;48;160;34;146;22;18;108;69;159;181;42;5;41;193;139;68;140;93;117;143;183;89;186;23;137;0;46;115;59;118;51;151;133;176;80;79;63;94;124;101;86;75;120;44;25;16;171;175;113;56;31,9178447661028796310,0.002000
greedy_intra:nodes_start:greedy,158,71633,23063,48570,22912,1,158;154;70;135;180;63;79;133;51;118;59;115;46;0;143;117;93;140;68;139;193;41;5;42;181;159;69;108;18;22;146;34;160;48;54;177;184;43;116;65;149;123;127;162;151;80;176;137;23;183;89;186;114;15;9;62;144;14;138;185;40;165;90;81;196;179;145;78;31;56;113;175;171;16;25;44;120;2;129;92;57;55;52;106;178;49;102;148;124;94;152;97;1;101;75;86;26;100;121;53,8321560167036645156,0.000991
greedy_intra:nodes_start:greedy,159,71475,23225,48250,49310,5,159;146;22;18;69;108;140;93;117;143;183;89;0;46;68;139;115;59;118;51;137;176;80;79;63;94;124;152;97;1;101;2;120;82;129;92;57;55;52;49;102;148;9;62;144;14;3;178;106;185;40;165;90;81;196;179;145;78;31;56;113;175;171;16;25;44;75;86;26;100;121;53;180;154;70;135;133;151;162;127;123;149;65;116;43;184;112;4;190;10;177;54;48;160;34;181;42;5;41;193,6659883270574918267,0.001967
greedy_intra:nodes_start:greedy,160,71022,23049,47973,42020,3,160;48;54;177;10;190;4;112;84;184;42;43;116;65;149;123;127;162;151;133;135;70;154;180;53;121;100;26;86;75;44;25;16;171;175;113;56;31;78;145;179;196;81;90;165;40;185;106;178;3;14;144;62;9;148;102;49;52;55;57;92;129;82;120;2;101;1;97;152;124;94;63;79;80;176;137;23;186;89;183;143;117;0;51;118;59;115;46;68;139;41;193;159;69;108;18;22;146;181;34,4945353628208460220,0.002031
greedy_intra:nodes_start:greedy,161,71725,22939,48786,109603,12,123;127;70;135;154;180;158;53;121;100;26;86;75;44;25;16;171;175;113;56;31;78;145;179;196;81;90;165;40;185;106;178;3;14;144;62;9;148;102;49;52;55;57;92;129;82;120;2;101;1;97;152;124;94;63;79;80;176;137;23;186;89;183;143;117;0;51;118;59;115;46;68;139;193;41;5;42;181;159;69;108;18;22;146;34;160;48;54;177;10;190;184;43;116;65;131;149;162;151;133,8428866642492781035,0.005031
greedy_intra:nodes_start:greedy,162,71489,23366,48123,45204,5,162;151;133;135;70;154;180;53;121;100;26;86;75;44;25;16;171;175;113;56;31;78;145;179;196;81;90;165;40;185;106;178;3;14;144;62;9;148;102;49;52;55;57;92;129;82;120;2;101;1;97;152;124;94;63;79;80;176;137;23;186;89;183;143;117;0;51;118;59;115;46;68;139;193;41;5;42;181;159;69;108;18;22;146;34;160;48;54;177;10;4;112;84;184;43;116;65;149;123;127,6943242487205373494,0.002059
greedy_intra:nodes_start:greedy,163,71640,23151,48489,65529,7,140;68;46;139;115;59;118;51;0;117;143;183;89;186;23;137;176;80;79;63;94;124;152;97;1;101;2;120;82;129;57;92;55;52;49;102;148;9;62;144;14;3;178;106;185;40;165;90;81;196;179;145;78;31;56;113;175;171;16;25;44;75;86;26;100;121;53;180;154;70;135;133;151;162;127;123;149;65;116;43;184;84;190;10;177;54;48;160;34;181;42;5;41;193;159;146;22;18;69;108,989193344042423867,0.003408
greedy_intra:nodes_start:greedy,164,72157,23629,48528,13293,1,164;7;95;39;165;138;14;144;62;9;148;102;49;178;106;52;55;57;92;129;2;152;97;1;101;100;53;180;154;135;70;127;123;162;149;65;116;43;184;177;54;48;160;34;146;22;18;108;69;159;181;42;5;41;193;139;68;140;93;117;143;183;89;23;137;0;46;115;59;118;51;151;133;176;80;79;63;94;26;86;75;120;44;25;16;171;175;113;56;31;78;145;179;196;81;185;40;90;27;58,1142560431899546855,0.001000
greedy_intra:nodes_start:greedy,165,71455,23393,48062,13943,1,165;40;185;90;81;196;179;145;78;31;56;113;175;171;16;25;44;120;75;86;26;124;94;63;79;80;176;133;151;51;118;59;115;46;0;137;23;186;89;183;143;117;93;140;68;139;193;41;5;42;181;159;69;108;18;22;146;34;160;48;54;177;10;190;84;184;43;116;65;131;149;162;123;127;70;135;154;180;53;100;101;1;97;152;2;129;92;57;55;52;106;178;49;102;148;9;62;144;14;138,7402069674853738774,0.000999
greedy_intra:nodes_start:greedy,166,71791,23246,48545,62638,6,35;184;190;10;177;54;48;160;34;146;22;18;108;69;159;181;42;5;41;193;139;68;140;93;117;143;183;89;186;23;137;176;80;79;63;94;124;152;97;1;101;2;120;82;129;92;57;55;52;49;102;148;9;62;144;14;3;178;106;185;40;165;90;81;196;179;145;78;31;56;113;175;171;16;25;44;75;86;26;100;121;53;180;154;135;70;127;123;162;133;151;51;0;46;115;118;59;65;116;43,2628571509543807238,0.003430
greedy_intra:nodes_start:greedy,167,72706,24130,48576,13656,1,167;148;9;62;102;144;14;49;178;106;165;39;95;7;164;58;27;90;81;196;40;185;52;55;57;129;92;179;145;78;31;56;113;175;171;16;25;44;120;2;75;101;1;97;152;26;100;86;53;154;70;135;180;63;79;133;51;118;59;115;46;0;89;183;143;117;93;140;68;139;193;41;5;42;181;159;69;108;18;22;146;34;160;48;54;177;184;43;116;65;149;123;127;162;151;80;176;137;94;124,8701324197264973289,0.000719
greedy_intra:nodes_start:greedy,168,72061,23746,48315,83760,9,179;145;78;196;81;90;165;40;185;106;178;3;14;144;62;9;148;102;49;52;55;92;57;129;2;152;1;97;26;100;53;180;154;135;70;127;123;162;149;131;65;116;43;184;190;10;177;54;48;160;34;146;22;18;108;69;159;181;42;5;41;193;139;68;140;93;117;143;183;89;186;23;137;0;46;115;59;118;51;151;133;176;80;79;63;94;124;101;86;75;120;44;25;16;171;175;113;56;31;157,311869890105367775,0.003616
greedy_intra:nodes_start:greedy,169,71897,23702,48195,19886,2,119;40;90;165;138;14;144;62;9;148;102;49;178;106;52;55;57;92;129;2;152;97;1;101;100;53;180;154;135;70;127;123;162;149;131;65;116;43;184;190;10;177;54;48;160;34;146;22;18;108;69;159;181;42;5;41;193;139;68;140;93;117;143;183;89;186;23;137;0;46;115;59;118;51;151;133;176;80;79;63;94;124;26;86;75;120;44;25;16;171;175;113;56;31;78;145;179;185;81;196,4377094528046128496,0.001000
greedy_intra:nodes_start:greedy,170,71203,22579,48624,60969,6,170;117;0;46;68;139;115;193;41;5;42;181;159;69;108;18;22;146;34;160;48;54;177;10;112;4;84;184;43;116;65;59;118;51;151;133;162;123;127;70;135;154;180;53;121;100;26;86;75;44;25;16;171;175;113;56;31;78;145;179;196;81;90;165;40;185;106;178;3;14;144;62;9;148;102;49;52;55;57;92;129;82;120;2;101;1;97;152;124;94;63;79;80;176;137;23;186;89;183;143,4015954430805022366,0.002000
greedy_intra:nodes_start:greedy,171,71934,23794,48140,24125,2,171;175;113;56;31;145;78;92;179;196;81;90;40;165;185;106;178;3;14;144;62;9;148;102;49;52;55;57;129;2;152;97;1;101;100;53;180;154;135;70;127;123;162;149;131;65;116;43;184;84;190;10;177;54;48;160;34;146;22;18;108;69;159;181;42;5;41;193;139;68;140;93;117;143;183;89;186;23;137;0;46;115;59;118;51;151;133;176;80;79;63;94;124;26;86;75;120;44;25;16,3064993014028664041,0.000993
greedy_intra:nodes_start:greedy,172,71946,23684,48262,96218,12,167;148;15;9;62;102;144;14;49;178;106;165;39;27;90;81;196;40;185;52;55;57;129;92;179;145;78;31;56;113;175;171;16;25;44;120;2;75;86;101;124;94;63;79;80;176;133;151;51;118;59;115;46;0;137;23;186;89;183;143;117;93;140;68;139;193;41;5;42;181;159;69;108;18;22;146;34;160;48;54;177;184;43;116;65;131;149;162;123;127;70;135;154;180;53;100;26;97;1;152,6560114513598458665,0.004972
greedy_intra:nodes_start:greedy,173,71814,23244,48570,57933,7,127;70;154;180;158;53;121;100;26;86;75;101;1;97;152;94;124;148;102;49;178;106;52;55;57;92;129;2;120;44;25;16;171;175;113;56;31;78;145;179;196;81;90;165;40;185;138;14;144;62;9;15;114;186;89;183;23;137;176;80;151;162;123;149;65;116;43;184;177;54;48;160;34;146;22;18;108;69;159;181;42;5;41;193;139;68;140;93;117;143;0;46;115;59;118;51;133;79;63;135,9051345558483039492,0.003211
greedy_intra:nodes_start:greedy,174,71531,23469,48062,65453,8,196;40;185;179;145;78;31;56;113;175;171;16;25;44;120;75;86;101;124;94;63;79;80;176;133;151;51;118;59;115;46;0;137;23;186;89;183;143;117;93;140;68;139;193;41;5;42;181;159;69;108;18;22;146;34;160;48;54;177;10;190;84;184;43;116;65;131;149;162;123;127;70;135;154;180;53;100;26;97;1;152;2;129;92;57;55;52;106;178;49;102;148;9;62;144;14;138;165;90;81,880802851874707746,0.004537
greedy_intra:nodes_start:greedy,175,71934,23794,48140,13841,2,175;113;56;31;145;78;92;179;196;81;90;40;165;185;106;178;3;14;144;62;9;148;102;49;52;55;57;129;2;152;97;1;101;100;53;180;154;135;70;127;123;162;149;131;65;116;43;184;84;190;10;177;54;48;160;34;146;22;18;108;69;159;181;42;5;41;193;139;68;140;93;117;143;183;89;186;23;137;0;46;115;59;118;51;151;133;176;80;79;63;94;124;26;86;75;120;44;25;16;171,6625384638206502594,0.000000
greedy_intra:nodes_start:greedy,176,71577,23015,48562,42644,3,176;80;79;63;94;124;152;97;1;101;2;120;82;129;92;57;55;52;49;102;148;9;62;144;14;3;178;106;185;40;165;90;81;196;179;145;78;31;56;113;175;171;16;25;44;75;86;26;100;121;53;180;154;135;70;127;123;162;133;151;149;131;65;116;43;184;84;190;10;177;54;48;160;34;146;22;18;108;69;159;181;42;5;41;193;139;68;46;115;59;118;51;0;117;143;183;89;186;23;137,5893349012372210228,0.003035
greedy_intra:nodes_start:greedy,177,71885,23321,48564,51244,4,177;54;48;34;160;42;181;195;146;22;18;108;69;159;193;41;139;68;140;93;117;143;183;89;186;23;137;176;80;79;63;94;124;152;97;1;101;2;120;82;129;57;92;55;52;49;102;148;9;62;144;14;3;178;106;185;40;165;90;81;196;179;145;78;31;56;113;175;171;16;25;44;75;86;26;100;121;53;180;154;135;70;127;123;162;133;151;51;0;46;115;118;59;116;65;43;184;84;190;10,1839794871920731734,0.002000
greedy_intra:nodes_start:greedy,178,71455,23393,48062,17018,2,178;49;102;148;9;62;144;14;138;165;40;185;90;81;196;179;145;78;31;56;113;175;171;16;25;44;120;75;86;26;124;94;63;79;80;176;133;151;51;118;59;115;46;0;137;23;186;89;183;143;117;93;140;68;139;193;41;5;42;181;159;69;108;18;22;146;34;160;48;54;177;10;190;84;184;43;116;65;131;149;162;123;127;70;135;154;180;53;100;101;1;97;152;2;129;92;57;55;52;106,6770436569273089212,0.001000
greedy_intra:nodes_start:greedy,179,71472,23332,48140,36297,5,179;145;78;31;56;113;175;171;16;25;44;120;75;86;101;124;94;63;79;80;176;133;151;51;118;59;115;46;0;137;23;186;89;183;143;117;93;140;68;139;193;41;5;42;181;159;69;108;18;22;146;34;160;48;54;177;10;190;84;184;43;116;65;131;149;162;123;127;70;135;154;180;53;100;26;1;97;152;2;129;92;57;55;52;49;102;148;9;62;144;14;3;178;106;185;40;165;90;81;196,6067097888073736003,0.002001
greedy_intra:nodes_start:greedy,180,71633,23063,48570,22916,1,180;135;70;154;158;53;121;100;26;86;75;101;1;97;152;94;124;148;102;49;178;106;52;55;57;92;129;2;120;44;25;16;171;175;113;56;31;78;145;179;196;81;90;165;40;185;138;14;144;62;9;15;114;186;89;183;23;137;176;80;151;162;127;123;149;65;116;43;184;177;54;48;160;34;146;22;18;108;69;159;181;42;5;41;193;139;68;140;93;117;143;0;46;115;59;118;51;133;79;63,6335324035080866296,0.000997
greedy_intra:nodes_start:greedy,181,71223,23250,47973,25129,2,181;34;160;48;54;177;10;190;4;112;84;184;42;43;116;65;149;123;127;162;151;133;135;70;154;180;53;121;100;26;86;75;44;25;16;171;175;113;56;31;78;145;179;196;81;90;165;40;185;106;178;3;14;144;62;9;148;102;49;52;55;92;57;129;82;120;2;101;1;97;152;124;94;63;79;80;176;137;23;186;89;183;143;117;0;51;118;59;115;46;68;139;41;193;159;69;108;18;22;146,811344732118817945,0.001031
greedy_intra:nodes_start:greedy,182,71688,23118,48570,37523,3,53;121;100;26;86;75;101;1;97;152;94;124;148;102;49;178;106;52;55;57;92;129;2;120;44;25;16;171;175;113;56;31;78;145;179;196;81;90;40;185;165;138;14;144;62;9;15;114;186;89;183;23;137;176;80;151;162;127;123;149;65;116;43;184;177;54;48;160;34;146;22;18;108;69;159;181;42;5;41;193;139;68;140;93;117;143;0;46;115;59;118;51;133;79;63;180;135;70;154;158,2009341498714085049,0.001000
greedy_intra:nodes_start:greedy,183,70693,22488,48205,54402,4,183;89;186;23;137;176;80;79;63;94;124;152;97;1;101;2;120;82;129;92;57;55;52;49;102;148;9;62;144;14;3;178;106;185;40;165;90;81;196;179;145;78;31;56;113;175;171;16;25;44;75;86;26;100;121;53;180;154;135;70;127;123;162;133;151;51;118;59;65;116;43;184;84;112;4;190;10;177;54;48;160;34;146;22;18;108;69;159;181;42;5;193;41;115;139;68;46;0;117;143,3640740362338859023,0.002000
greedy_intra:nodes_start:greedy,184,71865,23365,48500,38173,3,184;43;116;65;59;118;115;46;0;51;151;133;162;123;127;70;135;154;180;53;121;100;26;86;75;44;25;16;171;175;113;56;31;78;145;179;196;81;90;165;40;185;106;178;3;14;144;62;9;148;102;49;52;55;92;57;129;82;120;2;101;1;97;152;124;94;63;79;80;176;137;23;186;89;183;143;117;93;140;68;139;193;41;5;42;181;159;69;108;18;22;146;34;160;48;54;177;10;190;84,8372348231901720028,0.002000
greedy_intra:nodes_start:greedy,185,71453,23391,48062,29463,2,185;90;81;196;179;145;78;31;56;113;175;171;16;25;44;120;75;86;101;124;94;63;79;80;176;133;151;51;118;59;115;46;0;137;23;186;89;183;143;117;93;140;68;139;193;41;5;42;181;159;69;108;18;22;146;34;160;48;54;177;10;190;84;184;43;116;65;131;149;162;123;127;70;135;154;180;53;100;26;1;97;152;2;129;92;57;55;52;106;178;49;102;148;9;62;144;14;138;165;40,970891671434587216,0.001017
greedy_intra:nodes_start:greedy,186,70888,22683,48205,51776,4,186;89;183;143;117;0;46;68;139;115;193;41;5;42;181;159;69;108;18;22;146;34;160;48;54;177;10;190;4;112;84;184;43;116;65;59;118;51;151;133;162;123;127;70;135;154;180;53;121;100;26;86;75;44;25;16;171;175;113;56;31;78;145;179;196;81;90;165;40;185;106;178;3;14;144;62;9;148;102;49;52;55;92;57;129;82;120;2;101;1;97;152;124;94;63;79;80;176;137;23,8649236175803808361,0.002000
greedy_intra:nodes_start:greedy,187,71554,23449,48105,62655,7,90;81;196;40;185;179;145;78;31;56;113;175;171;16;25;44;120;75;86;152;124;94;63;79;80;176;133;151;51;118;59;115;46;0;137;23;186;89;183;143;117;93;140;68;139;193;41;5;42;181;159;69;108;18;22;146;34;160;48;54;177;10;190;184;43;116;65;131;149;162;123;127;70;135;154;180;53;100;26;97;1;101;2;129;92;57;55;52;106;178;49;102;148;9;62;144;14;138;165;27,5805718476376034512,0.003001
greedy_intra:nodes_start:greedy,188,72267,23952,48315,33329,6,157;31;145;78;92;179;196;81;90;40;165;185;106;178;3;14;144;62;9;148;102;49;52;55;57;129;2;152;97;1;26;100;53;180;154;135;70;127;123;162;149;131;65;116;43;184;190;10;177;54;48;160;34;146;22;18;108;69;159;181;42;5;41;193;139;68;140;93;117;143;183;89;186;23;137;0;46;115;59;118;51;151;133;176;80;79;63;94;124;101;86;75;120;44;25;16;171;175;113;56,2344722879999652918,0.003024
greedy_intra:nodes_start:greedy,189,71828,22768,49060,23506,1,189;94;124;148;102;49;178;106;52;55;57;92;129;2;120;44;25;16;171;175;113;56;31;78;145;179;196;81;90;165;40;185;138;14;144;62;9;15;114;186;89;183;23;137;176;80;151;162;123;149;65;116;43;184;177;54;48;160;34;146;22;18;108;69;159;181;42;5;41;193;139;68;140;93;117;143;0;46;115;59;118;51;133;79;63;180;135;70;154;158;53;121;100;26;86;75;101;1;97;152,7530215934765597361,0.001187
greedy_intra:nodes_start:greedy,190,71482,23305,48177,79864,7,190;10;177;54;48;160;42;181;34;146;22;18;108;69;159;41;193;139;68;46;115;118;59;65;116;43;184;35;131;149;123;162;133;151;51;0;117;143;183;89;23;137;176;80;79;63;94;124;152;97;1;101;2;120;82;129;92;57;55;52;49;102;148;9;62;144;14;3;178;106;185;40;165;90;81;196;179;145;78;31;56;113;175;171;16;25;44;75;86;26;100;121;53;180;154;135;70;127;112;4,8258846762802220694,0.003999
greedy_intra:nodes_start:greedy,191,72111,23312,48799,42054,4,139;193;41;5;42;181;159;69;108;18;22;146;34;160;48;54;177;10;190;84;184;43;116;65;149;123;127;162;151;133;135;70;154;180;53;121;100;26;86;75;44;25;16;171;175;113;56;31;78;145;179;196;81;90;40;165;185;106;178;3;14;144;62;9;148;102;49;52;55;57;92;129;82;120;2;101;1;97;152;124;94;63;79;80;176;137;23;186;89;183;143;117;0;51;118;59;115;46;68;198,445824079485339098,0.002000
greedy_intra:nodes_start:greedy,192,72057,23210,48847,60346,7,42;5;96;41;193;139;68;140;93;117;143;183;89;186;23;137;176;80;79;63;94;124;152;97;1;101;2;120;82;129;57;92;55;52;49;102;148;9;62;144;14;3;178;106;185;40;165;90;81;196;179;145;78;31;56;113;175;171;16;25;44;75;86;26;100;121;53;180;154;135;70;127;123;162;133;151;51;0;46;115;118;59;65;116;43;184;190;10;177;54;48;160;34;146;22;18;108;69;159;181,7081754690423199457,0.003000
greedy_intra:nodes_start:greedy,193,71833,23710,48123,19011,2,193;139;68;46;115;59;118;51;0;117;143;183;89;186;23;137;176;80;79;63;94;124;152;97;1;101;2;120;82;129;57;92;55;52;49;102;148;9;62;144;14;3;178;106;185;165;40;90;81;196;179;145;78;31;56;113;175;171;16;25;44;75;86;26;100;121;53;180;154;70;135;133;151;162;127;123;149;65;116;43;184;112;4;190;10;177;54;48;160;34;146;22;18;108;69;159;181;42;5;41,1826567084543077965,0.001000
greedy_intra:nodes_start:greedy,194,72190,23219,48971,35585,3,194;127;123;162;133;151;149;131;65;116;43;184;190;10;177;54;48;160;34;146;22;18;108;69;159;181;42;5;41;193;139;68;46;115;59;118;51;0;117;143;183;89;186;23;137;176;80;79;63;94;124;152;97;1;101;2;120;82;129;57;92;55;52;49;102;148;9;62;144;14;3;178;106;185;40;165;90;81;196;179;145;78;31;56;113;175;171;16;25;44;75;86;26;100;121;53;180;154;70;135,7955862928802948125,0.000999
greedy_intra:nodes_start:greedy,195,71620,23433,48187,17992,2,195;181;34;160;48;54;177;10;190;4;112;184;42;43;116;65;149;123;127;162;151;133;135;70;154;180;53;121;100;26;86;75;44;25;16;171;175;113;56;31;78;145;179;196;81;90;40;165;185;106;178;3;14;144;62;9;148;102;49;52;55;92;57;129;82;120;2;101;1;97;152;124;94;63;79;80;176;137;23;186;89;183;143;117;0;51;118;59;115;46;68;139;41;193;159;69;108;18;22;146,5488034857747028463,0.000000
greedy_intra:nodes_start:greedy,196,72217,23700,48517,17493,3,196;81;90;40;165;185;106;178;3;14;144;62;9;148;102;49;52;55;57;129;92;179;145;78;82;2;152;97;1;101;100;53;180;154;135;70;127;123;162;149;131;65;116;43;184;10;177;54;48;160;34;146;22;18;108;69;159;181;42;5;41;193;139;68;140;93;117;143;183;89;186;23;137;0;46;115;59;118;51;151;133;176;80;79;63;94;124;26;86;75;120;44;25;16;171;175;113;56;31;157,6782724585519484908,0.002025
greedy_intra:nodes_start:greedy,197,72210,23478,48732,45206,7,140;93;68;139;193;41;5;42;181;159;69;108;18;22;146;34;160;48;54;177;10;190;84;184;43;116;65;149;123;127;162;151;133;135;70;154;180;53;121;100;26;86;75;44;25;16;171;175;113;56;31;78;145;179;196;81;90;165;40;185;106;178;3;14;144;62;9;148;102;49;52;55;57;92;129;82;120;2;101;1;97;152;124;94;63;79;80;176;137;23;186;89;183;143;117;0;46;118;59;115,7177167201454352542,0.002989
greedy_intra:nodes_start:greedy,198,71833,23710,48123,23051,3,68;46;115;59;118;51;0;117;143;183;89;186;23;137;176;80;79;63;94;124;152;97;1;101;2;120;82;129;57;92;55;52;49;102;148;9;62;144;14;3;178;106;185;165;40;90;81;196;179;145;78;31;56;113;175;171;16;25;44;75;86;26;100;121;53;180;154;70;135;133;151;162;127;123;149;65;116;43;184;112;4;190;10;177;54;48;160;34;146;22;18;108;69;159;181;42;5;41;193;139,6776772762691765093,0.001000
greedy_intra:nodes_start:greedy,199,71505,23189,48316,78090,7,93;68;46;139;115;59;118;51;0;117;143;183;89;186;23;137;176;80;79;63;94;124;152;97;1;101;2;120;82;129;57;92;55;52;49;102;148;9;62;144;14;3;178;106;185;40;165;90;81;196;179;145;78;31;56;113;175;171;16;25;44;75;86;26;100;121;53;180;154;70;135;133;151;162;127;123;149;65;116;43;184;84;190;10;177;54;48;160;34;181;42;5;41;193;159;146;22;18;108;140,3203631833907462218,0.003001
greedy_intra:edges_start:random,0,74857,25497,49360,660533,463,82;25;44;120;75;86;101;2;152;1;97;26;100;121;53;154;180;63;122;80;79;133;135;127;123;162;151;118;59;116;65;149;184;43;42;115;139;41;193;181;160;48;190;10;177;54;34;146;22;159;18;117;0;68;46;51;176;137;143;183;89;23;186;15;144;49;102;62;9;148;94;124;167;55;52;106;178;3;14;138;185;40;165;27;90;81;196;157;56;113;175;171;16;31;78;145;179;57;92;129,6192186771100589569,0.076251
greedy_intra:edges_start:random,1,73253,22711,50542,886134,488,112;184;54;160;34;181;42;5;43;116;47;65;118;115;46;68;139;41;193;159;146;22;18;108;117;0;170;143;183;89;23;137;176;80;122;94;124;111;167;148;9;62;144;14;102;49;178;106;52;55;185;40;119;165;90;81;196;31;56;113;175;171;16;44;25;78;145;179;57;92;129;120;2;152;97;1;101;75;86;26;100;121;136;53;158;154;70;135;180;63;79;133;162;151;51;59;149;131;123;127,6731543826702232651,0.090867
greedy_intra:edges_start:random,2,73425,24157,49268,758908,505,80;51;118;59;115;139;68;46;0;143;117;108;18;22;146;159;193;41;181;34;54;177;4;112;184;160;42;5;43;116;65;47;131;149;123;127;70;135;154;53;100;26;97;1;152;2;75;101;86;158;180;133;162;151;79;122;63;94;124;148;167;52;55;57;129;120;44;25;16;171;175;113;56;31;78;145;92;196;81;90;27;39;165;119;40;185;106;178;3;49;138;14;144;102;62;9;89;183;137;176,5758862765168015730,0.088851
greedy_intra:edges_start:random,3,73551,24915,48636,563557,478,118;59;65;149;123;112;4;177;54;48;34;160;184;42;43;116;115;139;41;193;181;195;146;22;159;199;18;69;108;68;46;93;117;0;170;143;183;89;186;23;137;176;80;133;79;63;94;148;62;144;21;164;90;165;119;40;185;14;49;3;178;106;52;179;145;196;81;157;31;56;113;175;171;16;78;25;44;120;129;92;57;55;2;152;1;101;75;86;100;26;97;53;180;154;135;70;127;162;151;51,903407078381934484,0.080811
greedy_intra:edges_start:random,4,74462,23684,50778,660752,475,0;117;170;143;183;89;23;137;186;15;62;9;148;37;102;144;49;178;3;14;138;39;90;165;8;119;40;185;106;52;55;57;129;92;145;179;196;81;31;56;113;175;171;16;78;44;120;2;152;97;1;101;75;86;100;26;94;122;79;151;162;133;63;53;180;154;135;70;127;123;112;4;190;10;177;54;34;160;42;181;22;159;193;41;139;115;116;65;43;184;84;35;131;149;59;118;51;80;176;46,804464613251847596,0.083667
greedy_intra:edges_start:random,5,73896,23237,50659,622061,471,112;84;184;54;160;34;181;146;22;159;193;41;42;5;115;139;46;0;143;183;89;23;186;114;15;148;37;9;62;144;21;164;27;90;165;138;14;102;49;3;178;106;52;55;57;92;129;82;78;145;179;185;119;40;81;196;31;56;113;175;171;16;25;44;120;2;152;97;1;101;75;86;26;100;53;121;124;94;63;122;80;176;137;51;151;133;79;180;154;70;135;162;59;65;116;43;131;149;123;127,6193239062934821079,0.085990
greedy_intra:edges_start:random,6,73430,24388,49042,712216,509,9;186;23;89;183;137;176;80;151;51;59;118;115;116;65;149;131;43;5;42;181;159;193;41;139;68;46;0;170;143;117;108;18;22;34;160;54;177;10;184;84;112;123;162;127;70;135;154;158;53;180;133;79;63;94;148;49;178;52;55;57;129;2;152;1;97;26;100;121;86;101;75;120;44;25;82;92;179;145;78;16;171;175;113;56;31;196;81;90;165;119;40;185;106;3;138;14;144;102;62,2836284548219262464,0.089951
greedy_intra:edges_start:random,7,72141,22382,49759,656000,477,139;115;59;118;109;51;133;151;162;149;131;43;47;65;116;42;5;181;41;193;159;22;34;160;184;48;54;177;10;190;4;112;123;127;70;135;154;180;53;158;121;100;26;97;152;1;101;86;75;2;120;25;44;129;55;57;92;78;16;171;175;113;56;31;145;179;196;81;90;165;119;40;185;52;106;178;49;102;14;144;62;9;15;148;124;94;63;79;80;176;137;23;186;89;183;143;0;117;68;46,2683837369035356912,0.077486
greedy_intra:edges_start:random,8,72897,24966,47931,571481,443,89;183;143;0;117;108;18;159;22;34;160;48;54;177;10;184;112;127;135;154;180;53;100;26;86;75;120;44;25;16;171;175;113;56;31;78;145;179;92;129;82;2;101;1;97;152;124;94;63;80;79;133;151;162;123;149;65;116;43;42;181;193;41;139;68;46;115;59;118;51;176;137;23;148;102;3;106;178;52;55;57;196;81;40;119;185;165;39;90;27;164;7;21;14;49;144;62;9;15;186,5774810334049888938,0.081842
greedy_intra:edges_start:random,9,74298,25224,49074,602788,451,56;31;78;145;196;81;90;165;119;40;185;179;92;57;55;52;106;178;49;102;138;14;144;62;9;89;183;137;124;94;63;122;79;80;176;51;151;59;115;46;68;0;143;117;93;140;108;18;139;41;193;22;146;34;160;184;54;177;10;4;112;43;42;181;5;116;65;131;149;123;127;162;133;135;70;154;180;158;53;121;100;26;86;75;101;1;97;2;152;148;167;129;82;120;44;25;16;171;175;113,7432775179342661602,0.068807
greedy_intra:edges_start:random,10,73059,24677,48382,745461,504,186;9;62;144;102;49;138;14;178;106;185;40;119;165;90;81;196;31;56;113;175;171;16;44;120;25;78;145;179;92;129;57;55;52;167;37;148;124;152;97;26;100;101;1;2;75;86;53;180;154;135;70;127;112;4;10;177;54;160;34;181;41;193;159;22;18;108;139;68;140;93;117;143;0;46;198;115;5;42;184;43;116;65;118;59;149;123;162;151;51;176;80;133;79;63;94;137;183;89;23,7985650523007078771,0.086162
greedy_intra:edges_start:random,11,73083,24748,48335,587796,444,1;101;75;2;120;44;25;78;16;171;175;113;56;31;157;145;92;129;152;94;124;148;167;55;52;57;179;196;81;90;40;165;185;106;178;3;49;14;144;62;9;15;186;137;23;89;183;143;0;46;198;115;139;68;117;93;140;108;18;159;193;41;42;181;146;22;34;160;177;10;190;4;112;184;131;149;43;116;65;162;123;127;70;135;133;151;59;118;51;176;80;79;63;180;154;53;86;100;26;97,6989136502504276103,0.072876
greedy_intra:edges_start:random,12,73329,24190,49139,700351,504,80;122;94;124;148;167;152;97;1;101;26;100;86;75;2;82;120;44;25;16;171;175;113;56;31;78;129;92;57;55;52;179;145;196;81;90;27;165;119;40;185;106;178;49;102;14;144;62;9;15;114;186;89;183;23;137;176;51;59;118;46;0;143;117;108;18;139;115;41;193;159;22;146;181;34;160;54;184;42;5;43;116;65;131;149;35;112;127;70;135;123;162;151;133;180;154;53;121;63;79,2156873874955993880,0.087623
greedy_intra:edges_start:random,13,74077,23203,50874,635305,447,162;135;70;154;180;53;100;26;86;101;1;97;152;2;75;120;82;44;25;78;16;171;175;113;56;31;157;145;179;91;196;81;90;165;119;40;185;3;138;14;144;62;9;15;148;37;102;49;178;106;52;55;57;92;129;124;94;63;79;133;80;176;51;137;23;186;89;183;143;117;0;46;115;139;41;193;159;22;34;160;181;42;43;116;65;131;184;54;177;10;4;112;84;35;123;149;59;118;72;151,4242013627515857579,0.074586
greedy_intra:edges_start:random,14,72590,23831,48759,640085,438,149;131;35;112;4;123;127;70;135;154;180;53;100;26;86;75;101;1;97;152;2;129;120;44;25;16;171;175;113;31;78;145;92;57;55;52;179;185;119;40;196;157;81;90;27;39;165;106;178;3;138;14;144;49;102;62;9;148;167;124;94;63;79;133;162;151;80;176;137;23;186;114;89;183;143;0;117;108;18;159;22;146;34;160;54;184;43;42;181;193;41;115;139;68;46;51;118;59;116;65,6839502922560433296,0.075862
greedy_intra:edges_start:random,15,73151,24554,48597,691244,482,56;113;175;171;16;31;78;145;179;57;92;129;25;44;120;75;101;86;26;100;121;53;63;79;80;176;51;59;151;133;162;180;154;135;70;127;123;112;4;10;177;54;184;149;65;116;43;42;160;34;181;5;41;193;159;146;22;18;108;69;139;115;198;46;68;117;0;143;183;89;186;23;137;124;94;97;1;2;152;148;9;62;144;14;138;102;49;3;178;106;52;55;185;165;27;90;119;40;81;196,8952645512923904996,0.079476
greedy_intra:edges_start:random,16,73806,24494,49312,651362,489,9;62;144;21;164;90;81;40;119;165;185;179;145;31;56;113;175;171;16;78;82;25;44;120;75;86;101;1;97;26;100;121;53;63;122;79;180;154;135;70;127;123;149;65;116;42;181;34;160;48;54;177;10;190;184;43;115;41;193;159;22;18;108;139;46;0;143;183;89;114;15;186;23;137;51;118;59;72;151;162;133;80;176;94;124;148;167;152;2;129;92;57;55;52;106;178;3;14;49;102,5335209554152958053,0.083042
greedy_intra:edges_start:random,17,72551,23784,48767,746839,474,123;127;70;135;154;180;53;86;75;101;1;97;26;100;121;94;152;2;120;44;25;129;92;57;179;145;78;16;171;175;113;31;196;81;90;27;40;119;165;39;164;21;138;14;144;62;9;102;49;178;106;185;55;52;167;37;148;137;23;89;183;143;0;117;93;108;69;18;159;22;146;34;160;48;54;177;10;184;43;42;41;193;139;46;115;116;65;131;149;59;118;51;176;80;122;63;79;133;151;162,6503719066024230197,0.079748
greedy_intra:edges_start:random,18,72719,24529,48190,705202,455,31;78;145;179;185;196;81;90;40;119;165;39;95;164;7;21;144;15;186;137;23;89;183;143;117;93;108;18;68;46;118;51;151;133;162;59;65;116;43;115;139;41;193;159;22;181;42;160;34;48;54;177;10;184;84;112;123;127;70;135;154;180;53;100;26;97;1;101;86;75;2;152;124;94;63;79;80;176;148;37;9;62;102;49;14;3;178;106;52;55;57;92;129;120;44;25;16;171;175;113,19619845628964696,0.073026
greedy_intra:edges_start:random,19,73804,26089,47715,494014,492,21;164;165;40;90;81;196;78;31;56;113;175;171;16;25;44;120;75;86;101;1;26;100;97;152;2;129;57;92;145;179;185;106;178;52;55;148;124;94;79;63;121;53;180;154;135;127;123;131;35;84;112;4;10;177;54;48;34;160;184;65;116;43;42;181;146;22;18;159;193;41;115;139;68;93;117;143;0;46;51;118;59;149;162;151;133;80;176;137;183;89;23;186;9;62;102;144;14;49;138,2000371057801377855,0.072243
greedy_intra:edges_start:random,20,73518,23926,49592,623850,477,34;54;177;10;190;4;112;184;160;42;43;116;65;149;123;162;133;151;72;59;115;41;193;159;139;68;46;118;109;51;176;80;79;135;154;180;53;63;94;124;152;2;101;1;97;26;100;86;75;120;44;25;16;171;175;113;31;196;81;90;165;119;40;185;179;145;78;92;57;129;167;148;37;102;49;3;178;55;52;106;138;14;144;62;9;15;137;23;89;183;143;170;0;117;93;108;18;22;146;181,3546084981494028850,0.075442
greedy_intra:edges_start:random,21,75141,25713,49428,496121,503,112;123;162;151;72;51;137;176;80;133;70;135;154;180;53;100;26;97;1;101;86;75;2;82;129;152;121;63;79;94;124;148;49;3;178;106;52;55;57;92;179;145;78;120;44;25;56;113;175;171;16;31;196;81;40;119;185;165;27;90;164;21;138;14;144;102;62;9;186;89;183;143;117;93;140;68;0;46;115;118;59;149;131;65;116;43;42;5;41;193;139;108;18;159;22;146;181;34;160;184,8191911880911225798,0.080498
greedy_intra:edges_start:random,22,73302,25359,47943,605375,494,119;40;106;178;49;148;137;176;80;51;151;79;63;94;124;100;26;97;1;101;75;86;121;53;180;154;70;135;133;162;123;112;4;190;10;177;54;34;181;5;42;160;184;43;116;65;149;59;118;115;46;139;41;193;159;146;22;18;108;93;117;0;143;183;89;186;15;9;62;102;144;14;21;164;39;165;90;81;196;157;31;113;175;171;16;78;25;44;120;82;2;152;129;92;145;179;57;55;52;185,5226724779468669978,0.083908
greedy_intra:edges_start:random,23,72972,23057,49915,712752,500,15;148;124;94;63;122;79;80;176;137;51;151;162;133;180;136;182;121;189;152;2;129;78;145;92;57;55;52;106;178;49;102;9;62;144;14;185;40;119;165;90;81;196;31;56;113;175;171;16;25;44;120;75;86;101;1;97;26;100;53;158;154;135;70;127;123;131;149;59;118;65;116;43;42;181;160;184;10;177;54;48;34;146;22;159;18;193;41;139;115;46;68;117;0;143;183;89;23;186;114,2900897512645761192,0.079150
greedy_intra:edges_start:random,24,74517,24146,50371,511943,461,181;160;34;103;146;22;108;18;159;193;139;41;5;115;46;68;0;117;143;89;183;186;23;137;176;80;79;133;136;121;97;152;1;101;86;75;2;129;55;57;92;145;78;82;120;44;25;16;171;175;113;31;157;179;196;81;90;165;119;40;185;52;106;3;178;14;144;49;102;62;9;148;124;94;189;26;100;53;158;180;63;154;135;70;127;123;162;151;51;118;59;149;131;112;84;184;65;116;43;42,8027205702279423374,0.073149
greedy_intra:edges_start:random,25,73927,24385,49542,548503,489,160;34;103;146;22;181;42;43;184;131;149;162;133;80;79;63;176;137;51;151;59;118;116;47;65;115;198;46;68;139;41;193;159;18;117;0;143;183;89;23;186;15;148;9;62;144;102;49;14;138;3;178;106;185;40;119;165;27;90;81;196;31;56;113;175;171;16;78;145;25;44;120;129;92;52;55;57;2;75;152;124;94;189;97;1;101;86;26;100;53;180;154;135;127;123;112;4;10;177;54,85047093455975668,0.081214
greedy_intra:edges_start:random,26,73478,22903,50575,702808,494,25;44;120;129;2;75;86;101;1;97;152;189;26;100;121;53;158;180;154;135;70;127;123;112;84;184;160;34;22;159;193;41;181;42;43;116;65;149;162;151;133;63;79;80;176;51;118;59;115;139;68;46;0;117;143;183;89;114;186;23;137;94;124;148;37;15;62;9;102;49;14;144;21;164;27;90;39;165;119;40;185;138;3;178;106;52;55;57;92;179;196;81;157;31;113;175;171;16;78;145,519413969307957858,0.072554
greedy_intra:edges_start:random,27,72619,24319,48300,773773,517,81;185;40;119;90;165;138;3;178;49;14;144;62;9;167;152;97;124;94;63;122;80;79;133;162;151;51;176;137;148;15;186;89;183;143;0;117;93;108;18;68;46;139;115;118;59;65;116;43;42;41;193;159;22;146;181;34;160;184;48;54;30;177;10;190;4;112;123;127;70;135;154;180;53;100;26;1;101;86;75;2;120;82;129;92;57;55;52;106;179;145;78;25;44;16;171;175;113;31;196,8151228420975932474,0.089405
greedy_intra:edges_start:random,28,73674,23677,49997,668190,498,186;23;137;15;37;148;9;62;102;49;144;14;138;3;178;106;55;52;179;185;40;165;90;81;196;145;78;31;113;175;171;16;25;44;120;92;57;129;2;152;1;101;75;86;97;26;100;121;94;124;63;53;180;154;135;70;127;123;112;4;177;54;184;35;131;149;59;65;47;116;43;42;160;34;181;146;22;159;193;41;139;46;115;118;51;151;162;133;79;80;176;0;140;93;117;143;153;183;89;114,2272699412131509364,0.077379
greedy_intra:edges_start:random,29,74446,24958,49488,570802,461,34;146;22;195;181;41;193;159;18;69;108;140;93;117;143;170;0;68;139;46;118;59;115;5;42;43;116;65;47;131;149;123;162;151;133;79;180;63;80;176;51;137;183;89;9;62;144;102;49;14;138;185;165;90;40;196;31;113;175;171;16;78;145;25;44;120;129;92;57;55;52;106;178;148;167;2;1;101;75;86;26;97;152;94;121;100;53;158;154;135;70;127;112;184;190;10;177;30;54;160,8865478256723441852,0.073094
greedy_intra:edges_start:random,30,73725,23733,49992,735542,525,118;137;0;117;143;183;89;23;186;15;148;9;62;144;14;49;178;106;165;27;90;40;185;52;55;57;129;92;145;179;196;31;113;175;171;16;78;25;44;120;2;152;189;124;94;122;63;182;121;100;26;97;1;101;75;86;53;180;154;135;70;127;123;162;151;133;79;80;176;51;109;59;65;149;131;47;116;43;42;184;10;177;54;48;160;34;103;146;22;159;181;41;193;18;108;140;68;46;139;115,742795447085125535,0.084343
greedy_intra:edges_start:random,31,74110,24356,49754,533174,430,14;144;102;62;9;15;186;89;183;153;0;143;117;68;46;115;139;41;193;159;18;22;146;34;181;5;42;160;184;177;10;4;112;127;123;149;65;43;116;59;118;51;137;23;148;37;167;152;2;1;101;97;26;100;121;189;124;94;63;79;80;176;133;151;162;135;70;154;180;158;136;53;86;75;120;44;129;92;57;179;145;78;25;16;171;175;56;113;31;196;81;90;165;40;185;55;52;106;178;49,1127532970894638630,0.066063
greedy_intra:edges_start:random,32,74360,23493,50867,633854,437,135;70;127;123;112;4;10;177;184;43;116;65;59;162;151;51;118;115;139;193;41;42;160;34;22;159;18;69;108;68;46;117;143;0;153;183;89;114;186;23;137;176;80;133;79;122;63;94;124;189;152;2;129;92;145;57;55;52;106;178;3;49;102;148;15;9;62;144;14;138;39;27;90;165;119;40;185;196;31;113;175;171;16;78;25;44;120;75;86;101;1;97;26;100;121;182;136;53;180;154,5499362567364766088,0.071474
greedy_intra:edges_start:random,33,74342,23894,50448,522586,435,177;54;48;160;34;103;146;22;18;159;193;41;139;198;115;96;181;42;5;59;118;51;46;68;117;0;143;183;89;23;137;148;9;62;144;102;49;14;90;165;40;185;106;178;52;55;57;129;92;145;31;113;175;171;16;78;25;44;120;2;75;101;86;158;53;121;100;26;97;1;152;189;124;94;122;80;176;133;79;63;180;154;135;70;127;112;4;123;162;151;149;131;47;65;116;43;184;84;190;10,5574001000796205736,0.067430
greedy_intra:edges_start:random,34,72633,24099,48534,599026,456,63;80;176;137;183;89;23;186;114;15;148;37;9;62;102;49;144;14;138;165;90;119;40;185;106;178;52;55;57;179;196;81;113;175;171;16;31;78;145;92;129;25;44;120;2;75;86;101;1;100;26;97;152;94;121;53;180;154;135;70;127;162;123;112;84;35;131;149;43;42;160;184;177;54;48;34;181;146;22;195;159;193;41;139;18;108;93;117;143;0;68;46;115;116;65;59;51;151;133;79,2235497107873445564,0.073500
greedy_intra:edges_start:random,35,73439,24469,48970,504012,407,51;118;59;65;47;149;131;43;116;115;46;0;89;183;143;117;93;68;139;41;193;159;18;22;34;54;160;181;42;184;177;10;4;112;123;127;70;135;162;151;133;79;63;180;154;158;53;121;100;26;97;1;152;2;101;86;75;120;82;129;92;57;179;145;25;44;16;171;175;113;56;31;78;157;196;81;90;27;165;119;40;185;55;52;106;178;3;49;14;144;102;9;62;186;23;137;148;94;80;176,2261489856300909804,0.062107
greedy_intra:edges_start:random,36,73147,22976,50171,710099,487,151;176;80;94;63;122;79;133;162;149;131;35;184;160;34;54;177;112;123;127;70;135;154;180;158;53;121;100;26;86;75;101;97;1;152;2;129;92;120;44;25;16;171;175;113;56;85;31;78;145;157;196;81;90;165;119;40;185;179;57;55;52;106;178;14;49;102;144;62;9;148;15;186;137;23;89;183;143;170;0;117;93;108;18;22;146;159;193;41;42;43;116;65;59;115;139;46;118;51;72,3292462431437768887,0.078960
greedy_intra:edges_start:random,37,74417,23349,51068,632076,453,138;14;144;49;102;62;9;15;114;186;89;183;23;137;176;51;118;115;139;46;0;170;143;117;93;140;108;18;193;41;159;22;34;54;184;160;181;42;43;116;65;149;59;151;133;162;123;127;135;154;180;158;53;121;100;26;86;75;2;152;1;101;97;94;63;122;79;80;12;124;37;148;167;52;55;57;129;120;44;25;16;171;175;113;56;31;157;78;145;92;179;196;81;90;165;40;185;106;178;3,3800585594408989584,0.079034
greedy_intra:edges_start:random,38,73434,23414,50020,638699,474,180;158;53;100;26;86;75;101;1;97;152;2;120;44;16;171;175;113;56;31;196;145;78;25;82;129;92;57;179;185;40;90;27;39;165;55;52;106;178;3;138;14;49;144;62;9;148;124;94;63;122;79;80;133;151;162;123;149;43;42;181;5;116;65;59;118;51;176;137;186;114;23;89;183;143;0;46;115;41;193;139;68;117;93;140;108;18;22;146;103;34;160;54;184;84;112;127;70;135;154,4813581717968921341,0.081218
greedy_intra:edges_start:random,39,72193,24064,48129,573801,464,69;68;46;115;59;149;131;65;116;43;42;139;41;193;159;22;146;34;160;48;54;184;177;10;190;4;112;123;127;70;135;154;180;63;79;133;162;151;80;122;94;124;152;1;97;26;100;53;86;101;75;2;129;57;92;120;44;25;145;78;16;171;175;113;56;31;157;179;196;81;90;165;119;40;185;52;55;106;178;49;14;144;62;9;148;15;186;23;89;183;137;176;51;118;0;143;117;93;108;18,6214492378220869764,0.070488
greedy_intra:edges_start:random,40,73319,25342,47977,659649,508,34;54;177;160;43;42;5;41;159;193;115;65;116;149;184;84;4;112;123;127;70;135;154;180;63;80;79;94;121;53;158;100;26;97;152;1;101;86;75;120;44;25;16;171;175;113;56;31;78;145;179;196;81;90;165;119;40;185;106;178;52;55;57;92;129;2;167;148;102;49;14;144;62;9;15;186;23;137;176;51;151;133;162;59;118;0;89;183;143;117;46;139;68;93;140;108;18;22;146;181,1739244198893873288,0.089590
greedy_intra:edges_start:random,41,73448,23652,49796,654127,476,145;78;31;56;113;175;171;16;25;44;82;120;75;101;86;100;26;97;1;152;2;129;92;179;57;55;167;124;94;63;180;53;158;154;135;70;127;112;84;184;10;177;54;160;34;22;159;193;41;181;42;5;43;116;115;139;68;46;118;59;65;131;149;123;162;72;151;133;79;122;80;176;51;137;0;117;143;183;89;23;186;15;148;9;62;144;14;102;49;178;106;52;185;40;119;165;27;90;81;196,107622880727903400,0.073599
greedy_intra:edges_start:random,42,74992,24677,50315,627666,455,180;135;70;154;158;53;121;100;26;97;1;101;86;75;44;120;2;152;167;52;55;57;129;92;179;145;78;16;171;175;113;56;31;196;40;90;27;39;165;119;185;106;178;14;144;49;102;62;9;15;37;148;124;94;80;176;51;59;118;137;23;186;89;183;143;117;0;46;139;18;159;193;41;115;5;42;43;160;181;22;34;48;54;177;184;84;112;35;116;65;149;123;127;162;151;133;79;122;63;136,3255022243805355533,0.079912
greedy_intra:edges_start:random,43,74402,24755,49647,704606,450,23;186;148;9;62;144;102;49;14;138;185;40;119;165;90;81;196;157;56;113;175;171;16;31;179;145;78;25;44;120;2;92;129;57;55;52;106;178;167;94;152;1;101;75;86;100;26;97;189;121;136;53;158;154;70;135;180;63;122;176;80;79;133;162;123;127;112;84;184;177;54;160;34;22;159;18;69;108;140;93;117;143;183;89;0;46;139;41;193;42;43;149;65;116;115;118;59;151;51;137,7575833646543038514,0.073707
greedy_intra:edges_start:random,44,73475,24068,49407,575218,446,152;1;101;75;2;120;44;25;129;92;57;55;52;179;145;78;16;171;175;113;56;31;196;81;90;40;119;39;165;185;106;178;3;14;49;102;144;62;9;15;148;124;189;121;182;63;94;80;79;133;162;151;51;176;137;23;89;183;143;117;0;46;68;108;18;193;159;22;41;139;115;118;59;123;149;65;116;43;42;181;34;160;48;54;30;177;10;190;184;112;127;135;154;180;158;53;86;100;26;97,1437666331378763347,0.076611
greedy_intra:edges_start:random,45,74107,24524,49583,539779,480,101;1;97;152;2;75;120;44;16;171;175;113;31;157;196;81;90;27;165;119;40;185;179;145;78;92;129;57;55;52;106;178;49;14;144;102;62;9;37;148;167;124;94;15;114;186;23;89;183;153;143;117;0;137;51;118;59;65;116;115;46;139;193;159;69;108;18;22;34;160;181;41;5;42;43;149;131;184;54;177;112;123;127;70;135;154;162;151;133;176;80;79;63;180;158;53;121;100;26;86,2397170087317070684,0.068078
greedy_intra:edges_start:random,46,73414,24385,49029,535790,451,84;112;4;10;177;54;34;22;159;193;41;181;160;184;43;116;42;5;96;115;139;46;68;117;0;143;183;114;15;186;23;89;137;176;80;79;63;94;148;9;62;144;14;21;7;164;90;81;196;40;119;185;165;138;102;49;178;106;52;55;57;92;129;145;78;31;56;113;175;171;16;25;44;120;2;152;1;97;26;101;75;86;53;180;154;70;135;133;151;51;118;59;162;127;123;149;131;65;47;35,6481610205839251007,0.071936
greedy_intra:edges_start:random,47,72617,23203,49414,812441,515,102;9;62;144;14;138;165;119;40;90;81;145;179;185;106;52;55;57;92;129;78;31;113;175;171;16;25;44;120;2;75;101;86;1;152;97;26;100;121;53;180;154;135;70;127;123;149;131;47;65;116;43;42;181;160;184;84;112;4;190;10;177;54;48;34;22;18;159;193;41;139;115;198;46;68;93;117;0;143;183;89;137;51;118;59;162;151;133;79;80;176;122;63;94;124;148;167;178;3;49,8593322994554874649,0.094857
greedy_intra:edges_start:random,48,72472,23251,49221,786098,560,41;96;5;42;184;177;10;190;4;112;84;35;131;149;65;43;116;115;139;46;118;59;51;176;80;122;63;79;133;151;162;123;127;70;135;154;180;158;53;100;26;86;75;101;1;97;189;94;124;152;2;129;120;44;25;16;171;175;113;31;196;40;90;165;185;145;78;92;57;55;52;106;178;14;144;49;102;62;9;148;15;186;137;23;89;183;143;0;117;108;18;22;146;34;54;160;181;195;159;193,3030504749856933620,0.098687
greedy_intra:edges_start:random,49,74963,25037,49926,658208,462,177;54;160;34;146;22;41;193;18;108;140;93;117;0;170;143;183;89;186;23;137;176;15;144;14;165;90;81;196;40;119;185;52;106;178;3;49;102;62;9;148;167;55;57;92;145;179;31;16;171;175;113;56;78;25;44;120;82;129;2;75;86;101;1;26;97;152;124;94;63;121;100;53;158;70;127;123;135;154;180;79;133;162;151;80;51;109;59;118;46;139;115;42;43;116;65;149;131;184;10,4382925433708917306,0.072682
greedy_intra:edges_start:random,50,75393,22185,53208,645243,446,95;21;7;164;27;90;81;196;145;78;157;31;56;113;175;171;16;25;44;120;129;92;57;167;148;124;94;189;97;1;152;2;75;101;86;26;100;121;53;158;180;154;135;127;123;149;131;47;65;116;43;42;184;177;54;160;34;181;146;22;193;41;139;46;115;59;118;51;151;162;133;79;63;122;80;176;137;183;89;186;9;62;15;144;102;49;14;138;32;3;178;106;52;55;179;185;40;119;165;39,717273132375320016,0.071084
greedy_intra:edges_start:random,51,73566,23312,50254,729581,504,25;129;57;92;145;78;31;16;171;175;113;56;196;81;90;27;165;185;119;40;179;55;52;106;178;49;102;14;144;62;9;148;15;186;137;23;89;183;143;0;46;115;116;43;42;181;193;41;139;108;18;159;22;34;160;48;54;177;184;84;112;131;149;47;65;59;118;72;109;51;176;80;122;63;79;133;151;162;123;127;70;135;154;180;158;53;136;121;94;97;152;2;1;101;26;100;86;75;120;44,5958426038446731119,0.091060
greedy_intra:edges_start:random,52,73689,24604,49085,711051,507,94;124;148;167;152;2;120;44;25;16;171;175;113;31;78;145;92;129;57;55;52;196;81;90;40;119;165;185;106;178;3;49;102;14;144;62;9;186;23;89;183;143;117;93;0;137;59;118;51;176;80;122;79;133;151;162;149;65;116;43;5;96;115;139;46;68;108;18;159;22;146;181;193;41;42;160;34;54;177;184;84;112;123;127;70;135;154;180;158;53;121;100;26;86;75;101;1;97;189;63,5433674228864361179,0.078615
greedy_intra:edges_start:random,53,74396,22898,51498,767054,515,143;117;93;140;68;46;115;139;41;193;159;18;22;34;54;177;184;160;181;42;5;43;116;65;59;151;162;123;127;70;135;154;180;158;53;136;182;121;100;26;86;75;101;1;97;152;2;129;57;179;92;120;44;25;16;171;175;113;56;31;78;145;196;81;90;165;119;40;185;52;55;167;49;3;178;106;32;138;14;21;144;102;62;9;148;124;94;189;63;122;79;133;80;176;51;137;23;186;89;183,2630679019605033190,0.083437
greedy_intra:edges_start:random,54,74200,24872,49328,694541,487,51;118;59;115;46;0;23;137;148;94;63;180;154;158;53;121;100;86;26;97;152;1;101;75;2;120;82;129;57;92;145;78;25;44;16;171;175;113;31;196;179;55;52;185;40;90;165;106;178;3;138;14;49;102;144;62;9;15;186;89;183;143;117;139;41;193;18;22;146;159;181;34;160;48;54;30;177;10;190;4;112;131;149;65;116;43;42;184;35;123;127;70;135;162;72;151;133;79;80;176,2634182253604587110,0.084938
greedy_intra:edges_start:random,55,75097,25646,49451,791294,453,105;116;47;131;149;65;59;118;46;198;139;68;0;137;176;80;63;79;133;51;72;151;162;123;35;184;54;177;10;4;112;127;135;154;180;53;100;26;86;101;1;97;152;94;124;148;9;62;102;49;178;106;52;55;57;92;129;75;2;120;44;25;78;31;16;171;175;113;56;81;196;145;179;185;40;90;27;165;14;144;186;23;89;183;143;117;93;140;108;69;18;193;159;22;34;160;41;115;42;43,7925659412548824694,0.078282
greedy_intra:edges_start:random,56,73491,22957,50534,855418,505,55;57;92;145;31;113;175;171;16;78;25;44;120;129;2;1;152;97;101;75;86;26;100;121;53;158;180;154;135;70;127;123;149;131;43;5;42;181;41;193;159;199;69;108;18;22;146;34;160;54;30;177;10;190;184;35;65;116;59;118;115;139;46;68;140;93;117;0;143;183;137;176;51;151;162;133;79;80;122;63;182;189;94;124;167;148;15;9;62;144;102;49;14;165;90;40;185;106;178;52,3042493577016978445,0.095047
greedy_intra:edges_start:random,57,75076,23267,51809,637901,462,62;9;15;148;94;124;111;167;52;55;179;145;78;92;57;129;2;1;97;152;189;63;122;79;80;176;137;23;89;183;0;46;118;51;151;72;59;115;139;41;193;159;22;181;42;5;116;65;149;131;43;184;48;160;34;30;54;177;10;190;4;112;123;162;133;127;70;135;154;180;158;53;121;100;26;86;101;75;120;82;44;25;16;171;175;113;31;196;81;90;165;119;40;185;106;178;49;14;144;102,5332052939097106730,0.074702
greedy_intra:edges_start:random,58,73142,23687,49455,758513,467,55;52;106;178;14;144;49;102;62;9;37;148;15;186;23;137;183;143;0;46;68;117;93;140;108;18;22;159;193;41;139;115;5;181;34;48;54;177;10;190;184;160;42;43;116;65;131;149;123;127;162;151;59;118;51;176;80;133;79;122;63;94;124;152;97;26;100;121;136;53;180;154;135;70;158;86;101;1;75;2;129;57;92;120;44;25;78;16;171;175;113;56;31;145;196;81;40;90;165;185,3246473288991136472,0.077708
greedy_intra:edges_start:random,59,72784,24350,48434,761522,498,54;177;4;112;127;123;149;59;118;51;137;176;80;133;151;162;70;135;154;180;79;63;94;152;1;101;97;26;100;53;86;75;2;129;92;179;145;78;25;120;44;16;171;175;113;56;31;196;81;40;119;90;27;164;39;165;185;57;55;52;106;178;3;14;144;49;102;62;9;148;186;23;89;183;143;170;0;117;68;93;140;108;69;18;22;159;193;41;139;198;46;115;116;65;43;184;42;181;34;160,7423032531827658971,0.084709
greedy_intra:edges_start:random,60,74079,23873,50206,838871,514,94;124;167;148;15;9;62;102;144;14;49;3;178;106;185;40;119;165;39;164;27;90;81;196;31;113;175;171;16;78;145;25;44;120;82;92;179;52;55;57;129;2;75;86;101;1;152;97;26;100;121;53;63;180;158;154;135;70;127;112;123;162;133;151;59;149;131;65;116;43;5;42;184;177;54;160;34;22;159;193;41;139;68;93;117;0;143;183;89;186;23;137;46;198;115;51;176;80;79;122,7128156018720984449,0.089461
greedy_intra:edges_start:random,61,74219,24352,49867,478354,444,139;115;46;0;143;183;89;186;23;137;176;80;94;124;97;101;1;152;129;167;148;15;9;62;102;144;14;49;3;178;106;52;55;57;92;179;185;40;165;90;81;145;78;31;113;175;171;16;44;120;2;75;86;26;100;121;53;158;154;70;135;194;127;112;4;190;10;177;54;184;35;123;162;180;63;79;133;151;51;118;59;149;131;65;116;43;42;5;96;41;181;160;34;103;146;22;108;18;159;193,9043025226289302381,0.081842
greedy_intra:edges_start:random,62,74790,24589,50201,703144,489,129;2;152;178;106;52;55;57;92;179;145;78;16;171;175;113;56;31;157;196;185;165;119;40;81;90;27;164;21;14;138;3;49;102;144;62;9;148;167;111;124;94;80;176;137;89;183;143;0;46;139;18;22;146;34;54;177;160;184;112;127;70;135;123;149;65;116;43;5;42;181;159;193;41;115;59;118;51;151;162;133;79;63;136;180;154;158;53;121;100;26;86;97;1;101;75;120;44;25;82,6229328569913324474,0.077094
greedy_intra:edges_start:random,63,72103,23607,48496,866211,511,106;178;14;144;49;102;62;9;15;114;186;148;167;124;94;63;79;80;133;162;151;51;176;137;23;89;183;153;0;170;143;117;93;108;18;68;46;139;115;118;59;149;65;116;43;42;41;193;22;146;181;34;160;184;54;177;10;4;112;123;127;70;135;154;180;53;100;26;97;152;1;101;86;75;2;129;120;44;25;92;57;55;52;179;145;78;16;171;175;113;31;157;196;81;90;27;165;119;40;185,1090006997629128223,0.087423
greedy_intra:edges_start:random,64,76328,25790,50538,508650,449,113;145;78;25;82;129;92;57;179;40;185;196;81;90;27;39;165;14;144;102;62;9;15;186;23;89;183;143;0;117;18;22;146;181;42;43;184;160;34;48;54;177;10;4;112;35;116;65;131;149;123;162;133;80;176;151;59;118;115;41;193;139;46;51;137;148;49;178;3;106;52;55;128;167;124;94;121;63;122;79;180;135;70;154;158;53;100;26;97;152;1;101;86;75;2;120;44;16;171;175,6336619531997487181,0.075211
greedy_intra:edges_start:random,65,72619,24355,48264,551805,429,68;46;115;42;43;116;65;59;118;51;80;176;137;183;89;23;186;15;9;62;144;102;49;14;3;178;106;52;55;57;129;92;179;185;40;165;27;90;81;196;31;113;175;171;16;25;78;145;44;120;82;2;75;101;86;100;26;97;1;152;148;124;94;121;53;154;70;135;180;63;79;151;133;162;149;131;123;127;112;4;84;184;177;54;160;34;181;195;146;22;159;193;41;139;69;18;108;117;143;0,2684039856771498486,0.065521
greedy_intra:edges_start:random,66,73242,23907,49335,867816,508,100;86;101;75;120;44;25;92;145;78;16;171;175;113;31;196;81;90;40;185;165;138;14;144;49;178;106;52;55;57;129;2;97;1;152;124;94;63;122;176;80;79;133;151;162;59;65;47;116;115;46;118;51;137;148;9;62;186;23;89;183;143;0;117;68;139;41;193;159;18;22;146;181;42;43;77;149;131;35;184;160;34;48;54;177;10;190;4;112;123;127;70;135;154;180;158;53;121;189;26,5412142705100657270,0.091908
greedy_intra:edges_start:random,67,71884,22431,49453,688524,484,186;23;137;176;80;151;51;109;118;115;42;43;116;65;59;162;133;79;122;63;94;124;148;9;62;144;14;138;102;49;3;178;106;185;40;119;165;90;81;196;179;52;55;57;129;92;145;78;31;56;113;175;171;16;44;120;2;152;97;1;101;75;86;26;100;121;53;158;180;154;135;70;127;123;112;4;10;177;54;184;160;34;181;41;193;159;22;18;108;139;46;68;140;93;117;0;170;143;183;89,5838174180204825593,0.079430
greedy_intra:edges_start:random,68,73126,23560,49566,703267,457,165;90;40;185;52;55;57;92;145;179;196;81;31;113;175;171;16;78;25;44;120;129;2;75;86;97;124;94;152;1;101;26;100;53;158;154;70;135;180;63;122;80;176;51;109;118;59;72;151;79;133;162;194;127;123;149;131;112;84;184;177;54;48;160;34;181;42;43;47;65;116;115;46;68;139;41;193;159;195;146;22;18;108;93;117;0;143;183;89;23;137;148;9;62;144;102;49;14;178;106,4807668003304704445,0.074418
greedy_intra:edges_start:random,69,74594,23964,50630,596640,456,108;69;18;199;159;193;41;139;68;46;115;5;42;181;195;22;146;34;160;48;54;177;4;112;84;184;43;116;65;149;123;162;133;151;59;118;51;137;176;80;79;63;94;124;180;135;70;154;158;53;121;100;26;97;1;101;86;75;2;120;44;16;171;175;113;56;31;25;82;129;92;57;152;167;148;49;178;106;55;52;179;145;78;40;185;165;14;144;62;9;15;186;23;89;183;143;170;0;117;93,733790840051772162,0.068477
greedy_intra:edges_start:random,70,73056,22984,50072,812114,534,42;43;116;65;59;118;51;176;80;79;122;63;189;94;124;148;137;23;186;15;9;62;144;102;49;14;3;178;106;52;55;185;40;119;165;27;90;81;196;179;145;78;157;31;56;113;175;171;16;25;44;120;82;92;57;129;2;75;86;101;1;152;97;26;100;121;53;158;154;180;133;151;162;135;127;123;112;184;177;54;160;34;181;41;193;159;22;18;108;117;143;183;89;153;0;46;68;139;115;5,4995005750238971861,0.087150
greedy_intra:edges_start:random,71,74426,23203,51223,836950,484,52;185;40;81;90;27;165;106;178;3;14;49;102;144;62;9;37;167;124;148;15;23;186;89;183;153;143;117;0;46;139;41;193;159;22;146;34;160;54;177;10;184;84;112;127;123;149;131;47;65;116;43;42;115;118;59;162;151;51;137;176;80;133;194;135;70;154;180;158;53;63;79;122;94;121;100;26;86;75;101;1;97;152;2;120;44;25;16;171;175;113;31;78;145;179;92;82;129;57;55,5216566752553195267,0.077765
greedy_intra:edges_start:random,72,72763,23817,48946,655230,461,146;22;159;193;41;139;115;198;46;68;69;18;108;117;0;143;183;89;23;186;15;144;14;138;3;106;178;49;102;62;9;148;167;129;82;92;145;179;57;55;52;185;40;119;165;90;81;196;31;113;175;171;16;78;25;44;120;2;75;101;86;100;26;97;1;152;94;121;53;180;154;70;135;194;162;151;133;79;63;80;176;137;51;118;59;116;65;149;123;127;112;4;10;177;184;43;42;160;54;34,3277810406040132553,0.084595
greedy_intra:edges_start:random,73,72985,24924,48061,546134,429,143;117;108;18;22;146;181;42;116;65;43;160;34;54;177;10;190;4;112;84;184;35;131;149;123;162;151;127;70;135;154;180;53;100;26;121;133;176;80;79;63;94;124;189;152;97;1;101;86;75;2;129;120;44;25;145;78;16;171;175;113;31;196;81;90;165;119;40;185;57;92;55;52;106;178;3;14;49;102;144;62;9;148;15;186;23;137;51;118;59;115;41;193;159;139;68;46;0;89;183,4629879392537474454,0.081364
greedy_intra:edges_start:random,74,74502,23024,51478,781307,491,144;15;37;148;124;94;189;121;182;63;79;80;176;137;23;89;183;143;0;117;68;46;139;193;41;115;116;65;47;43;42;160;181;22;34;54;177;184;35;84;112;131;149;59;118;51;133;151;162;123;127;70;135;154;180;158;53;100;26;86;101;75;120;44;25;82;92;179;145;78;31;56;113;175;171;16;81;90;165;119;40;185;106;3;178;52;55;57;129;2;1;97;152;167;9;62;102;49;138;14,6019595150693713931,0.081300
greedy_intra:edges_start:random,75,74219,24150,50069,499304,463,146;22;159;41;193;18;108;139;115;198;46;68;36;140;93;117;0;143;183;89;186;9;62;144;102;14;138;49;178;106;185;165;40;81;196;31;56;113;175;171;16;78;145;179;92;52;55;57;129;82;44;25;120;2;1;101;75;86;121;53;180;154;70;135;162;133;151;79;63;94;124;100;26;97;152;167;148;137;176;80;51;59;118;116;5;42;43;65;131;149;123;127;112;84;184;177;54;48;160;34,4699415038445313659,0.075322
greedy_intra:edges_start:random,76,73100,23669,49431,767931,466,149;47;65;59;118;51;176;137;148;37;167;129;2;152;1;97;26;100;121;124;94;63;79;80;133;151;162;123;127;70;135;154;180;158;53;86;101;75;120;44;25;16;171;175;113;31;157;196;81;90;165;40;185;179;145;78;92;57;55;52;178;106;138;14;49;102;144;62;9;15;186;89;183;143;117;0;46;139;108;18;22;146;181;159;193;41;115;116;105;43;42;160;34;54;177;184;35;84;112;131,7576613503350972078,0.079228
greedy_intra:edges_start:random,77,73492,24465,49027,525701,447,186;114;15;9;62;144;102;49;14;138;165;90;81;196;40;119;185;3;178;106;52;55;57;179;31;113;175;171;16;44;25;78;145;92;129;82;120;75;86;101;26;97;1;152;2;167;148;124;94;122;133;79;63;121;53;180;154;135;70;127;123;162;151;118;59;149;131;65;116;43;184;10;177;54;34;160;42;41;193;159;22;18;69;108;140;93;117;68;139;115;46;0;143;183;89;23;51;80;176;137,4938905723043967526,0.073592
greedy_intra:edges_start:random,78,73534,23821,49713,585257,494,75;2;120;44;78;16;171;175;113;56;31;145;92;129;57;55;52;178;106;179;196;81;90;165;40;185;138;14;144;49;102;62;9;37;148;15;186;23;137;176;51;118;59;115;46;0;183;143;117;93;108;69;18;22;146;159;193;41;139;5;116;65;43;42;181;34;160;48;54;177;10;184;35;131;149;123;127;70;135;194;162;151;133;79;80;122;63;94;124;152;97;121;53;180;154;86;100;26;1;101,9022498190890749800,0.086791
greedy_intra:edges_start:random,79,73726,24084,49642,606694,497,59;118;162;123;127;70;135;154;180;53;121;100;26;1;97;101;86;75;2;152;124;167;106;178;52;55;57;92;129;120;44;25;16;171;175;113;31;78;145;179;185;40;165;14;49;102;144;62;9;148;15;186;89;183;143;117;93;140;0;137;176;94;63;79;80;133;151;51;46;115;139;193;41;159;108;18;22;146;34;160;48;54;177;10;190;4;112;84;35;184;43;42;181;5;96;116;65;47;131;149,695407709411706429,0.079188
greedy_intra:edges_start:random,80,73573,24045,49528,518563,435,92;129;57;185;40;165;90;81;196;145;78;31;113;175;171;16;25;44;120;75;101;1;97;86;53;100;26;121;182;63;180;158;154;70;135;127;123;162;133;151;149;131;59;118;51;46;115;116;65;43;42;160;184;112;4;177;54;48;34;181;146;22;159;193;41;139;68;140;93;117;0;143;183;89;23;186;114;15;137;176;80;79;94;152;2;167;148;9;62;102;49;144;14;138;3;178;106;52;55;179,5159646670217991589,0.069219
greedy_intra:edges_start:random,81,72250,23008,49242,618200,494,158;180;154;135;70;127;123;112;4;84;190;10;177;54;48;34;146;22;18;108;159;193;41;181;160;184;43;42;115;139;46;0;143;183;89;23;137;176;51;118;59;116;65;162;151;133;79;80;122;63;94;124;167;148;15;9;62;102;49;144;14;178;106;52;55;57;185;40;119;165;90;81;196;157;31;113;175;171;16;44;25;78;145;179;92;129;82;120;75;86;100;26;97;1;101;2;152;189;121;53,3879172165384718658,0.075968
greedy_intra:edges_start:random,82,72203,24813,47390,667893,477,62;9;89;183;143;117;0;23;137;176;80;79;133;162;151;51;118;59;115;46;68;139;41;193;108;18;159;22;146;34;160;181;42;43;116;65;149;131;35;184;54;177;10;4;112;123;127;70;135;154;180;53;86;101;1;75;2;152;97;26;100;63;122;94;124;148;167;178;106;165;119;40;185;52;55;57;92;129;120;44;25;16;171;175;113;56;31;78;145;179;196;81;90;164;7;21;14;49;102;144,2391426877977013865,0.090582
greedy_intra:edges_start:random,83,75130,25638,49492,632263,456,116;65;59;118;51;176;151;133;79;80;122;63;94;124;167;148;9;62;15;186;23;137;0;117;143;183;89;114;144;14;21;7;164;138;102;49;3;178;106;40;119;165;90;81;113;175;171;16;31;196;185;52;55;57;129;92;179;145;78;25;44;120;75;86;101;2;152;1;97;26;100;121;136;53;158;180;154;135;70;127;123;112;184;177;54;160;34;181;41;193;22;18;108;139;198;68;46;115;42;43,3089108930382198377,0.076456
greedy_intra:edges_start:random,84,72769,23382,49387,815917,507,70;135;133;79;63;180;154;158;53;121;100;26;97;101;86;75;120;44;25;82;92;179;145;78;16;171;175;113;31;157;196;81;90;165;119;40;185;106;178;3;49;14;144;102;62;9;15;148;167;52;55;57;129;2;1;152;124;94;122;80;176;137;23;186;114;89;183;0;143;117;108;18;159;22;146;34;160;54;184;84;112;131;149;65;116;43;42;181;193;41;139;46;115;118;59;51;151;162;123;127,2391194997974266841,0.084889
greedy_intra:edges_start:random,85,72849,24528,48321,662302,434,189;94;124;148;15;114;186;137;23;89;183;143;0;117;68;46;115;5;41;193;139;69;108;18;159;22;146;181;42;116;43;184;160;34;54;177;10;4;112;127;123;162;149;65;59;118;51;176;80;151;133;79;63;180;135;70;154;158;53;121;100;26;1;101;86;75;2;129;120;44;25;78;16;171;175;113;31;196;81;90;165;40;185;179;145;92;57;55;52;106;178;3;14;144;49;102;62;9;152;97,6635702321142450539,0.070502
greedy_intra:edges_start:random,86,73796,24010,49786,583165,434,75;86;101;1;97;26;100;121;53;158;154;180;135;70;127;123;112;4;84;35;149;59;65;47;43;116;96;5;42;181;160;48;184;190;10;177;54;34;22;18;108;159;193;41;139;115;46;68;93;117;143;0;153;183;89;23;186;137;176;80;51;151;162;133;79;63;94;124;152;129;92;57;55;52;106;178;3;49;148;15;9;62;144;14;185;165;90;40;145;78;31;113;175;171;16;44;120;25;82;2,5724926619366244192,0.066612
greedy_intra:edges_start:random,87,72493,23139,49354,597844,455,14;49;102;62;9;148;124;94;152;2;129;92;57;55;52;178;106;185;40;119;165;27;90;81;196;31;113;175;171;16;78;145;25;44;82;120;75;101;1;97;86;26;100;121;136;53;158;154;135;70;127;123;112;184;177;54;48;160;34;146;22;159;193;41;181;42;5;43;116;65;59;118;51;151;162;133;180;63;79;80;176;137;0;46;115;139;69;18;108;140;93;117;170;143;183;89;23;186;15;144,2366020615285821365,0.073633
greedy_intra:edges_start:random,88,72630,23370,49260,566367,416,97;152;167;178;106;52;55;57;179;145;92;129;2;1;101;86;75;120;44;25;78;16;171;175;113;31;196;81;90;40;185;165;14;49;102;144;62;9;148;124;94;63;79;133;151;59;115;118;51;80;176;137;89;183;143;0;117;68;46;139;41;193;159;69;108;18;22;146;181;42;160;34;48;54;30;177;10;4;112;84;35;184;43;116;65;131;149;123;127;70;135;154;180;158;53;136;182;121;100;26,4718604405141548261,0.065660
greedy_intra:edges_start:random,89,73981,25550,48431,587442,452,40;179;92;129;2;152;1;101;100;26;97;94;124;137;148;9;62;102;144;15;186;89;183;143;0;117;108;18;22;146;34;181;159;193;41;139;46;115;118;59;151;162;123;35;184;131;149;65;116;43;42;160;48;54;177;10;4;112;127;70;135;133;79;51;176;80;63;180;154;158;53;86;75;120;44;25;78;145;31;16;171;175;113;56;157;196;81;90;27;165;14;49;3;178;106;55;57;52;185;119,2417287031891602856,0.073694
greedy_intra:edges_start:random,90,72896,24013,48883,812055,440,26;121;63;94;124;152;97;1;101;86;75;2;129;57;92;145;78;120;44;25;16;171;175;113;31;196;81;90;165;40;185;106;3;138;14;144;62;9;102;49;178;52;55;167;148;15;186;89;183;23;137;176;80;79;133;162;123;149;65;59;118;72;151;51;0;143;117;68;46;198;139;115;116;43;42;41;193;159;18;22;146;181;34;160;48;54;177;10;190;184;84;112;127;70;135;154;180;158;53;100,8845572179476256971,0.075072
greedy_intra:edges_start:random,91,72729,23272,49457,729918,457,78;145;185;40;165;90;21;144;15;186;23;89;183;0;143;117;93;68;46;115;139;41;193;159;108;18;22;146;34;30;54;177;4;112;84;184;48;160;42;43;116;65;47;131;149;59;118;51;151;162;123;127;70;135;154;180;158;53;100;26;97;101;86;75;2;1;152;189;124;94;63;122;79;133;80;176;137;148;9;62;102;49;14;3;178;106;55;52;57;92;129;82;120;44;25;16;171;175;113;31,1221574664987694194,0.079108
greedy_intra:edges_start:random,92,71564,22736,48828,789268,501,63;79;133;80;176;137;23;89;183;143;0;117;68;46;198;115;139;41;193;159;18;22;146;195;181;5;42;160;34;54;177;10;4;112;84;35;184;43;116;47;65;59;118;51;151;162;149;131;123;127;70;135;154;180;53;86;100;26;97;1;101;75;120;44;25;16;171;175;113;31;78;145;179;196;81;90;27;165;40;119;185;55;52;106;178;49;138;14;144;102;62;9;148;57;92;129;2;152;124;94,603471777723775564,0.093715
greedy_intra:edges_start:random,93,72759,23873,48886,655524,488,81;196;145;31;113;175;171;16;78;25;44;120;75;86;26;100;121;97;101;1;152;2;129;92;179;57;55;52;106;178;167;124;94;122;80;176;51;118;59;72;151;162;133;79;63;180;53;158;154;135;70;127;123;65;116;43;184;177;54;160;34;181;42;41;193;159;22;18;139;115;46;68;93;117;0;143;183;89;23;137;186;114;15;148;9;62;102;49;144;14;138;21;7;164;27;90;165;185;119;40,7450689546921558491,0.077897
greedy_intra:edges_start:random,94,74403,24185,50218,670357,440,133;79;80;122;124;94;63;180;154;70;135;194;127;123;162;149;131;35;112;4;177;54;48;184;160;34;146;181;42;5;43;116;47;65;59;118;115;46;139;41;193;159;22;18;108;117;143;183;89;186;15;9;62;144;14;49;3;178;106;165;90;81;196;40;185;52;55;57;129;92;179;145;78;31;113;175;171;16;25;44;120;75;86;53;121;189;100;26;97;1;101;2;152;167;37;148;137;176;51;151,883444554611988876,0.070590
greedy_intra:edges_start:random,95,73983,25051,48932,804792,482,49;167;148;137;23;153;0;46;68;117;143;183;89;186;15;9;62;102;144;14;165;39;27;90;81;196;31;113;175;171;16;44;120;2;97;1;101;75;86;26;100;121;53;158;180;154;135;70;127;112;4;84;190;10;177;54;48;34;160;184;43;42;181;22;18;159;193;41;139;115;5;116;65;149;123;162;151;59;118;51;176;80;133;79;63;94;152;129;92;179;145;78;57;55;52;185;40;106;178;3,8078128419061325531,0.086730
greedy_intra:edges_start:random,96,74253,24476,49777,680618,459,92;78;25;44;120;82;129;57;167;124;152;2;75;101;1;97;100;26;86;121;53;158;154;180;136;94;63;79;80;176;51;151;133;162;194;135;70;127;123;112;84;184;177;54;34;160;42;43;116;65;149;118;59;115;139;41;193;159;146;22;18;68;46;0;117;143;183;89;186;23;137;15;148;9;62;144;14;49;3;178;106;165;27;90;119;40;185;52;55;179;196;81;157;56;113;175;171;16;31;145,2083694093641804427,0.076617
greedy_intra:edges_start:random,97,74162,24107,50055,693577,511,120;44;25;129;92;57;55;52;179;145;78;16;171;175;113;56;31;196;81;90;165;119;40;185;106;178;3;138;14;144;49;102;62;9;148;167;124;94;122;63;180;79;133;151;80;176;137;51;109;46;0;23;186;89;183;143;117;68;139;193;41;115;118;59;72;162;149;65;116;43;42;181;159;18;22;34;160;54;177;184;84;112;123;127;194;135;70;154;158;53;121;100;26;86;75;101;1;97;152;2,2493404444210089350,0.085697
greedy_intra:edges_start:random,98,74090,24407,49683,708287,479,81;196;145;78;31;56;113;175;171;16;25;44;120;82;92;57;129;2;75;86;101;1;97;152;26;100;53;63;122;80;79;133;151;162;180;154;135;70;127;123;149;131;43;42;181;160;184;177;54;34;146;22;18;108;69;159;193;41;139;115;116;47;65;59;118;46;68;93;117;143;170;0;51;176;137;12;94;124;167;148;186;23;89;183;114;15;9;62;144;49;178;55;52;106;14;138;165;185;40;90,6280351416877372969,0.077942
greedy_intra:edges_start:random,99,72186,23264,48922,746440,492,86;75;120;44;25;145;78;16;171;175;113;31;157;196;81;90;165;40;185;138;14;144;102;49;178;106;52;55;57;92;129;2;152;94;124;148;37;9;62;15;114;186;137;23;89;183;143;0;117;93;140;108;69;18;22;146;159;193;41;139;46;115;59;118;51;176;80;151;162;133;79;122;63;180;154;135;123;149;65;116;43;42;184;160;181;34;54;177;4;112;127;70;53;121;189;100;26;97;1;101,1112034056682144383,0.088958
greedy_intra:edges_start:random,100,72203,22764,49439,794071,500,78;31;16;171;175;113;196;81;90;165;119;40;185;55;52;106;178;3;49;14;144;102;62;9;148;15;186;137;23;89;183;153;0;170;143;117;93;140;108;18;22;146;34;160;48;54;177;184;43;42;181;159;193;41;139;46;115;116;65;47;149;131;112;127;123;162;151;59;118;51;176;80;124;94;63;79;133;135;70;154;180;158;53;121;100;26;86;101;75;1;97;152;2;120;44;129;92;57;179;145,8491450633626964271,0.090316
greedy_intra:edges_start:random,101,72533,23732,48801,770041,489,54;48;184;160;34;181;42;43;5;115;139;41;193;159;146;22;18;108;68;46;140;93;117;0;143;183;89;23;137;186;114;15;9;62;102;144;14;49;148;124;94;63;121;100;26;97;1;152;2;129;57;55;52;178;106;185;165;40;81;196;179;145;31;113;175;171;16;25;78;92;82;44;120;75;101;86;53;158;180;154;135;70;127;162;151;133;79;80;176;51;59;116;65;131;149;123;112;4;10;177,4844929278595607168,0.077581
greedy_intra:edges_start:random,102,73048,24712,48336,576545,480,180;154;135;70;127;123;112;4;177;54;184;160;34;181;146;22;18;159;193;41;139;68;117;143;183;89;23;137;0;46;115;5;42;43;65;116;131;149;162;151;59;118;51;176;80;133;79;122;63;94;124;167;148;186;114;15;9;62;102;49;52;106;178;14;144;21;7;164;27;90;39;165;40;185;196;31;113;175;171;16;44;120;25;78;145;92;57;55;129;2;152;97;1;101;75;86;26;100;121;53,8887681816739978547,0.078249
greedy_intra:edges_start:random,103,72711,23912,48799,658398,511,26;86;101;75;16;171;175;56;113;31;78;145;92;57;129;25;44;120;2;97;1;152;167;49;3;178;106;52;55;185;40;90;165;138;14;144;102;62;9;148;124;94;137;23;89;183;143;0;117;93;108;18;139;68;46;115;41;193;159;22;146;181;34;160;48;54;30;177;10;190;4;112;84;184;42;116;65;43;131;149;59;118;51;176;80;63;180;79;133;151;162;123;127;70;135;154;158;53;121;100,1211109590807724255,0.089306
greedy_intra:edges_start:random,104,72557,24206,48351,591942,446,133;151;162;127;70;135;154;180;79;63;94;121;53;86;26;97;101;75;2;1;152;167;148;102;49;3;178;106;52;55;57;92;129;82;120;44;25;16;171;175;113;56;31;78;145;179;196;81;90;165;185;40;138;14;144;62;9;15;186;137;23;89;183;143;0;46;198;115;139;68;117;93;140;108;18;22;159;193;41;181;34;160;48;54;177;10;184;42;43;35;112;123;149;65;116;59;118;51;80;176,5572017941651287316,0.072639
greedy_intra:edges_start:random,105,73696,23740,49956,596594,461,59;118;115;139;193;41;159;146;22;18;108;68;46;117;143;170;0;153;183;89;186;9;62;144;14;165;90;40;185;179;92;145;78;31;113;175;171;16;25;44;120;2;129;57;55;52;106;178;49;102;148;23;137;51;176;80;133;162;151;79;63;94;124;152;1;101;75;86;97;26;100;121;53;180;154;135;70;127;123;149;131;184;84;112;4;10;177;30;54;160;34;181;96;5;42;43;77;47;65;116,5301436297216384095,0.079645
greedy_intra:edges_start:random,106,73626,24126,49500,707317,482,100;26;97;1;101;75;86;53;158;70;135;194;127;123;112;35;84;4;190;10;177;30;54;48;34;146;22;18;108;93;117;0;143;183;89;186;23;137;51;118;59;65;116;43;115;46;139;41;193;159;181;42;160;184;131;149;162;151;133;154;180;63;79;80;176;148;15;9;62;102;144;14;49;178;106;185;165;40;196;31;113;175;171;16;25;44;120;78;145;52;55;57;92;129;82;2;152;94;124;121,5163516414658851387,0.078181
greedy_intra:edges_start:random,107,73510,25391,48119,704953,506,86;75;2;120;44;16;171;175;113;56;31;78;145;179;196;81;90;27;164;39;165;40;185;52;106;178;14;49;102;144;62;9;186;89;23;137;51;176;80;79;133;151;118;59;149;131;65;116;43;184;42;41;193;139;115;46;0;183;143;117;93;140;108;69;18;159;22;146;181;34;160;54;177;4;112;123;162;127;70;135;154;158;180;63;94;124;148;167;55;57;92;129;152;1;101;97;26;100;121;53,4951047695364974769,0.075733
greedy_intra:edges_start:random,108,73567,23370,50197,830608,492,120;25;78;145;179;57;92;129;82;2;1;101;75;86;26;100;121;53;63;180;154;70;135;194;127;123;162;151;133;79;80;176;51;118;59;116;65;149;131;47;43;184;10;177;54;160;34;181;42;41;193;159;22;18;139;115;198;46;68;117;0;143;183;89;137;124;94;97;152;167;37;148;186;15;9;62;144;14;102;49;3;178;106;52;55;185;40;119;165;27;90;81;196;31;56;113;175;171;16;44,4191135042421160560,0.086078
greedy_intra:edges_start:random,109,74083,24576,49507,599499,452,41;193;139;68;46;0;143;117;108;18;159;22;34;181;42;43;160;184;177;4;112;127;70;135;133;79;122;63;180;154;158;53;121;189;94;124;148;167;152;97;26;100;1;101;86;75;2;120;44;25;16;171;175;113;56;31;157;196;179;145;78;92;82;129;57;55;52;185;81;90;165;119;40;106;178;3;49;14;144;102;62;9;15;186;23;89;183;137;176;80;151;162;123;149;65;116;59;51;118;115,2932889470191335024,0.068322
greedy_intra:edges_start:random,110,75737,24667,51070,708160,491,119;165;27;90;81;196;113;175;171;16;31;78;145;179;57;92;129;44;25;120;2;75;86;101;1;152;97;26;100;121;53;158;154;180;136;182;189;19;124;94;63;122;176;80;79;133;162;151;51;59;115;46;68;139;193;41;42;116;65;149;123;135;70;127;112;84;184;54;160;34;22;159;18;117;0;143;183;89;23;137;186;114;15;148;37;9;62;102;49;14;144;21;164;7;178;106;52;55;185;40,5099960907182028122,0.082930
greedy_intra:edges_start:random,111,72861,24431,48430,573393,456,78;16;171;175;113;56;31;196;81;90;165;40;185;14;49;102;144;62;9;15;114;89;183;143;117;93;140;108;18;22;146;103;34;30;54;177;10;190;4;112;84;35;184;48;160;42;181;159;193;41;139;43;116;65;149;59;118;115;46;0;137;23;186;148;167;178;106;52;55;57;92;129;2;101;1;97;152;124;94;63;79;133;80;176;51;151;162;123;135;180;154;53;100;26;86;75;120;44;25;145,8828305138433325567,0.072848
greedy_intra:edges_start:random,112,74392,25469,48923,672992,473,120;44;25;129;55;57;92;78;16;171;175;113;56;31;145;81;90;165;40;185;52;106;178;3;14;49;102;144;62;9;15;186;89;23;137;148;167;152;124;94;80;176;51;118;59;115;41;193;139;198;46;68;0;183;143;117;93;108;18;22;146;159;181;34;54;177;160;42;43;116;65;149;131;184;84;4;112;127;123;162;72;151;133;135;70;154;158;53;180;79;63;121;100;26;97;1;101;86;75;2,8031538625535703081,0.078387
greedy_intra:edges_start:random,113,73963,26049,47914,611007,494,94;53;100;26;86;75;101;1;97;152;2;129;92;145;78;25;120;44;16;171;175;113;56;31;196;81;90;27;119;40;185;179;57;55;52;178;3;106;165;164;21;144;14;49;102;62;9;148;15;186;80;176;137;23;89;183;143;117;0;46;115;139;108;18;22;193;41;181;34;160;54;177;10;4;112;84;190;184;42;43;116;65;118;51;59;149;131;35;123;127;70;135;154;180;162;151;133;79;122;63,472042758861366853,0.081545
greedy_intra:edges_start:random,114,72786,23663,49123,688220,454,39;165;40;185;106;52;55;57;92;129;2;1;152;167;148;49;178;14;144;102;62;9;15;137;23;89;183;143;0;117;93;140;108;18;69;139;46;118;109;51;176;80;122;63;79;133;151;162;59;65;47;116;43;42;5;115;41;193;146;22;159;181;34;160;48;54;177;10;190;184;131;149;123;127;70;135;154;180;53;94;97;26;100;86;101;75;120;44;25;145;78;16;171;175;113;31;196;81;90;27,3052234066851791305,0.076024
greedy_intra:edges_start:random,115,74438,23192,51246,676616,483,146;22;18;69;108;93;117;143;0;153;183;89;23;186;114;15;37;102;49;3;178;106;52;55;57;92;129;120;44;25;16;171;175;113;78;145;179;185;40;165;14;144;62;9;148;137;46;115;139;41;193;159;195;181;42;5;43;116;65;59;118;51;176;80;79;63;94;124;152;2;75;86;101;1;97;26;100;121;53;136;158;154;180;133;151;162;149;131;123;135;70;127;112;84;184;10;177;54;160;34,2017664797595947734,0.079849
greedy_intra:edges_start:random,116,72667,22506,50161,578433,484,44;25;129;92;78;16;171;175;113;31;145;196;81;90;165;119;40;185;57;55;52;106;178;3;49;102;14;144;62;9;148;15;186;89;183;23;137;176;80;79;133;162;151;51;118;59;131;149;47;65;116;43;42;181;193;41;139;115;46;68;108;69;18;159;22;146;103;34;160;54;177;10;190;184;84;4;112;123;127;70;135;154;180;53;121;63;122;94;124;189;100;26;86;101;1;97;152;2;75;120,3590668481658074203,0.078602
greedy_intra:edges_start:random,117,72832,23739,49093,676898,488,121;100;26;97;152;2;1;101;75;86;53;158;154;135;70;127;112;4;190;10;177;30;54;48;184;160;34;146;22;18;108;140;68;139;46;0;143;183;137;23;186;15;144;14;185;40;165;39;27;90;81;196;157;31;113;175;171;16;44;120;25;78;145;92;129;57;55;52;106;178;49;62;9;148;94;63;122;79;80;176;51;151;59;118;115;41;193;159;181;42;43;116;65;47;131;149;123;162;133;180,7995063659427225916,0.088997
greedy_intra:edges_start:random,118,71701,21997,49704,753223,447,9;62;144;14;49;3;178;106;185;40;119;165;90;81;196;145;78;31;56;113;175;171;16;25;44;120;75;101;1;97;26;100;86;53;180;154;135;70;127;123;112;84;35;131;149;47;65;116;43;184;177;54;48;34;160;42;181;146;22;159;193;41;139;115;46;68;93;117;0;143;183;89;114;186;23;137;176;80;51;118;59;162;151;133;79;63;122;94;124;152;2;82;129;92;57;55;52;167;148;15,984639590670692703,0.069950
greedy_intra:edges_start:random,119,74585,26341,48244,637231,472,0;46;176;80;122;63;94;137;183;89;23;148;167;124;100;26;97;152;2;129;57;179;40;119;39;165;185;52;55;106;178;3;14;49;9;62;144;21;164;27;90;81;31;113;175;171;16;78;145;92;25;44;120;75;1;101;86;53;154;180;79;133;135;70;127;123;162;151;51;118;59;149;65;116;43;42;5;115;139;41;193;159;181;160;184;84;112;4;177;54;48;34;146;22;18;69;108;93;117;143,827141395693343195,0.074028
greedy_intra:edges_start:random,120,71668,23234,48434,870877,449,106;178;3;14;49;102;144;62;9;148;15;114;186;137;23;89;183;143;117;0;46;139;193;159;108;18;22;34;48;54;177;10;190;112;4;84;35;131;149;65;116;43;184;160;181;5;42;41;115;59;51;176;80;79;133;151;162;123;127;70;135;154;180;53;63;94;124;121;100;26;86;75;101;97;1;152;2;120;44;25;82;129;92;57;179;145;78;16;171;175;113;31;196;81;90;165;40;185;55;52,424120849378490308,0.082095
greedy_intra:edges_start:random,121,74702,25174,49528,689544,466,113;171;175;16;78;25;44;120;145;179;57;92;129;2;75;101;1;152;97;26;100;86;53;180;154;70;135;194;127;123;149;131;112;84;184;54;160;34;22;18;108;117;143;183;89;114;15;186;23;137;80;176;0;68;46;115;139;193;41;42;43;116;65;59;118;51;151;162;133;79;63;94;124;111;167;55;52;106;178;3;14;49;148;9;62;102;144;21;7;164;39;165;185;40;119;90;81;196;157;31,2396132931641312191,0.083594
greedy_intra:edges_start:random,122,74037,24010,50027,642044,520,46;68;93;117;0;143;183;89;23;137;176;51;118;59;116;43;47;65;149;151;133;79;80;122;63;94;152;167;148;15;9;62;144;102;49;52;106;178;14;138;165;90;40;185;179;55;57;2;129;92;145;78;31;56;113;175;171;16;44;120;75;86;101;1;97;26;100;121;53;180;154;70;135;194;162;127;123;131;35;112;4;84;184;177;54;48;160;34;181;42;5;41;193;159;22;18;108;139;115;198,5901862918605735450,0.087051
greedy_intra:edges_start:random,123,72601,23612,48989,686651,499,40;119;90;165;138;14;144;49;102;62;9;148;186;137;23;89;183;0;143;117;46;115;118;51;176;80;94;63;122;79;133;151;162;123;59;65;149;131;35;184;43;116;42;5;139;41;193;159;18;22;146;181;34;160;54;177;10;190;4;112;127;70;135;154;180;158;53;121;100;26;86;75;101;1;97;152;2;129;82;120;44;25;16;171;175;113;56;31;81;196;145;78;92;179;57;55;52;178;106;185,517166510312188213,0.082120
greedy_intra:edges_start:random,124,74179,25026,49153,616826,455,100;86;1;101;75;120;44;16;171;175;31;113;78;145;179;106;178;3;14;49;167;148;124;94;189;121;53;154;135;70;127;123;149;131;35;84;112;4;177;54;160;184;43;77;47;65;116;42;5;41;193;181;34;146;22;159;18;108;93;117;143;0;46;68;139;115;59;118;51;151;162;133;180;63;79;80;176;137;23;89;183;9;62;102;144;21;164;90;165;40;185;52;55;57;92;129;2;152;97;26,5590604567026833518,0.072629
greedy_intra:edges_start:random,125,72825,23790,49035,626483,471,63;121;100;26;97;1;101;75;86;53;180;154;135;127;123;112;4;190;10;177;184;160;48;54;34;22;18;108;93;117;143;0;46;115;139;41;193;159;181;42;43;116;65;131;149;59;118;151;162;133;79;80;176;51;137;23;183;89;186;9;62;102;144;14;138;185;40;165;90;81;196;157;31;113;175;171;16;25;44;120;2;152;129;82;92;78;145;179;57;55;52;106;178;49;37;148;167;124;94;122,6557077698157332428,0.089437
greedy_intra:edges_start:random,126,74361,22765,51596,674995,451,51;109;176;80;133;151;162;149;131;47;65;116;43;42;5;59;118;115;139;198;46;68;0;143;117;93;140;36;108;69;18;22;146;195;159;193;41;181;184;48;160;34;30;54;177;10;190;4;112;123;127;70;135;154;180;79;63;94;53;100;26;86;101;1;97;152;2;75;120;44;25;129;92;145;78;16;171;175;113;56;31;196;185;40;165;106;178;49;14;144;62;9;148;15;114;186;23;89;183;137,3232569429490634721,0.072709
greedy_intra:edges_start:random,127,73198,24102,49096,673386,484,106;52;185;40;165;90;81;196;179;145;78;31;56;113;175;171;16;25;44;120;82;129;92;57;55;2;152;97;1;75;86;101;26;100;121;53;154;70;135;180;63;79;133;162;123;112;4;10;177;54;34;160;184;43;42;41;193;159;181;195;146;22;18;108;139;68;117;143;0;153;183;89;114;186;23;137;46;115;116;65;59;118;51;72;151;176;80;94;124;167;148;15;9;62;102;144;14;49;3;178,6270310489848307451,0.083974
greedy_intra:edges_start:random,128,73942,24004,49938,698003,433,26;86;75;2;120;44;25;16;171;175;113;31;78;145;196;81;90;165;119;40;185;179;92;82;129;57;55;52;106;178;3;14;144;49;102;62;9;148;186;23;137;176;80;122;63;79;133;151;51;118;46;0;89;183;143;117;93;140;68;198;139;193;41;115;59;162;123;149;65;116;43;42;184;160;181;159;18;22;146;103;34;48;54;177;112;127;135;154;180;158;53;100;121;189;124;94;152;97;1;101,4049449346334620831,0.073169
greedy_intra:edges_start:random,129,73628,25286,48342,698865,463,26;100;121;94;124;152;167;148;49;102;144;62;9;15;114;186;89;23;137;176;80;51;118;59;116;65;47;43;42;115;46;68;0;183;143;117;93;140;108;18;139;41;193;181;159;22;146;34;160;184;54;177;4;112;127;70;135;123;131;149;162;151;133;79;63;180;154;53;86;75;120;44;25;16;171;175;113;56;31;78;145;92;179;185;40;81;90;165;14;3;178;106;52;55;57;129;2;101;1;97,5553680007291162783,0.080047
greedy_intra:edges_start:random,130,72693,22444,50249,783041,507,48;54;177;10;4;112;184;43;116;65;59;118;72;151;133;162;123;127;70;135;154;180;158;53;136;121;100;26;86;101;1;97;152;2;75;120;44;25;16;171;56;113;175;31;157;145;78;82;129;92;57;55;52;179;196;81;90;165;40;185;106;178;3;49;102;14;144;62;9;148;167;124;94;63;79;80;176;51;137;23;186;89;183;143;0;117;68;46;115;139;41;5;42;160;181;193;159;22;146;34,5244659289431438015,0.092341
greedy_intra:edges_start:random,131,75832,26370,49462,665569,427,180;79;80;176;122;63;94;124;121;53;158;100;97;26;86;75;101;1;2;120;44;25;16;171;175;113;56;31;157;81;196;179;145;78;92;57;55;129;152;167;148;49;102;14;138;3;178;106;52;185;40;119;165;39;90;27;164;144;62;9;186;23;137;51;118;115;46;0;89;183;143;117;68;139;108;18;22;193;41;181;42;43;184;160;34;54;177;4;112;123;149;131;65;116;59;162;151;133;135;154,8607297346135542169,0.072352
greedy_intra:edges_start:random,132,72475,23271,49204,724949,486,89;23;114;186;137;176;80;79;63;94;124;167;148;15;62;9;144;102;49;178;52;106;138;14;21;164;90;165;40;119;185;81;196;179;145;78;31;113;175;171;16;25;44;120;92;57;55;129;2;152;97;1;101;75;86;26;100;53;180;154;135;70;127;123;162;151;133;51;109;118;59;116;43;65;149;131;35;112;4;84;184;177;54;48;160;34;146;22;159;193;41;42;5;115;139;46;0;117;143;183,3548421958296301964,0.084984
greedy_intra:edges_start:random,133,74164,24827,49337,715360,512,53;158;154;135;70;127;123;112;131;149;47;65;116;43;42;115;139;41;193;159;181;160;177;184;54;34;146;22;18;108;140;93;117;68;46;118;59;151;133;162;180;63;79;122;80;176;51;137;0;143;183;89;186;15;148;124;94;189;97;1;152;167;9;62;102;144;14;49;3;106;178;52;55;129;92;57;185;40;119;165;90;81;31;56;113;175;171;16;78;145;25;44;120;2;75;101;86;26;100;121,1710577756048386758,0.083915
greedy_intra:edges_start:random,134,72250,22534,49716,680947,498,80;176;51;109;59;118;115;116;65;47;43;42;160;34;181;146;22;195;159;41;193;18;108;140;93;68;139;46;0;143;183;89;23;137;148;9;62;144;14;49;3;178;106;185;40;119;165;90;81;196;55;52;57;92;145;78;31;56;113;175;171;16;25;44;120;82;129;2;152;97;1;101;75;86;26;100;121;53;158;180;154;135;70;127;112;4;10;177;54;184;131;149;123;162;151;133;79;122;63;94,6631815522713324340,0.090506
greedy_intra:edges_start:random,135,73472,24773,48699,679205,493,62;9;148;94;152;1;2;129;92;78;145;179;40;185;57;55;52;106;178;3;14;138;165;90;81;196;31;113;175;171;16;25;44;82;120;75;86;101;97;26;53;158;154;180;63;79;80;176;133;135;70;127;123;149;131;65;59;162;151;51;118;115;116;43;42;184;84;112;4;10;177;54;48;160;34;181;146;22;159;193;41;139;46;68;18;108;93;117;143;170;0;153;183;89;23;137;15;144;49;102,7736785078608528919,0.087978
greedy_intra:edges_start:random,136,74238,24845,49393,676410,521,115;96;5;116;65;149;59;118;51;176;137;148;9;62;15;144;102;49;14;178;106;52;55;57;92;185;40;119;165;90;81;196;157;31;113;175;171;16;78;145;25;44;120;2;75;101;86;100;26;97;1;152;94;121;53;158;154;135;180;63;122;80;79;133;151;162;123;70;127;112;4;10;177;54;184;43;42;181;160;34;22;18;108;69;159;193;41;139;68;93;117;143;183;89;114;186;23;153;0;46,8496367037276822204,0.086876
greedy_intra:edges_start:random,137,74065,24968,49097,699153,473,23;137;176;80;63;79;133;151;72;162;123;127;70;135;154;180;53;94;124;148;167;152;1;97;26;100;86;101;75;2;129;82;120;44;25;78;31;16;171;175;113;81;90;165;40;196;179;145;92;57;55;52;185;106;178;3;14;49;102;144;62;9;89;183;143;117;93;108;69;18;22;146;159;193;41;115;5;42;181;34;160;54;177;184;84;112;149;131;43;47;65;116;59;118;109;51;46;139;68;0,8143185544817585553,0.080038
greedy_intra:edges_start:random,138,73903,23886,50017,569201,440,118;51;176;80;79;133;151;162;59;149;131;47;65;116;115;96;5;42;43;160;54;177;184;35;84;4;112;123;127;70;135;154;180;158;53;121;86;101;75;2;152;1;97;26;100;189;63;122;94;124;148;167;57;129;120;44;25;82;92;145;78;16;171;175;113;56;31;157;196;81;90;165;40;185;55;52;106;178;49;14;144;62;9;137;89;183;143;0;117;93;108;18;159;22;34;181;193;41;139;46,3668211374689024310,0.067452
greedy_intra:edges_start:random,139,72507,23820,48687,695465,484,183;143;117;93;140;68;139;41;193;159;69;108;18;22;146;42;43;181;34;160;184;54;177;4;112;127;123;194;135;70;154;180;53;86;100;26;97;152;1;101;75;2;129;82;120;44;25;16;171;175;113;56;31;78;145;196;81;90;27;165;40;185;179;92;57;55;52;106;178;3;14;49;102;144;62;9;15;37;148;124;94;63;79;80;176;51;118;59;151;133;162;65;116;115;46;0;137;23;186;89,1830669664903800120,0.083131
greedy_intra:edges_start:random,140,71738,22662,49076,689297,476,52;55;57;92;129;25;44;120;2;75;86;101;1;152;97;26;100;121;53;158;63;94;80;176;51;151;133;79;180;154;135;70;127;123;162;149;131;35;84;112;4;184;177;54;48;160;34;181;42;43;116;65;59;118;115;46;139;41;193;22;18;108;93;117;0;143;183;89;23;137;186;114;15;148;37;9;62;144;102;49;14;138;3;178;106;185;40;119;165;90;81;196;31;113;175;171;16;78;145;179,1666646405086447755,0.075009
greedy_intra:edges_start:random,141,74426,24969,49457,595234,427,152;94;148;23;89;183;143;117;0;46;68;139;108;18;22;159;193;41;42;181;34;160;48;54;30;177;10;190;184;35;84;112;127;123;149;162;151;59;116;105;65;47;131;77;43;5;115;118;51;137;176;80;79;133;135;70;154;180;63;53;121;100;26;86;101;75;120;44;25;78;16;171;175;113;31;145;179;196;81;90;119;40;185;165;14;144;15;9;62;102;49;178;106;52;57;92;129;2;1;97,7976860261834131910,0.066952
greedy_intra:edges_start:random,142,75098,25403,49695,505232,455,26;97;1;101;86;75;82;120;44;25;113;175;171;16;31;78;145;179;57;92;129;2;152;167;49;3;178;106;52;55;185;119;40;196;81;90;27;165;14;144;102;62;9;148;176;151;162;59;65;116;43;149;123;112;4;84;190;10;177;184;54;30;48;34;160;42;5;181;146;22;18;108;93;117;170;143;183;89;23;137;0;46;139;193;41;115;118;51;80;63;79;133;135;180;154;158;53;121;94;100,3940147430882192192,0.070132
greedy_intra:edges_start:random,143,73119,23630,49489,698465,464,62;9;186;23;89;183;143;117;0;153;137;148;52;55;57;179;145;78;92;129;2;1;152;124;94;63;79;80;176;51;109;118;59;149;131;65;116;43;115;46;139;18;22;159;193;41;42;181;34;160;54;177;10;190;184;35;84;112;127;123;162;151;133;135;70;154;180;158;53;121;100;26;97;101;86;75;120;44;25;16;171;56;113;175;31;196;81;90;165;119;40;185;106;178;3;138;14;144;49;102,6612285425581274741,0.079097
greedy_intra:edges_start:random,144,72665,23974,48691,694716,523,185;165;14;106;178;49;102;144;62;9;148;37;15;186;137;23;89;183;143;0;117;93;108;18;159;22;146;34;160;54;177;10;4;112;123;127;70;135;162;133;151;51;118;59;149;65;116;43;184;42;181;193;41;139;115;46;176;80;79;180;154;53;121;182;63;94;124;152;97;1;101;26;100;86;75;2;120;44;25;82;129;92;57;55;52;179;145;78;16;171;175;113;56;31;157;196;81;90;119;40,7905838635277740667,0.091495
greedy_intra:edges_start:random,145,73247,24115,49132,617789,489,139;46;115;116;65;43;42;181;160;184;131;149;59;118;109;51;137;183;143;117;0;89;23;186;15;9;62;144;14;49;178;106;185;40;119;165;90;81;196;145;78;31;56;113;175;171;16;25;44;120;129;92;57;55;52;167;37;148;124;94;63;121;97;152;2;1;101;75;100;26;86;53;158;180;154;70;135;79;80;176;133;151;162;123;127;112;4;10;177;54;34;103;146;22;18;108;69;159;193;41,6196860249908375124,0.077226
greedy_intra:edges_start:random,146,74831,24458,50373,592870,522,9;167;152;1;2;75;86;101;97;26;100;121;53;154;180;133;162;135;70;127;123;112;84;184;10;177;54;160;34;146;22;18;139;193;41;42;43;116;131;149;65;59;51;151;72;118;115;46;0;183;89;23;137;176;80;79;122;63;94;124;148;37;15;144;14;138;21;7;164;27;90;165;39;119;40;185;81;196;31;56;113;175;171;16;25;44;120;129;78;145;92;57;55;52;106;178;3;49;102;62,3773956336800914356,0.077723
greedy_intra:edges_start:random,147,74681,23067,51614,586861,463,196;157;31;56;113;175;171;16;44;25;78;145;179;57;92;129;82;120;2;75;86;53;180;154;70;135;194;127;123;162;149;131;35;184;54;160;34;181;42;5;43;116;65;59;51;109;118;115;46;68;139;41;193;159;22;18;117;0;143;183;89;23;137;176;80;151;133;79;122;63;121;100;26;101;1;97;152;189;94;124;111;167;55;52;185;40;106;178;49;148;9;62;144;14;138;165;39;27;90;81,2160588566575237686,0.071566
greedy_intra:edges_start:random,148,72690,24369,48321,609059,504,159;193;18;108;140;93;117;143;183;0;46;139;41;5;42;43;131;149;47;65;116;115;59;118;51;151;162;133;79;63;80;176;137;23;89;186;9;62;144;14;138;165;90;81;196;31;56;113;175;171;16;25;44;120;75;101;86;100;26;97;1;152;2;82;129;55;52;57;92;78;145;179;40;185;106;178;49;102;148;124;94;121;53;180;154;135;70;127;123;112;4;10;177;54;184;160;34;181;146;22,4705759207150814966,0.085950
greedy_intra:edges_start:random,149,72786,23951,48835,679070,470,135;154;162;151;133;79;80;122;63;180;53;121;189;94;124;167;152;97;26;100;1;101;86;75;2;129;120;44;25;16;171;175;113;56;31;78;145;157;196;81;90;27;165;185;40;179;92;57;55;52;106;178;3;49;14;144;102;62;9;148;15;186;89;183;143;117;0;23;137;176;51;118;59;131;149;65;116;43;42;115;139;46;68;108;18;193;41;159;22;146;34;160;54;177;184;84;112;123;127;70,8854278196353266188,0.077615
greedy_intra:edges_start:random,150,73687,24060,49627,682191,522,179;196;185;40;165;90;81;31;113;175;171;16;78;145;25;44;120;75;2;152;189;124;148;94;80;176;51;118;59;162;151;79;122;63;121;100;26;97;1;101;86;53;158;154;180;133;194;135;70;127;123;149;131;184;84;112;4;10;177;54;48;160;34;181;42;43;47;65;116;115;139;41;193;159;22;18;108;68;46;0;143;183;137;23;186;15;9;62;144;102;49;14;3;178;106;52;55;57;129;92,5839739134356191841,0.079231
greedy_intra:edges_start:random,151,73044,24132,48912,761083,471,69;18;22;146;159;193;41;139;42;43;116;65;47;149;131;35;184;160;34;54;177;4;112;127;123;162;135;70;154;180;63;53;100;26;86;101;75;2;129;82;120;44;25;16;171;175;113;56;31;78;145;179;92;57;55;52;178;106;185;40;165;90;27;164;21;14;49;102;144;62;9;186;23;89;183;137;148;167;97;1;152;124;94;176;80;79;133;151;51;118;59;115;46;0;170;143;117;93;140;108,1801682895996809326,0.076715
greedy_intra:edges_start:random,152,73161,24693,48468,659454,458,10;190;4;112;123;162;127;70;135;154;180;53;86;75;2;152;1;101;97;26;100;94;63;79;80;176;137;23;148;167;52;55;57;92;129;120;44;25;78;16;171;175;113;31;145;81;90;165;40;185;106;178;3;138;14;49;102;144;62;9;186;89;183;143;0;46;139;68;117;93;140;108;18;22;103;34;146;159;193;41;115;59;118;51;151;133;149;131;47;65;116;43;5;42;181;160;184;48;54;177,8485922581783026436,0.078448
greedy_intra:edges_start:random,153,72901,23886,49015,717629,552,184;84;35;123;112;4;190;10;177;30;54;48;160;34;146;22;18;108;139;115;46;117;143;0;137;23;183;89;186;114;15;148;37;9;62;144;102;49;14;178;106;52;92;129;57;55;185;40;165;90;81;31;56;113;175;171;16;78;145;25;44;120;2;75;86;101;1;152;97;26;100;53;180;154;70;135;63;79;122;94;124;176;80;133;162;151;51;118;59;149;131;47;65;116;43;42;41;193;159;181,5765266299765023624,0.084184
greedy_intra:edges_start:random,154,73433,23587,49846,764982,457,194;162;123;127;112;184;54;160;34;181;42;43;116;65;47;131;149;59;118;115;46;68;139;41;193;159;22;18;108;93;117;0;170;143;183;89;23;137;51;151;133;176;80;79;63;94;124;148;37;15;186;114;9;62;102;49;144;14;165;119;40;27;90;81;196;185;3;178;106;52;55;57;179;145;31;113;175;171;16;78;92;129;25;44;120;2;75;86;101;1;152;97;26;100;121;53;180;154;70;135,7970997542774136450,0.084321
greedy_intra:edges_start:random,155,75217,25006,50211,515580,440,0;183;89;186;15;9;62;144;21;164;27;90;39;165;119;40;81;196;157;31;113;175;171;16;44;25;120;82;129;92;145;78;179;57;55;52;185;106;178;14;49;102;148;167;111;124;152;2;75;86;101;1;97;26;100;94;63;80;176;137;51;118;59;151;133;79;180;53;158;154;70;135;127;162;123;112;184;43;131;149;65;116;115;139;41;42;181;160;34;146;22;159;193;199;18;69;108;93;117;143,9051589824345922102,0.071966
greedy_intra:edges_start:random,156,74435,24561,49874,695133,488,102;49;14;165;27;90;40;185;196;179;145;31;113;175;171;16;44;120;25;78;82;92;57;55;52;106;178;3;167;124;152;129;2;75;101;1;97;26;100;86;53;180;154;135;127;123;112;4;190;10;177;54;184;35;131;149;162;133;63;94;122;79;80;176;51;151;72;118;59;65;116;43;42;181;160;34;103;146;22;159;18;108;41;193;139;115;46;0;117;143;183;137;23;186;15;148;37;9;62;144,5005130698581077052,0.092390
greedy_intra:edges_start:random,157,72214,22822,49392,647378,444,108;18;69;139;46;115;41;193;159;22;146;181;34;160;54;177;184;42;43;116;65;131;149;59;118;51;176;80;133;151;162;123;127;70;135;154;158;180;79;63;94;124;189;121;53;100;26;97;86;75;101;1;152;2;129;82;120;44;25;16;171;175;113;56;31;78;145;92;179;196;81;90;165;119;40;185;3;178;106;52;55;57;167;148;49;14;144;102;62;9;15;114;186;137;23;89;183;143;0;117,1239806560364533353,0.073745
greedy_intra:edges_start:random,158,74298,25334,48964,643303,479,86;101;1;97;26;100;121;80;176;51;118;59;65;116;42;193;41;115;46;68;139;108;18;22;146;34;160;43;149;131;35;184;54;177;10;190;84;4;112;123;162;151;133;127;70;135;154;180;158;53;79;63;94;152;167;148;49;62;9;15;186;137;23;89;153;0;117;143;183;114;144;14;165;90;81;196;40;119;185;3;178;106;52;55;57;129;92;145;78;31;56;113;175;171;16;25;44;120;2;75,1852984932873041470,0.079336
greedy_intra:edges_start:random,159,72248,23185,49063,778578,492,149;47;65;116;59;118;51;46;68;139;115;5;42;43;160;34;22;159;41;193;18;108;140;93;117;0;143;183;89;186;23;137;176;80;122;63;94;124;148;9;62;144;102;49;14;178;106;52;55;185;40;119;165;27;90;81;196;145;31;113;175;171;16;25;78;92;57;129;82;44;120;2;152;97;1;86;75;101;26;100;53;158;154;180;79;133;151;162;135;127;123;112;4;84;190;10;177;54;184;131,914227332699759957,0.084616
greedy_intra:edges_start:random,160,73803,23479,50324,649166,464,113;175;171;16;25;44;120;82;2;75;86;100;26;101;97;1;152;94;124;12;122;80;176;51;118;59;116;65;47;131;149;151;162;133;79;63;121;53;158;180;154;135;127;123;112;177;54;34;160;184;43;42;181;41;193;22;18;108;139;115;46;68;140;93;117;143;183;89;23;186;137;15;148;9;62;102;144;14;138;49;178;106;185;40;119;165;27;90;81;196;52;55;92;129;57;179;145;78;31;56,4785218563989740933,0.075652
greedy_intra:edges_start:random,161,71782,22135,49647,813919,476,3;178;106;52;55;57;129;82;92;78;145;179;185;40;119;165;90;81;196;31;113;175;171;16;25;44;120;75;86;101;2;152;1;97;26;100;53;158;180;154;135;70;127;123;112;4;190;10;177;54;48;34;160;184;35;131;149;47;65;116;43;42;5;115;198;46;68;139;41;193;159;146;22;18;117;0;143;183;89;23;137;80;176;51;118;59;72;162;151;133;79;63;94;148;9;62;144;102;49;14,4976981105140752387,0.079708
greedy_intra:edges_start:random,162,75372,25605,49767,657934,490,57;92;129;120;2;75;86;121;100;26;101;1;97;152;189;124;167;148;94;182;63;122;79;133;180;53;158;154;135;70;127;123;162;151;59;149;112;177;54;34;22;159;193;41;42;181;160;184;43;65;116;115;118;51;80;176;137;46;139;68;93;117;0;143;183;89;186;15;9;62;144;102;49;14;21;164;27;90;165;119;40;185;196;81;31;56;113;175;171;16;44;25;78;145;179;52;178;3;106;55,4937436370971980276,0.078900
greedy_intra:edges_start:random,163,74613,23663,50950,671731,469,79;63;94;97;1;26;100;86;101;75;2;152;124;148;167;92;129;120;44;25;16;171;175;113;56;31;157;81;196;78;145;91;179;57;55;52;178;3;106;185;40;119;8;165;39;90;27;95;164;7;21;144;14;49;102;62;9;15;186;137;23;89;183;143;117;0;46;115;139;193;41;42;160;181;159;22;146;34;54;184;84;112;123;149;131;43;116;65;59;118;51;176;80;151;162;135;154;53;180;133,2059999907954124843,0.076325
greedy_intra:edges_start:random,164,73095,24080,49015,756146,445,179;92;25;82;129;57;55;52;106;185;40;196;81;90;27;39;165;138;3;178;49;102;14;144;62;9;148;186;23;89;183;143;0;46;68;139;115;118;59;149;131;65;116;43;42;181;41;193;159;108;18;22;146;103;34;160;54;177;10;190;184;112;123;162;151;51;137;176;80;79;133;127;70;135;154;180;158;53;121;63;94;124;152;97;26;1;101;86;75;2;120;44;16;171;175;113;56;31;78;145,6569075094055454458,0.074793
greedy_intra:edges_start:random,165,73953,24724,49229,728687,502,59;51;109;118;151;162;123;127;70;135;154;53;121;100;26;86;75;101;97;1;2;120;44;25;78;16;171;175;113;56;31;81;196;145;179;185;40;119;90;27;165;178;49;102;144;14;106;52;55;57;92;129;152;124;94;136;180;133;79;63;122;80;176;137;23;186;148;9;62;15;114;89;183;143;0;117;68;46;115;139;41;193;159;18;22;146;34;48;160;181;42;184;54;177;112;149;131;43;116;65,2967915619163889761,0.084352
greedy_intra:edges_start:random,166,74260,25136,49124,664018,489,122;63;94;124;167;49;3;178;106;52;55;179;145;78;92;57;129;2;152;1;97;26;100;121;180;133;79;80;176;151;162;149;65;116;59;51;137;23;186;89;183;143;0;117;46;68;93;140;108;69;18;22;34;181;193;41;139;115;43;42;160;184;177;10;4;112;123;127;70;135;154;158;53;86;101;75;120;44;25;16;171;175;113;31;157;196;81;90;165;119;40;185;138;14;21;144;102;62;9;148,4373080213998014347,0.076093
greedy_intra:edges_start:random,167,73610,23377,50233,600136,462,43;65;149;131;184;160;34;54;30;177;10;190;4;84;112;123;127;70;135;194;162;151;133;79;63;180;154;158;53;100;86;75;101;97;26;94;124;152;1;2;129;92;82;120;44;25;16;171;175;113;56;31;196;78;145;179;57;55;52;185;40;81;90;27;165;106;178;3;14;144;49;102;62;9;148;137;89;183;143;117;0;46;68;139;41;193;159;22;146;181;42;5;115;118;109;51;80;176;59;116,2000878052275680918,0.081227
greedy_intra:edges_start:random,168,75249,23137,52112,603707,472,78;25;82;120;44;16;171;175;113;56;31;157;196;81;90;27;165;119;40;185;55;52;106;178;3;138;14;144;155;49;102;62;9;15;186;23;89;183;143;117;0;137;176;80;151;162;51;46;198;115;139;68;140;108;18;22;193;41;181;34;160;184;42;43;116;65;59;149;123;127;70;135;154;180;133;79;63;158;53;121;100;86;75;101;1;97;26;19;189;94;124;148;167;152;2;129;92;57;179;145,2229265744602015128,0.081509
greedy_intra:edges_start:random,169,72776,23313,49463,907987,466,51;118;59;149;35;84;4;112;123;127;70;135;154;158;53;121;94;124;167;148;9;62;102;49;3;178;52;55;57;129;152;97;26;100;1;101;86;75;2;120;92;179;145;78;25;44;16;171;175;113;56;31;196;81;90;40;119;165;185;106;14;144;15;186;137;23;89;183;143;0;117;68;46;115;139;41;193;159;22;146;181;34;48;54;177;184;160;42;43;116;65;162;151;133;79;180;63;122;80;176,8791459027542221851,0.079369
greedy_intra:edges_start:random,170,71857,23358,48499,816673,487,185;40;165;90;81;196;31;56;113;175;171;16;78;145;25;44;120;129;92;57;55;52;167;148;137;176;80;94;124;152;2;75;86;101;1;97;26;100;121;53;158;154;180;63;79;133;135;70;127;112;4;84;35;184;10;177;54;48;160;34;181;42;5;43;65;47;131;149;123;162;151;51;118;59;116;115;46;139;41;193;159;22;18;108;117;0;143;183;89;23;186;15;9;62;144;102;49;14;178;106,7146617138489264657,0.081357
greedy_intra:edges_start:random,171,73773,24389,49384,667402,457,90;81;196;31;113;175;171;16;78;25;44;120;2;75;1;101;86;121;100;26;97;152;124;94;122;63;136;53;158;154;180;79;80;51;151;133;162;135;70;127;123;112;177;54;34;160;184;149;65;59;118;115;116;43;42;181;146;22;159;193;41;139;18;69;108;140;93;117;68;198;46;0;143;183;89;137;176;148;9;62;102;49;144;14;138;3;178;106;52;55;57;129;92;145;179;185;40;119;165;27,4453229780080857466,0.075418
greedy_intra:edges_start:random,172,73529,25714,47815,689489,469,80;176;51;118;59;149;131;35;84;112;127;70;135;123;162;151;133;79;63;94;121;180;154;53;100;26;97;1;101;86;75;2;152;167;178;106;185;179;52;55;57;129;120;44;25;92;145;78;31;16;171;175;113;196;81;40;119;90;27;39;165;14;144;49;102;62;9;148;15;186;23;89;183;143;0;117;93;140;108;18;159;22;146;181;160;34;54;177;10;184;43;65;116;42;41;193;139;115;46;137,3170879301750141639,0.084142
greedy_intra:edges_start:random,173,73514,23993,49521,764159,504,159;193;41;181;42;43;65;116;115;139;46;0;143;183;137;23;186;15;148;37;167;55;52;178;3;49;102;9;62;144;14;138;106;185;40;165;90;81;196;179;145;157;31;56;113;175;171;16;78;25;44;120;82;92;57;129;2;75;101;86;158;53;121;100;26;97;1;152;124;94;80;176;59;118;51;151;162;133;79;63;180;154;135;70;127;149;123;112;4;84;184;177;54;48;160;34;146;22;18;108,5598996177682110285,0.077989
greedy_intra:edges_start:random,174,71585,22432,49153,736746,473,193;159;18;22;146;34;160;48;54;184;177;10;190;4;112;127;70;135;154;180;63;79;80;176;51;118;59;65;116;42;43;131;149;123;162;151;133;53;121;189;94;124;152;1;97;26;100;86;101;75;2;129;120;44;25;16;171;175;113;56;31;78;145;179;92;57;55;52;196;81;90;165;40;185;106;178;3;49;14;144;102;62;9;148;15;186;137;23;89;183;143;117;93;140;68;46;198;115;139;41,4128931535123978741,0.080477
greedy_intra:edges_start:random,175,74628,23852,50776,692834,496,154;135;70;127;112;177;54;34;181;160;184;42;41;193;159;22;18;68;46;139;115;43;116;65;47;131;149;123;162;59;118;51;151;133;79;63;122;80;176;137;183;89;186;15;148;94;124;111;167;57;92;179;55;52;185;40;119;165;106;178;3;49;102;9;62;144;14;138;21;7;164;27;90;81;196;145;78;31;113;175;171;16;25;44;120;82;129;2;152;97;1;101;75;86;26;100;121;53;158;180,7942350611315327634,0.077804
greedy_intra:edges_start:random,176,73886,24929,48957,608019,499,44;120;75;86;101;1;97;26;100;53;180;154;70;127;135;63;152;2;167;148;124;94;79;133;151;162;123;112;84;35;184;177;54;48;160;34;181;42;5;41;193;159;146;22;18;69;108;93;117;0;46;68;139;115;116;43;65;47;131;149;59;51;80;176;137;143;183;89;23;186;114;15;9;62;144;102;49;14;138;3;178;106;165;90;40;185;196;31;113;175;171;16;78;145;179;52;55;57;92;129,8955636783462646198,0.078413
greedy_intra:edges_start:random,177,72728,23933,48795,741250,489,96;5;42;43;131;149;112;4;84;35;123;127;70;135;154;53;121;100;26;86;101;1;97;152;2;75;120;44;25;78;16;171;175;113;56;31;196;145;92;129;57;55;52;178;3;106;185;40;81;90;165;14;49;144;62;9;148;124;94;63;79;180;162;151;133;80;176;137;23;89;183;143;0;117;93;108;69;18;22;146;195;159;181;34;160;48;54;177;10;184;116;65;59;118;51;46;115;139;193;41,6455257299457325731,0.083025
greedy_intra:edges_start:random,178,74244,24904,49340,716857,474,34;181;195;146;22;159;18;69;108;93;117;143;183;0;68;139;46;118;51;151;133;79;63;122;80;176;137;23;186;148;9;62;102;49;14;144;21;164;39;165;119;40;90;81;196;179;145;78;31;56;113;175;171;16;25;44;120;75;86;1;101;2;82;129;92;57;55;52;185;106;178;167;124;94;152;97;26;100;53;180;154;70;135;194;127;123;162;59;115;41;193;42;116;65;149;131;43;184;54;160,8187101903543004305,0.080485
greedy_intra:edges_start:random,179,72968,23578,49390,791268,493,144;14;138;3;178;106;52;55;185;40;119;165;27;90;81;196;31;113;175;171;16;78;145;179;57;92;129;82;25;44;120;75;101;86;121;100;26;97;1;2;152;94;63;53;158;180;154;70;135;194;162;123;127;112;4;84;184;177;54;48;34;22;18;108;159;181;160;42;43;131;149;65;116;59;151;133;79;80;176;51;118;115;41;193;139;198;46;68;117;0;143;183;89;23;137;148;49;102;9;62,7020138703752829472,0.088706
greedy_intra:edges_start:random,180,75375,24636,50739,671043,486,119;106;178;3;138;49;102;148;9;62;144;14;21;164;95;39;165;90;81;196;157;31;85;56;113;175;171;16;78;145;25;44;120;92;129;2;152;1;101;75;86;97;26;100;121;63;136;53;158;154;180;135;70;127;123;162;151;118;59;116;65;43;84;4;112;190;10;177;184;42;181;160;34;22;18;159;193;41;139;115;46;0;117;143;183;137;51;176;80;133;79;122;94;124;167;57;55;52;185;40,4266300344146267501,0.086487
greedy_intra:edges_start:random,181,72470,23479,48991,693938,481,115;139;41;193;159;18;22;146;181;42;160;34;54;184;112;127;123;162;149;131;47;65;43;116;59;118;51;137;176;80;63;79;151;133;135;70;154;180;53;121;94;124;148;167;52;55;57;92;129;82;2;152;1;97;26;100;86;101;75;120;44;25;78;16;171;175;113;56;31;145;179;196;81;90;27;165;119;40;185;106;178;49;14;144;102;62;9;15;114;186;23;89;183;143;0;117;93;140;68;46,5701597956304807100,0.081685
greedy_intra:edges_start:random,182,72876,23020,49856,638937,499,53;158;180;154;135;70;127;123;162;151;133;79;122;63;80;176;51;59;118;46;68;139;115;116;65;149;131;43;184;35;84;112;4;177;54;160;34;103;146;22;159;195;181;42;41;193;18;108;140;93;117;0;143;183;89;23;137;186;15;62;9;37;148;124;94;152;129;57;55;52;106;178;49;144;14;165;90;40;185;179;92;145;78;31;113;175;171;16;44;120;2;75;86;101;1;97;26;100;121;136,8772780473927337846,0.086341
greedy_intra:edges_start:random,183,74962,24050,50912,622640,430,137;183;89;23;186;114;15;144;14;138;185;40;119;165;90;81;196;31;113;175;171;16;25;44;120;82;2;129;92;78;145;179;57;55;52;106;178;49;102;62;9;37;148;167;111;124;152;97;26;100;1;101;75;86;158;154;180;53;121;94;63;122;176;80;79;133;151;162;135;127;123;112;184;149;65;116;43;42;5;139;41;193;181;160;54;34;22;18;108;93;117;143;170;0;68;46;115;59;118;51,4950399712025838500,0.080379
greedy_intra:edges_start:random,184,73940,24702,49238,545592,478,160;181;159;193;41;96;5;42;43;184;54;30;177;10;190;84;4;112;123;127;70;135;154;180;53;121;100;26;86;101;75;2;120;44;16;171;175;113;31;78;145;196;40;90;165;185;106;14;144;102;62;9;15;148;49;178;52;55;57;92;129;152;1;97;124;94;63;122;79;133;80;176;186;89;183;23;137;51;72;151;162;149;65;116;59;118;115;46;0;143;117;93;140;68;139;18;22;146;34;48,8498980787041346065,0.074208
greedy_intra:edges_start:random,185,74900,24408,50492,595638,504,65;47;116;43;42;181;22;18;108;140;93;117;143;183;0;68;139;193;41;115;46;118;51;176;80;137;23;89;186;114;15;148;62;9;144;102;49;14;3;178;106;52;55;185;40;165;90;81;31;56;113;175;171;16;78;145;92;129;44;25;120;2;75;1;101;86;26;100;53;180;136;182;121;189;97;152;124;94;63;122;79;133;151;162;154;135;70;127;123;112;177;54;34;160;48;184;35;131;149;59,8220411971747509478,0.085332
greedy_intra:edges_start:random,186,74481,24902,49579,549974,508,59;151;133;79;180;53;158;154;70;135;194;162;123;127;112;4;10;177;54;34;146;22;159;18;108;193;41;181;160;184;84;35;149;65;47;116;43;5;42;115;139;46;0;117;143;183;89;23;137;148;9;62;102;49;144;14;138;90;165;106;52;178;55;57;129;92;78;145;179;185;119;40;81;196;31;113;175;171;16;44;120;75;86;121;189;100;26;97;1;101;2;152;124;94;63;122;80;176;51;118,4220722271185849341,0.078999
greedy_intra:edges_start:random,187,72406,23405,49001,658110,453,138;165;27;90;81;40;185;106;178;52;55;57;179;196;31;113;175;171;16;78;145;129;92;82;25;44;120;2;75;101;86;100;26;97;1;152;124;94;53;180;154;135;70;127;123;149;131;47;65;116;43;184;10;177;54;160;34;181;5;42;41;193;159;146;22;18;108;69;139;68;117;143;0;46;115;59;118;51;151;162;133;63;122;79;80;176;137;183;89;23;186;15;148;37;9;62;102;49;144;14,1085578255213433391,0.085206
greedy_intra:edges_start:random,188,73934,24706,49228,622913,465,149;131;112;177;54;34;160;184;42;43;77;47;65;116;59;115;5;41;193;159;181;146;22;18;108;139;68;46;0;117;143;183;89;186;23;137;51;118;151;133;79;122;80;176;148;9;62;102;49;144;14;3;178;106;185;40;119;165;27;90;81;196;31;113;175;171;16;78;145;179;57;55;52;124;94;63;121;100;26;97;101;1;152;2;129;92;82;25;44;120;75;86;53;180;154;135;70;127;123;162,8379105706669292713,0.073803
greedy_intra:edges_start:random,189,72121,23774,48347,695928,464,184;177;54;160;34;146;22;159;193;41;115;139;18;108;140;93;117;143;170;0;68;46;118;59;51;151;162;133;79;122;80;176;137;23;183;89;186;15;124;94;148;9;62;102;144;14;49;178;106;52;55;57;185;40;119;165;90;81;196;157;31;113;175;171;16;44;25;78;145;92;129;120;75;86;101;1;2;152;97;26;100;53;63;180;154;135;70;127;123;112;4;84;35;131;149;65;116;43;42;181,3579949133061914334,0.080490
greedy_intra:edges_start:random,190,73194,24294,48900,652524,513,42;41;193;139;68;46;115;118;51;59;131;149;47;65;116;43;160;34;54;177;184;84;4;112;127;70;158;53;180;154;135;194;123;162;151;133;79;80;122;63;94;124;121;100;26;97;152;1;101;86;75;2;120;44;25;175;171;16;113;56;31;78;145;179;92;129;57;55;52;178;106;185;40;196;81;90;165;14;144;49;102;62;9;148;176;137;23;186;89;183;143;0;117;108;18;69;159;22;146;181,3906843672272519567,0.083093
greedy_intra:edges_start:random,191,72941,23581,49360,690671,478,127;123;162;151;72;51;176;80;133;79;122;63;94;124;189;152;2;129;92;57;55;52;106;178;3;49;102;148;137;118;59;116;65;149;131;112;84;184;177;54;48;34;160;43;42;181;22;159;193;41;139;115;198;46;68;69;18;108;140;93;117;0;143;183;89;186;9;62;144;14;165;185;40;90;81;196;179;145;78;31;113;175;171;16;25;44;120;75;86;101;1;97;26;100;53;158;180;154;135;70,8421672589055181555,0.089030
greedy_intra:edges_start:random,192,72385,23168,49217,732107,483,151;51;176;80;133;79;122;63;94;124;167;148;9;62;102;49;144;14;3;178;106;52;55;57;129;92;145;179;185;40;119;165;27;90;81;196;157;56;113;175;171;16;31;78;25;44;120;82;2;152;1;97;101;75;86;26;100;121;53;158;180;154;135;70;127;123;112;177;54;160;184;43;42;181;34;146;22;159;193;41;139;18;108;140;93;117;143;183;89;137;0;46;115;118;59;116;65;131;149;162,3902810418353839591,0.079482
greedy_intra:edges_start:random,193,73307,24202,49105,602313,435,35;184;177;54;48;34;160;43;5;42;181;22;159;193;41;139;18;108;140;93;117;143;0;68;46;115;118;59;116;65;131;149;162;151;80;176;137;183;89;186;15;148;9;62;144;14;102;49;178;106;185;40;196;81;90;165;52;55;57;92;179;145;78;31;113;175;171;16;25;44;120;75;2;129;167;124;94;189;19;152;97;26;1;101;86;100;121;53;154;180;63;79;133;135;70;127;123;112;4;84,387870552757199783,0.074954
greedy_intra:edges_start:random,194,72773,23876,48897,671897,475,79;122;94;124;148;15;186;23;137;176;80;51;118;59;151;133;162;123;149;131;35;112;4;84;184;160;48;54;177;10;30;34;22;18;108;140;93;68;139;41;193;159;181;42;5;43;65;116;115;46;0;117;143;183;89;114;9;62;144;14;49;178;106;165;90;40;185;55;52;57;92;179;145;78;31;56;113;175;171;16;25;44;120;129;2;75;86;101;1;152;97;26;100;121;53;154;70;135;180;63,7045575026175987045,0.078381
greedy_intra:edges_start:random,195,74285,23033,51252,583123,472,135;70;127;162;151;133;79;63;122;80;176;51;59;65;116;42;43;149;123;112;84;184;54;160;34;22;18;159;193;41;5;115;139;68;46;0;117;143;183;89;23;137;186;114;15;9;62;144;14;102;49;178;106;185;40;119;165;90;81;196;179;157;31;85;56;113;175;171;16;44;25;78;145;92;57;55;52;167;37;148;124;94;152;2;129;82;120;75;86;101;1;97;26;100;121;136;53;158;180;154,1705564388021391561,0.087999
greedy_intra:edges_start:random,196,72529,23356,49173,814035,517,52;55;57;179;92;129;120;44;25;16;171;175;113;31;78;145;196;81;90;40;185;165;138;14;144;49;102;62;9;15;148;124;94;63;79;133;151;59;118;51;80;176;137;23;89;183;143;117;93;140;68;46;115;139;41;193;159;69;108;18;22;146;34;54;160;42;43;116;65;47;149;131;184;177;10;4;112;123;127;162;194;135;70;154;180;158;53;100;26;86;75;101;97;1;2;152;167;3;178;106,4325710519675581862,0.088000
greedy_intra:edges_start:random,197,74276,25160,49116,663127,470,135;70;154;180;53;63;94;124;152;121;100;26;97;1;101;86;75;2;120;44;25;82;129;92;78;16;171;175;113;31;145;179;57;55;52;178;106;185;40;196;81;90;165;138;3;49;102;14;144;62;9;148;15;186;80;176;137;23;89;183;143;117;0;46;115;139;68;93;140;108;69;18;22;159;193;41;181;146;34;54;184;160;42;43;47;65;116;118;59;149;131;112;127;123;162;72;51;151;133;79,3416310353584164542,0.079999
greedy_intra:edges_start:random,198,72958,23946,49012,683569,514,144;49;102;62;9;148;186;23;89;183;137;176;80;51;151;133;162;123;149;131;65;116;59;115;46;0;143;117;93;68;139;193;41;43;42;181;195;159;18;22;146;34;160;184;48;54;177;4;112;127;70;135;154;180;158;53;86;101;1;97;26;100;121;63;79;94;124;152;2;75;120;44;25;82;129;92;145;78;16;171;175;113;56;31;81;90;27;39;165;40;185;196;179;57;55;52;106;178;3;14,5524026103712226624,0.084000
greedy_intra:edges_start:random,199,72967,23614,49353,825713,550,177;54;48;184;160;34;146;22;18;108;117;0;143;183;89;186;23;137;176;80;94;124;167;148;15;9;62;102;49;144;14;178;106;52;55;57;185;40;165;90;31;113;175;171;16;44;120;25;78;145;179;92;129;2;75;86;101;1;152;97;26;100;121;53;158;154;70;135;180;136;63;79;133;151;162;127;123;72;51;59;118;46;115;139;41;193;159;181;42;43;116;65;47;149;131;35;112;4;190;10,48071868155339934,0.098000
greedy_intra:edges_start:greedy,0,70829,22624,48205,61206,5,0;117;143;183;89;186;23;137;176;80;79;63;94;124;152;97;1;101;2;120;44;25;16;171;175;113;56;31;78;145;179;196;81;90;40;165;185;106;178;3;14;144;62;9;148;102;49;52;55;57;92;129;82;75;86;26;100;121;53;180;154;135;70;127;123;162;133;151;51;118;59;65;116;43;184;84;112;4;190;10;177;54;48;160;34;146;22;18;108;69;159;181;42;5;41;193;115;139;68;46,3394199176441996557,0.003001
greedy_intra:edges_start:greedy,1,71633,23444,48189,27249,4,1;101;75;86;53;154;70;135;180;63;79;133;162;127;123;149;65;116;43;184;10;177;54;48;160;34;146;22;18;108;69;159;181;42;5;41;193;139;68;140;93;117;143;0;46;115;59;118;51;151;80;176;137;23;183;89;186;114;15;9;62;144;14;138;165;185;40;90;81;196;179;145;78;31;56;113;175;171;16;25;44;120;2;129;92;57;55;52;106;178;49;102;148;124;94;121;100;26;97;152,3124220919142526969,0.001998
greedy_intra:edges_start:greedy,2,71258,23118,48140,105229,11,2;129;92;57;55;52;49;102;148;9;62;144;14;3;178;106;185;40;165;90;81;196;179;145;78;31;56;113;175;171;16;25;44;120;75;86;26;100;53;180;154;135;70;127;123;162;149;131;65;116;43;184;84;190;10;177;54;48;160;34;146;22;18;108;69;159;181;42;5;41;193;139;68;140;93;117;143;183;89;186;23;137;0;46;115;59;118;51;151;133;176;80;79;63;94;124;152;97;1;101,862890986651651178,0.005027
greedy_intra:edges_start:greedy,3,71016,22954,48062,59020,5,138;14;144;62;9;148;102;49;178;106;52;55;57;92;129;2;152;124;94;63;79;80;176;133;151;51;118;59;115;46;0;137;23;186;89;183;143;117;93;140;68;139;193;41;5;42;181;159;69;108;18;22;146;34;160;48;54;177;10;190;84;184;43;116;65;131;149;162;123;127;70;135;154;180;53;100;26;97;1;101;86;75;120;44;25;16;171;175;113;56;31;78;145;179;196;81;90;165;40;185,2588094630113781928,0.002028
greedy_intra:edges_start:greedy,4,71494,23317,48177,108226,9,4;190;10;177;54;48;34;160;42;181;146;22;18;108;69;159;41;193;139;68;46;115;118;59;65;116;43;184;35;131;149;123;162;133;151;51;0;117;143;183;89;23;137;176;80;79;63;94;124;152;97;1;101;2;129;92;57;55;52;49;102;148;9;62;144;14;3;178;106;185;40;165;90;81;196;179;145;78;31;56;113;175;171;16;25;44;82;120;75;86;26;100;121;53;180;154;135;70;127;112,5484897677786134102,0.004774
greedy_intra:edges_start:greedy,5,71647,23524,48123,21315,3,5;43;116;65;149;123;127;162;151;133;135;70;154;180;53;121;100;26;86;75;44;25;16;171;175;113;56;31;78;145;179;196;81;90;40;165;185;106;178;3;14;144;62;9;148;102;49;52;55;92;57;129;82;120;2;101;1;97;152;124;94;63;79;80;176;137;23;186;89;183;143;117;0;51;118;59;115;46;68;139;41;193;159;69;108;18;22;146;181;34;160;48;54;177;10;4;112;84;184;42,8414691634542324106,0.001092
greedy_intra:edges_start:greedy,6,71413,22843,48570,69357,7,158;53;121;100;26;86;75;101;1;97;152;94;124;148;102;49;178;106;52;55;57;92;129;2;120;44;25;16;171;175;113;56;31;78;145;179;196;81;90;165;40;185;138;14;144;62;9;15;114;186;89;183;23;137;176;80;51;118;59;115;46;0;143;117;93;140;68;139;193;41;5;42;181;159;69;108;18;22;146;34;160;48;54;177;184;43;116;65;149;123;127;162;151;133;79;63;180;135;70;154,5756415681480505626,0.002000
greedy_intra:edges_start:greedy,7,72169,24204,47965,69218,7,7;21;144;62;9;148;102;14;49;178;106;52;55;185;165;40;179;145;78;92;57;129;2;101;1;97;152;124;94;63;79;80;176;133;151;51;118;59;115;46;0;137;23;89;183;143;117;93;140;68;139;193;41;5;42;181;159;69;108;18;22;146;34;160;48;54;177;184;43;116;65;149;162;123;127;70;135;154;180;53;100;26;86;75;120;44;25;16;171;175;113;56;31;157;196;81;90;27;95;164,2867664640021896700,0.001968
greedy_intra:edges_start:greedy,8,71161,23056,48105,61126,8,27;165;40;185;138;14;144;62;9;148;102;49;178;106;52;55;57;92;129;2;101;1;97;152;124;94;63;79;80;176;133;151;51;118;59;115;46;0;137;23;186;89;183;143;117;93;140;68;139;193;41;5;42;181;159;69;108;18;22;146;34;160;48;54;177;10;190;184;43;116;65;131;149;162;123;127;70;135;154;180;53;100;26;86;75;120;44;25;16;171;175;113;56;31;78;145;179;196;81;90,541016838060727776,0.002801
greedy_intra:edges_start:greedy,9,71269,23207,48062,43080,3,9;148;102;49;178;106;52;55;57;92;129;2;152;97;1;101;100;26;124;94;63;79;80;176;133;151;51;118;59;115;46;0;137;23;186;89;183;143;117;93;140;68;139;193;41;5;42;181;159;69;108;18;22;146;34;160;48;54;177;10;190;84;184;43;116;65;131;149;162;123;127;70;135;154;180;53;86;75;120;44;25;16;171;175;113;56;31;78;145;179;196;81;90;165;40;185;138;14;144;62,1623044269065098818,0.001999
greedy_intra:edges_start:greedy,10,71379,23202,48177,82846,9,10;190;4;112;127;70;135;154;180;53;121;100;26;86;75;120;44;25;16;171;175;113;56;31;78;145;179;196;81;90;165;40;185;106;178;3;14;144;62;9;148;102;49;52;55;57;92;129;82;2;101;1;97;152;124;94;63;79;80;176;137;23;89;183;143;117;0;51;133;151;162;123;149;131;35;184;43;116;65;59;118;115;46;68;139;41;193;159;69;108;18;22;146;34;181;42;160;48;54;177,6999333971530189532,0.006001
greedy_intra:edges_start:greedy,11,71104,22899,48205,137750,14,190;10;177;54;48;160;34;181;146;22;18;108;69;159;193;41;5;42;43;116;65;59;51;118;46;68;139;115;0;117;143;183;89;186;23;137;176;80;79;63;94;124;152;97;1;101;2;82;129;92;57;55;52;49;102;148;9;62;144;14;3;178;106;185;40;165;90;81;196;179;145;78;31;56;113;175;171;16;25;44;120;75;86;26;100;121;53;180;154;70;135;133;151;162;123;127;112;4;84;184,6641274591014395137,0.005999
greedy_intra:edges_start:greedy,12,72375,23408,48967,63631,5,124;94;152;97;1;101;2;120;44;25;16;171;175;113;56;31;78;145;179;57;92;129;82;75;86;26;100;121;53;158;154;70;135;180;63;79;133;80;151;162;123;149;65;116;43;184;177;54;48;160;34;146;22;18;108;69;159;181;42;5;41;193;139;68;140;93;117;143;0;46;115;59;118;51;176;137;23;183;89;186;114;15;9;62;144;14;138;165;90;81;196;40;185;55;52;106;178;49;102;148,8046461682193150056,0.002002
greedy_intra:edges_start:greedy,13,71578,23263,48315,78073,10,157;31;56;113;175;171;16;25;44;120;75;86;101;1;97;26;100;53;180;154;135;70;127;123;162;149;131;65;116;43;184;190;10;177;54;48;160;34;146;22;18;108;69;159;181;42;5;41;193;139;68;140;93;117;143;183;89;186;23;137;0;46;115;59;118;51;151;133;176;80;79;63;94;124;152;2;129;57;55;52;49;102;148;9;62;144;14;3;178;106;185;40;165;90;81;196;179;92;145;78,315673075196131014,0.004001
greedy_intra:edges_start:greedy,14,71246,23052,48194,49807,6,14;144;62;9;148;102;49;178;106;52;55;57;92;129;2;152;97;1;101;26;100;121;94;63;79;80;176;133;151;51;118;59;115;46;0;137;23;186;89;183;143;117;93;140;68;139;193;41;5;42;181;159;69;108;18;22;146;34;160;48;54;177;10;190;84;184;43;116;65;131;149;162;123;127;70;135;154;180;53;86;75;120;44;25;16;171;175;113;56;31;78;145;179;196;81;90;165;40;185;138,3868346684008945337,0.003017
greedy_intra:edges_start:greedy,15,71424,23402,48022,45953,4,15;144;14;138;165;185;40;90;81;196;179;145;78;31;56;113;175;171;16;25;44;120;75;86;26;100;53;180;154;135;70;127;123;162;149;131;65;116;43;184;190;10;177;54;48;160;34;146;22;18;108;69;159;181;42;5;41;193;139;68;140;93;117;143;183;89;186;23;137;0;46;115;59;118;51;151;133;176;80;79;63;94;124;101;1;97;152;2;129;92;57;55;52;106;178;49;102;62;9;148,3099393275223490766,0.001999
greedy_intra:edges_start:greedy,16,71349,23209,48140,80944,8,16;25;44;120;75;86;101;1;97;26;100;53;180;154;135;70;127;123;162;149;131;65;116;43;184;84;190;10;177;54;48;160;34;146;22;18;108;69;159;181;42;5;41;193;139;68;140;93;117;143;183;89;186;23;137;0;46;115;59;118;51;151;133;176;80;79;63;94;124;152;2;129;57;55;52;49;102;148;9;62;144;14;3;178;106;185;40;165;90;81;196;179;92;145;78;31;56;113;175;171,5788292037025022228,0.004000
greedy_intra:edges_start:greedy,17,72427,23597,48830,112084,13,119;40;185;106;178;3;14;144;62;9;148;102;49;52;55;57;129;92;179;145;78;82;2;152;94;63;79;80;176;133;151;51;118;59;115;46;0;137;23;89;183;143;117;93;140;68;139;193;41;42;181;159;108;18;22;146;34;160;48;54;177;184;43;116;65;149;162;123;127;70;135;154;180;53;26;97;1;101;86;75;120;44;25;16;171;175;113;56;31;157;196;81;90;27;58;164;7;95;39;165,3059444854120153284,0.006000
greedy_intra:edges_start:greedy,18,71475,23225,48250,43566,5,18;22;146;159;193;41;5;42;181;34;160;48;54;177;10;190;4;112;184;43;116;65;149;123;127;162;151;133;135;70;154;180;53;121;100;26;86;75;44;25;16;171;175;113;56;31;78;145;179;196;81;90;165;40;185;106;178;3;14;144;62;9;148;102;49;52;55;57;92;129;82;120;2;101;1;97;152;124;94;63;79;80;176;137;51;118;59;115;139;68;46;0;89;183;143;117;93;140;108;69,7939504056198399118,0.002000
greedy_intra:edges_start:greedy,19,71740,22680,49060,48564,4,189;94;124;148;102;49;178;106;52;55;57;92;129;2;120;44;25;16;171;175;113;56;31;78;145;179;196;81;90;165;40;185;138;14;144;62;9;15;114;186;89;183;23;137;176;80;151;51;118;59;115;46;0;143;117;93;140;68;139;193;41;5;42;181;159;69;108;18;22;146;34;160;48;54;177;184;43;116;65;149;123;162;133;79;63;180;135;70;154;158;53;121;100;26;86;75;101;1;97;152,5695621215493804437,0.001971
greedy_intra:edges_start:greedy,20,71904,22926,48978,52479,5,199;22;146;159;193;41;5;42;181;34;160;48;54;177;10;190;84;184;43;116;65;149;123;127;162;151;133;135;70;154;180;53;121;100;26;86;75;44;25;16;171;175;113;56;31;78;145;179;196;81;90;165;40;185;106;178;3;14;144;62;9;148;102;49;52;55;57;92;129;82;120;2;101;1;97;152;124;94;63;79;80;176;137;51;118;59;115;139;68;46;0;89;183;143;117;93;140;108;69;18,3532193830807977817,0.002006
greedy_intra:edges_start:greedy,21,71481,23576,47905,50985,4,21;14;138;185;40;165;90;81;196;179;145;78;31;56;113;175;171;16;25;44;120;75;86;101;1;97;26;100;53;180;154;135;70;127;123;162;149;131;65;116;43;184;190;10;177;54;48;160;34;146;22;18;108;69;159;181;42;5;41;193;139;68;140;93;117;143;183;89;186;23;137;0;46;115;59;118;51;151;133;176;80;79;63;94;124;152;2;129;92;57;55;52;106;178;49;102;148;9;62;144,8517342594838663643,0.001000
greedy_intra:edges_start:greedy,22,71157,23184,47973,49739,4,22;146;181;34;160;48;54;177;10;190;4;112;84;184;42;43;116;65;149;123;127;162;151;133;135;70;154;180;53;121;100;26;86;75;82;120;44;25;16;171;175;113;56;31;78;145;179;196;81;90;40;165;185;106;178;3;14;144;62;9;148;102;49;52;55;57;92;129;2;101;1;97;152;124;94;63;79;80;176;137;23;186;89;183;143;117;0;51;118;59;115;46;68;139;41;193;159;69;108;18,6159078285360248849,0.002000
greedy_intra:edges_start:greedy,23,70663,22458,48205,89608,8,23;137;176;80;79;63;94;124;152;97;1;101;2;129;92;57;55;52;49;102;148;9;62;144;14;3;178;106;185;40;165;90;81;196;179;145;78;31;56;113;175;171;16;25;44;82;120;75;86;26;100;121;53;180;154;135;70;127;123;162;133;151;51;118;59;65;116;43;184;84;112;4;190;10;177;54;48;160;34;146;22;18;108;69;159;181;42;5;41;193;115;139;68;46;0;117;143;183;89;186,3422550638099248338,0.004000
greedy_intra:edges_start:greedy,24,71862,23300,48562,58639,7,131;149;123;127;162;151;133;135;70;154;180;53;121;100;26;86;75;120;44;25;16;171;175;113;56;31;78;145;179;196;81;90;40;165;185;106;178;3;14;144;62;9;148;102;49;52;55;92;57;129;82;2;101;1;97;152;124;94;63;79;80;176;137;23;186;89;183;143;117;0;51;118;59;115;46;68;139;193;41;5;42;181;159;69;108;18;22;146;34;160;48;54;177;10;190;84;184;43;116;65,1696080122013830115,0.003010
greedy_intra:edges_start:greedy,25,71152,23012,48140,72656,8,25;44;120;75;86;101;1;97;26;100;53;180;154;135;70;127;123;162;149;131;65;116;43;184;84;190;10;177;54;48;160;34;146;22;18;108;69;159;181;42;5;41;193;139;68;140;93;117;143;183;89;186;23;137;0;46;115;59;118;51;151;133;176;80;79;63;94;124;152;2;129;92;57;55;52;49;102;148;9;62;144;14;3;178;106;185;40;165;90;81;196;179;145;78;31;56;113;175;171;16,362850525797079365,0.003337
greedy_intra:edges_start:greedy,26,71236,23210,48026,45989,3,26;97;152;94;124;148;102;49;178;106;52;55;57;92;129;2;120;44;25;16;171;175;113;56;31;78;145;179;196;81;90;165;40;185;138;14;144;62;9;15;114;186;89;183;23;137;176;80;51;118;59;115;46;0;143;117;93;140;68;139;193;41;5;42;181;159;69;108;18;22;146;34;160;48;54;177;10;190;184;43;116;65;149;123;127;162;151;133;79;63;180;135;70;154;53;86;75;101;1;100,6799553756276067025,0.002620
greedy_intra:edges_start:greedy,27,72070,23542,48528,35258,3,27;58;164;7;95;39;165;138;14;144;62;9;148;102;49;178;106;52;55;57;92;129;2;152;97;1;101;26;100;94;63;79;80;176;133;151;51;118;59;115;46;0;137;23;89;183;143;117;93;140;68;139;193;41;5;42;181;159;69;108;18;22;146;34;160;48;54;177;184;43;116;65;149;162;123;127;70;135;154;180;53;86;75;120;44;25;16;171;175;113;56;31;78;145;179;196;81;185;40;90,1025270893852494083,0.002001
greedy_intra:edges_start:greedy,28,71757,23150,48607,73794,7,35;43;116;65;131;149;123;127;162;151;133;135;70;154;180;53;121;100;26;86;75;44;25;16;171;175;113;56;31;78;145;179;196;81;90;165;40;185;106;178;3;14;144;62;9;148;102;49;52;55;57;92;129;82;120;2;101;1;97;152;124;94;63;79;80;176;137;23;186;89;183;143;117;0;51;118;59;115;46;68;139;193;41;5;42;181;159;69;108;18;22;146;34;160;48;54;177;10;190;184,2616073674818088941,0.002972
greedy_intra:edges_start:greedy,29,71450,22843,48607,115227,11,149;123;162;151;133;135;70;154;180;53;121;100;26;86;75;120;44;25;16;171;175;113;56;31;78;145;179;196;81;90;165;40;185;106;178;3;14;144;62;9;148;102;49;52;55;57;92;129;82;2;101;1;97;152;124;94;63;79;80;176;137;23;186;89;183;143;117;0;51;59;118;46;68;139;115;116;65;43;42;5;41;193;159;69;108;18;22;146;181;34;160;48;54;177;184;35;84;4;112;131,1572044011831475582,0.005233
greedy_intra:edges_start:greedy,30,71604,23040,48564,129675,12,48;54;177;10;190;84;184;43;116;65;59;118;115;46;0;51;151;133;162;123;127;70;135;154;180;53;121;100;26;86;75;120;82;44;25;16;171;175;113;56;31;78;145;179;196;81;90;165;40;185;106;178;3;14;144;62;9;148;102;49;52;55;57;92;129;2;101;1;97;152;124;94;63;79;80;176;137;23;186;89;183;143;117;93;140;68;139;41;193;159;69;108;18;22;146;195;181;42;160;34,544391907893545702,0.004999
greedy_intra:edges_start:greedy,31,71718,23578,48140,40106,4,31;145;78;92;179;196;81;90;165;40;185;106;178;3;14;144;62;9;148;102;49;52;55;57;129;2;152;97;1;101;100;26;124;94;63;79;80;176;133;151;51;118;59;115;46;0;137;23;186;89;183;143;117;93;140;68;139;193;41;5;42;181;159;69;108;18;22;146;34;160;48;54;177;10;190;84;184;43;116;65;131;149;162;123;127;70;135;154;180;53;86;75;120;44;25;16;171;175;113;56,1515257250340886260,0.002007
greedy_intra:edges_start:greedy,32,71301,23107,48194,69632,9,138;14;144;62;9;148;102;49;178;106;52;55;57;92;129;2;152;97;1;101;26;100;121;94;63;79;80;176;133;151;51;118;59;115;46;0;137;23;186;89;183;143;117;93;140;68;139;193;41;5;42;181;159;69;108;18;22;146;34;160;48;54;177;10;190;84;184;43;116;65;131;149;162;123;127;70;135;154;180;53;86;75;120;44;25;16;171;175;113;56;31;78;145;179;196;81;90;40;185;165,2675739092416687526,0.005001
greedy_intra:edges_start:greedy,33,71345,22945,48400,49655,7,37;102;49;178;106;52;55;57;92;129;2;152;124;94;63;79;80;176;133;151;51;118;59;115;46;0;137;23;186;89;183;143;117;93;140;68;139;193;41;5;42;181;159;69;108;18;22;146;34;160;48;54;177;10;190;184;43;116;65;131;149;162;123;127;70;135;154;180;53;100;86;26;97;1;101;75;120;44;25;16;171;175;113;56;31;78;145;179;196;81;90;40;185;165;138;14;144;62;9;148,265225833298960622,0.003997
greedy_intra:edges_start:greedy,34,71169,23196,47973,18554,2,34;181;146;22;18;108;69;159;193;41;139;68;46;115;59;118;51;0;117;143;183;89;186;23;137;176;80;79;63;94;124;152;97;1;101;2;120;82;129;92;57;55;52;49;102;148;9;62;144;14;3;178;106;185;165;40;90;81;196;179;145;78;31;56;113;175;171;16;25;44;75;86;26;100;121;53;180;154;70;135;133;151;162;127;123;149;65;116;43;42;184;84;112;4;190;10;177;54;48;160,6883654519013315312,0.001000
greedy_intra:edges_start:greedy,35,70846,22596,48250,98145,9,35;84;4;112;127;123;162;151;133;135;70;154;180;53;121;100;26;86;75;120;44;25;16;171;175;113;56;31;78;145;179;196;81;90;165;40;185;106;178;3;14;144;62;9;148;102;49;52;55;57;92;129;82;2;101;1;97;152;124;94;63;79;80;176;137;23;186;89;183;143;117;0;46;68;139;115;118;51;59;65;116;43;42;5;41;193;159;69;108;18;22;146;181;34;160;48;54;177;10;184,302098911433393228,0.003999
greedy_intra:edges_start:greedy,36,72044,22876,49168,80550,7,36;108;69;18;22;146;159;193;41;5;42;181;34;160;48;54;177;10;190;84;184;43;116;65;149;123;127;162;151;133;135;70;154;180;53;121;100;26;86;75;120;82;44;25;16;171;175;113;56;31;78;145;179;196;81;90;165;40;185;106;178;3;14;144;62;9;148;102;49;52;55;57;92;129;2;101;1;97;152;124;94;63;79;80;176;137;51;118;59;115;139;68;46;0;89;183;143;117;93;140,3569586853054717154,0.004000
greedy_intra:edges_start:greedy,37,71470,23070,48400,40027,3,37;102;49;178;106;52;55;57;92;129;2;152;97;1;101;26;124;94;63;79;80;176;133;151;51;118;59;115;46;0;137;23;186;89;183;143;117;93;140;68;139;193;41;5;42;181;159;69;108;18;22;146;34;160;48;54;177;10;190;184;43;116;65;131;149;162;123;127;70;135;154;180;53;100;86;75;120;44;25;16;171;175;113;56;31;78;145;179;196;81;90;165;40;185;138;14;144;62;9;148,2421880654522005172,0.002000
greedy_intra:edges_start:greedy,38,71808,23361,48447,67427,9,157;78;145;92;179;196;81;90;165;40;185;106;178;3;14;144;62;9;148;102;49;52;55;57;129;2;152;97;1;101;26;100;121;94;63;79;80;176;133;151;51;118;59;115;46;0;137;23;186;89;183;143;117;93;140;68;139;193;41;5;42;181;159;69;108;18;22;146;34;160;48;54;177;10;190;184;43;116;65;131;149;162;123;127;70;135;154;180;53;86;75;120;44;25;16;171;175;113;56;31,3519612606964956842,0.003001
greedy_intra:edges_start:greedy,39,72006,23800,48206,32859,3,39;95;7;164;27;90;40;185;81;196;179;145;78;31;56;113;175;171;16;25;44;120;75;86;100;53;180;154;135;70;127;123;162;149;65;116;43;184;177;54;48;160;34;146;22;18;108;69;159;181;42;5;41;193;139;68;140;93;117;143;183;89;23;137;0;46;115;59;118;51;151;133;176;80;79;63;94;124;26;101;1;97;152;2;129;92;57;55;52;106;178;49;102;148;9;62;144;14;138;165,3313671881775489562,0.001000
greedy_intra:edges_start:greedy,40,71369,23307,48062,37244,3,40;90;81;196;179;145;78;31;56;113;175;171;16;25;44;120;75;86;100;53;180;154;135;70;127;123;162;149;131;65;116;43;184;84;190;10;177;54;48;160;34;146;22;18;108;69;159;181;42;5;41;193;139;68;140;93;117;143;183;89;186;23;137;0;46;115;59;118;51;151;133;176;80;79;63;94;124;26;101;1;97;152;2;129;92;57;55;52;106;178;49;102;148;9;62;144;14;138;165;185,1228848937160242276,0.001000
greedy_intra:edges_start:greedy,41,71369,23246,48123,64439,6,41;5;42;181;159;69;108;18;22;146;34;160;48;54;177;10;190;4;112;184;43;116;65;149;123;127;162;151;133;135;70;154;180;53;121;100;26;86;75;120;44;25;16;171;175;113;56;31;78;145;179;196;81;90;165;40;185;106;178;3;14;144;62;9;148;102;49;52;55;57;92;129;82;2;101;1;97;152;124;94;63;79;80;176;137;23;186;89;183;143;117;0;51;118;59;115;46;68;139;193,5680346977100374497,0.003000
greedy_intra:edges_start:greedy,42,71717,23594,48123,39198,4,42;5;41;193;139;68;46;115;59;118;51;0;117;143;183;89;186;23;137;176;80;79;63;94;124;152;97;1;101;2;82;129;57;92;55;52;49;102;148;9;62;144;14;3;178;106;185;165;40;90;81;196;179;145;78;31;56;113;175;171;16;25;44;120;75;86;26;100;121;53;180;154;70;135;133;151;162;127;123;149;65;116;43;184;112;4;190;10;177;54;48;160;34;146;22;18;108;69;159;181,1510809337936546104,0.002002
greedy_intra:edges_start:greedy,43,71867,23367,48500,30847,2,43;65;116;59;118;115;46;0;51;151;133;162;123;127;70;135;154;180;53;121;100;26;86;75;44;25;16;171;175;113;56;31;78;145;179;196;81;90;40;165;185;106;178;3;14;144;62;9;148;102;49;52;55;57;92;129;82;120;2;101;1;97;152;124;94;63;79;80;176;137;23;186;89;183;143;117;93;140;68;139;193;41;5;42;181;159;69;108;18;22;146;34;160;48;54;177;10;190;84;184,3313998261183611772,0.001000
greedy_intra:edges_start:greedy,44,71405,23265,48140,59721,6,44;25;16;171;175;113;56;31;78;145;179;196;81;90;165;40;185;106;178;3;14;144;62;9;148;102;49;52;55;57;92;129;2;152;97;1;101;100;26;124;94;63;79;80;176;133;151;51;118;59;115;46;0;137;23;186;89;183;143;117;93;140;68;139;193;41;5;42;181;159;69;108;18;22;146;34;160;48;54;177;10;190;84;184;43;116;65;131;149;162;123;127;70;135;154;180;53;86;75;120,771208284460022785,0.003003
greedy_intra:edges_start:greedy,45,71865,23714,48151,102449,13,112;127;162;151;133;135;70;154;180;53;121;100;26;86;75;120;82;44;25;16;171;175;113;56;31;78;145;179;196;81;90;165;40;185;106;178;3;14;144;62;9;148;102;49;52;55;57;92;129;2;101;1;97;152;124;94;63;79;80;176;137;23;186;89;183;143;117;0;51;118;59;115;46;68;139;193;41;5;42;181;159;69;108;18;22;146;34;160;48;54;177;10;190;84;184;43;116;65;149;123,3957639053973681093,0.005000
greedy_intra:edges_start:greedy,46,71480,23357,48123,49034,5,46;115;59;118;51;0;117;143;183;89;186;23;137;176;80;79;63;94;124;152;97;1;101;2;120;44;25;16;171;175;113;56;31;78;145;179;196;81;90;165;40;185;106;178;3;14;144;62;9;148;102;49;52;55;57;92;129;82;75;86;26;100;121;53;180;154;70;135;133;151;162;127;123;149;65;116;43;184;112;4;190;10;177;54;48;160;34;146;22;18;108;69;159;181;42;5;41;193;139;68,8881412784720215369,0.001999
greedy_intra:edges_start:greedy,47,71665,23103,48562,89809,8,131;149;123;127;162;151;133;135;70;154;180;53;121;100;26;86;75;120;82;44;25;16;171;175;113;56;31;78;145;179;196;81;90;165;40;185;106;178;3;14;144;62;9;148;102;49;52;55;57;92;129;2;101;1;97;152;124;94;63;79;80;176;137;23;186;89;183;143;117;0;51;59;118;115;46;68;139;193;41;5;42;181;159;69;108;18;22;146;34;160;48;54;177;10;190;84;184;43;116;65,47916670622307540,0.003573
greedy_intra:edges_start:greedy,48,71751,23187,48564,99607,10,48;34;160;42;181;195;146;22;18;108;69;159;193;41;139;68;140;93;117;143;183;89;186;23;137;176;80;79;63;94;124;152;97;1;101;2;129;92;57;55;52;49;102;148;9;62;144;14;3;178;106;185;165;40;90;81;196;179;145;78;31;56;113;175;171;16;25;44;82;120;75;86;26;100;121;53;180;154;135;70;127;123;162;133;151;51;0;46;115;118;59;65;116;43;184;84;190;10;177;54,225650006584691783,0.004000
greedy_intra:edges_start:greedy,49,71324,23262,48062,39636,4,49;178;106;52;55;57;92;129;2;152;97;1;101;100;26;124;94;63;79;80;176;133;151;51;118;59;115;46;0;137;23;186;89;183;143;117;93;140;68;139;193;41;5;42;181;159;69;108;18;22;146;34;160;48;54;177;10;190;84;184;43;116;65;131;149;162;123;127;70;135;154;180;53;86;75;120;44;25;16;171;175;113;56;31;78;145;179;196;81;90;40;185;165;138;14;144;62;9;148;102,7170983758122539907,0.002031
greedy_intra:edges_start:greedy,50,72023,23708,48315,93807,11,157;78;145;92;179;196;81;90;40;165;185;106;178;3;14;144;62;9;148;102;49;52;55;57;129;2;152;97;1;101;26;124;94;63;79;80;176;133;151;51;118;59;115;46;0;137;23;186;89;183;143;117;93;140;68;139;193;41;5;42;181;159;69;108;18;22;146;34;160;48;54;177;10;190;184;43;116;65;131;149;162;123;127;70;135;154;180;53;100;86;75;120;44;25;16;171;175;113;56;31,7252324150214812772,0.005069
greedy_intra:edges_start:greedy,51,71627,23504,48123,42398,4,51;118;59;115;46;68;139;193;41;5;42;181;159;69;108;18;22;146;34;160;48;54;177;10;190;4;112;184;43;116;65;149;123;127;162;151;133;135;70;154;180;53;121;100;26;86;75;82;129;92;57;55;52;49;102;148;9;62;144;14;3;178;106;185;165;40;90;81;196;179;145;78;31;56;113;175;171;16;25;44;120;2;101;1;97;152;124;94;63;79;80;176;137;23;186;89;183;143;117;0,3951338350359681592,0.002000
greedy_intra:edges_start:greedy,52,71098,23036,48062,82464,7,52;106;178;49;102;148;9;62;144;14;138;185;40;165;90;81;196;179;145;78;31;56;113;175;171;16;25;44;120;75;101;1;97;100;26;86;53;180;154;135;70;127;123;162;149;131;65;116;43;184;84;190;10;177;54;48;160;34;146;22;18;108;69;159;181;42;5;41;193;139;68;140;93;117;143;183;89;186;23;137;0;46;115;59;118;51;151;133;176;80;79;63;94;124;152;2;129;92;57;55,2750944379245898140,0.004081
greedy_intra:edges_start:greedy,53,71545,22975,48570,25081,2,53;158;154;70;135;180;63;79;133;162;127;123;149;65;116;43;184;177;54;48;160;34;146;22;18;108;69;159;181;42;5;41;193;139;68;140;93;117;143;0;46;115;59;118;51;151;80;176;137;23;183;89;186;114;15;9;62;144;14;138;185;40;165;90;81;196;179;145;78;31;56;113;175;171;16;25;44;120;2;129;92;57;55;52;106;178;49;102;148;124;94;152;97;1;101;75;86;26;100;121,3399985064137809633,0.001001
greedy_intra:edges_start:greedy,54,71675,23111,48564,99832,9,54;48;160;34;42;181;195;146;22;18;108;69;159;193;41;139;68;140;93;117;143;183;89;186;23;137;176;80;79;63;94;124;152;97;1;101;2;129;92;57;55;52;49;102;148;9;62;144;14;3;178;106;185;40;165;90;81;196;179;145;78;31;56;113;175;171;16;25;44;120;82;75;86;26;100;121;53;180;154;135;70;127;123;162;133;151;51;0;46;115;118;59;65;116;43;184;84;190;10;177,2923541372936399011,0.004398
greedy_intra:edges_start:greedy,55,71132,23070,48062,53712,5,55;52;178;106;49;102;148;9;62;144;14;138;185;40;165;90;81;196;179;145;78;31;56;113;175;171;16;25;44;120;75;101;1;97;26;100;86;53;180;154;135;70;127;123;162;149;131;65;116;43;184;84;190;10;177;54;48;160;34;146;22;18;108;69;159;181;42;5;41;193;139;68;140;93;117;143;183;89;186;23;137;0;46;115;59;118;51;151;133;176;80;79;63;94;124;152;2;129;92;57,6192157380057881061,0.001998
greedy_intra:edges_start:greedy,56,71602,23462,48140,52732,6,56;31;78;145;92;179;196;81;90;165;40;185;106;178;3;14;144;62;9;148;102;49;52;55;57;129;2;152;97;1;101;100;26;124;94;63;79;80;176;133;151;51;118;59;115;46;0;137;23;186;89;183;143;117;93;140;68;139;193;41;5;42;181;159;69;108;18;22;146;34;160;48;54;177;10;190;84;184;43;116;65;131;149;162;123;127;70;135;154;180;53;86;75;120;44;25;16;171;175;113,7637032958269932407,0.002586
greedy_intra:edges_start:greedy,57,71270,23130,48140,42869,5,57;55;52;49;102;148;9;62;144;14;3;178;106;185;40;165;90;81;196;179;145;78;31;56;113;175;171;16;25;44;120;75;101;1;97;26;86;100;53;180;154;135;70;127;123;162;149;131;65;116;43;184;84;190;10;177;54;48;160;34;146;22;18;108;69;159;181;42;5;41;193;139;68;140;93;117;143;183;89;186;23;137;0;46;115;59;118;51;151;133;176;80;79;63;94;124;152;2;129;92,6253938704340293502,0.003011
greedy_intra:edges_start:greedy,58,72442,24155,48287,50030,4,58;95;27;90;81;196;157;31;56;113;175;171;16;25;44;120;75;86;100;53;180;154;135;70;127;123;162;149;65;116;43;184;177;54;48;160;34;146;22;18;108;69;159;181;42;5;41;193;139;68;140;93;117;143;183;89;23;137;0;46;115;59;118;51;151;133;176;80;79;63;94;26;101;1;97;152;2;129;57;92;78;145;179;40;165;185;55;52;106;178;14;49;102;148;9;62;144;21;7;164,7774653873368452583,0.002004
greedy_intra:edges_start:greedy,59,71555,23432,48123,52838,6,59;115;46;68;139;193;41;5;42;181;159;69;108;18;22;146;34;160;48;54;177;10;112;4;84;184;43;116;65;149;123;127;162;151;133;135;70;154;180;53;121;100;26;86;75;82;120;44;25;16;171;175;113;56;31;78;145;179;196;81;90;165;40;185;106;178;3;14;144;62;9;148;102;49;52;55;57;92;129;2;101;1;97;152;124;94;63;79;80;176;137;23;186;89;183;143;117;0;51;118,4415811327120372494,0.002972
greedy_intra:edges_start:greedy,60,71570,23447,48123,76022,10,68;46;115;59;118;51;0;117;143;183;89;186;23;137;176;80;79;63;94;124;152;97;1;101;2;82;129;57;92;55;52;49;102;148;9;62;144;14;3;178;106;185;40;165;90;81;196;179;145;78;31;56;113;175;171;16;25;44;120;75;86;26;100;121;53;180;154;70;135;133;151;162;127;123;149;65;116;43;184;112;4;190;10;177;54;48;160;34;146;22;18;108;69;159;181;42;5;41;193;139,134141396204574158,0.004021
greedy_intra:edges_start:greedy,61,71095,23073,48022,50372,5,15;144;14;138;185;40;165;90;81;196;179;145;78;31;56;113;175;171;16;25;44;120;75;86;101;1;97;26;100;53;180;154;135;70;127;123;162;149;131;65;116;43;184;190;10;177;54;48;160;34;146;22;18;108;69;159;181;42;5;41;193;139;68;140;93;117;143;183;89;186;23;137;0;46;115;59;118;51;151;133;176;80;79;63;94;124;152;2;129;92;57;55;52;106;178;49;102;62;9;148,6678463189971463031,0.001998
greedy_intra:edges_start:greedy,62,71314,23252,48062,23619,3,62;144;14;138;185;40;165;90;81;196;179;145;78;31;56;113;175;171;16;25;44;120;75;86;100;53;180;154;135;70;127;123;162;149;131;65;116;43;184;84;190;10;177;54;48;160;34;146;22;18;108;69;159;181;42;5;41;193;139;68;140;93;117;143;183;89;186;23;137;0;46;115;59;118;51;151;133;176;80;79;63;94;124;26;101;1;97;152;2;129;92;57;55;52;106;178;49;102;148;9,733706882491010376,0.001000
greedy_intra:edges_start:greedy,63,71515,22945,48570,37039,3,63;180;135;70;154;158;53;121;100;26;86;75;101;1;97;152;94;124;148;102;49;178;106;52;55;57;92;129;2;120;44;25;16;171;175;113;56;31;78;145;179;196;81;90;40;185;165;138;14;144;62;9;15;114;186;89;183;23;137;176;51;118;59;115;46;0;143;117;93;140;68;139;193;41;5;42;181;159;69;108;18;22;146;34;160;48;54;177;184;43;116;65;149;123;127;162;151;133;80;79,3504358795994419425,0.001000
greedy_intra:edges_start:greedy,64,72345,22826,49519,22673,1,64;114;186;89;183;23;137;176;51;118;59;115;46;0;143;117;93;140;68;139;193;41;5;42;181;159;69;108;18;22;146;34;160;48;54;177;184;43;116;65;149;123;162;151;80;133;79;63;180;135;70;154;158;53;121;100;26;86;75;101;1;97;152;94;124;148;9;62;102;49;178;106;52;55;57;92;129;2;120;44;25;16;171;175;113;56;31;78;145;179;196;81;90;185;40;165;138;14;144;15,2415572048211593668,0.001022
greedy_intra:edges_start:greedy,65,71678,23555,48123,45778,6,65;149;123;127;162;151;133;135;70;154;180;53;121;100;26;86;75;82;120;44;25;16;171;175;113;56;31;78;145;179;196;81;90;165;40;185;106;178;3;14;144;62;9;148;102;49;52;55;92;57;129;2;101;1;97;152;124;94;63;79;80;176;137;23;186;89;183;143;117;0;51;118;59;115;46;68;139;193;41;5;42;181;159;69;108;18;22;146;34;160;48;54;177;10;4;112;84;184;43;116,2650674959494874145,0.002031
greedy_intra:edges_start:greedy,66,72306,23816,48490,77563,8,23;51;118;59;115;46;0;89;183;143;117;93;140;68;139;193;41;5;42;181;159;69;108;18;22;146;34;160;48;54;177;10;190;84;184;43;116;65;149;123;127;162;151;133;135;70;154;180;53;121;100;26;86;75;120;82;44;25;16;171;175;113;56;31;78;145;179;196;81;90;165;40;185;106;178;3;14;144;62;9;148;102;49;52;55;57;92;129;2;101;1;97;152;124;94;63;79;80;176;137,6631328443816810041,0.003741
greedy_intra:edges_start:greedy,67,72068,22900,49168,47367,5,36;108;69;18;22;146;159;193;41;5;42;181;34;160;48;54;177;10;190;84;184;43;116;65;149;123;127;162;151;133;135;70;154;180;53;121;100;26;86;75;44;25;16;171;175;113;56;31;78;145;179;196;81;90;165;40;185;106;178;3;14;144;62;9;148;102;49;52;55;57;92;129;82;120;2;101;1;97;152;124;94;63;79;80;176;137;51;118;59;115;139;68;46;0;89;183;143;117;93;140,6922409807077732361,0.002971
greedy_intra:edges_start:greedy,68,71631,23508,48123,49771,5,68;46;115;59;118;51;0;117;143;183;89;186;23;137;176;80;79;63;94;124;152;97;1;101;2;120;44;25;16;171;175;113;56;31;78;145;179;196;81;90;40;165;185;106;178;3;14;144;62;9;148;102;49;52;55;57;92;129;82;75;86;26;100;121;53;180;154;70;135;133;151;162;127;123;149;65;116;43;184;84;112;4;10;177;54;48;160;34;146;22;18;108;69;159;181;42;5;41;193;139,398893730671103168,0.003000
greedy_intra:edges_start:greedy,69,71643,22792,48851,74393,6,69;108;18;199;22;146;159;193;41;5;42;181;34;160;48;54;177;10;190;84;184;43;116;65;149;123;127;162;151;133;135;70;154;180;53;121;100;26;86;75;120;44;25;16;171;175;113;56;31;78;145;179;196;81;90;165;40;185;106;178;3;14;144;62;9;148;102;49;52;55;57;92;129;82;2;101;1;97;152;124;94;63;79;80;176;137;23;186;89;183;143;117;0;51;118;59;115;46;68;139,755263779058958547,0.003000
greedy_intra:edges_start:greedy,70,71468,22898,48570,33681,2,70;154;158;53;121;100;26;86;75;101;1;97;152;94;124;148;102;49;178;106;52;55;57;92;129;2;120;44;25;16;171;175;113;56;31;78;145;179;196;81;90;40;185;165;138;14;144;62;9;15;114;186;89;183;23;137;176;80;51;118;59;115;46;0;143;117;93;140;68;139;193;41;5;42;181;159;69;108;18;22;146;34;160;48;54;177;184;43;116;65;149;123;127;162;151;133;79;63;180;135,5357785400432608056,0.001001
greedy_intra:edges_start:greedy,71,72133,23605,48528,30487,2,58;164;7;95;39;165;138;14;144;62;9;148;102;49;178;106;52;55;57;92;129;2;152;97;1;101;26;94;63;79;80;176;133;151;51;118;59;115;46;0;137;23;89;183;143;117;93;140;68;139;193;41;5;42;181;159;69;108;18;22;146;34;160;48;54;177;184;43;116;65;149;162;123;127;70;135;154;180;53;100;86;75;120;44;25;16;171;175;113;56;31;78;145;179;196;81;185;40;90;27,5814616990986457145,0.001564
greedy_intra:edges_start:greedy,72,72163,23293,48870,55418,5,109;51;0;117;143;183;89;186;23;137;176;80;79;63;94;124;152;97;1;101;2;129;57;92;55;52;49;102;148;9;62;144;14;3;178;106;185;40;165;90;81;196;179;145;78;31;56;113;175;171;16;25;44;120;82;75;86;26;100;121;53;180;154;70;135;133;151;162;127;123;149;65;116;43;184;84;190;10;177;54;48;160;34;146;22;18;108;69;159;181;42;5;41;193;139;68;46;115;118;59,924353245733216751,0.002999
greedy_intra:edges_start:greedy,73,71732,23619,48113,64511,8,114;15;148;9;62;102;49;178;106;52;55;57;92;129;2;152;124;94;63;79;80;176;133;151;51;118;59;115;46;0;137;23;186;89;183;143;117;93;140;68;139;193;41;5;42;181;159;69;108;18;22;146;34;160;48;54;177;10;184;43;116;65;131;149;162;123;127;70;135;154;180;53;86;26;100;97;1;101;75;120;44;25;16;171;175;113;56;31;78;145;179;196;81;90;185;40;165;138;14;144,7182270612966243911,0.002999
greedy_intra:edges_start:greedy,74,71680,23039,48641,92315,8,121;100;26;97;152;1;101;75;86;53;154;70;135;180;63;79;80;133;151;162;127;123;149;65;116;43;184;177;54;48;160;34;146;22;18;108;69;159;181;42;5;41;193;139;68;140;93;117;143;0;46;115;59;118;51;176;137;23;183;89;186;114;15;9;62;144;14;138;185;40;165;90;81;196;179;145;78;31;56;113;175;171;16;25;44;120;2;129;92;57;55;52;106;178;49;102;148;124;94;189,1300358318281403229,0.004001
greedy_intra:edges_start:greedy,75,71549,23207,48342,82024,8,75;82;120;44;25;16;171;175;113;56;31;78;145;179;196;81;90;165;40;185;106;178;3;14;144;62;9;148;102;49;52;55;57;92;129;2;101;1;97;152;124;94;63;79;80;176;133;151;51;118;59;115;46;0;137;23;186;89;183;143;117;93;140;68;139;193;41;5;42;181;159;69;108;18;22;146;34;160;48;54;177;10;190;184;43;116;65;131;149;162;123;127;70;135;154;180;53;100;26;86,2406219290617330791,0.003948
greedy_intra:edges_start:greedy,76,72302,23476,48826,36765,5,153;176;80;151;51;118;59;115;46;68;139;193;41;5;42;181;159;69;108;18;22;146;34;160;48;54;177;10;184;43;116;65;149;123;127;162;133;79;63;180;135;70;154;158;53;121;100;26;86;75;101;1;97;152;94;124;148;102;49;178;106;52;55;57;92;129;2;120;44;25;16;171;175;113;56;31;78;145;179;196;81;90;40;185;165;138;14;144;62;9;15;114;186;137;23;89;183;143;117;0,655292692272568381,0.002000
greedy_intra:edges_start:greedy,77,71774,23356,48418,71096,7,149;43;184;190;10;177;54;48;160;34;146;22;18;108;69;159;181;42;5;41;193;139;68;140;93;117;143;183;89;186;23;137;176;80;79;63;94;124;152;97;1;101;2;129;92;57;55;52;49;102;148;9;62;144;14;3;178;106;185;40;165;90;81;196;179;145;78;31;56;113;175;171;16;25;44;120;82;75;86;26;100;121;53;180;154;135;70;127;123;162;133;151;51;0;46;115;118;59;116;65,2433729155247102947,0.003005
greedy_intra:edges_start:greedy,78,71450,23310,48140,57914,5,78;31;56;113;175;171;16;25;44;120;75;86;100;53;180;154;135;70;127;123;162;149;131;65;116;43;184;84;190;10;177;54;48;160;34;146;22;18;108;69;159;181;42;5;41;193;139;68;140;93;117;143;183;89;186;23;137;0;46;115;59;118;51;151;133;176;80;79;63;94;124;26;101;1;97;152;2;129;92;57;55;52;49;102;148;9;62;144;14;3;178;106;185;40;165;90;81;196;179;145,9010926116327151026,0.002972
greedy_intra:edges_start:greedy,79,71895,23009,48886,50110,4,79;80;176;133;151;51;118;59;115;46;0;137;23;186;89;183;143;117;93;140;68;139;193;41;5;42;181;159;69;108;18;22;146;34;160;48;54;177;184;43;116;65;131;149;162;123;127;70;135;154;180;158;53;121;100;26;86;75;44;25;16;171;175;113;56;31;78;145;179;196;81;90;165;40;185;106;178;3;14;144;62;9;148;102;49;52;55;57;92;129;82;120;2;101;1;97;152;124;94;63,3238149545796279325,0.002027
greedy_intra:edges_start:greedy,80,71565,23003,48562,61585,5,80;79;63;94;124;152;97;1;101;2;129;92;57;55;52;49;102;148;9;62;144;14;3;178;106;185;40;165;90;81;196;179;145;78;31;56;113;175;171;16;25;44;120;82;75;86;26;100;121;53;180;154;135;70;127;123;162;133;151;149;131;65;116;43;184;84;190;10;177;54;48;160;34;146;22;18;108;69;159;181;42;5;41;193;139;68;46;115;59;118;51;0;117;143;183;89;186;23;137;176,7916528164847463890,0.002021
greedy_intra:edges_start:greedy,81,71538,23476,48062,36210,3,81;196;40;185;179;145;78;31;56;113;175;171;16;25;44;120;75;86;100;53;180;154;135;70;127;123;162;149;131;65;116;43;184;84;190;10;177;54;48;160;34;146;22;18;108;69;159;181;42;5;41;193;139;68;140;93;117;143;183;89;186;23;137;0;46;115;59;118;51;151;133;176;80;79;63;94;124;26;101;1;97;152;2;129;92;57;55;52;106;178;49;102;148;9;62;144;14;138;165;90,7840871833589975837,0.002094
greedy_intra:edges_start:greedy,82,71781,23439,48342,49433,6,82;2;75;86;100;53;180;154;135;70;127;123;162;149;131;65;116;43;184;190;10;177;54;48;160;34;146;22;18;108;69;159;181;42;5;41;193;139;68;140;93;117;143;183;89;186;23;137;0;46;115;59;118;51;151;133;176;80;79;63;94;124;26;101;1;97;152;129;92;57;55;52;49;102;148;9;62;144;14;3;178;106;185;40;165;90;81;196;179;145;78;31;56;113;175;171;16;25;44;120,1126570217795763870,0.002758
greedy_intra:edges_start:greedy,83,71269,22973,48296,46971,7,114;89;183;143;117;0;46;68;139;115;41;193;5;42;181;159;69;108;18;22;146;34;160;48;54;177;10;4;112;84;184;43;116;65;59;118;51;151;133;162;123;127;70;135;154;180;53;121;100;26;86;75;44;25;16;171;175;113;56;31;78;145;179;196;81;90;165;40;185;106;178;3;14;144;62;9;148;102;49;52;55;92;57;129;82;120;2;101;1;97;152;124;94;63;79;80;176;137;23;186,345934882645822442,0.002001
greedy_intra:edges_start:greedy,84,70933,22683,48250,114544,10,84;4;112;127;123;162;151;133;135;70;154;180;53;121;100;26;86;75;120;44;25;16;171;175;113;56;31;78;145;179;196;81;90;165;40;185;106;178;3;14;144;62;9;148;102;49;52;55;57;92;129;82;2;101;1;97;152;124;94;63;79;80;176;137;23;186;89;183;143;117;0;68;139;115;46;51;118;59;65;116;43;42;5;41;193;159;69;108;18;22;146;181;34;160;48;54;177;10;184;35,1512456692081620992,0.003998
greedy_intra:edges_start:greedy,85,72367,24052,48315,19639,3,157;145;179;196;81;90;40;165;185;106;178;3;14;144;62;9;148;102;49;52;55;92;57;129;2;152;97;1;101;100;53;180;154;135;70;127;123;162;149;131;65;116;43;184;190;10;177;54;48;160;34;146;22;18;108;69;159;181;42;5;41;193;139;68;140;93;117;143;183;89;186;23;137;0;46;115;59;118;51;151;133;176;80;79;63;94;124;26;86;75;120;44;25;78;31;16;171;175;113;56,5857105333459773222,0.001002
greedy_intra:edges_start:greedy,86,71413,22843,48570,24467,2,86;75;101;1;97;152;94;124;148;102;49;178;106;52;55;57;92;129;2;120;44;25;16;171;175;113;56;31;78;145;179;196;81;90;165;40;185;138;14;144;62;9;15;114;186;89;183;23;137;176;80;51;118;59;115;46;0;143;117;93;140;68;139;193;41;5;42;181;159;69;108;18;22;146;34;160;48;54;177;184;43;116;65;149;123;127;162;151;133;79;63;180;135;70;154;158;53;121;100;26,9120908281092841633,0.001999
greedy_intra:edges_start:greedy,87,72377,23165,49212,96731,13,74;2;129;92;57;55;52;49;102;148;9;62;144;14;3;178;106;185;40;165;90;81;196;179;145;78;31;56;113;175;171;16;25;44;120;82;75;86;53;180;154;135;70;127;123;162;149;131;65;116;43;184;10;177;54;48;160;34;146;22;18;108;69;159;181;42;5;41;193;139;68;140;93;117;143;183;89;186;23;137;0;46;115;59;118;51;151;133;176;80;79;63;94;121;100;26;101;1;97;152,8630062791052283091,0.003998
greedy_intra:edges_start:greedy,88,71973,23631,48342,93192,9,82;92;179;196;81;90;165;40;185;106;178;3;14;144;62;9;148;102;49;52;55;57;129;2;152;124;94;63;79;80;176;133;151;51;118;59;115;46;0;137;23;186;89;183;143;117;93;140;68;139;193;41;5;42;181;159;69;108;18;22;146;34;160;48;54;177;10;190;184;43;116;65;131;149;162;123;127;70;135;154;180;53;100;86;26;97;1;101;75;120;44;16;171;175;113;56;31;145;78;25,380342062991619552,0.003910
greedy_intra:edges_start:greedy,89,70695,22195,48500,64628,6,89;186;23;137;176;80;79;63;94;124;152;97;1;101;2;82;129;92;57;55;52;49;102;148;9;62;144;14;3;178;106;185;40;165;90;81;196;179;145;78;31;56;113;175;171;16;25;44;120;75;86;26;100;121;53;180;154;135;70;127;123;162;133;151;51;118;59;65;116;43;184;84;190;10;177;54;48;160;34;146;22;18;108;69;159;181;42;5;193;41;115;139;46;68;140;93;117;0;143;183,8577101783240840258,0.003010
greedy_intra:edges_start:greedy,90,71369,23307,48062,39357,4,90;40;185;165;138;14;144;62;9;148;102;49;178;106;52;55;57;92;129;2;152;97;1;101;26;124;94;63;79;80;176;133;151;51;118;59;115;46;0;137;23;186;89;183;143;117;93;140;68;139;193;41;5;42;181;159;69;108;18;22;146;34;160;48;54;177;10;190;84;184;43;116;65;131;149;162;123;127;70;135;154;180;53;100;86;75;120;44;25;16;171;175;113;56;31;78;145;179;196;81,263224707174313330,0.003024
greedy_intra:edges_start:greedy,91,71582,23267,48315,57598,7,157;179;145;78;31;56;113;175;171;16;25;44;120;75;86;26;100;53;180;154;135;70;127;123;162;149;131;65;116;43;184;190;10;177;54;48;160;34;146;22;18;108;69;159;181;42;5;41;193;139;68;140;93;117;143;183;89;186;23;137;0;46;115;59;118;51;151;133;176;80;79;63;94;124;152;97;1;101;2;129;92;57;55;52;49;102;148;9;62;144;14;3;178;106;185;40;165;90;81;196,4665668378378103979,0.003000
greedy_intra:edges_start:greedy,92,71258,23118,48140,61164,6,92;129;2;101;1;97;152;124;94;63;79;80;176;133;151;51;118;59;115;46;0;137;23;186;89;183;143;117;93;140;68;139;193;41;5;42;181;159;69;108;18;22;146;34;160;48;54;177;10;190;84;184;43;116;65;131;149;162;123;127;70;135;154;180;53;100;26;86;75;120;44;25;16;171;175;113;56;31;78;145;179;196;81;90;165;40;185;106;178;3;14;144;62;9;148;102;49;52;55;57,4350629077276063501,0.002000
greedy_intra:edges_start:greedy,93,71602,23352,48250,87397,8,93;140;108;69;18;22;146;159;193;41;5;42;181;34;160;48;54;177;10;4;112;84;184;43;116;65;149;123;127;162;151;133;135;70;154;180;53;121;100;26;86;75;120;82;44;25;16;171;175;113;56;31;78;145;179;196;81;90;40;165;185;106;178;3;14;144;62;9;148;102;49;52;55;57;92;129;2;101;1;97;152;124;94;63;79;80;176;137;51;118;59;115;139;68;46;0;89;183;143;117,5333937490176174643,0.003492
greedy_intra:edges_start:greedy,94,71468,22898,48570,35202,2,94;152;97;1;101;75;86;26;100;121;53;158;154;70;135;180;63;79;133;151;162;127;123;149;65;116;43;184;177;54;48;160;34;146;22;18;108;69;159;181;42;5;41;193;139;68;140;93;117;143;0;46;115;59;118;51;80;176;137;23;183;89;186;114;15;9;62;144;14;138;165;185;40;90;81;196;179;145;78;31;56;113;175;171;16;25;44;120;2;129;92;57;55;52;106;178;49;102;148;124,8281306547315665583,0.001000
greedy_intra:edges_start:greedy,95,71912,23384,48528,42364,3,95;7;164;58;27;90;40;185;81;196;179;145;78;31;56;113;175;171;16;25;44;120;75;86;101;1;97;26;100;53;180;154;135;70;127;123;162;149;65;116;43;184;177;54;48;160;34;146;22;18;108;69;159;181;42;5;41;193;139;68;140;93;117;143;183;89;23;137;0;46;115;59;118;51;151;133;176;80;79;63;94;152;2;129;92;57;55;52;106;178;49;102;148;9;62;144;14;138;165;39,2543180611289305029,0.002000
greedy_intra:edges_start:greedy,96,71527,23404,48123,44961,6,5;43;116;65;149;123;127;162;151;133;135;70;154;180;53;121;100;26;86;75;120;44;25;16;171;175;113;56;31;78;145;179;196;81;90;40;165;185;106;178;3;14;144;62;9;148;102;49;52;55;92;57;129;82;2;101;1;97;152;124;94;63;79;80;176;137;23;186;89;183;143;117;0;51;118;59;115;46;68;139;41;193;159;69;108;18;22;146;181;34;160;48;54;177;10;190;4;112;184;42,4003004672331508810,0.002000
greedy_intra:edges_start:greedy,97,71578,23389,48189,27882,4,97;152;1;101;75;86;53;154;70;135;180;63;79;133;162;127;123;149;65;116;43;184;10;177;54;48;160;34;146;22;18;108;69;159;181;42;5;41;193;139;68;140;93;117;143;0;46;115;59;118;51;151;80;176;137;23;183;89;186;114;15;9;62;144;14;138;185;40;165;90;81;196;179;145;78;31;56;113;175;171;16;25;44;120;2;129;92;57;55;52;106;178;49;102;148;124;94;121;100;26,1727074107044659190,0.001653
greedy_intra:edges_start:greedy,98,72648,24043,48605,85592,9,119;81;196;157;31;56;113;175;171;16;25;44;120;75;86;100;53;180;154;135;70;127;123;162;149;65;116;43;184;177;54;48;160;34;146;22;18;108;69;159;181;42;5;41;193;139;68;140;93;117;143;183;89;23;137;0;46;115;59;118;51;151;133;176;80;79;63;94;26;101;1;97;152;2;82;78;145;179;92;129;57;55;52;49;102;148;9;62;144;14;3;178;106;185;165;39;164;27;90;40,1722902138093973523,0.003967
greedy_intra:edges_start:greedy,99,71662,23092,48570,65326,6,121;100;26;97;86;75;101;1;152;94;124;148;102;49;178;106;52;55;57;92;129;2;120;44;25;16;171;175;113;56;31;78;145;179;196;81;90;165;40;185;138;14;144;62;9;15;114;186;89;183;23;137;176;80;151;51;118;59;115;46;0;143;117;93;140;68;139;193;41;5;42;181;159;69;108;18;22;146;34;160;48;54;177;184;43;116;65;149;123;127;162;133;79;63;180;135;70;154;158;53,197942654089615182,0.002000
greedy_intra:edges_start:greedy,100,71413,22843,48570,34953,2,100;26;86;75;101;1;97;152;94;124;148;102;49;178;106;52;55;57;92;129;2;120;44;25;16;171;175;113;56;31;78;145;179;196;81;90;165;40;185;138;14;144;62;9;15;114;186;89;183;23;137;176;80;51;118;59;115;46;0;143;117;93;140;68;139;193;41;5;42;181;159;69;108;18;22;146;34;160;48;54;177;184;43;116;65;149;123;127;162;151;133;79;63;180;135;70;154;158;53;121,1038018038590575781,0.000991
greedy_intra:edges_start:greedy,101,71695,23506,48189,31818,3,101;1;152;97;26;100;121;94;124;148;102;49;178;106;52;55;57;92;129;2;120;44;25;16;171;175;113;56;31;78;145;179;196;81;90;185;40;165;138;14;144;62;9;15;114;186;89;183;23;137;176;80;151;51;118;59;115;46;0;143;117;93;140;68;139;193;41;5;42;181;159;69;108;18;22;146;34;160;48;54;177;10;184;43;116;65;149;123;127;162;133;79;63;180;135;70;154;53;86;75,1581142322691538187,0.001000
greedy_intra:edges_start:greedy,102,71324,23262,48062,45523,4,102;148;9;62;144;14;138;165;185;40;90;81;196;179;145;78;31;56;113;175;171;16;25;44;120;75;86;53;180;154;135;70;127;123;162;149;131;65;116;43;184;84;190;10;177;54;48;160;34;146;22;18;108;69;159;181;42;5;41;193;139;68;140;93;117;143;183;89;186;23;137;0;46;115;59;118;51;151;133;176;80;79;63;94;124;26;100;101;1;97;152;2;129;92;57;55;52;106;178;49,6355646293891990923,0.001000
greedy_intra:edges_start:greedy,103,71107,23134,47973,59669,5,181;34;160;48;54;177;10;190;4;112;84;184;42;43;116;65;149;123;127;162;151;133;135;70;154;180;53;121;100;26;86;75;120;44;25;16;171;175;113;56;31;78;145;179;196;81;90;165;40;185;106;178;3;14;144;62;9;148;102;49;52;55;92;57;129;82;2;101;1;97;152;124;94;63;79;80;176;137;23;186;89;183;143;117;0;51;118;59;115;46;68;139;41;193;159;69;108;18;22;146,2938272735085178113,0.001984
greedy_intra:edges_start:greedy,104,71960,23748,48212,65228,8,10;54;48;160;34;181;42;195;146;22;18;108;69;159;41;193;139;68;140;93;117;143;183;89;186;23;137;176;80;79;63;94;124;152;97;1;101;2;120;82;129;92;57;55;52;49;102;148;9;62;144;14;3;178;106;185;40;165;90;81;196;179;145;78;31;56;113;175;171;16;25;44;75;86;26;100;121;53;180;154;135;70;127;123;162;133;151;51;0;46;115;118;59;116;65;43;184;112;4;177,4267461636047966003,0.002999
greedy_intra:edges_start:greedy,105,71514,22952,48562,98272,10,131;149;123;127;162;151;133;135;70;154;180;53;121;100;26;86;75;120;44;25;16;171;175;113;56;31;78;145;179;196;81;90;165;40;185;106;178;3;14;144;62;9;148;102;49;52;55;57;92;129;82;2;101;1;97;152;124;94;63;79;80;176;137;23;186;89;183;143;117;0;51;118;59;115;46;68;139;193;41;5;42;181;159;69;108;18;22;146;34;160;48;54;177;10;190;84;184;43;116;65,4091744338473559454,0.006003
greedy_intra:edges_start:greedy,106,71431,23369,48062,37567,3,106;178;49;102;148;9;62;144;14;138;165;40;185;90;81;196;179;145;78;31;56;113;175;171;16;25;44;120;75;86;100;53;180;154;135;70;127;123;162;149;131;65;116;43;184;84;190;10;177;54;48;160;34;146;22;18;108;69;159;181;42;5;41;193;139;68;140;93;117;143;183;89;186;23;137;0;46;115;59;118;51;151;133;176;80;79;63;94;124;26;101;1;97;152;2;129;92;57;55;52,4527097863200096384,0.002000
greedy_intra:edges_start:greedy,107,72133,23605,48528,40287,4,27;58;164;7;95;39;165;138;14;144;62;9;148;102;49;178;106;52;55;57;92;129;2;152;97;1;101;26;94;63;79;80;176;133;151;51;118;59;115;46;0;137;23;89;183;143;117;93;140;68;139;193;41;5;42;181;159;69;108;18;22;146;34;160;48;54;177;184;43;116;65;149;162;123;127;70;135;154;180;53;100;86;75;120;44;25;16;171;175;113;56;31;78;145;179;196;81;185;40;90,1965067725335500076,0.002000
greedy_intra:edges_start:greedy,108,71906,23055,48851,37917,3,108;69;139;68;46;115;59;118;51;0;117;143;183;89;186;23;137;176;80;79;63;94;124;152;97;1;101;2;120;82;129;92;57;55;52;49;102;148;9;62;144;14;3;178;106;185;165;40;90;81;196;179;145;78;31;56;113;175;171;16;25;44;75;86;26;100;121;53;180;154;70;135;133;151;162;127;123;149;65;116;43;184;84;190;10;177;54;48;160;34;181;42;5;41;193;159;146;22;199;18,3117522165250383575,0.002000
greedy_intra:edges_start:greedy,109,71411,22811,48600,112512,11,109;46;115;118;59;65;116;43;184;112;4;190;10;177;54;48;160;34;146;22;18;108;69;159;181;42;5;41;193;139;68;117;0;143;183;89;186;23;137;176;80;79;63;94;124;152;97;1;101;2;129;92;57;55;52;49;102;148;9;62;144;14;3;178;106;185;40;165;90;81;196;179;145;78;31;56;113;175;171;16;25;44;120;82;75;86;26;100;121;53;180;154;135;70;127;123;162;133;151;51,7406168847182821590,0.004993
greedy_intra:edges_start:greedy,110,72083,23284,48799,57173,6,198;193;41;5;42;181;159;69;108;18;22;146;34;160;48;54;177;10;190;84;184;43;116;65;149;123;127;162;151;133;135;70;154;180;53;121;100;26;86;75;82;129;92;57;55;52;49;102;148;9;62;144;14;3;178;106;185;40;165;90;81;196;179;145;78;31;56;113;175;171;16;25;44;120;2;101;1;97;152;124;94;63;79;80;176;137;23;186;89;183;143;117;0;51;118;59;115;46;68;139,1958417802399239942,0.002999
greedy_intra:edges_start:greedy,111,72288,23692,48596,31286,3,167;148;9;62;102;144;14;49;178;106;165;39;95;164;27;90;81;196;40;185;52;55;57;129;92;179;145;78;31;56;113;175;171;16;25;44;120;2;152;97;1;101;75;86;26;100;121;53;158;154;70;135;180;63;79;133;151;162;127;123;149;65;116;43;184;177;54;48;160;34;146;22;18;108;69;159;181;42;5;41;193;139;68;140;93;117;143;183;89;0;46;115;59;118;51;80;176;137;94;124,2910717360192131226,0.002008
greedy_intra:edges_start:greedy,112,71351,23101,48250,78413,7,112;4;84;35;184;10;177;54;48;160;34;181;146;22;18;108;69;159;193;41;5;42;43;65;116;115;139;68;46;118;59;51;0;117;143;183;89;186;23;137;176;80;79;63;94;124;152;97;1;101;2;120;82;129;92;57;55;52;49;102;148;9;62;144;14;3;178;106;185;40;165;90;81;196;179;145;78;31;56;113;175;171;16;25;44;75;86;26;100;121;53;180;154;70;135;133;151;162;123;127,5334815433354750482,0.003998
greedy_intra:edges_start:greedy,113,71647,23507,48140,56729,5,113;56;31;78;145;92;179;196;81;90;165;40;185;106;178;3;14;144;62;9;148;102;49;52;55;57;129;2;152;97;1;101;26;124;94;63;79;80;176;133;151;51;118;59;115;46;0;137;23;186;89;183;143;117;93;140;68;139;193;41;5;42;181;159;69;108;18;22;146;34;160;48;54;177;10;190;84;184;43;116;65;131;149;162;123;127;70;135;154;180;53;100;86;75;120;44;25;16;171;175,4671967558040122137,0.002999
greedy_intra:edges_start:greedy,114,71392,22822,48570,45734,3,114;186;89;183;23;137;176;51;118;59;115;46;0;143;117;93;140;68;139;193;41;5;42;181;159;69;108;18;22;146;34;160;48;54;177;184;43;116;65;149;123;127;162;151;133;80;79;63;180;135;70;154;158;53;121;100;26;86;75;101;1;97;152;94;124;148;9;62;102;49;178;106;52;55;57;92;129;2;120;44;25;16;171;175;113;56;31;78;145;179;196;81;90;165;40;185;138;14;144;15,5941066592763001620,0.001000
greedy_intra:edges_start:greedy,115,71768,23645,48123,32661,3,115;59;118;51;0;117;143;183;89;186;23;137;176;80;79;63;94;124;152;97;1;101;2;120;82;129;57;92;55;52;49;102;148;9;62;144;14;3;178;106;185;40;165;90;81;196;179;145;78;31;56;113;175;171;16;25;44;75;86;26;100;121;53;180;154;70;135;133;151;162;127;123;149;65;116;43;184;84;4;112;10;177;54;48;160;34;146;22;18;108;69;159;181;42;5;41;193;139;68;46,3633524314774957737,0.001000
greedy_intra:edges_start:greedy,116,71837,23714,48123,24594,3,116;43;184;84;112;4;10;177;54;48;160;34;146;22;18;108;69;159;181;42;5;41;193;139;68;46;115;59;118;51;0;117;143;183;89;186;23;137;176;80;79;63;94;124;152;97;1;101;2;120;82;129;57;92;55;52;49;102;148;9;62;144;14;3;178;106;185;165;40;90;81;196;179;145;78;31;56;113;175;171;16;25;44;75;86;26;100;121;53;180;154;70;135;133;151;162;127;123;149;65,9213121048428283845,0.002008
greedy_intra:edges_start:greedy,117,70675,22470,48205,83666,7,117;0;46;68;139;115;193;41;5;42;181;159;69;108;18;22;146;34;160;48;54;177;10;190;4;112;84;184;43;116;65;59;118;51;151;133;162;123;127;70;135;154;180;53;121;100;26;86;75;82;120;44;25;16;171;175;113;56;31;78;145;179;196;81;90;165;40;185;106;178;3;14;144;62;9;148;102;49;52;55;57;92;129;2;101;1;97;152;124;94;63;79;80;176;137;23;186;89;183;143,2346297526322163746,0.003422
greedy_intra:edges_start:greedy,118,71477,23354,48123,72561,8,118;51;0;117;143;183;89;186;23;137;176;80;79;63;94;124;152;97;1;101;2;129;92;57;55;52;49;102;148;9;62;144;14;3;178;106;185;40;165;90;81;196;179;145;78;31;56;113;175;171;16;25;44;120;82;75;86;26;100;121;53;180;154;70;135;133;151;162;127;123;149;65;116;43;184;84;112;4;10;177;54;48;160;34;146;22;18;108;69;159;181;42;5;41;193;139;68;46;115;59,7698420723408329491,0.002896
greedy_intra:edges_start:greedy,119,71232,23037,48195,76723,6,119;40;185;165;138;14;144;62;9;148;102;49;178;106;52;55;57;92;129;2;152;97;124;94;63;79;80;176;133;151;51;118;59;115;46;0;137;23;186;89;183;143;117;93;140;68;139;193;41;5;42;181;159;69;108;18;22;146;34;160;48;54;177;10;190;184;43;116;65;131;149;162;123;127;70;135;154;180;53;100;26;1;101;86;75;120;44;25;16;171;175;113;56;31;78;145;179;196;81;90,7102133571964784592,0.003052
greedy_intra:edges_start:greedy,120,71330,23190,48140,91992,10,120;75;86;101;1;26;100;53;180;154;135;70;127;123;162;149;131;65;116;43;184;84;190;10;177;54;48;160;34;146;22;18;108;69;159;181;42;5;41;193;139;68;140;93;117;143;183;89;186;23;137;0;46;115;59;118;51;151;133;176;80;79;63;94;124;152;97;2;129;92;57;55;52;49;102;148;9;62;144;14;3;178;106;185;40;165;90;81;196;179;145;78;31;56;113;175;171;16;25;44,5667513680959272564,0.004003
greedy_intra:edges_start:greedy,121,71805,23235,48570,24576,1,121;100;26;97;86;75;101;1;152;94;124;148;102;49;178;106;52;55;57;92;129;2;120;44;25;16;171;175;113;56;31;78;145;179;196;81;90;40;185;165;138;14;144;62;9;15;114;186;89;183;23;137;176;80;151;162;127;123;149;65;116;43;184;177;54;48;160;34;146;22;18;108;69;159;181;42;5;41;193;139;68;140;93;117;143;0;46;115;59;118;51;133;79;63;180;135;70;154;158;53,9051570202454456127,0.001001
greedy_intra:edges_start:greedy,122,72489,23279,49210,22644,2,122;176;80;79;133;151;51;118;59;115;46;0;137;23;89;183;143;117;93;140;68;139;193;41;5;42;181;159;69;108;18;22;146;34;160;48;54;177;184;43;116;65;131;149;162;123;127;70;135;154;180;158;53;121;100;26;86;75;44;25;16;171;175;113;56;31;78;145;179;196;81;90;40;165;185;106;178;3;14;144;62;9;148;102;49;52;55;92;57;129;82;120;2;101;1;97;152;124;94;63,4694998721438760823,0.001000
greedy_intra:edges_start:greedy,123,71577,23015,48562,39307,3,123;162;133;151;149;131;65;116;43;184;84;190;10;177;54;48;160;34;146;22;18;108;69;159;181;42;5;41;193;139;68;46;115;59;118;51;0;117;143;183;89;186;23;137;176;80;79;63;94;124;152;97;1;101;2;120;82;129;92;57;55;52;49;102;148;9;62;144;14;3;178;106;185;40;165;90;81;196;179;145;78;31;56;113;175;171;16;25;44;75;86;26;100;121;53;180;154;135;70;127,5647376495999305460,0.001999
greedy_intra:edges_start:greedy,124,71413,22843,48570,42092,3,124;148;102;49;178;106;52;55;57;92;129;2;120;44;25;16;171;175;113;56;31;78;145;179;196;81;90;165;40;185;138;14;144;62;9;15;114;186;89;183;23;137;176;80;51;118;59;115;46;0;143;117;93;140;68;139;193;41;5;42;181;159;69;108;18;22;146;34;160;48;54;177;184;43;116;65;149;123;127;162;151;133;79;63;180;135;70;154;158;53;121;100;26;86;75;101;1;97;152;94,5175857278710584739,0.001994
greedy_intra:edges_start:greedy,125,72587,23106,49481,109510,12,74;2;129;92;57;55;52;106;178;49;102;9;62;144;14;138;165;90;81;196;40;185;179;145;78;31;56;113;175;171;16;25;44;82;120;75;86;53;154;70;135;180;63;79;80;133;151;162;123;149;65;116;43;184;177;54;48;160;34;146;22;18;108;69;159;181;42;5;41;193;139;68;140;93;117;143;0;46;115;59;118;51;176;137;23;183;89;186;114;15;148;124;94;121;100;26;101;1;97;152,6613983573468558690,0.004392
greedy_intra:edges_start:greedy,126,72117,23792,48325,36995,5,149;112;4;84;35;184;177;54;48;160;34;181;146;22;18;108;69;159;193;41;5;42;43;116;65;46;68;139;115;59;118;51;0;117;143;183;89;186;23;137;176;80;79;63;94;124;152;97;1;101;2;120;44;25;16;171;175;113;56;31;78;145;179;196;81;90;40;165;185;106;178;3;14;144;62;9;148;102;49;52;55;92;57;129;82;75;86;26;100;121;53;180;154;70;135;133;151;162;127;123,1651298407158032620,0.002554
greedy_intra:edges_start:greedy,127,71838,23333,48505,52329,5,127;70;135;154;180;53;121;100;26;86;75;120;44;25;16;171;175;113;56;31;78;145;179;196;81;90;165;40;185;106;178;3;14;144;62;9;148;102;49;52;55;92;57;129;82;2;101;1;97;152;124;94;63;79;80;176;133;151;51;118;59;115;46;0;137;23;186;89;183;143;117;93;140;68;139;193;41;5;42;181;159;69;108;18;22;146;34;160;48;54;177;10;184;43;116;65;131;149;162;123,6969536720025433246,0.002000
greedy_intra:edges_start:greedy,128,71193,23024,48169,108724,11,3;49;14;144;102;62;9;148;167;57;92;129;2;152;124;94;63;79;80;176;133;151;51;118;59;115;46;0;137;23;186;89;183;143;117;93;140;68;139;193;41;5;42;181;159;69;108;18;22;146;34;160;48;54;177;10;190;184;43;116;65;131;149;162;123;127;70;135;154;180;53;86;100;26;97;1;101;75;120;44;25;16;171;175;113;56;31;78;145;179;196;81;90;165;40;185;55;52;106;178,3857911454981684488,0.003982
greedy_intra:edges_start:greedy,129,71354,23214,48140,79682,9,129;92;57;55;52;49;102;148;9;62;144;14;3;178;106;185;40;165;90;81;196;179;145;78;31;56;113;175;171;16;25;44;120;75;86;101;26;100;53;180;154;135;70;127;123;162;149;131;65;116;43;184;84;190;10;177;54;48;160;34;146;22;18;108;69;159;181;42;5;41;193;139;68;140;93;117;143;183;89;186;23;137;0;46;115;59;118;51;151;133;176;80;79;63;94;124;97;1;152;2,3758413182935377517,0.003998
greedy_intra:edges_start:greedy,130,71688,23118,48570,34870,4,124;148;102;49;178;106;52;55;57;92;129;2;120;44;25;16;171;175;113;56;31;78;145;179;196;81;90;40;185;165;138;14;144;62;9;15;114;186;89;183;23;137;176;80;151;162;127;123;149;65;116;43;184;177;54;48;160;34;146;22;18;108;69;159;181;42;5;41;193;139;68;140;93;117;143;0;46;115;59;118;51;133;79;63;180;135;70;154;158;53;121;100;26;86;75;101;1;97;152;94,8465322700384263936,0.002006
greedy_intra:edges_start:greedy,131,71618,23056,48562,56454,5,131;149;123;127;162;151;133;135;70;154;180;53;121;100;26;86;75;82;120;44;25;16;171;175;113;56;31;78;145;179;196;81;90;165;40;185;106;178;3;14;144;62;9;148;102;49;52;55;57;92;129;2;101;1;97;152;124;94;63;79;80;176;137;23;186;89;183;143;117;0;51;118;59;115;46;68;139;193;41;5;42;181;159;69;108;18;22;146;34;160;48;54;177;10;190;84;184;43;116;65,3955578087767863042,0.002019
greedy_intra:edges_start:greedy,132,71828,23791,48037,46510,6,21;14;138;165;40;185;90;81;196;179;145;78;31;56;113;175;171;16;25;44;120;75;86;53;180;154;135;70;127;123;162;149;131;65;116;43;184;190;10;177;54;48;160;34;146;22;18;108;69;159;181;42;5;41;193;139;68;140;93;117;143;183;89;186;23;137;0;46;115;59;118;51;151;133;176;80;79;63;94;121;100;26;101;1;97;152;2;129;92;57;55;52;106;178;49;102;148;9;62;144,6244483132684879332,0.002024
greedy_intra:edges_start:greedy,133,72101,23596,48505,19557,2,133;151;51;118;59;115;46;0;137;23;186;89;183;143;117;93;140;68;139;193;41;5;42;181;159;69;108;18;22;146;34;160;48;54;177;10;184;43;116;65;131;149;162;123;127;70;135;154;180;53;121;100;26;86;75;44;25;16;171;175;113;56;31;78;145;179;196;81;90;40;165;185;106;178;3;14;144;62;9;148;102;49;52;55;92;57;129;82;120;2;101;1;97;152;124;94;63;79;80;176,7201917346569553788,0.000997
greedy_intra:edges_start:greedy,134,72262,23844,48418,61910,7,93;108;18;69;139;22;146;159;193;41;5;42;181;34;160;48;54;177;10;190;184;43;116;65;149;123;127;162;151;133;135;70;154;180;53;121;100;26;86;75;120;82;44;25;16;171;175;113;56;31;78;145;179;196;81;90;40;165;185;106;178;3;14;144;62;9;148;102;49;52;55;92;57;129;2;101;1;97;152;124;94;63;79;80;176;137;23;186;89;183;143;117;0;51;118;59;115;46;68;140,7545859014192003075,0.004001
greedy_intra:edges_start:greedy,135,71515,22945,48570,44466,3,135;70;154;158;53;121;100;26;86;75;101;1;97;152;94;124;148;102;49;178;106;52;55;57;92;129;2;120;44;25;16;171;175;113;56;31;78;145;179;196;81;90;40;185;165;138;14;144;62;9;15;114;186;89;183;23;137;176;51;118;59;115;46;0;143;117;93;140;68;139;193;41;5;42;181;159;69;108;18;22;146;34;160;48;54;177;184;43;116;65;149;123;127;162;151;133;80;79;63;180,5543922042549624389,0.002002
greedy_intra:edges_start:greedy,136,72056,23357,48699,67164,7,158;154;180;135;70;133;151;162;127;123;149;65;116;43;184;84;190;10;177;54;48;160;34;146;22;18;108;69;159;181;42;5;41;193;139;68;46;115;59;118;51;0;117;143;183;89;186;23;137;176;80;79;63;94;124;152;97;1;101;2;129;92;57;55;52;49;102;148;9;62;144;14;3;178;106;185;165;40;90;81;196;179;145;78;31;56;113;175;171;16;25;44;120;82;75;86;26;100;121;53,4100768441872469427,0.003000
greedy_intra:edges_start:greedy,137,71600,23030,48570,32988,2,137;23;183;89;186;114;15;9;62;144;14;138;165;185;40;90;81;196;179;145;78;31;56;113;175;171;16;25;44;120;2;129;92;57;55;52;106;178;49;102;148;124;94;152;97;1;101;75;86;26;100;121;53;158;154;70;135;180;63;79;133;162;127;123;149;65;116;43;184;177;54;48;160;34;146;22;18;108;69;159;181;42;5;41;193;139;68;140;93;117;143;0;46;115;59;118;51;151;80;176,26278464783686455,0.002973
greedy_intra:edges_start:greedy,138,71016,22954,48062,46700,5,138;14;144;62;9;148;102;49;178;106;52;55;57;92;129;2;152;124;94;63;79;80;176;133;151;51;118;59;115;46;0;137;23;186;89;183;143;117;93;140;68;139;193;41;5;42;181;159;69;108;18;22;146;34;160;48;54;177;10;190;84;184;43;116;65;131;149;162;123;127;70;135;154;180;53;100;26;97;1;101;86;75;120;44;25;16;171;175;113;56;31;78;145;179;196;81;90;165;40;185,4100417208480263526,0.002000
greedy_intra:edges_start:greedy,139,71369,23246,48123,59434,6,139;68;46;115;59;118;51;0;117;143;183;89;186;23;137;176;80;79;63;94;124;152;97;1;101;2;82;129;92;57;55;52;49;102;148;9;62;144;14;3;178;106;185;40;165;90;81;196;179;145;78;31;56;113;175;171;16;25;44;120;75;86;26;100;121;53;180;154;70;135;133;151;162;127;123;149;65;116;43;184;112;4;190;10;177;54;48;160;34;146;22;18;108;69;159;181;42;5;41;193,2377681890391973750,0.003000
greedy_intra:edges_start:greedy,140,71467,23217,48250,69562,8,140;108;69;18;22;146;159;193;41;5;42;181;34;160;48;54;177;10;4;112;84;184;43;116;65;149;123;127;162;151;133;135;70;154;180;53;121;100;26;86;75;82;120;44;25;16;171;175;113;56;31;78;145;179;196;81;90;165;40;185;106;178;3;14;144;62;9;148;102;49;52;55;57;92;129;2;101;1;97;152;124;94;63;79;80;176;137;51;118;59;115;139;68;46;0;89;183;143;117;93,346595812252839765,0.002225
greedy_intra:edges_start:greedy,141,71100,22509,48591,80178,9,114;23;89;183;143;0;117;93;140;68;46;115;139;193;41;5;42;181;159;69;108;18;22;146;34;160;48;54;177;10;190;184;43;116;65;59;118;51;151;133;162;123;127;70;135;154;180;53;121;100;26;86;75;120;44;25;16;171;175;113;56;31;78;145;179;196;81;90;165;40;185;106;178;3;14;144;62;9;148;102;49;52;55;92;57;129;82;2;101;1;97;152;124;94;63;79;80;176;137;186,734671396955311681,0.003364
greedy_intra:edges_start:greedy,142,72083,23284,48799,40703,7,198;139;68;46;115;59;118;51;0;117;143;183;89;186;23;137;176;80;79;63;94;124;152;97;1;101;2;120;44;25;16;171;175;113;56;31;78;145;179;196;81;90;165;40;185;106;178;3;14;144;62;9;148;102;49;52;55;57;92;129;82;75;86;26;100;121;53;180;154;70;135;133;151;162;127;123;149;65;116;43;184;84;190;10;177;54;48;160;34;146;22;18;108;69;159;181;42;5;41;193,3195636086042979886,0.002000
greedy_intra:edges_start:greedy,143,70675,22470,48205,79849,7,143;117;0;46;68;139;115;193;41;5;42;181;159;69;108;18;22;146;34;160;48;54;177;10;190;4;112;84;184;43;116;65;59;118;51;151;133;162;123;127;70;135;154;180;53;121;100;26;86;75;82;120;44;25;16;171;175;113;56;31;78;145;179;196;81;90;165;40;185;106;178;3;14;144;62;9;148;102;49;52;55;57;92;129;2;101;1;97;152;124;94;63;79;80;176;137;23;186;89;183,1339209640346747691,0.002003
greedy_intra:edges_start:greedy,144,71121,23059,48062,55046,5,144;14;138;185;40;165;90;81;196;179;145;78;31;56;113;175;171;16;25;44;120;75;101;1;97;86;26;100;53;180;154;135;70;127;123;162;149;131;65;116;43;184;84;190;10;177;54;48;160;34;146;22;18;108;69;159;181;42;5;41;193;139;68;140;93;117;143;183;89;186;23;137;0;46;115;59;118;51;151;133;176;80;79;63;94;124;152;2;129;92;57;55;52;106;178;49;102;148;9;62,8957849485958808939,0.003001
greedy_intra:edges_start:greedy,145,71450,23310,48140,50490,5,145;179;196;81;90;165;40;185;106;178;3;14;144;62;9;148;102;49;52;55;57;92;129;2;152;97;1;101;26;124;94;63;79;80;176;133;151;51;118;59;115;46;0;137;23;186;89;183;143;117;93;140;68;139;193;41;5;42;181;159;69;108;18;22;146;34;160;48;54;177;10;190;84;184;43;116;65;131;149;162;123;127;70;135;154;180;53;100;86;75;120;44;25;16;171;175;113;56;31;78,5382916247641544208,0.003306
greedy_intra:edges_start:greedy,146,71169,23196,47973,26753,2,146;181;34;160;48;54;177;10;190;4;112;84;184;42;43;116;65;149;123;127;162;151;133;135;70;154;180;53;121;100;26;86;75;44;25;16;171;175;113;56;31;78;145;179;196;81;90;40;165;185;106;178;3;14;144;62;9;148;102;49;52;55;57;92;129;82;120;2;101;1;97;152;124;94;63;79;80;176;137;23;186;89;183;143;117;0;51;118;59;115;46;68;139;41;193;159;69;108;18;22,785453365022642127,0.001668
greedy_intra:edges_start:greedy,147,71885,23673,48212,61468,8,10;177;4;112;184;43;65;116;59;118;115;46;0;51;151;133;162;123;127;70;135;154;180;53;121;100;26;86;75;82;129;92;57;55;52;49;102;148;9;62;144;14;3;178;106;185;40;165;90;81;196;179;145;78;31;56;113;175;171;16;25;44;120;2;101;1;97;152;124;94;63;79;80;176;137;23;186;89;183;143;117;93;140;68;139;193;41;159;69;108;18;22;146;195;181;42;160;34;48;54,6521714193390069624,0.003702
greedy_intra:edges_start:greedy,148,71071,23009,48062,47814,5,148;102;49;178;106;52;55;57;92;129;2;152;124;94;63;79;80;176;133;151;51;118;59;115;46;0;137;23;186;89;183;143;117;93;140;68;139;193;41;5;42;181;159;69;108;18;22;146;34;160;48;54;177;10;190;84;184;43;116;65;131;149;162;123;127;70;135;154;180;53;100;26;97;1;101;86;75;120;44;25;16;171;175;113;56;31;78;145;179;196;81;90;40;185;165;138;14;144;62;9,8543794478348825585,0.002000
greedy_intra:edges_start:greedy,149,71489,23366,48123,49157,5,149;123;127;162;151;133;135;70;154;180;53;121;100;26;86;75;44;25;16;171;175;113;56;31;78;145;179;196;81;90;165;40;185;106;178;3;14;144;62;9;148;102;49;52;55;57;92;129;82;120;2;101;1;97;152;124;94;63;79;80;176;137;23;186;89;183;143;117;0;51;118;59;115;46;68;139;193;41;5;42;181;159;69;108;18;22;146;34;160;48;54;177;10;4;112;84;184;43;116;65,814224010875045424,0.002002
greedy_intra:edges_start:greedy,150,72333,23295,49038,145637,14,121;100;26;101;1;97;152;2;129;92;57;179;145;78;31;56;113;175;171;16;25;44;82;120;75;86;53;154;70;135;180;63;79;80;133;151;162;123;149;65;116;43;184;177;54;48;160;34;146;22;18;108;69;159;181;42;5;41;193;139;68;140;93;117;143;0;46;115;59;118;51;176;137;23;183;89;186;114;15;9;62;144;14;138;165;90;81;196;40;185;55;52;106;178;49;102;148;124;94;189,3696311512279575392,0.006000
greedy_intra:edges_start:greedy,151,71577,23015,48562,42834,3,151;133;162;123;127;70;135;154;180;53;121;100;26;86;75;44;25;16;171;175;113;56;31;78;145;179;196;81;90;165;40;185;106;178;3;14;144;62;9;148;102;49;52;55;57;92;129;82;120;2;101;1;97;152;124;94;63;79;80;176;137;23;186;89;183;143;117;0;51;118;59;115;46;68;139;193;41;5;42;181;159;69;108;18;22;146;34;160;48;54;177;10;190;84;184;43;116;65;131;149,8873420292000136534,0.001567
greedy_intra:edges_start:greedy,152,71501,23312,48189,38321,4,152;1;101;75;86;53;154;70;135;180;63;79;133;151;162;127;123;149;65;116;43;184;10;177;54;48;160;34;146;22;18;108;69;159;181;42;5;41;193;139;68;140;93;117;143;0;46;115;59;118;51;80;176;137;23;183;89;186;114;15;9;62;144;14;138;165;185;40;90;81;196;179;145;78;31;56;113;175;171;16;25;44;120;2;129;92;57;55;52;106;178;49;102;148;124;94;121;100;26;97,4927710387411083306,0.004000
greedy_intra:edges_start:greedy,153,70811,22677,48134,74992,11,93;117;0;143;183;89;186;23;137;176;80;79;63;94;124;152;97;1;101;2;82;129;57;92;55;52;49;102;148;9;62;144;14;3;178;106;185;40;165;90;81;196;179;145;78;31;56;113;175;171;16;25;44;120;75;86;26;100;121;53;180;154;135;70;127;123;162;133;151;51;118;59;65;116;43;184;84;112;4;10;177;54;48;160;34;146;22;18;108;69;159;181;42;5;193;41;115;139;46;68,8594852125049023775,0.003998
greedy_intra:edges_start:greedy,154,71468,22898,48570,34548,2,154;158;53;121;100;26;86;75;101;1;97;152;94;124;148;102;49;178;106;52;55;57;92;129;2;120;44;25;16;171;175;113;56;31;78;145;179;196;81;90;40;185;165;138;14;144;62;9;15;114;186;89;183;23;137;176;80;51;118;59;115;46;0;143;117;93;140;68;139;193;41;5;42;181;159;69;108;18;22;146;34;160;48;54;177;184;43;116;65;149;123;127;162;151;133;79;63;180;135;70,7482744510006514265,0.001001
greedy_intra:edges_start:greedy,155,71858,23953,47905,28277,3,21;14;138;165;185;40;90;81;196;179;145;78;31;56;113;175;171;16;25;44;120;75;86;26;124;94;63;79;80;176;133;151;51;118;59;115;46;0;137;23;186;89;183;143;117;93;140;68;139;193;41;5;42;181;159;69;108;18;22;146;34;160;48;54;177;10;190;184;43;116;65;131;149;162;123;127;70;135;154;180;53;100;101;1;97;152;2;129;92;57;55;52;106;178;49;102;148;9;62;144,7704257774975304141,0.001002
greedy_intra:edges_start:greedy,156,71450,22843,48607,110460,11,149;123;162;151;133;135;70;154;180;53;121;100;26;86;75;120;44;25;16;171;175;113;56;31;78;145;179;196;81;90;165;40;185;106;178;3;14;144;62;9;148;102;49;52;55;57;92;129;82;2;101;1;97;152;124;94;63;79;80;176;137;23;186;89;183;143;117;0;51;59;118;46;68;139;115;116;65;43;42;5;41;193;159;69;108;18;22;146;181;34;160;48;54;177;184;35;84;4;112;131,2595148415197484234,0.006000
greedy_intra:edges_start:greedy,157,71686,23239,48447,62296,7,157;196;81;90;165;40;185;106;178;3;14;144;62;9;148;102;49;52;55;179;145;78;92;57;129;2;152;97;1;101;26;100;121;94;63;79;80;176;133;151;51;118;59;115;46;0;137;23;186;89;183;143;117;93;140;68;139;193;41;5;42;181;159;69;108;18;22;146;34;160;48;54;177;10;190;184;43;116;65;131;149;162;123;127;70;135;154;180;53;86;75;120;44;25;16;171;175;113;56;31,5761375040343167301,0.002998
greedy_intra:edges_start:greedy,158,71468,22898,48570,33017,2,158;154;70;135;180;63;79;133;151;162;127;123;149;65;116;43;184;177;54;48;160;34;146;22;18;108;69;159;181;42;5;41;193;139;68;140;93;117;143;0;46;115;59;118;51;80;176;137;23;183;89;186;114;15;9;62;144;14;138;165;185;40;90;81;196;179;145;78;31;56;113;175;171;16;25;44;120;2;129;92;57;55;52;106;178;49;102;148;124;94;152;97;1;101;75;86;26;100;121;53,7608885460039579981,0.001000
greedy_intra:edges_start:greedy,159,71854,23604,48250,22018,2,159;146;22;18;69;108;140;93;117;143;183;89;0;68;46;139;115;59;118;51;137;176;80;79;63;94;124;152;97;1;101;2;120;82;129;57;92;55;52;49;102;148;9;62;144;14;3;178;106;185;165;40;90;81;196;179;145;78;31;56;113;175;171;16;25;44;75;86;26;100;121;53;180;154;70;135;133;151;162;127;123;149;65;116;43;184;112;4;190;10;177;54;48;160;34;181;42;5;41;193,8159092447534766248,0.001000
greedy_intra:edges_start:greedy,160,71370,23397,47973,18165,1,160;48;54;177;10;190;4;112;84;184;42;43;116;65;149;123;127;162;151;133;135;70;154;180;53;121;100;26;86;75;44;25;16;171;175;113;56;31;78;145;179;196;81;90;40;165;185;106;178;3;14;144;62;9;148;102;49;52;55;92;57;129;82;120;2;101;1;97;152;124;94;63;79;80;176;137;23;186;89;183;143;117;0;51;118;59;115;46;68;139;41;193;159;69;108;18;22;146;181;34,6452416772134391336,0.000994
greedy_intra:edges_start:greedy,161,71742,22956,48786,114629,11,127;123;162;151;133;149;131;65;116;43;184;190;10;177;54;48;160;34;146;22;18;108;69;159;181;42;5;41;193;139;68;46;115;59;118;51;0;117;143;183;89;186;23;137;176;80;79;63;94;124;152;97;1;101;2;120;82;129;92;57;55;52;49;102;148;9;62;144;14;3;178;106;185;40;165;90;81;196;179;145;78;31;56;113;175;171;16;25;44;75;86;26;100;121;53;158;180;154;135;70,6560042906143517004,0.005028
greedy_intra:edges_start:greedy,162,71833,23710,48123,14879,2,162;151;133;135;70;154;180;53;121;100;26;86;75;44;25;16;171;175;113;56;31;78;145;179;196;81;90;40;165;185;106;178;3;14;144;62;9;148;102;49;52;55;92;57;129;82;120;2;101;1;97;152;124;94;63;79;80;176;137;23;186;89;183;143;117;0;51;118;59;115;46;68;139;193;41;5;42;181;159;69;108;18;22;146;34;160;48;54;177;10;190;4;112;184;43;116;65;149;123;127,8342764782408742434,0.000000
greedy_intra:edges_start:greedy,163,71427,22938,48489,89061,13,140;68;46;139;115;59;118;51;0;117;143;183;89;186;23;137;176;80;79;63;94;124;152;97;1;101;2;129;92;57;55;52;49;102;148;9;62;144;14;3;178;106;185;40;165;90;81;196;179;145;78;31;56;113;175;171;16;25;44;120;82;75;86;26;100;121;53;180;154;70;135;133;151;162;127;123;149;65;116;43;184;84;190;10;177;54;48;160;34;181;42;5;41;193;159;146;22;18;69;108,676366687116006145,0.004002
greedy_intra:edges_start:greedy,164,72133,23605,48528,31447,2,164;7;95;39;165;138;14;144;62;9;148;102;49;178;106;52;55;57;92;129;2;152;97;1;101;26;94;63;79;80;176;133;151;51;118;59;115;46;0;137;23;89;183;143;117;93;140;68;139;193;41;5;42;181;159;69;108;18;22;146;34;160;48;54;177;184;43;116;65;149;162;123;127;70;135;154;180;53;100;86;75;120;44;25;16;171;175;113;56;31;78;145;179;196;81;185;40;90;27;58,557481577522778937,0.002124
greedy_intra:edges_start:greedy,165,71269,23207,48062,45001,4,165;40;185;138;14;144;62;9;148;102;49;178;106;52;55;57;92;129;2;152;97;1;101;100;26;124;94;63;79;80;176;133;151;51;118;59;115;46;0;137;23;186;89;183;143;117;93;140;68;139;193;41;5;42;181;159;69;108;18;22;146;34;160;48;54;177;10;190;84;184;43;116;65;131;149;162;123;127;70;135;154;180;53;86;75;120;44;25;16;171;175;113;56;31;78;145;179;196;81;90,7272820739332474239,0.002000
greedy_intra:edges_start:greedy,166,72023,23478,48545,60357,6,35;184;190;10;177;54;48;160;34;146;22;18;108;69;159;181;42;5;41;193;139;68;140;93;117;143;183;89;186;23;137;176;80;79;63;94;124;152;97;1;101;2;82;129;57;92;55;52;49;102;148;9;62;144;14;3;178;106;185;165;40;90;81;196;179;145;78;31;56;113;175;171;16;25;44;120;75;86;26;100;121;53;180;154;135;70;127;123;162;133;151;51;0;46;115;118;59;65;116;43,7810787180550147792,0.002808
greedy_intra:edges_start:greedy,167,72486,23910,48576,30832,2,167;148;9;62;102;144;14;49;178;106;165;39;95;7;164;58;27;90;81;196;40;185;52;55;57;129;92;179;145;78;31;56;113;175;171;16;25;44;120;2;75;101;1;97;152;26;100;86;53;154;70;135;180;63;79;133;151;162;127;123;149;65;116;43;184;177;54;48;160;34;146;22;18;108;69;159;181;42;5;41;193;139;68;140;93;117;143;183;89;0;46;115;59;118;51;80;176;137;94;124,4667732378320088379,0.001000
greedy_intra:edges_start:greedy,168,72025,23710,48315,63757,8,157;145;179;78;31;56;113;175;171;16;25;44;120;75;86;53;180;154;135;70;127;123;162;149;131;65;116;43;184;190;10;177;54;48;160;34;146;22;18;108;69;159;181;42;5;41;193;139;68;140;93;117;143;183;89;186;23;137;0;46;115;59;118;51;151;133;176;80;79;63;94;124;26;100;101;1;97;152;2;129;57;92;55;52;49;102;148;9;62;144;14;3;178;106;185;40;165;90;81;196,2754406647789886814,0.003816
greedy_intra:edges_start:greedy,169,71132,22937,48195,71137,7,119;40;185;165;138;14;144;62;9;148;102;49;178;106;52;55;57;92;129;2;101;1;97;152;124;94;63;79;80;176;133;151;51;118;59;115;46;0;137;23;186;89;183;143;117;93;140;68;139;193;41;5;42;181;159;69;108;18;22;146;34;160;48;54;177;10;190;184;43;116;65;131;149;162;123;127;70;135;154;180;53;100;26;86;75;120;44;25;16;171;175;113;56;31;78;145;179;196;81;90,8449560506556874631,0.002007
greedy_intra:edges_start:greedy,170,71119,22495,48624,78208,8,170;117;0;46;68;139;115;41;193;5;42;181;159;69;108;18;22;146;34;160;48;54;177;10;4;112;84;184;43;116;65;59;118;51;151;133;162;123;127;70;135;154;180;53;121;100;26;86;75;82;120;44;25;16;171;175;113;56;31;78;145;179;196;81;90;165;40;185;106;178;3;14;144;62;9;148;102;49;52;55;57;92;129;2;101;1;97;152;124;94;63;79;80;176;137;23;186;89;183;143,6780184527536895537,0.002996
greedy_intra:edges_start:greedy,171,71763,23623,48140,47536,4,171;175;113;56;31;145;78;92;179;196;81;90;165;40;185;106;178;3;14;144;62;9;148;102;49;52;55;57;129;2;152;97;1;101;26;124;94;63;79;80;176;133;151;51;118;59;115;46;0;137;23;186;89;183;143;117;93;140;68;139;193;41;5;42;181;159;69;108;18;22;146;34;160;48;54;177;10;190;84;184;43;116;65;131;149;162;123;127;70;135;154;180;53;100;86;75;120;44;25;16,7032387698895997967,0.001998
greedy_intra:edges_start:greedy,172,71955,23490,48465,33297,3,124;167;148;9;62;102;144;14;49;178;106;165;39;27;90;81;196;40;185;52;55;57;129;92;179;145;78;31;56;113;175;171;16;25;44;120;2;75;86;100;53;180;154;135;70;127;123;162;149;131;65;116;43;184;177;54;48;160;34;146;22;18;108;69;159;181;42;5;41;193;139;68;140;93;117;143;183;89;186;23;137;0;46;115;59;118;51;151;133;176;80;79;63;94;121;26;101;1;97;152,7939912178179790484,0.001000
greedy_intra:edges_start:greedy,173,71577,23007,48570,47294,6,127;162;151;133;80;79;63;180;135;70;154;158;53;121;100;26;86;75;101;1;97;152;94;124;148;102;49;178;106;52;55;57;92;129;2;120;44;25;16;171;175;113;56;31;78;145;179;196;81;90;185;40;165;138;14;144;62;9;15;114;186;89;183;23;137;176;51;118;59;115;46;0;143;117;93;140;68;139;193;41;5;42;181;159;69;108;18;22;146;34;160;48;54;177;184;43;116;65;149;123,1556933223262380813,0.001999
greedy_intra:edges_start:greedy,174,71240,23178,48062,41978,4,196;40;185;179;145;78;31;56;113;175;171;16;25;44;120;75;86;101;1;97;26;100;53;180;154;135;70;127;123;162;149;131;65;116;43;184;84;190;10;177;54;48;160;34;146;22;18;108;69;159;181;42;5;41;193;139;68;140;93;117;143;183;89;186;23;137;0;46;115;59;118;51;151;133;176;80;79;63;94;124;152;2;129;92;57;55;52;106;178;49;102;148;9;62;144;14;138;165;90;81,1965647752809185313,0.001000
greedy_intra:edges_start:greedy,175,71398,23258,48140,101297,10,175;113;56;31;78;145;92;179;196;81;90;165;40;185;106;178;3;14;144;62;9;148;102;49;52;55;57;129;2;152;124;94;63;79;80;176;133;151;51;118;59;115;46;0;137;23;186;89;183;143;117;93;140;68;139;193;41;5;42;181;159;69;108;18;22;146;34;160;48;54;177;10;190;84;184;43;116;65;131;149;162;123;127;70;135;154;180;53;86;100;26;97;1;101;75;120;44;25;16;171,2994551292894594019,0.004430
greedy_intra:edges_start:greedy,176,71572,23010,48562,44361,4,176;80;79;63;94;124;152;97;1;101;2;120;44;25;16;171;175;113;56;31;78;145;179;196;81;90;165;40;185;106;178;3;14;144;62;9;148;102;49;52;55;57;92;129;82;75;86;26;100;121;53;180;154;135;70;127;123;162;133;151;149;131;65;116;43;184;84;190;10;177;54;48;160;34;146;22;18;108;69;159;181;42;5;41;193;139;68;46;115;59;118;51;0;117;143;183;89;186;23;137,3766109441704290578,0.002112
greedy_intra:edges_start:greedy,177,71512,22948,48564,107765,10,177;54;48;34;160;42;181;195;146;22;18;108;69;159;193;41;139;68;140;93;117;143;183;89;186;23;137;176;80;79;63;94;124;152;97;1;101;2;82;129;92;57;55;52;49;102;148;9;62;144;14;3;178;106;185;40;165;90;81;196;179;145;78;31;56;113;175;171;16;25;44;120;75;86;26;100;121;53;180;154;135;70;127;123;162;133;151;51;0;46;115;118;59;65;116;43;184;84;190;10,8603285934870079028,0.004003
greedy_intra:edges_start:greedy,178,71071,23009,48062,75070,7,178;49;102;148;9;62;144;14;138;165;185;40;90;81;196;179;145;78;31;56;113;175;171;16;25;44;120;75;86;101;1;97;26;100;53;180;154;135;70;127;123;162;149;131;65;116;43;184;84;190;10;177;54;48;160;34;146;22;18;108;69;159;181;42;5;41;193;139;68;140;93;117;143;183;89;186;23;137;0;46;115;59;118;51;151;133;176;80;79;63;94;124;152;2;129;92;57;55;52;106,1057931053758187001,0.003331
greedy_intra:edges_start:greedy,179,71405,23265,48140,44608,5,179;145;78;31;56;113;175;171;16;25;44;120;75;86;53;180;154;135;70;127;123;162;149;131;65;116;43;184;84;190;10;177;54;48;160;34;146;22;18;108;69;159;181;42;5;41;193;139;68;140;93;117;143;183;89;186;23;137;0;46;115;59;118;51;151;133;176;80;79;63;94;124;26;100;101;1;97;152;2;129;92;57;55;52;49;102;148;9;62;144;14;3;178;106;185;40;165;90;81;196,6548179470661050213,0.002037
greedy_intra:edges_start:greedy,180,71468,22898,48570,33582,2,180;135;70;154;158;53;121;100;26;86;75;101;1;97;152;94;124;148;102;49;178;106;52;55;57;92;129;2;120;44;25;16;171;175;113;56;31;78;145;179;196;81;90;40;185;165;138;14;144;62;9;15;114;186;89;183;23;137;176;80;51;118;59;115;46;0;143;117;93;140;68;139;193;41;5;42;181;159;69;108;18;22;146;34;160;48;54;177;184;43;116;65;149;123;127;162;151;133;79;63,4603725029535160398,0.000999
greedy_intra:edges_start:greedy,181,71199,23226,47973,63142,5,181;34;160;48;54;177;10;190;4;112;84;184;42;43;116;65;149;123;127;162;151;133;135;70;154;180;53;121;100;26;86;75;120;82;44;25;16;171;175;113;56;31;78;145;179;196;81;90;165;40;185;106;178;3;14;144;62;9;148;102;49;52;55;92;57;129;2;101;1;97;152;124;94;63;79;80;176;137;23;186;89;183;143;117;0;51;118;59;115;46;68;139;41;193;159;69;108;18;22;146,5474611191263834264,0.001999
greedy_intra:edges_start:greedy,182,71699,23129,48570,32695,2,158;121;100;26;86;75;101;1;97;152;94;124;148;102;49;178;106;52;55;57;92;129;2;120;44;25;16;171;175;113;56;31;78;145;179;196;81;90;185;40;165;138;14;144;62;9;15;114;186;89;183;23;137;176;80;51;118;59;115;46;0;143;117;93;140;68;139;193;41;5;42;181;159;69;108;18;22;146;34;160;48;54;177;184;43;116;65;149;123;127;162;151;133;79;63;180;135;70;154;53,2784430008654601397,0.001000
greedy_intra:edges_start:greedy,183,71093,22888,48205,13474,1,183;89;186;23;137;176;80;79;63;94;124;152;97;1;101;2;120;82;129;57;92;55;52;49;102;148;9;62;144;14;3;178;106;185;165;40;90;81;196;179;145;78;31;56;113;175;171;16;25;44;75;86;26;100;121;53;180;154;135;70;127;123;162;133;151;51;118;59;65;116;43;184;84;112;4;190;10;177;54;48;160;34;146;22;18;108;69;159;181;42;5;115;41;193;139;68;46;0;117;143,95934998506355203,0.000999
greedy_intra:edges_start:greedy,184,71749,23249,48500,62659,5,184;43;116;65;59;118;115;46;0;51;151;133;162;123;127;70;135;154;180;53;121;100;26;86;75;120;44;25;16;171;175;113;56;31;78;145;179;196;81;90;165;40;185;106;178;3;14;144;62;9;148;102;49;52;55;92;57;129;82;2;101;1;97;152;124;94;63;79;80;176;137;23;186;89;183;143;117;93;140;68;139;193;41;5;42;181;159;69;108;18;22;146;34;160;48;54;177;10;190;84,9079145394493232332,0.002997
greedy_intra:edges_start:greedy,185,71314,23252,48062,31170,3,185;138;14;144;62;9;148;102;49;178;106;52;55;57;92;129;2;152;97;1;101;26;124;94;63;79;80;176;133;151;51;118;59;115;46;0;137;23;186;89;183;143;117;93;140;68;139;193;41;5;42;181;159;69;108;18;22;146;34;160;48;54;177;10;190;84;184;43;116;65;131;149;162;123;127;70;135;154;180;53;100;86;75;120;44;25;16;171;175;113;56;31;78;145;179;196;81;90;165;40,1368968829871584357,0.000999
greedy_intra:edges_start:greedy,186,70687,22482,48205,62364,5,186;89;183;143;117;0;46;68;139;115;193;41;5;42;181;159;69;108;18;22;146;34;160;48;54;177;10;190;4;112;84;184;43;116;65;59;118;51;151;133;162;123;127;70;135;154;180;53;121;100;26;86;75;44;25;16;171;175;113;56;31;78;145;179;196;81;90;165;40;185;106;178;3;14;144;62;9;148;102;49;52;55;57;92;129;82;120;2;101;1;97;152;124;94;63;79;80;176;137;23,1634449753955082517,0.001999
greedy_intra:edges_start:greedy,187,71532,23427,48105,46831,5,27;165;138;14;144;62;9;148;102;49;178;106;52;55;57;92;129;2;152;97;1;101;100;26;124;94;63;79;80;176;133;151;51;118;59;115;46;0;137;23;186;89;183;143;117;93;140;68;139;193;41;5;42;181;159;69;108;18;22;146;34;160;48;54;177;10;190;184;43;116;65;131;149;162;123;127;70;135;154;180;53;86;75;120;44;25;16;171;175;113;56;31;78;145;179;185;40;196;81;90,230678255526509917,0.001000
greedy_intra:edges_start:greedy,188,71843,23528,48315,78587,11,157;31;56;113;175;171;16;25;44;120;75;86;26;100;53;180;154;135;70;127;123;162;149;131;65;116;43;184;190;10;177;54;48;160;34;146;22;18;108;69;159;181;42;5;41;193;139;68;140;93;117;143;183;89;186;23;137;0;46;115;59;118;51;151;133;176;80;79;63;94;124;97;101;1;152;2;129;57;55;52;49;102;148;9;62;144;14;3;178;106;185;40;165;90;81;196;179;92;78;145,4219526284526194358,0.003000
greedy_intra:edges_start:greedy,189,71663,22603,49060,25929,2,189;94;124;148;102;49;178;106;52;55;57;92;129;2;120;44;25;16;171;175;113;56;31;78;145;179;196;81;90;40;185;165;138;14;144;62;9;15;114;186;89;183;23;137;176;80;51;118;59;115;46;0;143;117;93;140;68;139;193;41;5;42;181;159;69;108;18;22;146;34;160;48;54;177;184;43;116;65;149;123;162;151;133;79;63;180;135;70;154;158;53;121;100;26;86;75;101;1;97;152,6654017543935955258,0.001027
greedy_intra:edges_start:greedy,190,71494,23317,48177,89034,9,190;10;177;54;48;34;160;42;181;146;22;18;108;69;159;41;193;139;68;46;115;118;59;65;116;43;184;35;131;149;123;162;133;151;51;0;117;143;183;89;23;137;176;80;79;63;94;124;152;97;1;101;2;129;92;57;55;52;49;102;148;9;62;144;14;3;178;106;185;40;165;90;81;196;179;145;78;31;56;113;175;171;16;25;44;82;120;75;86;26;100;121;53;180;154;135;70;127;112;4,5726809243041577120,0.004007
greedy_intra:edges_start:greedy,191,71952,23153,48799,73767,7,198;68;46;115;59;118;51;0;117;143;183;89;186;23;137;176;80;79;63;94;124;152;97;1;101;2;129;92;57;55;52;49;102;148;9;62;144;14;3;178;106;185;40;165;90;81;196;179;145;78;31;56;113;175;171;16;25;44;120;82;75;86;26;100;121;53;180;154;70;135;133;151;162;127;123;149;65;116;43;184;84;190;10;177;54;48;160;34;146;22;18;108;69;159;181;42;5;41;193;139,8789086954217669401,0.002992
greedy_intra:edges_start:greedy,192,71991,23144,48847,87601,9,96;5;42;181;159;69;108;18;22;146;34;160;48;54;177;10;190;184;43;116;65;59;118;115;46;0;51;151;133;162;123;127;70;135;154;180;53;121;100;26;86;75;82;120;44;25;16;171;175;113;56;31;78;145;179;196;81;90;40;165;185;106;178;3;14;144;62;9;148;102;49;52;55;57;92;129;2;101;1;97;152;124;94;63;79;80;176;137;23;186;89;183;143;117;93;140;68;139;193;41,2010072352123316184,0.004004
greedy_intra:edges_start:greedy,193,71520,23397,48123,51583,6,193;139;68;46;115;59;118;51;0;117;143;183;89;186;23;137;176;80;79;63;94;124;152;97;1;101;2;82;129;92;57;55;52;49;102;148;9;62;144;14;3;178;106;185;165;40;90;81;196;179;145;78;31;56;113;175;171;16;25;44;120;75;86;26;100;121;53;180;154;70;135;133;151;162;127;123;149;65;116;43;184;84;112;4;10;177;54;48;160;34;146;22;18;108;69;159;181;42;5;41,2846000537493468733,0.001999
greedy_intra:edges_start:greedy,194,71873,22902,48971,69730,6,194;127;123;162;133;151;149;131;65;116;43;184;190;10;177;54;48;160;34;146;22;18;108;69;159;181;42;5;41;193;139;68;46;115;59;118;51;0;117;143;183;89;186;23;137;176;80;79;63;94;124;152;97;1;101;2;82;129;92;57;55;52;49;102;148;9;62;144;14;3;178;106;185;40;165;90;81;196;179;145;78;31;56;113;175;171;16;25;44;120;75;86;26;100;121;53;180;154;70;135,9017492651558610520,0.004004
greedy_intra:edges_start:greedy,195,71252,23065,48187,67269,8,195;181;34;160;48;54;177;10;4;112;84;184;42;43;116;65;149;123;127;162;151;133;135;70;154;180;53;121;100;26;86;75;120;82;44;25;16;171;175;113;56;31;78;145;179;196;81;90;165;40;185;106;178;3;14;144;62;9;148;102;49;52;55;57;92;129;2;101;1;97;152;124;94;63;79;80;176;137;23;186;89;183;143;117;0;51;118;59;115;46;68;139;41;193;159;69;108;18;22;146,4093389403915081462,0.003377
greedy_intra:edges_start:greedy,196,71854,23337,48517,57094,6,196;81;90;165;40;185;106;178;3;14;144;62;9;148;102;49;52;55;57;129;92;179;145;78;82;2;101;1;97;152;124;94;63;79;80;176;133;151;51;118;59;115;46;0;137;23;186;89;183;143;117;93;140;68;139;193;41;5;42;181;159;69;108;18;22;146;34;160;48;54;177;10;184;43;116;65;131;149;162;123;127;70;135;154;180;53;100;26;86;75;120;44;25;16;171;175;113;56;31;157,8695174450748544093,0.003000
greedy_intra:edges_start:greedy,197,71871,23072,48799,48934,8,198;46;68;139;193;41;5;42;181;159;69;108;18;22;146;34;160;48;54;177;10;190;84;184;43;116;65;149;123;127;162;151;133;135;70;154;180;53;121;100;26;86;75;82;129;92;57;55;52;49;102;148;9;62;144;14;3;178;106;185;40;165;90;81;196;179;145;78;31;56;113;175;171;16;25;44;120;2;101;1;97;152;124;94;63;79;80;176;137;23;186;89;183;143;117;0;51;118;59;115,6625270111988451581,0.003029
greedy_intra:edges_start:greedy,198,71369,23246,48123,68936,7,68;46;115;59;118;51;0;117;143;183;89;186;23;137;176;80;79;63;94;124;152;97;1;101;2;82;129;92;57;55;52;49;102;148;9;62;144;14;3;178;106;185;40;165;90;81;196;179;145;78;31;56;113;175;171;16;25;44;120;75;86;26;100;121;53;180;154;70;135;133;151;162;127;123;149;65;116;43;184;112;4;190;10;177;54;48;160;34;146;22;18;108;69;159;181;42;5;41;193;139,5216491235227770158,0.003630
greedy_intra:edges_start:greedy,199,71782,23466,48316,33807,4,93;139;68;46;115;59;118;51;0;117;143;183;89;186;23;137;176;80;79;63;94;124;152;97;1;101;2;120;82;129;57;92;55;52;49;102;148;9;62;144;14;3;178;106;185;40;165;90;81;196;179;145;78;31;56;113;175;171;16;25;44;75;86;26;100;121;53;180;154;70;135;133;151;162;127;123;149;65;116;43;184;84;190;10;177;54;48;160;34;181;42;5;41;193;159;146;22;18;108;140,8397197010881707728,0.001000
