method,run,objective,tour_length,selected_costs,evaluations,improvements,final_selected,seed,duration_ms
steepest_intra:nodes_start:random,0,62654,37516,25138,2257450,150,179;20;28;149;140;183;130;95;176;113;89;165;127;137;114;103;163;124;106;153;187;81;160;33;138;182;121;131;38;1;198;117;177;21;82;111;35;109;0;144;104;5;190;80;175;78;36;61;141;97;77;8;56;49;11;25;31;193;54;139;168;145;152;148;47;94;185;86;143;29;90;122;72;107;40;100;63;135;18;55;34;155;3;70;169;134;74;118;51;191;133;10;147;6;188;62;128;194;166;172,689667337113723693,0.067172
steepest_intra:nodes_start:random,1,63380,36156,27224,1988350,132,13;43;118;121;73;193;31;54;51;147;85;134;139;11;160;81;194;166;145;132;169;65;188;6;126;168;195;152;140;183;55;111;8;104;56;144;33;138;25;45;5;177;187;163;103;113;180;176;88;86;128;124;109;29;0;35;143;159;106;189;15;155;184;170;34;18;62;77;82;87;21;78;175;131;90;133;122;135;63;38;27;1;117;190;36;61;141;97;153;95;185;179;94;47;148;60;20;28;3;70,2910469692788774115,0.062999
steepest_intra:nodes_start:random,2,66044,40417,25627,2152800,143,190;5;25;74;118;112;54;117;198;1;16;135;90;191;134;139;11;138;104;8;87;21;61;79;91;82;33;195;13;145;15;3;132;169;6;131;24;156;193;31;73;121;51;182;153;163;103;113;194;166;176;187;141;36;177;107;40;133;147;109;86;185;179;20;28;149;152;168;27;38;63;122;188;70;155;170;34;55;18;35;0;29;160;144;111;143;94;47;148;140;183;95;62;124;106;81;77;78;175;80,4828540852306065410,0.061031
steepest_intra:nodes_start:random,3,57330,32471,24859,2990000,199,152;140;183;95;124;153;81;111;8;144;35;143;159;106;86;185;99;47;94;66;103;127;89;163;187;21;177;73;193;31;54;82;77;141;61;36;78;175;80;190;45;5;25;182;139;169;188;6;147;117;198;1;38;63;100;40;107;17;72;10;133;122;90;51;121;112;131;135;118;138;104;160;33;11;168;195;13;132;70;3;34;55;18;62;176;113;194;166;179;148;20;28;149;155;15;145;29;0;109;170,2083254579450907546,0.081859
steepest_intra:nodes_start:random,4,63009,37392,25617,2152800,143,25;5;78;177;8;104;56;144;160;33;49;11;138;182;51;135;63;100;40;107;29;0;109;35;143;159;106;124;62;18;121;198;117;193;31;54;73;136;82;111;13;195;168;21;36;61;140;149;28;20;148;47;183;152;155;189;153;81;77;141;175;80;190;1;131;122;133;10;178;90;125;191;71;147;6;188;169;145;34;55;95;130;185;86;176;113;194;166;66;94;179;103;127;89;163;15;3;70;132;139,1196576927512197182,0.061966
steepest_intra:nodes_start:random,5,63555,35313,28242,2152800,143,160;33;144;56;104;138;51;131;38;27;16;1;21;82;81;153;163;89;127;103;113;176;194;166;147;107;40;63;136;175;78;45;121;125;90;191;71;188;70;3;15;145;29;0;35;109;170;183;140;28;152;184;155;189;128;86;185;130;95;11;182;25;5;177;8;143;159;106;124;62;18;55;34;139;74;118;134;43;168;195;13;132;169;6;122;135;117;193;31;54;73;190;80;36;61;141;77;111;12;39,7326638739101168993,0.063262
steepest_intra:nodes_start:random,6,64482,37574,26908,2421900,161,89;127;187;141;118;74;109;55;95;185;86;166;153;77;81;62;18;34;3;132;169;6;147;192;188;70;155;183;66;94;47;148;60;20;28;140;152;170;189;138;182;36;61;79;91;8;168;195;145;15;13;191;90;135;63;1;198;117;54;73;136;104;56;144;33;25;31;193;190;80;175;5;177;21;87;82;111;12;0;35;124;194;113;176;106;143;29;11;139;43;134;98;51;121;131;122;133;10;160;163,5487807553417393593,0.068603
steepest_intra:nodes_start:random,7,58637,33308,25329,2347150,156,179;22;99;185;130;95;55;34;189;3;70;161;195;168;145;15;155;184;152;18;62;128;124;106;143;144;160;139;134;51;98;118;182;11;29;0;109;35;111;81;153;163;89;127;165;82;87;21;142;80;190;45;5;177;8;104;33;138;25;121;54;31;193;117;1;38;63;135;122;90;6;13;132;169;188;147;40;107;133;140;94;47;148;20;183;77;97;91;61;78;175;36;141;187;103;113;176;194;166;86,8374314864088941097,0.067317
steepest_intra:nodes_start:random,8,65211,39353,25858,1943500,129,97;141;77;81;124;140;183;95;130;99;166;194;153;82;8;144;160;49;29;34;55;18;62;103;163;21;73;31;54;117;198;156;193;175;36;61;91;128;86;185;179;66;94;47;148;60;20;145;195;168;35;143;106;176;180;113;159;139;51;90;191;6;132;13;70;161;169;188;147;122;63;38;27;190;80;5;177;111;0;109;170;152;155;3;15;11;33;56;104;25;1;135;131;121;182;138;89;127;187;146,973728825460285496,0.055987
steepest_intra:nodes_start:random,9,65095,39940,25155,2317250,154,183;83;62;124;106;176;166;194;113;81;82;177;5;136;193;117;54;31;73;45;78;175;80;190;138;33;160;143;128;185;179;86;104;25;151;198;156;24;1;135;122;51;139;11;103;114;127;153;77;21;61;36;91;141;97;187;165;89;163;35;29;145;155;152;28;20;148;47;94;121;131;63;40;107;133;10;147;134;43;168;195;132;169;90;191;6;188;70;3;34;130;95;18;109;0;144;8;111;55;140,7801883802454495979,0.073003
steepest_intra:nodes_start:random,10,67407,39592,27815,2257450,150,63;122;90;191;98;177;61;36;78;136;193;31;73;5;91;106;128;166;194;141;175;80;190;117;54;25;104;144;8;82;21;33;11;145;15;155;189;29;160;111;77;97;187;89;113;179;185;86;176;180;143;109;3;70;132;169;188;6;10;72;107;40;100;163;103;114;137;127;165;153;81;138;182;74;118;121;112;19;131;125;51;134;139;0;35;124;62;18;183;140;152;195;168;147;178;133;135;1;27;38,8185599367018053683,0.066006
steepest_intra:nodes_start:random,11,58070,33505,24565,2107950,140,81;127;114;113;103;89;187;97;77;141;91;177;73;193;117;121;182;138;11;139;168;13;132;169;70;155;152;140;183;55;18;34;188;147;90;122;133;107;40;63;135;131;51;104;144;124;95;130;99;66;94;148;9;170;189;3;15;145;195;109;29;49;33;160;111;153;163;86;185;179;47;60;20;28;149;4;62;128;176;180;194;166;106;143;35;0;8;61;36;5;78;175;80;190;136;31;54;25;21;82,2208311502348156449,0.059000
steepest_intra:nodes_start:random,12,56241,30510,25731,2691000,179,127;89;194;86;185;130;95;55;34;13;195;18;62;106;153;187;81;77;91;5;136;193;198;117;54;31;73;104;8;144;160;33;49;11;138;182;139;168;169;188;6;147;90;122;135;1;190;80;45;175;78;141;163;103;113;180;176;111;82;21;61;36;177;25;121;51;134;132;70;3;15;145;189;155;184;152;183;9;99;22;128;124;143;35;0;29;109;170;140;4;149;28;20;148;47;94;66;179;166;114,2882950739597478852,0.073000
steepest_intra:nodes_start:random,13,67622,40098,27524,2122900,141,103;113;166;194;127;89;163;187;141;78;175;162;80;190;45;5;144;12;35;143;159;106;176;180;160;90;122;133;10;191;134;43;139;182;138;33;49;11;195;145;15;3;132;169;6;107;40;63;135;77;153;81;56;104;8;21;61;36;91;82;111;18;55;34;189;29;0;109;62;124;128;86;185;95;13;126;168;118;131;1;198;117;121;51;147;192;188;70;155;152;28;20;140;183;25;54;31;193;73;177,1390454287114650150,0.057509
steepest_intra:nodes_start:random,14,64532,38496,26036,2302300,153,133;38;27;131;121;33;143;106;176;180;194;166;22;99;185;86;128;124;122;63;135;35;62;95;130;18;55;183;140;4;149;28;20;148;47;81;77;177;5;73;31;193;190;80;162;136;117;198;156;24;1;54;36;61;91;141;153;163;113;179;94;152;155;90;51;134;43;145;189;170;34;111;82;21;78;175;45;25;182;138;104;8;144;160;0;109;29;11;139;168;195;13;132;15;3;70;169;188;6;147,9099637677739818499,0.061000
steepest_intra:nodes_start:random,15,66427,39707,26720,2227550,148,36;78;5;177;157;104;56;144;160;33;138;182;117;193;31;54;73;25;87;21;45;136;190;80;175;141;77;106;124;62;3;15;169;188;6;178;133;10;115;147;70;149;28;20;140;155;134;118;51;107;40;100;63;131;121;8;143;86;185;148;47;94;179;166;35;11;139;43;145;34;55;95;130;99;183;152;170;18;128;176;194;113;163;153;81;1;135;32;122;90;132;13;195;168;29;109;0;111;82;61,1565683366483455342,0.059999
steepest_intra:nodes_start:random,16,62760,38106,24654,2048150,136,0;109;170;28;20;148;47;94;179;185;166;103;163;153;82;21;61;36;141;81;18;55;34;189;145;133;40;107;90;139;11;25;121;27;38;63;135;122;147;188;169;6;131;1;156;198;117;54;136;177;8;77;187;127;89;86;95;130;183;140;152;155;3;70;15;62;128;124;35;195;168;134;71;191;125;51;182;138;33;143;106;176;194;113;180;111;73;31;193;190;80;175;78;142;45;5;104;144;160;29,8533574081137575138,0.054000
steepest_intra:nodes_start:random,17,62709,36156,26553,2078050,138,90;122;131;121;51;139;170;140;20;28;149;152;155;195;168;29;41;77;97;141;142;45;136;190;80;175;78;5;177;160;12;0;143;106;159;138;25;54;73;104;111;18;62;124;89;103;113;194;166;86;185;95;55;34;3;70;13;43;134;147;133;63;135;1;156;198;117;193;31;182;11;33;144;8;21;36;61;79;91;82;183;148;47;94;179;176;163;187;146;153;81;35;109;145;15;132;169;188;6;191,5763173755900122350,0.055000
steepest_intra:nodes_start:random,18,67612,40777,26835,2093000,139,70;13;145;15;3;189;55;95;130;9;140;183;113;114;103;180;128;34;195;168;139;182;177;36;61;111;0;109;18;62;99;148;20;28;132;122;135;131;121;25;21;141;146;187;165;127;89;163;153;97;77;81;159;106;124;143;82;87;8;144;160;169;188;6;147;178;10;133;191;90;125;51;5;78;175;80;190;138;11;152;47;94;185;86;104;31;193;117;54;73;33;29;35;176;194;166;52;172;179;155,1665765270566113685,0.066001
steepest_intra:nodes_start:random,19,60765,35909,24856,2287350,152,35;111;77;61;36;193;117;198;121;51;33;81;153;163;103;89;127;114;194;166;52;172;179;185;22;99;183;170;145;13;195;168;106;124;62;18;55;34;3;70;188;6;38;27;1;131;90;122;135;63;100;40;107;133;147;134;11;29;20;148;47;94;130;95;86;176;113;141;175;80;190;136;173;104;8;82;21;177;5;78;45;73;31;54;25;182;138;139;169;132;15;149;28;140;152;184;155;189;109;0,3612808378472807341,0.060999
steepest_intra:nodes_start:random,20,61738,37234,24504,2302300,153,183;34;109;35;153;103;113;176;194;166;86;106;159;21;177;54;31;190;80;36;141;187;163;89;165;127;114;179;185;95;18;62;56;104;138;182;139;11;0;143;124;128;130;9;199;140;152;155;147;133;122;107;40;63;135;90;6;70;3;15;145;189;170;148;47;94;66;99;55;168;195;132;169;188;134;74;25;5;78;175;193;117;198;156;1;131;121;51;33;111;81;77;82;8;144;160;29;28;20;60,8999606833589161664,0.062305
steepest_intra:nodes_start:random,21,69117,43097,26020,2810600,187,160;25;198;156;1;135;122;131;182;144;176;113;194;62;15;145;11;138;78;142;45;190;80;175;141;187;165;137;127;89;103;163;153;111;0;35;124;128;86;166;179;185;3;169;191;90;130;99;94;47;148;20;28;188;147;10;44;133;178;6;155;152;140;183;95;106;143;81;77;61;36;104;33;168;195;13;70;161;132;134;121;117;193;31;54;5;177;21;82;8;118;51;98;74;139;29;109;34;55;18,1205510571235251045,0.075138
steepest_intra:nodes_start:random,22,63973,39253,24720,2137850,142,103;26;113;180;176;106;143;35;0;160;29;109;170;152;4;140;183;130;95;62;18;55;34;111;31;117;198;1;27;38;63;135;122;90;147;169;132;13;195;168;33;144;82;21;8;104;51;133;107;40;131;193;190;80;5;124;86;166;194;153;81;77;91;177;112;19;136;45;175;78;25;182;138;11;139;134;6;188;70;3;20;148;47;185;141;61;36;73;54;121;145;155;28;94;66;179;114;127;89;163,4262769965320073418,0.058000
steepest_intra:nodes_start:random,23,58782,32598,26184,2332200,155,182;104;144;160;33;11;139;51;125;90;191;178;133;10;115;147;6;188;65;169;132;13;195;168;145;15;161;70;3;155;170;18;62;95;130;99;166;114;103;113;194;20;28;149;4;86;176;180;153;77;5;142;175;78;36;61;21;8;82;91;141;187;127;89;163;143;0;122;135;63;38;1;193;190;80;31;54;117;198;121;25;177;111;106;124;128;185;179;94;47;148;55;35;109;34;183;140;152;29;138,8399065944904937512,0.062002
steepest_intra:nodes_start:random,24,62805,37747,25058,2107950,140,15;3;13;168;139;25;54;31;61;91;97;153;81;77;21;51;125;107;40;124;128;106;143;111;177;190;80;175;78;5;121;131;122;135;63;100;133;10;147;6;188;169;132;70;155;28;20;148;47;94;179;166;194;176;113;26;103;163;8;104;144;160;33;138;11;49;35;152;140;183;95;130;185;86;114;137;127;89;187;141;36;136;193;117;1;90;191;71;134;62;83;18;55;34;189;145;195;29;0;109,6916762035081304369,0.056998
steepest_intra:nodes_start:random,25,64048,39117,24931,2242500,149,153;89;127;187;141;36;63;40;107;100;90;191;121;175;78;25;134;169;132;29;0;109;35;170;34;18;55;4;149;140;183;62;124;106;159;143;111;144;182;135;32;122;133;10;147;6;188;86;166;194;176;113;103;163;8;104;138;11;139;168;195;13;70;3;15;145;136;190;80;42;156;1;28;20;60;148;47;94;66;179;185;95;152;155;189;160;33;51;125;131;198;117;193;31;54;73;5;177;21;77,442979694677087426,0.059001
steepest_intra:nodes_start:random,26,59658,33948,25710,2033200,135,176;180;113;194;166;86;29;160;33;138;182;74;118;25;177;5;45;142;175;78;36;61;1;27;38;63;135;122;131;121;139;11;104;73;31;54;117;198;193;190;80;136;6;188;169;161;70;189;106;124;62;18;55;20;148;47;94;140;183;99;179;185;168;195;126;132;13;145;15;3;155;152;170;34;35;109;0;8;82;77;81;153;163;103;89;127;187;141;21;134;147;90;51;98;144;111;143;128;95;130,135434615624959757,0.054999
steepest_intra:nodes_start:random,27,63549,38681,24868,2167750,144,47;94;99;130;128;124;8;21;45;80;190;193;117;198;1;38;63;135;29;109;0;144;104;177;78;175;142;121;131;122;133;90;191;35;143;106;176;180;113;194;166;86;95;183;140;152;134;51;98;118;55;185;179;103;163;153;111;160;168;195;145;13;132;169;188;6;139;11;49;33;138;182;25;54;31;73;5;36;61;141;187;127;89;62;18;34;189;15;147;10;107;40;70;3;155;149;28;20;60;148,1781820265502391804,0.057506
steepest_intra:nodes_start:random,28,65062,36910,28152,2392000,159,102;63;122;188;70;161;13;132;191;90;125;51;21;87;82;153;163;89;127;103;113;176;18;55;170;152;140;183;130;185;95;62;131;38;27;156;198;117;168;195;6;147;133;107;40;10;169;145;15;3;155;184;34;141;36;61;104;56;29;0;109;35;143;106;166;86;128;124;177;80;190;193;54;121;158;182;138;33;160;144;8;77;97;81;111;11;139;134;74;118;25;5;78;175;45;136;73;31;1;135,5397070409410572781,0.064000
steepest_intra:nodes_start:random,29,56980,31940,25040,2107950,140,151;121;112;19;73;31;193;136;190;80;175;78;5;177;77;97;146;187;141;91;61;36;138;139;168;195;95;130;99;22;185;86;166;194;176;113;103;89;163;153;81;56;104;160;33;11;132;169;188;6;147;133;107;40;63;131;25;29;0;109;179;94;47;148;60;20;28;140;143;111;82;21;8;144;35;55;183;152;155;3;70;15;189;106;124;62;18;34;145;13;134;51;191;90;122;135;1;198;117;54,6846174204616995463,0.057001
steepest_intra:nodes_start:random,30,65113,38524,26589,2137850,142,148;20;28;152;109;0;160;144;111;176;113;103;127;89;51;90;133;10;6;188;169;15;145;29;81;153;187;146;82;131;135;32;102;63;122;147;134;70;3;155;170;34;95;185;86;128;106;77;61;175;80;190;193;54;21;87;25;117;198;121;118;11;189;4;149;140;183;55;18;62;124;143;35;168;195;13;132;139;182;138;33;56;104;8;177;5;73;31;164;136;45;78;36;141;97;163;194;166;94;47,6305225727393977432,0.071001
steepest_intra:nodes_start:random,31,62003,36632,25371,2451800,163,28;62;124;106;103;163;153;81;121;131;100;40;107;122;134;139;11;144;104;177;5;142;175;78;36;61;77;143;55;34;70;132;169;188;10;133;147;6;109;176;113;187;141;80;190;136;173;25;182;43;168;195;13;145;15;3;155;170;183;199;140;152;184;189;29;160;33;138;118;51;191;90;135;63;38;27;1;198;117;193;54;31;164;73;21;8;111;0;35;18;95;47;94;179;166;194;86;185;148;20,651844727217755095,0.085998
steepest_intra:nodes_start:random,32,63622,38348,25274,2197650,146,122;63;135;131;177;21;82;62;83;18;55;34;145;195;168;134;121;54;31;193;175;78;36;61;117;198;156;1;169;70;152;140;183;95;128;124;106;143;35;0;29;33;160;111;103;26;113;166;179;66;94;47;148;99;22;185;86;194;176;180;153;81;77;187;127;137;114;89;163;109;13;132;15;3;155;149;28;20;60;130;144;56;8;104;51;90;133;10;178;147;139;11;138;5;80;190;25;182;188;6,3653032075723492349,0.060003
steepest_intra:nodes_start:random,33,63593,37706,25887,2317250,154,135;122;90;191;125;51;29;0;109;170;152;18;62;124;106;128;183;140;155;145;132;6;147;40;107;139;11;49;33;160;144;8;82;21;78;175;36;141;77;81;153;163;103;113;180;176;143;15;3;70;161;195;168;134;118;74;182;138;35;34;55;130;95;91;61;177;25;121;178;10;133;63;1;156;198;117;54;73;31;193;190;80;45;5;188;169;13;194;166;86;185;148;20;60;47;94;179;111;104;131,8541457166535133334,0.064998
steepest_intra:nodes_start:random,34,61761,37098,24663,2586350,172,187;8;104;144;143;176;113;194;166;60;20;81;77;5;45;190;80;175;78;142;21;82;106;148;47;94;66;179;141;91;61;36;177;25;51;191;133;10;147;169;132;139;11;109;34;55;140;183;95;62;18;189;145;13;195;168;29;0;35;124;86;185;130;152;155;15;3;70;188;6;134;118;121;73;31;54;131;125;90;122;40;63;102;135;38;27;1;156;198;117;193;182;138;33;160;111;153;163;89;127,8899711012687425186,0.072081
steepest_intra:nodes_start:random,35,68652,43359,25293,1973400,131,73;25;168;145;15;189;170;148;47;94;183;3;70;155;152;28;20;140;195;134;90;122;133;10;147;6;188;169;132;109;35;62;18;55;34;182;1;24;156;198;136;5;176;194;166;185;130;95;86;82;21;175;78;177;104;29;0;89;127;114;113;103;163;111;144;56;8;77;97;153;81;160;33;11;139;107;40;63;135;138;143;124;106;187;141;61;36;45;80;190;193;117;131;121;125;51;98;112;54;31,5356251888821850359,0.051999
steepest_intra:nodes_start:random,36,67414,42796,24618,2093000,139,63;40;107;100;122;182;138;33;160;0;111;176;194;166;179;66;94;28;149;4;155;3;70;15;145;153;163;165;187;81;77;82;21;61;36;5;193;31;140;20;60;148;47;114;127;89;103;113;35;109;195;13;132;169;188;6;190;80;141;86;185;130;95;128;106;159;143;124;62;83;18;55;170;189;168;121;198;117;54;25;11;152;183;174;34;29;139;147;10;133;90;51;118;104;8;177;78;175;1;135,4485224380940059674,0.060001
steepest_intra:nodes_start:random,37,70631,44541,26090,2003300,133,185;179;172;52;166;194;113;176;106;160;33;138;182;74;134;169;132;15;3;155;184;152;170;29;11;139;147;10;133;63;1;198;117;54;112;121;51;118;144;111;143;124;145;188;6;122;32;135;18;62;94;47;148;183;55;177;78;142;5;168;195;8;82;21;190;80;175;36;77;81;153;163;103;89;127;187;97;141;91;61;136;193;156;16;27;38;90;70;28;20;140;34;35;109;0;25;31;73;104;86,8451532618897919064,0.054526
steepest_intra:nodes_start:random,38,65058,39885,25173,2586350,172,35;0;144;8;21;61;36;91;153;194;166;86;34;132;169;6;147;10;133;122;90;188;70;149;28;4;155;3;15;145;29;109;185;94;47;148;60;20;140;152;139;51;135;63;38;27;1;131;43;168;195;13;134;121;73;136;190;80;175;78;5;177;141;187;127;89;103;163;11;74;118;182;138;82;77;81;159;143;111;160;33;25;54;117;193;31;104;124;95;130;183;55;18;83;62;128;176;113;180;106,967017817235993179,0.069154
steepest_intra:nodes_start:random,39,60927,36113,24814,2242500,149,168;195;145;15;3;70;132;13;189;140;148;47;60;20;28;155;169;147;122;63;135;6;188;134;5;175;80;190;193;198;156;1;133;10;178;191;90;25;177;21;82;111;0;109;35;34;170;152;183;55;18;62;128;113;194;166;179;66;94;11;139;118;121;112;73;31;54;117;131;125;51;182;138;104;8;61;36;91;141;187;89;127;137;114;103;163;77;160;33;29;143;106;124;95;185;86;176;180;153;81,6195756919212213259,0.060508
steepest_intra:nodes_start:random,40,65029,37826,27203,2257450,150,160;29;109;0;144;173;73;136;45;5;61;36;175;78;177;168;195;55;130;99;95;62;134;122;63;133;10;147;6;188;169;145;34;18;86;166;194;113;176;153;81;111;143;159;106;124;185;94;47;148;20;28;35;56;104;8;21;82;77;97;141;91;138;11;139;182;25;54;31;156;16;27;42;80;190;193;131;51;132;13;15;155;184;152;140;183;3;70;191;90;135;38;1;198;117;151;112;121;118;33,1313803546129793911,0.060000
steepest_intra:nodes_start:random,41,62783,37410,25373,2107950,140,152;3;70;15;33;160;144;8;21;61;36;175;78;111;35;109;0;29;104;177;5;73;31;193;190;80;141;77;106;22;99;130;95;62;168;195;13;145;34;18;55;170;155;11;139;134;74;118;98;51;191;90;125;131;112;121;169;188;6;147;135;102;63;40;107;122;138;187;89;127;137;114;113;176;179;148;20;60;47;94;66;166;194;26;103;163;153;81;82;54;117;198;25;143;124;128;86;185;183;140,4879977335813260476,0.057001
steepest_intra:nodes_start:random,42,64541,38406,26135,2152800,143,70;155;20;148;47;94;185;86;166;163;153;144;160;104;8;111;143;159;81;77;97;141;91;61;73;164;31;25;182;138;139;134;10;133;107;40;63;135;122;90;11;29;152;140;183;130;95;3;15;145;13;195;168;49;33;177;5;190;80;162;175;82;113;194;114;137;127;165;187;36;78;45;136;193;117;54;21;89;103;128;62;18;55;34;109;0;35;124;106;176;180;118;98;121;51;71;147;6;188;169,1392223295215695338,0.057000
steepest_intra:nodes_start:random,43,57817,32921,24896,2556450,170,163;137;114;166;20;28;140;183;55;18;95;148;47;94;179;194;127;89;103;113;86;185;22;99;130;152;170;34;62;176;153;81;111;8;82;77;97;141;91;79;61;143;106;124;35;109;0;29;177;78;175;45;121;131;122;133;10;134;139;138;182;25;136;80;190;193;156;1;24;198;117;54;31;73;5;36;21;104;144;160;195;145;15;3;70;132;51;90;135;63;40;107;147;6;188;169;13;168;11;33,8002591312002423333,0.068000
steepest_intra:nodes_start:random,44,58259,33571,24688,2302300,153,38;1;131;90;51;29;109;0;25;54;31;193;117;121;195;13;145;70;132;169;188;139;21;141;91;61;36;5;45;190;80;175;78;177;81;185;179;99;130;95;83;55;34;170;152;184;155;3;15;163;89;103;166;86;128;18;62;124;106;143;153;180;176;194;113;114;137;127;187;97;77;82;8;104;138;11;33;160;144;111;35;183;199;20;60;94;47;148;28;149;140;189;168;43;134;6;147;122;135;63,7683646584131645635,0.061000
steepest_intra:nodes_start:random,45,61582,36809,24773,2451800,163,35;0;109;189;70;132;169;188;6;147;54;73;25;138;11;139;182;45;142;5;177;104;160;33;145;15;3;155;149;28;20;148;183;140;152;34;55;18;95;86;185;47;94;179;166;194;113;103;89;176;106;29;43;134;74;118;51;191;90;133;122;135;38;27;1;198;117;193;31;63;100;40;107;121;141;187;127;163;153;77;81;41;111;144;8;21;175;78;168;195;13;136;190;80;36;61;82;143;124;62,5408805728292468014,0.065000
steepest_intra:nodes_start:random,46,71546,45830,25716,1973400,131,198;117;193;177;187;127;89;33;49;11;168;43;182;36;61;82;183;140;20;148;179;166;194;180;176;106;143;133;107;40;10;70;3;189;155;184;152;34;55;18;62;95;130;185;86;153;81;73;164;31;54;25;138;124;47;94;113;103;163;175;80;190;5;104;160;144;8;21;91;141;77;111;195;13;132;191;90;125;51;6;188;134;118;74;139;0;35;109;29;121;131;135;63;122;147;169;161;15;145;1,7639818588632016742,0.053000
steepest_intra:nodes_start:random,47,63967,38747,25220,2466750,164,60;94;47;148;9;183;18;109;136;73;31;54;182;11;139;6;188;169;145;95;185;179;86;166;194;187;36;175;162;80;190;45;177;104;160;29;0;35;143;124;106;163;89;127;103;113;176;153;21;193;117;198;121;51;118;138;33;144;111;81;77;97;141;82;8;168;195;34;55;152;155;3;70;131;1;135;102;63;96;122;90;10;133;100;40;107;147;134;74;25;5;142;78;61;91;62;140;149;28;20,3939629682263660833,0.066000
steepest_intra:nodes_start:random,48,65395,40701,24694,2511600,167,175;80;190;5;177;82;77;187;127;89;106;143;104;25;1;27;38;135;122;90;51;139;160;144;111;153;163;103;114;113;180;176;194;166;179;22;185;86;61;36;21;138;11;145;155;152;149;28;140;183;95;109;29;33;182;118;121;198;117;193;31;54;73;74;134;188;169;132;161;13;126;195;34;18;62;35;0;168;6;147;133;107;40;63;131;91;141;124;55;170;189;15;70;3;20;148;47;94;99;8,3466178027325916895,0.067000
steepest_intra:nodes_start:random,49,62479,32914,29565,2481700,165,51;125;90;191;147;134;11;33;160;56;144;109;170;152;4;149;28;20;148;47;94;179;185;130;95;25;121;5;78;175;142;45;136;193;117;54;31;164;73;190;80;162;177;128;83;183;140;29;49;6;188;169;132;13;70;3;113;103;163;153;97;77;104;138;139;43;168;195;126;145;15;124;106;143;159;81;141;91;79;61;36;21;87;82;8;111;176;194;166;86;184;155;189;34;55;18;62;35;0;182,978722623285614712,0.067571
steepest_intra:nodes_start:random,50,62014,34589,27425,2033200,135,29;109;62;18;55;152;170;34;124;106;176;194;113;103;89;163;143;35;0;160;33;104;8;82;81;153;77;141;61;36;142;73;54;31;136;175;78;177;182;134;85;71;191;90;121;158;25;5;45;80;190;1;135;63;122;51;138;144;111;128;86;166;179;185;22;99;130;95;189;15;3;70;132;193;117;198;27;38;131;6;188;147;115;10;133;178;169;155;28;20;148;183;140;145;13;195;168;139;11;49,7282556777817464049,0.054919
steepest_intra:nodes_start:random,51,60786,34413,26373,2107950,140,111;95;185;94;47;148;60;20;28;149;4;152;170;55;62;124;176;113;103;163;153;81;77;10;133;122;131;121;98;118;169;132;195;168;74;158;112;198;1;63;135;117;193;175;78;5;25;182;138;104;8;82;87;21;177;73;54;31;190;80;36;61;141;187;127;194;166;86;106;159;143;160;33;29;109;34;140;183;83;18;35;0;49;11;139;43;134;6;188;70;3;15;145;147;107;40;100;90;51;144,7397202375388602277,0.056804
steepest_intra:nodes_start:random,52,57731,32654,25077,3004950,200,179;94;47;148;20;28;140;183;174;55;18;62;77;91;36;61;21;8;0;109;13;132;195;160;144;56;104;138;134;6;147;122;107;40;63;135;131;121;125;90;191;51;98;118;182;33;29;170;152;155;145;168;139;11;81;153;163;89;127;103;176;106;124;143;111;82;177;25;188;169;70;3;15;189;34;86;166;194;113;187;141;5;78;175;45;80;190;136;73;31;193;117;198;156;1;54;35;95;130;185,7319202104956962935,0.080966
steepest_intra:nodes_start:random,53,62802,32603,30199,2421900,161,160;29;195;13;132;169;6;10;107;40;100;90;125;121;112;151;198;1;131;51;98;182;138;104;8;56;144;143;62;83;18;55;34;155;188;147;178;133;122;63;102;135;117;193;190;80;31;54;5;77;176;166;86;106;61;36;78;175;45;136;73;173;177;21;87;82;111;159;124;95;185;130;183;140;152;109;0;35;81;153;163;89;187;141;91;25;118;74;134;161;70;3;15;145;168;43;139;11;49;33,2037590899715110917,0.066031
steepest_intra:nodes_start:random,54,61732,35048,26684,1898650,126,91;141;187;113;176;106;195;168;139;11;124;86;166;179;94;47;148;140;183;145;13;134;51;121;112;54;73;164;31;117;131;10;133;122;1;156;198;193;190;80;175;78;5;45;136;27;38;102;63;32;135;90;191;147;188;169;18;62;128;95;185;60;23;20;28;70;3;155;152;55;34;182;25;177;21;82;77;81;159;143;35;109;0;12;29;160;33;138;104;153;89;127;103;163;111;144;56;8;61;36,2352586970097587640,0.050972
steepest_intra:nodes_start:random,55,61272,35129,26143,2362100,157,55;34;145;13;15;3;189;128;86;95;185;94;47;148;60;20;28;168;191;90;125;51;104;8;21;61;36;141;187;166;183;140;53;155;70;147;133;122;107;40;63;135;131;5;177;111;143;106;124;62;83;18;109;29;11;139;43;134;182;138;33;82;77;81;153;163;89;127;137;114;103;26;113;194;176;35;0;160;25;198;1;16;38;27;156;117;193;31;54;73;121;6;188;169;132;126;195;184;152;170,8576114487517818974,0.066028
steepest_intra:nodes_start:random,56,67353,42374,24979,2093000,139,97;111;160;33;138;25;73;136;175;78;139;168;195;132;169;134;51;118;11;176;113;163;81;131;63;40;107;133;90;125;121;5;45;190;80;142;177;104;56;35;62;185;95;18;55;34;155;3;15;145;106;103;89;127;165;187;153;141;36;164;193;31;54;143;124;86;166;179;66;94;47;28;149;152;70;188;6;147;122;135;1;198;117;182;29;140;20;60;148;183;109;0;144;8;21;61;91;87;82;77,8325116032675400029,0.056002
steepest_intra:nodes_start:random,57,66522,41024,25498,1973400,131,149;140;183;15;145;33;160;124;128;106;141;61;36;118;74;134;6;192;147;51;117;193;175;78;143;130;99;148;47;176;113;103;127;89;163;187;153;81;77;111;29;3;70;133;63;135;122;90;191;188;169;132;13;126;195;168;139;11;138;21;87;82;8;104;144;35;18;55;34;131;38;1;121;158;25;182;0;109;189;155;152;170;177;5;80;190;31;54;62;95;185;86;194;166;179;66;94;60;20;28,9211339792356515012,0.052999
steepest_intra:nodes_start:random,58,63505,36695,26810,2078050,138,114;103;29;13;195;168;33;11;139;134;6;188;169;132;143;180;176;88;166;194;113;77;61;36;141;97;187;165;127;89;106;155;3;70;15;145;5;175;78;111;18;55;152;149;28;20;140;183;34;35;109;0;82;21;177;193;117;198;156;16;27;38;102;32;135;90;51;138;144;56;8;104;25;54;31;1;63;40;107;122;131;121;98;118;182;160;62;95;148;47;94;185;86;128;124;159;81;153;163;137,7683045977022048605,0.057000
steepest_intra:nodes_start:random,59,66391,38512,27879,2317250,154,36;61;56;145;15;70;3;189;69;29;160;11;139;182;25;131;27;38;63;6;188;169;132;13;155;152;170;195;168;109;0;35;127;137;165;187;77;82;122;135;1;198;117;193;5;177;111;140;28;20;183;83;124;106;153;186;163;89;103;119;159;143;34;55;18;62;176;180;113;26;114;194;166;86;128;144;33;138;157;104;8;21;91;141;81;185;99;130;95;147;10;133;90;51;121;54;31;190;80;175,1590408877667548162,0.062998
steepest_intra:nodes_start:random,60,59304,33523,25781,2511600,167,4;149;140;183;34;109;0;35;111;81;153;163;194;166;52;172;179;185;95;99;94;47;148;20;28;90;122;40;63;135;131;193;190;80;175;78;5;117;1;38;27;156;198;177;104;144;160;168;126;188;6;150;192;147;134;139;11;138;182;121;51;118;74;8;82;21;61;36;141;77;143;106;86;176;113;114;127;89;103;128;55;18;62;124;29;33;25;73;31;54;195;145;15;13;132;169;70;3;155;152,4500755629369944463,0.068007
steepest_intra:nodes_start:random,61,60815,35256,25559,2466750,164,81;159;143;35;0;144;56;25;121;112;193;190;80;45;5;141;187;163;180;176;86;83;18;62;128;124;106;189;3;169;188;70;152;148;47;94;66;179;166;194;127;165;89;103;113;185;95;170;155;15;145;29;111;82;8;104;138;182;139;168;195;160;33;11;134;147;133;122;90;191;51;131;117;198;156;1;63;135;109;34;55;183;140;149;28;20;60;99;153;77;61;36;78;175;136;31;54;73;177;21,2276527718092611543,0.065576
steepest_intra:nodes_start:random,62,67325,41197,26128,2137850,142,143;82;21;73;164;193;117;121;6;126;195;168;138;182;5;45;136;131;191;147;188;169;132;13;29;109;0;160;33;104;157;25;54;31;177;77;81;113;194;176;11;139;134;51;118;74;36;61;141;153;163;103;166;179;94;47;148;20;28;140;183;152;155;15;3;70;40;107;133;145;189;170;55;34;35;144;56;8;111;86;185;130;95;62;18;90;122;63;135;1;156;198;190;80;162;175;78;106;128;124,7966350991431334635,0.058001
steepest_intra:nodes_start:random,63,56927,29686,27241,2586350,172,195;13;70;3;15;145;132;169;188;126;43;11;35;34;55;18;83;62;176;103;89;127;165;187;153;159;189;155;152;140;149;28;20;183;95;86;185;148;47;94;179;166;194;113;163;81;111;33;138;139;134;6;147;191;90;125;182;143;106;128;124;74;118;98;51;25;177;5;73;31;54;121;131;122;135;1;117;193;190;80;175;78;36;141;77;91;61;21;87;82;8;104;56;144;0;109;29;160;49;168,2758197774912122930,0.070000
steepest_intra:nodes_start:random,64,61489,36054,25435,2855450,190,104;25;54;31;193;73;177;21;82;89;127;165;187;139;51;90;107;40;133;10;147;6;161;70;3;15;189;106;103;163;153;8;131;135;102;63;122;145;155;152;140;199;183;34;29;33;11;188;169;132;13;195;168;86;166;194;113;180;176;128;62;18;55;149;28;20;60;148;47;94;179;185;95;124;111;144;138;182;118;121;198;117;190;80;175;78;5;36;61;141;77;81;119;159;143;35;109;0;160;56,4964712708913172964,0.077971
steepest_intra:nodes_start:random,65,61756,35409,26347,2631200,175,54;73;177;77;187;165;127;89;103;163;97;141;91;36;61;21;8;104;144;160;29;0;83;95;130;99;185;86;113;194;166;172;179;189;15;3;70;188;6;147;191;90;51;182;11;139;134;133;122;63;102;135;169;132;13;195;168;111;81;153;106;124;159;143;35;109;34;183;47;148;20;140;33;138;25;78;175;80;190;136;45;5;82;180;176;128;62;18;55;170;152;28;149;4;155;145;121;117;193;31,1127042405042257469,0.070993
steepest_intra:nodes_start:random,66,66099,40603,25496,1883700,125,103;194;166;185;130;95;70;147;40;107;133;168;29;109;0;160;80;190;136;112;121;131;122;90;51;139;11;143;124;128;62;195;169;188;6;5;175;177;21;87;106;86;179;94;148;20;152;189;145;15;3;155;149;28;140;183;77;91;61;36;141;187;163;113;180;176;159;111;8;56;144;170;34;55;18;35;33;25;73;54;31;193;117;198;156;42;27;38;63;135;16;1;182;138;104;82;81;153;89;127,4804342683802366793,0.050228
steepest_intra:nodes_start:random,67,62000,37834,24166,2571400,171,10;133;107;40;63;122;51;25;8;21;177;36;61;141;179;148;60;20;199;140;152;170;189;145;195;168;55;18;62;128;124;144;104;5;175;80;190;31;54;117;121;182;138;160;159;176;180;113;103;114;194;166;66;94;47;99;130;95;185;86;106;35;0;33;11;139;29;109;183;28;149;4;70;132;169;188;90;135;38;27;1;131;13;15;3;155;184;34;143;81;77;187;127;89;163;153;111;134;6;147,4072477691274265476,0.069995
steepest_intra:nodes_start:random,68,59748,34937,24811,2421900,161,132;13;161;70;3;189;34;62;18;55;152;184;155;15;188;6;147;10;133;122;63;1;198;117;193;31;54;73;25;182;139;43;168;195;145;29;109;0;177;190;80;175;141;187;89;103;185;179;94;47;183;124;77;61;36;78;142;45;5;51;98;118;11;35;106;194;166;86;95;130;148;60;20;28;140;160;33;138;104;8;111;143;176;113;114;137;127;163;153;81;82;21;121;131;135;125;90;191;134;169,6556146008522901552,0.065004
steepest_intra:nodes_start:random,69,69382,44225,25157,2302300,153,152;155;3;15;145;43;139;74;118;134;188;70;149;28;20;148;144;104;25;54;31;117;193;136;36;61;141;77;81;111;35;143;159;106;176;113;194;124;109;0;160;33;190;80;175;187;127;89;163;153;29;13;132;169;195;168;11;138;182;51;71;147;6;34;55;185;22;179;166;86;183;140;189;121;135;122;90;125;131;1;156;16;27;38;63;40;107;133;47;94;99;95;18;62;21;78;5;177;8;170,6486763513947629198,0.061998
steepest_intra:nodes_start:random,70,58292,32312,25980,2735850,182,35;143;185;179;66;94;47;148;20;140;15;169;98;121;73;54;31;193;117;198;191;147;6;188;70;3;189;62;124;106;176;194;166;86;55;34;29;160;111;81;153;163;127;114;113;103;89;187;97;77;141;36;78;175;80;190;5;177;21;8;144;104;25;125;90;135;63;38;27;16;156;1;131;122;133;10;178;51;182;138;33;49;195;13;132;168;11;139;74;118;134;145;155;152;183;130;95;18;109;0,158415463053024865,0.074040
steepest_intra:nodes_start:random,71,68151,44318,23833,2317250,154,106;81;77;8;51;90;134;188;169;132;13;176;194;166;86;124;104;25;117;198;121;138;160;33;182;133;107;40;63;102;135;122;10;147;6;70;3;189;18;62;109;0;35;163;89;127;165;153;111;144;29;34;55;95;185;172;179;22;99;130;21;177;175;80;190;136;193;31;54;73;5;36;61;82;170;152;140;183;113;103;187;141;1;38;131;139;11;149;28;20;60;94;47;148;155;15;145;195;168;143,1657532207995842452,0.067000
steepest_intra:nodes_start:random,72,62338,36007,26331,2302300,153,187;163;89;103;113;180;62;18;183;148;60;20;28;149;4;35;8;104;33;160;144;111;81;153;77;141;91;36;61;21;82;138;182;51;90;191;147;152;140;47;94;66;179;185;95;83;55;34;189;145;195;168;0;176;194;166;86;170;3;70;188;6;169;132;13;15;155;184;143;106;124;128;22;99;130;109;29;121;1;27;38;102;63;135;133;10;72;107;40;100;122;139;11;25;54;117;193;31;5;177,7655359081509447280,0.062004
steepest_intra:nodes_start:random,73,59549,34477,25072,2646150,176,160;56;104;61;36;78;175;136;31;54;117;198;112;121;131;90;51;70;140;20;148;47;94;183;152;155;3;15;145;139;11;138;182;118;122;107;40;133;10;147;134;168;195;13;6;188;169;132;189;34;55;18;111;82;87;21;91;141;187;127;89;103;194;166;128;124;143;144;8;77;81;153;163;113;180;176;106;35;33;25;135;63;38;27;1;156;193;190;80;45;5;177;86;185;130;95;62;109;0;29,3085224705897102852,0.071581
steepest_intra:nodes_start:random,74,65862,39720,26142,2257450,150,122;51;124;166;113;176;81;82;112;16;38;27;80;190;136;160;29;0;109;34;140;183;55;35;8;177;73;164;31;173;104;56;144;111;143;106;159;21;5;78;175;142;45;182;139;168;195;145;155;152;28;20;130;95;185;99;148;47;94;179;86;62;18;15;3;70;13;132;169;188;6;147;10;133;90;36;61;91;141;97;187;127;89;103;163;153;77;193;156;1;198;117;54;25;138;33;11;121;131;135,1294077087038169797,0.060965
steepest_intra:nodes_start:random,75,65428,39697,25731,2167750,144,31;73;103;113;194;176;131;1;135;63;122;90;147;6;188;199;20;148;47;94;130;95;83;55;29;144;104;160;33;11;139;43;168;18;62;128;124;106;145;13;132;169;126;195;70;3;15;170;34;35;0;109;189;155;184;152;4;149;28;140;183;134;51;121;54;117;193;190;80;175;141;166;86;185;179;22;99;143;111;82;81;153;163;89;127;165;187;77;21;177;78;5;25;182;138;8;61;36;136;164,3462069255576695330,0.058038
steepest_intra:nodes_start:random,76,60731,33770,26961,2287350,152,54;31;73;138;11;139;182;25;136;190;80;45;5;86;179;94;47;148;20;152;195;168;29;109;62;95;130;185;166;194;176;81;8;104;111;159;143;144;33;49;160;35;106;124;18;55;140;183;113;103;89;163;153;0;145;15;3;189;184;155;70;132;169;188;6;147;10;133;178;90;191;120;51;125;131;38;1;117;193;142;175;78;91;141;97;77;82;87;21;61;36;177;121;122;72;107;40;100;63;135,5809260273300348022,0.062998
steepest_intra:nodes_start:random,77,61128,36608,24520,2227550,148,127;89;163;81;11;139;43;134;118;51;121;136;190;80;177;21;82;8;131;135;63;122;90;6;188;169;132;126;168;195;13;155;184;152;170;34;55;18;62;124;143;35;29;145;15;70;3;189;109;0;144;104;73;164;193;31;54;111;128;95;185;86;113;103;114;137;187;141;61;36;175;78;5;25;182;138;33;160;106;176;166;179;66;94;47;148;20;28;140;183;147;107;40;38;27;1;198;117;77;153,2988698673788599174,0.059042
steepest_intra:nodes_start:random,78,58969,33186,25783,2646150,176,130;99;185;179;66;94;47;35;160;144;104;8;77;97;81;159;143;152;155;145;195;168;134;136;80;190;193;31;73;54;131;122;133;10;147;6;70;3;15;13;132;169;188;43;139;11;138;33;29;109;0;111;82;21;5;142;175;78;141;153;128;4;149;28;20;148;176;163;89;103;113;194;166;86;183;140;55;34;182;117;198;156;24;1;38;63;135;90;191;51;121;25;177;36;61;106;124;62;18;95,5252663020989923142,0.070997
steepest_intra:nodes_start:random,79,62777,36629,26148,2167750,144,18;55;152;170;34;35;8;78;175;80;190;45;141;163;89;103;113;176;194;166;86;179;66;94;185;95;128;62;81;82;21;61;36;177;25;118;51;125;90;131;1;198;117;193;182;155;148;47;99;130;183;140;199;20;28;149;70;3;15;145;189;109;29;13;132;169;188;6;195;168;160;144;111;159;143;124;106;153;77;121;135;63;122;133;10;115;178;191;147;134;139;11;138;104;5;73;31;54;33;0,7843952711389504284,0.058000
steepest_intra:nodes_start:random,80,58452,31460,26992,2631200,175,177;5;78;175;45;80;190;73;31;193;198;156;1;24;117;54;25;182;138;33;160;109;62;18;55;34;3;70;147;133;122;135;63;102;38;27;131;121;11;49;29;0;35;143;106;86;99;148;47;94;66;179;185;169;188;6;191;90;51;139;144;68;82;87;21;104;56;81;153;89;127;103;113;194;166;176;180;163;187;141;36;61;79;91;97;77;168;195;145;155;152;140;28;20;183;95;128;124;111;8,5673342760332974916,0.071998
steepest_intra:nodes_start:random,81,62760,37266,25494,2287350,152,112;121;90;122;63;135;131;45;5;21;87;177;73;193;31;54;51;134;6;147;10;133;1;198;117;182;138;29;109;124;62;18;34;155;70;188;169;132;13;11;144;111;165;127;89;103;26;113;106;143;35;0;163;114;194;185;95;86;176;180;166;179;94;47;148;20;183;55;160;33;145;15;3;104;8;82;81;153;187;141;36;61;77;140;28;149;152;189;195;168;139;74;118;158;25;78;175;80;190;136,1919200984548069768,0.061547
steepest_intra:nodes_start:random,82,64209,38297,25912,2616250,174,60;20;28;11;139;121;54;31;117;198;193;164;73;45;142;175;78;118;98;51;90;191;109;183;47;94;166;187;141;61;36;177;25;182;138;144;81;153;97;77;82;134;147;133;122;63;135;131;6;188;169;132;145;15;155;184;152;4;149;140;170;195;168;29;0;35;143;106;176;194;113;111;160;49;33;104;8;21;5;80;190;136;43;13;70;3;189;34;103;127;89;163;124;62;18;55;95;86;185;148,137820968902571355,0.071002
steepest_intra:nodes_start:random,83,68110,43438,24672,2078050,138,132;13;143;163;89;153;81;82;8;144;0;35;109;29;56;87;21;104;138;168;195;145;15;155;149;28;140;152;25;117;198;131;51;139;11;33;160;49;189;170;34;55;18;111;177;5;193;1;38;63;40;107;133;10;134;106;176;166;194;113;103;127;187;77;135;122;90;147;6;188;70;3;169;121;54;31;190;175;124;148;60;20;183;62;128;95;130;185;22;99;47;94;66;179;86;97;141;36;61;182,8439568605815839781,0.056966
steepest_intra:nodes_start:random,84,62658,38708,23950,2870400,191,8;111;0;109;15;3;70;161;132;131;38;27;1;193;5;36;141;187;153;81;104;138;182;139;11;33;160;29;35;143;106;163;89;127;103;86;95;130;183;140;4;152;170;34;55;18;62;128;176;113;194;166;179;94;47;148;60;20;28;155;145;107;40;63;135;99;22;185;124;77;61;175;80;190;136;121;51;90;122;133;10;147;6;188;169;134;198;117;54;118;13;195;168;43;25;31;73;177;21;82,8390031018835227618,0.078265
steepest_intra:nodes_start:random,85,65903,40167,25736,2302300,153,121;182;8;82;87;21;177;31;193;190;80;175;77;153;163;165;187;141;61;36;5;73;122;133;147;134;29;124;106;143;138;90;191;6;188;169;132;152;140;4;149;28;179;166;127;89;103;113;194;176;180;81;41;111;104;25;16;27;38;131;125;51;98;118;74;139;99;94;47;148;20;183;34;35;0;109;15;3;70;13;195;160;33;11;168;145;155;55;95;185;86;62;18;144;54;117;198;1;63;135,2241999579653600103,0.061001
steepest_intra:nodes_start:random,86,67112,42629,24483,2093000,139,5;73;31;54;131;90;191;6;70;3;163;89;127;137;114;166;172;179;185;62;18;55;0;29;195;168;134;51;98;118;182;138;28;20;60;22;86;103;165;187;141;36;61;21;82;8;33;132;169;188;139;11;49;160;144;111;176;180;153;104;25;193;117;1;135;122;63;40;107;133;147;13;145;143;159;35;109;34;140;183;99;130;95;124;106;81;77;175;80;190;121;155;152;148;47;94;66;194;113;177,655505021433954018,0.056997
steepest_intra:nodes_start:random,87,60683,35044,25639,2048150,136,160;195;168;49;33;25;31;54;19;112;121;118;134;139;11;39;29;145;13;132;70;3;155;152;86;127;89;128;62;18;95;185;166;194;103;163;153;141;21;8;56;104;138;182;51;90;122;135;63;40;107;147;188;169;15;189;109;35;0;190;80;175;78;142;45;136;164;73;5;36;61;177;1;38;27;198;117;193;111;143;179;94;47;148;60;20;28;140;183;170;34;55;124;106;176;113;81;77;82;144,8956504266132562970,0.056000
steepest_intra:nodes_start:random,88,62519,36872,25647,2526550,168,0;111;82;61;5;45;142;175;78;36;141;77;81;153;163;103;159;143;106;124;62;183;199;20;148;94;179;114;187;80;190;136;25;182;155;149;28;140;152;189;11;138;139;43;70;3;15;145;69;109;29;195;168;160;144;33;51;90;10;133;122;121;177;21;8;104;73;54;31;193;117;198;1;135;63;40;147;6;188;169;132;13;89;127;113;176;22;99;130;55;34;18;83;95;185;86;166;194;128;35,1209271875909502826,0.066000
steepest_intra:nodes_start:random,89,68750,42663,26087,2287350,152,118;51;90;122;133;147;6;70;155;152;140;183;124;106;143;111;61;36;127;89;103;113;81;73;164;31;25;33;34;18;55;170;189;168;43;139;138;8;82;141;77;97;187;163;153;35;109;3;15;145;182;78;175;142;134;188;169;132;13;195;104;21;177;54;117;198;193;136;45;5;112;121;107;40;63;102;135;38;27;16;1;156;190;80;194;166;179;94;47;185;95;62;0;29;160;144;176;86;128;11,2075130878548465135,0.062000
steepest_intra:nodes_start:random,90,63674,37809,25865,2556450,170,194;113;141;61;36;117;198;193;190;80;175;5;177;21;82;111;28;20;148;47;99;185;86;34;147;10;133;43;29;0;109;145;15;3;70;132;13;195;168;35;143;163;89;127;187;8;104;144;128;95;130;9;184;155;189;25;73;31;54;121;134;169;188;6;135;63;40;107;100;122;90;191;125;51;118;139;11;182;138;33;160;170;152;140;183;174;55;18;83;62;124;106;81;77;153;176;94;66;179;166,679858673275244035,0.067000
steepest_intra:nodes_start:random,91,58771,33987,24784,2167750,144,63;40;107;100;122;90;51;147;10;133;198;117;31;54;25;168;195;13;169;188;6;134;43;132;70;170;152;184;155;3;15;145;189;55;86;166;194;143;1;38;27;156;193;190;80;45;104;8;82;77;153;163;89;103;124;62;18;140;4;149;28;20;60;148;47;185;95;183;174;34;109;29;160;0;35;106;176;113;127;187;81;111;33;11;139;182;138;177;5;142;175;78;36;61;91;141;21;121;131;135,6989880920036597117,0.058000
steepest_intra:nodes_start:random,92,60213,34803,25410,2586350,172,194;166;185;179;94;47;148;20;99;176;113;163;153;81;82;177;5;136;73;31;193;156;1;38;63;135;122;138;111;143;86;130;95;128;106;77;91;61;21;8;104;144;33;160;29;0;35;124;62;18;34;189;169;188;6;134;74;118;51;191;90;121;45;142;78;175;162;80;190;25;182;139;168;195;155;184;152;140;183;55;109;11;133;10;147;70;3;15;145;13;132;131;198;117;54;36;141;187;127;103,7193164914680786385,0.068002
steepest_intra:nodes_start:random,93,64095,39247,24848,2093000,139,35;29;138;25;177;36;61;91;143;18;95;130;47;94;66;99;185;81;77;141;187;165;137;179;148;20;28;149;152;184;155;145;168;139;45;5;104;160;33;31;193;190;80;175;78;106;124;62;128;176;114;127;89;163;153;111;182;51;131;135;122;90;147;134;195;13;161;70;3;15;132;169;188;6;63;38;27;1;117;54;121;11;34;55;174;183;140;170;109;0;144;8;21;82;103;26;113;194;166;86,6471036799168023891,0.055000
steepest_intra:nodes_start:random,94,60339,35589,24750,2421900,161,130;185;86;166;194;153;81;160;11;43;169;188;6;147;133;135;1;131;182;33;29;12;0;109;35;18;55;34;189;168;139;138;104;8;77;97;163;113;176;106;144;25;73;31;54;117;121;134;195;13;3;155;184;152;183;62;128;124;143;111;82;21;136;193;190;80;45;175;78;5;145;15;70;132;10;107;40;63;122;90;51;118;177;36;61;141;187;127;89;103;179;94;47;148;20;28;149;4;140;95,7201630575460121702,0.067040
steepest_intra:nodes_start:random,95,62990,35480,27510,2182700,145,40;63;102;135;38;1;131;134;139;29;0;49;11;138;54;31;117;198;193;190;80;175;78;142;121;90;191;51;177;36;141;187;165;127;89;163;159;35;109;34;170;152;174;95;86;185;130;183;28;140;55;143;111;82;87;21;61;79;91;97;153;47;94;179;166;194;114;103;144;160;33;104;8;77;81;124;62;18;128;176;113;106;13;132;169;6;188;70;3;145;195;168;182;25;73;136;45;5;112;122,336503073032019296,0.059000
steepest_intra:nodes_start:random,96,66737,41308,25429,2003300,133,80;5;128;86;194;176;180;163;153;81;77;82;8;104;182;138;143;159;89;127;187;141;91;78;175;45;73;164;31;193;198;117;54;183;94;47;148;20;147;90;122;107;40;63;102;135;131;177;36;61;106;124;62;189;3;70;188;169;132;13;15;149;28;140;34;109;0;111;144;33;160;35;18;55;95;130;99;185;179;166;113;103;21;25;121;51;134;145;155;184;152;170;29;11;139;168;195;43;136;190,8874660785972413676,0.053000
steepest_intra:nodes_start:random,97,63753,38356,25397,2302300,153,177;19;112;131;1;135;32;122;133;147;143;106;163;153;8;25;173;54;117;198;27;38;63;40;107;90;82;77;81;111;132;169;188;6;134;51;121;118;74;182;138;11;139;168;195;13;29;0;34;55;18;62;124;176;89;127;103;113;194;166;179;66;94;47;99;185;86;35;109;15;3;70;145;33;160;144;104;5;78;175;142;136;193;31;73;155;152;183;140;20;148;95;45;190;80;36;61;91;141;21,3492961023587767019,0.061001
steepest_intra:nodes_start:random,98,65354,37657,27697,2332200,155,45;5;177;82;87;21;78;175;80;190;193;31;54;63;135;131;141;97;77;111;8;1;38;27;156;198;117;73;25;138;33;160;0;109;35;143;106;180;176;124;62;189;145;132;169;188;6;43;144;81;187;127;166;179;185;95;55;34;147;10;133;122;90;191;184;152;140;183;170;155;3;70;15;153;163;89;103;113;194;86;128;83;18;29;182;121;125;51;134;13;195;168;139;11;104;91;79;61;36;142,5457309644919906390,0.061999
steepest_intra:nodes_start:random,99,60323,34438,25885,2885350,192,38;135;122;90;182;138;29;109;15;3;70;188;6;51;121;54;31;73;5;177;82;111;143;159;106;124;176;113;103;89;163;25;131;1;198;117;193;190;80;175;141;187;146;97;77;62;18;170;152;184;155;145;13;195;168;11;33;160;144;56;8;81;153;194;166;94;47;183;174;95;130;99;22;179;185;86;128;55;140;149;28;20;23;60;148;9;34;35;0;104;21;61;36;139;132;169;147;133;63;27,7731343201770368206,0.077000
steepest_intra:nodes_start:random,100,69454,43483,25971,2392000,159,18;86;194;166;179;94;47;148;185;95;5;80;190;193;156;1;24;198;117;177;21;104;13;70;3;103;163;153;81;8;25;107;40;100;63;135;122;90;183;199;20;28;140;152;155;15;145;160;144;111;176;113;89;127;187;141;36;175;78;82;143;106;124;128;62;35;0;29;11;139;43;168;195;49;33;138;134;188;169;132;189;34;55;109;74;120;51;98;118;182;77;97;91;61;73;31;54;121;147;6,7970164859827195385,0.066000
steepest_intra:nodes_start:random,101,58044,33877,24167,2377050,158,0;29;160;8;82;21;25;122;107;40;133;147;168;166;194;127;89;103;113;176;163;153;111;144;56;177;5;164;31;54;73;45;142;78;175;80;190;136;193;117;198;27;38;63;135;1;131;121;182;138;139;11;34;183;47;94;179;86;106;124;128;185;99;130;95;55;18;62;143;81;77;141;36;61;104;33;195;145;15;70;3;155;152;140;148;60;20;28;189;134;51;90;191;6;188;169;132;13;109;35,5071020960477380585,0.062000
steepest_intra:nodes_start:random,102,60384,35421,24963,2317250,154,10;147;134;74;118;121;131;90;51;139;11;33;138;182;5;177;21;82;185;179;94;47;148;130;95;86;111;8;104;168;145;15;3;70;13;195;29;35;143;106;124;128;62;18;152;155;135;63;38;27;16;1;156;198;117;193;77;97;141;61;36;78;175;80;190;136;0;109;34;55;183;140;20;60;166;194;176;113;103;163;89;127;165;187;153;81;144;160;43;6;188;169;132;126;25;73;31;54;122;133,388929513096004337,0.063505
steepest_intra:nodes_start:random,103,66476,40240,26236,2212600,147,74;182;138;87;21;177;78;175;36;61;153;86;179;94;60;20;34;109;35;18;47;148;140;152;170;55;174;183;130;95;143;5;45;121;90;51;43;168;195;188;169;132;145;62;124;106;176;194;113;25;1;156;198;117;193;80;190;31;54;155;149;28;99;185;166;103;127;89;163;187;141;91;131;135;102;63;122;147;6;70;3;15;29;81;97;77;82;111;0;12;160;144;56;8;104;33;49;11;139;134,4709617614238283467,0.059000
steepest_intra:nodes_start:random,104,61292,34343,26949,2347150,156,3;145;160;144;56;104;8;111;81;77;91;61;175;80;190;109;34;47;94;66;172;86;128;124;62;83;130;95;159;143;35;0;29;33;138;182;118;51;90;135;63;100;40;107;122;147;85;134;6;188;169;132;195;168;121;117;193;5;36;141;97;187;137;114;127;165;89;103;113;194;166;179;22;99;9;140;183;55;18;106;176;88;180;163;153;25;54;31;73;177;21;87;82;185;148;60;20;28;152;155,6579321992075906213,0.062000
steepest_intra:nodes_start:random,105,65125,39274,25851,2227550,148,127;103;113;176;194;166;179;185;18;55;155;3;145;81;153;106;159;143;90;122;63;102;135;1;156;198;117;193;31;54;73;144;111;124;62;29;138;158;121;98;118;74;182;21;91;141;187;163;86;95;183;140;34;35;0;109;170;152;28;20;148;47;94;70;188;6;134;25;177;36;61;87;160;33;11;147;133;107;40;100;38;27;131;125;51;169;195;168;139;5;190;80;175;78;104;56;8;82;77;89,3446777464856042102,0.059000
steepest_intra:nodes_start:random,106,62955,36845,26110,2063100,137,77;8;144;160;0;35;34;55;18;62;124;109;134;90;191;71;6;169;132;13;145;195;122;133;10;147;188;70;3;152;140;183;128;106;143;111;56;104;33;138;25;136;190;80;182;11;139;54;31;117;198;193;73;177;21;82;81;113;103;127;114;194;166;86;185;95;130;20;148;47;94;179;176;97;141;91;61;36;118;51;5;78;175;45;112;121;131;135;63;38;27;1;43;168;29;153;163;89;187;146,6065451256930436507,0.055000
steepest_intra:nodes_start:random,107,65945,40027,25918,2481700,165,149;155;189;121;131;117;31;54;55;47;94;18;62;143;159;111;144;49;168;195;145;15;3;70;73;190;80;136;25;29;109;0;82;8;56;104;191;90;122;63;40;107;188;169;132;13;6;147;178;10;133;135;1;198;193;61;91;77;81;153;163;103;113;194;166;176;187;141;36;78;175;142;5;177;21;34;152;140;183;185;86;106;160;33;138;182;118;98;51;134;139;11;35;124;128;95;130;148;20;28,8602222757543029821,0.065000
steepest_intra:nodes_start:random,108,59082,33271,25811,2466750,164,177;5;73;31;54;121;25;74;118;98;51;90;191;182;104;8;82;77;97;81;153;187;165;127;89;103;163;35;109;145;15;189;34;55;0;29;49;11;139;138;33;160;144;21;141;61;36;78;175;80;190;193;117;198;1;135;63;40;122;134;106;86;185;166;194;114;113;180;176;128;62;152;155;3;70;132;13;195;126;169;188;6;147;10;133;43;168;18;95;130;183;140;148;47;60;20;28;124;143;111,3321304490515870700,0.065001
steepest_intra:nodes_start:random,109,61600,35292,26308,2287350,152,112;117;198;131;125;147;6;188;168;195;13;145;81;153;163;89;103;113;176;166;86;62;170;155;3;15;132;169;134;135;1;73;136;45;175;78;25;11;49;160;144;33;138;182;90;133;10;191;51;98;121;54;31;193;190;80;27;38;63;122;70;152;183;148;47;66;94;60;20;28;140;109;104;56;35;34;55;18;95;130;185;128;124;106;77;141;61;36;5;177;21;82;8;111;159;143;0;29;139;118,1640139289722666530,0.060000
steepest_intra:nodes_start:random,110,64296,39169,25127,2377050,158,94;185;86;176;187;36;78;175;45;80;190;90;191;169;126;195;109;35;143;106;124;34;189;3;15;163;89;103;62;18;55;145;13;132;188;6;134;118;74;182;104;21;177;5;136;193;1;63;40;107;133;51;139;11;49;29;0;160;144;111;81;153;113;166;179;60;20;28;140;168;43;121;198;117;54;31;73;25;138;33;8;77;141;61;112;131;16;27;38;135;122;147;70;155;152;183;95;130;148;47,968242962721224119,0.064511
steepest_intra:nodes_start:random,111,65977,39750,26227,2272400,151,90;122;63;102;135;131;21;87;104;33;138;182;1;156;198;117;190;80;175;78;5;118;74;134;6;147;71;51;121;54;164;73;8;128;185;179;166;177;136;193;31;25;160;183;140;28;20;194;113;114;127;103;180;176;86;95;130;148;60;47;94;99;81;77;153;187;89;163;15;161;70;3;155;152;170;34;111;82;61;36;91;141;55;18;62;124;106;159;143;145;13;132;169;195;168;109;35;0;29;11,2713087422591750535,0.059997
steepest_intra:nodes_start:random,112,59205,34495,24710,2451800,163,139;43;134;147;191;90;125;51;118;25;36;61;141;77;81;106;95;130;20;148;47;94;179;166;194;113;114;127;89;103;163;187;111;8;138;121;131;135;63;40;107;6;70;3;155;170;34;109;177;78;175;5;188;169;132;13;189;55;18;62;124;143;35;0;29;168;195;145;15;184;152;140;183;185;86;176;153;82;21;45;80;190;198;1;38;122;133;10;117;193;31;54;73;136;104;56;144;160;33;11,1609706772011584006,0.065000
steepest_intra:nodes_start:random,113,66056,40039,26017,2137850,142,169;188;70;155;152;140;148;47;94;106;111;160;43;6;134;182;104;82;141;61;36;136;193;31;54;73;25;138;35;62;130;99;22;179;166;194;113;114;127;103;176;86;185;95;128;124;11;139;51;191;90;122;131;198;117;121;4;149;28;20;199;183;177;78;175;21;87;8;144;56;5;45;80;190;1;63;135;77;153;187;89;163;143;15;145;13;195;168;49;33;29;0;109;34;18;55;170;189;3;132,385553715750753015,0.060000
steepest_intra:nodes_start:random,114,63028,36921,26107,2347150,156,153;176;113;194;166;86;28;149;4;140;183;130;185;179;22;99;95;189;195;13;3;155;184;152;148;66;94;47;60;23;20;170;25;73;54;31;193;117;1;40;107;133;90;51;118;177;5;190;80;175;36;61;91;159;106;124;143;41;111;145;15;70;132;169;188;168;139;11;49;104;56;144;29;109;34;55;18;62;35;0;103;89;163;160;33;138;182;8;82;77;97;187;141;122;63;135;131;121;21;81,3044987454032461966,0.064002
steepest_intra:nodes_start:random,115,63216,36275,26941,2063100,137,15;155;189;109;0;111;81;187;153;106;124;143;35;29;195;13;6;147;178;133;44;10;188;70;3;168;182;25;1;38;27;16;117;31;54;104;8;21;61;36;91;141;77;82;144;118;51;191;90;125;121;198;156;135;63;122;131;193;190;80;136;134;169;132;34;55;18;62;128;95;130;185;166;194;176;159;160;33;138;11;139;152;140;183;148;47;94;66;179;22;99;86;180;113;103;163;177;175;5;145,1103736877471262377,0.054998
steepest_intra:nodes_start:random,116,63869,37214,26655,2137850,142,70;161;132;169;188;122;135;90;189;140;20;148;47;94;183;152;155;15;134;51;118;74;168;195;126;13;145;11;138;182;139;43;6;147;131;190;80;162;175;78;8;111;82;21;177;173;54;31;136;45;5;77;97;127;89;103;113;180;176;81;73;193;117;198;27;38;1;0;109;35;34;55;18;62;124;86;95;130;185;179;166;194;106;143;153;163;165;187;141;91;61;36;112;121;25;104;33;160;29;3,5088653919874197591,0.056000
steepest_intra:nodes_start:random,117,61264,35725,25539,2063100,137,138;121;112;36;61;141;97;77;111;144;43;134;51;131;117;54;31;73;33;160;35;0;11;139;29;109;18;55;34;132;169;188;6;192;147;168;195;13;149;28;20;60;99;185;166;194;127;89;103;113;176;62;83;140;183;95;128;124;106;143;159;163;187;153;145;15;70;3;155;184;152;148;47;94;179;86;81;82;21;80;190;136;25;104;8;177;5;78;175;45;193;198;1;38;63;135;122;90;118;182,1122599156493644370,0.056510
steepest_intra:nodes_start:random,118,63466,38488,24978,2018250,134,18;29;139;134;191;90;51;138;144;56;104;177;5;136;73;112;121;6;188;169;70;3;152;140;183;62;124;106;128;86;185;20;148;47;94;179;81;77;97;153;163;89;103;194;166;143;35;0;109;189;15;145;132;13;195;168;147;107;40;100;63;135;122;33;160;111;176;113;114;127;187;141;175;80;190;31;54;173;25;11;155;184;8;82;21;91;61;36;78;193;117;198;1;27;38;131;34;55;130;95,6899237304526623352,0.054033
steepest_intra:nodes_start:random,119,67264,41679,25585,2362100,157,81;111;82;61;36;21;11;168;195;13;132;169;134;118;74;182;138;33;109;18;83;62;144;104;160;35;143;124;106;177;78;175;142;145;15;3;155;184;170;34;55;89;127;103;194;166;185;99;148;60;20;5;45;80;190;136;193;117;135;122;133;147;6;43;29;0;180;176;179;66;94;47;28;70;188;90;51;91;141;187;153;163;113;86;95;130;183;140;152;139;25;54;31;198;1;131;121;8;77;97,4897925697619387685,0.063996
steepest_intra:nodes_start:random,120,64842,38763,26079,2257450,150,111;143;62;18;55;95;130;20;28;170;78;175;80;190;45;5;121;122;100;40;107;10;147;188;6;71;191;51;74;182;138;33;160;144;81;153;163;89;127;103;176;185;94;47;148;195;168;11;139;134;125;131;135;102;63;72;133;90;118;104;56;8;21;61;36;91;141;77;187;113;194;166;86;128;124;106;73;31;54;25;29;109;15;3;70;169;132;145;189;155;152;140;183;34;35;0;117;193;177;82,2267807038357643505,0.060999
steepest_intra:nodes_start:random,121,60452,34037,26415,2392000,159,63;131;198;156;1;27;38;135;32;122;118;104;56;8;153;163;194;166;86;185;47;148;140;183;130;95;18;55;152;155;189;15;3;70;188;6;134;51;90;125;25;82;87;21;177;73;54;31;193;117;121;74;169;132;145;176;113;103;89;127;187;141;5;136;190;80;45;175;78;36;61;91;144;160;49;168;195;13;111;77;81;35;0;33;138;182;139;11;29;109;143;106;124;62;34;147;10;133;107;40,8476604606015334132,0.064001
steepest_intra:nodes_start:random,122,62695,36203,26492,2287350,152,124;141;91;61;36;175;78;144;0;109;34;130;99;185;163;153;81;35;195;13;145;15;3;169;134;74;182;11;139;168;132;161;70;155;189;29;104;136;73;164;31;54;193;117;198;1;121;25;138;33;160;103;114;172;179;66;94;47;148;60;20;28;152;188;6;192;147;10;133;90;51;82;77;187;165;127;89;113;194;166;176;180;143;111;8;177;142;80;190;45;5;21;106;86;95;62;18;55;140;183,6679428525549690210,0.060999
steepest_intra:nodes_start:random,123,55686,30980,24706,2646150,176,153;141;61;91;77;81;143;34;55;18;62;124;106;35;109;0;29;195;13;132;169;188;6;43;139;11;33;160;104;8;166;179;94;47;148;185;86;95;183;140;20;28;152;155;189;168;134;121;131;27;38;135;122;147;70;3;15;145;138;177;5;198;1;63;40;107;133;10;90;191;51;118;74;182;25;73;31;54;117;193;136;190;80;45;142;175;78;36;21;87;82;176;194;113;103;163;89;127;165;187,4902866056331488695,0.071001
steepest_intra:nodes_start:random,124,64381,38601,25780,2451800,163,183;140;28;149;4;155;6;147;133;40;107;122;145;152;20;148;47;94;179;166;194;176;8;104;25;117;198;156;131;118;29;0;109;35;111;159;143;62;18;55;83;128;124;106;81;77;91;36;175;78;5;182;138;195;13;132;169;188;70;3;15;189;34;95;185;86;113;163;82;87;21;177;31;193;80;190;73;112;121;51;134;43;168;139;11;49;33;160;144;153;187;141;61;54;1;38;63;135;90;170,661119746367022090,0.065000
steepest_intra:nodes_start:random,125,62013,35626,26387,2406950,160,35;18;83;62;143;159;26;103;127;89;163;81;111;144;56;104;138;182;139;11;29;109;106;124;128;86;166;179;66;94;47;99;185;55;34;189;145;13;195;33;8;82;21;177;31;193;190;80;175;78;73;54;117;198;156;24;1;135;147;155;152;140;183;134;90;122;40;63;5;36;141;77;153;176;113;194;148;60;20;28;101;149;4;199;130;95;121;131;51;6;188;169;70;3;15;132;168;49;160;0,6349830439562586879,0.064000
steepest_intra:nodes_start:random,126,62825,37767,25058,2526550,168,33;134;10;133;131;190;80;140;199;20;148;99;185;86;176;113;194;166;179;94;47;60;28;149;4;34;35;144;56;104;8;82;21;177;78;175;45;121;6;188;169;132;13;109;106;159;143;0;29;138;54;31;193;73;25;182;11;139;122;100;107;40;63;135;1;117;136;5;36;61;141;77;111;15;3;70;147;71;191;90;51;153;163;89;127;103;124;62;18;55;95;130;183;152;155;145;195;168;49;160,2661256961158394677,0.067000
steepest_intra:nodes_start:random,127,62081,35986,26095,2272400,151,153;106;124;166;176;180;143;109;168;195;189;62;95;130;185;99;183;140;152;70;161;13;126;145;15;28;20;148;47;94;66;179;86;128;29;139;90;122;40;63;135;131;11;33;160;144;8;82;141;187;127;114;194;113;26;103;89;163;111;138;182;51;121;136;45;142;5;177;25;6;188;169;132;3;84;155;184;170;34;55;18;35;0;104;190;80;175;78;36;91;61;31;193;198;117;54;73;21;77;81,5714662883896219769,0.059000
steepest_intra:nodes_start:random,128,65271,38962,26309,1973400,131,163;180;176;8;182;74;51;90;191;147;6;70;3;155;34;55;130;99;94;66;179;22;185;124;143;111;82;21;1;38;63;122;135;117;54;25;33;160;0;29;168;195;183;47;148;20;145;13;132;169;188;89;127;187;177;19;112;121;118;134;139;11;138;104;56;144;109;35;18;62;128;103;114;113;194;166;86;95;140;28;149;4;53;152;170;106;153;81;77;97;141;36;175;80;190;193;31;73;5;61,7901542686232582728,0.052505
steepest_intra:nodes_start:random,129,63806,38093,25713,2078050,138,177;21;82;141;77;153;146;187;194;166;86;185;179;94;47;148;20;188;147;10;133;90;125;36;61;176;180;113;103;163;106;124;128;130;95;62;144;104;117;198;156;1;131;182;138;33;160;11;139;168;189;170;28;149;4;3;70;134;118;51;121;5;78;175;80;190;193;135;107;40;63;96;122;6;169;132;13;34;18;55;183;140;152;184;155;15;145;195;29;0;109;35;143;159;111;8;25;54;31;73,1452273679211385795,0.056000
steepest_intra:nodes_start:random,130,67506,41553,25953,2107950,140,176;8;104;51;191;133;10;178;147;192;6;188;70;3;183;99;179;185;86;193;117;198;25;139;11;33;0;35;124;166;194;103;89;163;187;141;36;5;31;54;118;74;168;195;13;132;169;40;63;135;122;90;155;152;140;20;148;47;94;95;109;29;145;15;34;55;18;83;62;43;134;131;38;27;1;121;182;138;160;143;106;159;111;82;21;177;45;80;190;73;136;142;175;78;61;91;77;81;153;113,366247410728670834,0.055592
steepest_intra:nodes_start:random,131,61298,34996,26302,2421900,161,144;180;176;194;166;86;128;124;106;81;77;82;111;62;18;183;140;20;28;152;145;168;11;33;91;61;190;80;36;141;187;153;41;0;35;143;159;103;26;113;179;185;195;147;10;133;122;135;1;198;117;193;31;54;5;78;175;142;45;136;73;173;177;21;87;8;104;138;25;121;131;90;51;118;74;182;139;134;6;188;169;70;3;15;155;34;55;95;148;47;94;114;137;127;165;89;163;109;29;160,6460878980214301852,0.064000
steepest_intra:nodes_start:random,132,60144,35166,24978,2421900,161,155;184;170;152;140;183;9;148;47;99;143;159;81;77;141;36;177;5;78;175;80;190;193;117;198;1;131;51;6;169;3;70;188;147;107;40;63;135;121;21;82;187;127;89;163;153;8;104;118;191;10;133;44;122;90;134;168;195;13;145;15;34;18;55;4;149;28;20;60;94;179;86;106;124;128;185;130;95;62;138;25;73;31;54;182;139;11;33;0;109;35;166;194;113;176;111;144;160;29;189,8714359837858711036,0.064000
steepest_intra:nodes_start:random,133,58829,32359,26470,2212600,147,70;188;6;134;11;49;33;104;56;144;160;29;0;109;35;8;82;111;34;152;4;149;28;99;185;86;130;95;55;145;195;51;54;105;190;80;136;173;25;138;182;121;131;1;198;117;193;31;164;73;45;142;175;78;5;139;168;15;3;132;169;147;122;135;63;133;10;90;153;163;103;113;176;194;166;179;94;47;148;60;20;140;183;21;177;36;61;91;141;97;77;81;159;143;106;124;128;62;18;155,8676415767007554629,0.058003
steepest_intra:nodes_start:random,134,59883,34311,25572,2676050,178,62;183;95;130;99;185;86;166;194;113;180;176;106;124;179;94;47;148;60;20;28;149;4;140;73;31;54;138;33;160;159;143;49;11;147;10;133;90;111;77;187;165;137;127;89;103;163;153;141;61;36;78;175;142;164;193;117;1;135;63;122;70;3;15;109;35;0;29;144;104;8;82;87;21;177;112;121;51;6;188;169;132;195;168;139;25;136;190;80;162;45;5;182;145;155;152;170;34;55;18,8019923876760285856,0.070998
steepest_intra:nodes_start:random,135,58372,34373,23999,2810600,187,86;166;194;176;106;143;81;153;180;113;103;163;111;144;160;13;132;169;188;6;121;198;156;1;27;38;63;135;122;107;40;133;10;147;134;43;11;89;127;187;77;182;51;90;131;117;193;190;80;31;54;36;61;141;82;8;104;138;139;168;195;29;0;109;145;15;70;3;155;34;55;83;18;35;33;25;5;45;142;175;78;177;21;149;28;20;60;148;47;94;179;185;95;183;140;152;170;62;124;128,7206878367279788362,0.077000
steepest_intra:nodes_start:random,136,61840,34212,27628,2137850,142,122;90;51;147;6;188;169;70;3;34;18;128;86;185;130;95;170;155;189;104;21;82;8;56;0;109;152;4;149;28;140;29;39;111;81;176;113;194;166;94;47;148;20;183;55;35;160;33;144;153;163;187;77;141;80;190;175;36;91;79;61;45;136;193;31;54;164;73;173;182;11;49;143;159;106;124;62;145;195;168;139;138;177;78;142;5;25;158;74;118;121;117;198;1;27;38;63;40;107;135,196271851711005804,0.057283
steepest_intra:nodes_start:random,137,63272,36007,27265,2362100,157,0;109;189;184;155;3;15;145;13;132;169;126;195;168;43;134;117;193;164;73;5;36;91;61;31;54;112;121;182;138;160;35;148;60;47;94;166;194;77;82;8;33;49;11;139;51;90;122;63;135;1;198;136;141;106;124;128;62;143;144;56;104;21;177;78;175;80;190;25;29;34;55;95;130;99;185;179;172;52;86;18;6;188;70;152;183;140;199;4;149;28;20;176;180;113;103;163;153;81;111,606232809015287064,0.063524
steepest_intra:nodes_start:random,138,64450,40301,24149,2257450,150,13;145;15;3;155;170;55;18;62;128;124;35;160;33;138;191;90;133;122;63;135;20;60;94;179;185;99;130;95;183;34;109;0;29;11;139;43;6;188;169;132;189;152;148;47;166;194;113;114;103;163;89;127;165;187;153;81;82;1;27;38;131;121;51;118;182;143;106;86;176;77;177;5;36;61;21;8;104;25;54;31;117;198;193;190;80;175;111;140;28;149;4;70;147;10;40;107;134;168;195,5680236820850933253,0.059000
steepest_intra:nodes_start:random,139,62408,35880,26528,2063100,137,141;77;106;128;124;144;56;104;8;81;153;163;89;127;103;113;35;49;74;118;85;134;13;145;15;3;70;147;10;133;122;90;51;33;160;12;0;109;29;138;121;198;117;193;190;80;45;5;25;182;11;139;43;6;188;169;132;126;168;195;155;149;28;20;148;47;94;179;185;1;38;63;135;131;62;95;86;166;194;176;183;140;152;170;34;55;18;143;159;111;82;21;177;78;175;136;31;54;36;61,2063490250962537837,0.054505
steepest_intra:nodes_start:random,140,63903,38096,25807,2197650,146,18;62;104;73;164;193;198;117;31;54;25;33;0;143;124;95;130;81;77;141;91;36;61;21;138;182;11;169;188;6;90;122;133;147;134;85;74;118;121;112;158;139;168;195;145;152;28;20;60;185;166;176;106;111;8;144;160;29;170;140;149;4;155;70;132;51;135;63;1;190;80;175;5;177;82;153;163;113;103;89;165;127;114;194;172;179;86;128;189;3;15;109;35;34;55;99;94;47;148;183,281749505149481114,0.059000
steepest_intra:nodes_start:random,141,60047,34659,25388,2347150,156,118;74;134;13;145;189;140;148;47;94;60;20;28;149;15;147;63;102;135;131;125;90;122;133;10;191;51;121;54;31;164;73;138;33;160;0;55;183;99;179;166;194;113;176;62;18;34;132;169;6;188;70;3;155;184;152;170;109;35;143;159;106;86;185;95;128;124;29;195;168;11;61;36;78;175;193;117;198;1;38;27;190;80;5;177;21;82;8;111;77;81;153;163;103;89;127;165;187;141;25,7080797929776731417,0.063001
steepest_intra:nodes_start:random,142,61677,34890,26787,2093000,139,103;113;176;194;166;185;179;94;47;183;133;40;107;122;182;11;145;15;13;132;51;125;38;16;1;198;117;31;193;156;27;92;63;102;135;131;121;74;139;168;195;134;118;98;6;188;70;155;152;140;28;20;148;86;106;159;143;111;56;8;82;21;80;190;73;164;54;90;191;147;169;3;189;34;55;18;62;124;35;49;138;25;5;175;78;177;144;0;109;29;160;33;104;61;36;141;77;153;163;89,5682732930832811669,0.055000
steepest_intra:nodes_start:random,143,64047,38651,25396,2451800,163,190;5;36;61;179;94;47;148;20;140;152;155;3;70;15;81;153;89;127;187;111;144;160;195;13;132;118;121;73;54;31;193;117;122;133;10;178;147;139;11;104;8;82;77;97;141;177;25;182;134;6;188;169;145;183;95;130;185;86;128;124;33;138;135;63;40;107;90;29;0;163;103;159;143;35;109;106;176;180;113;194;166;62;83;18;55;34;189;168;51;131;1;156;198;136;45;142;78;175;80,665286461655555641,0.065999
steepest_intra:nodes_start:random,144,66046,41094,24952,2152800,143,82;144;195;132;169;188;6;134;147;191;90;178;10;133;1;117;31;193;190;80;13;70;3;155;124;106;159;160;33;189;170;152;140;183;34;35;0;109;15;145;168;11;138;78;175;36;141;4;149;28;99;185;166;194;113;103;163;89;127;114;179;47;148;20;60;94;66;177;5;73;54;121;51;139;29;55;18;83;62;143;111;8;104;131;135;63;40;107;122;125;25;21;153;180;176;86;130;95;81;77,4933152305753239107,0.057000
steepest_intra:nodes_start:random,145,69579,43185,26394,2107950,140,31;193;45;175;78;139;168;195;189;86;166;194;106;35;109;0;29;11;182;138;36;61;21;104;8;111;144;160;33;136;190;80;5;177;87;82;143;124;185;179;66;94;99;130;34;74;121;135;63;147;6;188;169;70;3;15;155;184;53;152;170;55;18;62;176;113;103;145;13;132;43;134;54;73;153;163;187;141;117;198;1;131;125;51;191;90;122;133;10;118;77;81;128;95;47;148;20;140;183;25,3460751935521694535,0.057000
steepest_intra:nodes_start:random,146,60010,35157,24853,2601300,173,5;142;175;78;61;82;8;111;143;106;62;18;189;3;155;152;170;55;34;29;121;131;135;122;107;40;147;134;160;33;138;73;31;54;6;188;169;132;13;104;56;144;145;70;15;109;0;35;124;128;95;183;140;28;20;60;148;47;94;66;179;185;176;103;127;89;163;153;77;21;177;25;51;191;90;178;10;133;72;100;63;1;198;117;193;190;80;36;141;187;113;194;166;86;195;126;168;139;11;182,337560141362442050,0.068594
steepest_intra:nodes_start:random,147,64142,38612,25530,2107950,140,107;127;165;187;97;141;91;78;175;80;190;136;45;5;36;61;8;144;168;195;145;194;166;55;15;3;155;170;34;124;106;153;81;77;177;31;54;21;82;111;128;86;185;179;94;47;148;20;140;13;132;169;139;11;33;104;25;193;117;198;156;27;38;135;32;96;122;133;147;188;70;152;183;95;176;180;113;103;89;163;159;143;62;18;35;109;0;29;160;138;182;118;51;90;121;131;1;16;63;40,2950209753620351383,0.056000
steepest_intra:nodes_start:random,148,63800,38739,25061,2496650,166,94;60;20;28;140;183;95;103;127;165;89;15;3;70;147;122;135;90;191;51;118;182;138;33;160;29;0;109;35;111;82;136;193;117;198;1;16;27;38;63;131;121;45;5;141;163;166;47;148;130;25;54;31;73;81;143;124;106;153;77;61;36;78;175;80;190;177;21;8;104;139;134;6;188;169;132;155;152;170;34;55;18;62;194;114;113;180;176;145;13;195;168;11;49;56;144;128;86;185;179,7816002006039542057,0.066000
steepest_intra:nodes_start:random,149,63021,37600,25421,2137850,142,80;190;193;117;134;155;28;20;60;34;25;54;31;73;177;21;176;180;113;194;166;86;128;35;160;33;11;139;182;138;82;81;153;163;103;89;127;187;168;195;145;109;143;106;124;62;183;199;140;152;170;29;144;8;104;135;102;63;40;107;133;10;178;51;121;131;1;38;122;90;191;71;147;6;188;169;132;13;15;161;70;3;189;55;95;130;185;179;94;47;148;18;0;12;111;77;141;36;5;175,1212278561753318737,0.059999
steepest_intra:nodes_start:random,150,61094,36288,24806,2421900,161,89;103;113;176;106;143;111;82;8;144;11;139;168;195;13;132;70;3;15;145;29;160;25;31;193;136;61;77;153;187;141;36;73;54;134;169;188;6;117;198;156;131;90;51;118;74;182;138;49;33;104;21;177;5;142;78;175;80;190;45;81;124;95;185;179;172;166;194;86;62;18;183;140;152;55;34;35;109;0;121;1;27;38;135;102;63;100;40;107;122;133;10;147;155;28;20;148;47;94;163,4875385467089048275,0.064000
steepest_intra:nodes_start:random,151,61919,36353,25566,2257450,150,130;185;166;194;113;114;137;187;141;36;78;175;193;31;54;177;21;82;77;153;165;127;89;163;106;124;62;183;140;152;184;155;4;149;28;20;60;148;47;94;179;86;160;33;138;11;132;13;195;104;56;143;128;22;99;34;168;134;51;98;118;182;111;176;180;26;103;81;25;121;198;117;190;80;5;8;144;0;109;145;15;3;70;169;188;147;107;40;63;102;135;122;90;139;29;35;55;18;83;95,3548711627483973864,0.060507
steepest_intra:nodes_start:random,152,57731,31531,26200,2526550,168,80;190;193;117;198;156;27;38;135;74;139;145;15;3;70;161;10;133;122;90;147;6;65;188;134;85;43;169;132;13;195;168;11;138;144;160;33;49;29;0;109;35;111;77;163;89;103;113;176;194;166;86;95;130;183;140;149;28;20;60;148;47;94;179;185;62;124;106;153;81;143;18;55;34;152;155;54;31;1;131;121;125;51;118;182;104;8;21;177;25;107;40;100;63;5;61;36;78;175;45,549929096023664190,0.070504
steepest_intra:nodes_start:random,153,56992,32609,24383,2631200,175,28;20;60;148;47;94;66;179;166;194;114;137;127;165;187;97;82;8;111;143;62;18;95;185;86;176;113;103;89;163;153;33;138;182;139;11;29;0;35;81;77;141;36;61;21;145;13;132;169;188;6;147;10;133;44;122;72;100;63;38;27;16;131;90;70;3;155;140;9;99;130;183;55;34;124;106;109;195;168;134;51;121;54;31;117;198;1;40;107;135;190;80;175;78;5;177;104;160;152;149,3731830588401483684,0.070000
steepest_intra:nodes_start:random,154,64579,39812,24767,2242500,149,32;135;38;27;63;40;107;1;117;54;112;121;125;51;81;153;163;103;176;86;185;166;194;113;114;127;89;187;21;177;31;193;198;156;131;90;139;11;106;124;128;95;179;66;94;55;34;145;132;169;188;70;3;155;28;20;60;47;148;18;35;0;104;5;45;80;190;29;152;140;183;62;159;143;109;195;168;111;77;97;141;78;175;136;164;73;25;138;33;160;144;8;82;61;36;134;147;10;133;122,7256565225985856299,0.059000
steepest_intra:nodes_start:random,155,62092,37162,24930,2272400,151,189;155;184;170;152;140;183;99;130;95;34;188;6;147;71;51;134;139;104;8;77;97;141;21;82;62;18;55;86;113;103;163;153;81;111;11;168;195;176;194;166;179;185;109;29;0;35;124;106;143;160;33;138;182;90;10;133;122;131;25;177;36;5;78;175;136;73;54;63;40;107;100;135;117;31;193;190;80;156;27;38;1;198;112;121;169;132;148;47;94;60;20;28;149;4;145;13;70;3;15,7869483923530574902,0.061000
steepest_intra:nodes_start:random,156,64130,39548,24582,2571400,171,40;107;188;155;183;148;60;20;28;140;152;145;195;168;144;77;97;141;80;190;73;121;125;90;191;133;10;147;6;169;132;18;62;128;124;106;143;111;82;177;5;78;175;131;122;63;135;1;198;117;193;31;54;25;33;160;163;103;89;127;187;146;81;11;139;134;43;29;109;35;83;95;130;55;34;189;15;3;70;13;104;8;21;36;61;153;86;179;94;47;99;185;166;194;113;176;0;138;51;100,315746591627320446,0.070001
steepest_intra:nodes_start:random,157,62095,35335,26760,2511600,167,45;121;125;191;147;155;184;189;18;62;0;160;33;73;164;31;54;193;117;198;131;51;98;6;188;169;195;168;143;159;35;109;145;13;132;161;70;3;15;134;90;122;40;63;102;135;1;190;80;141;77;103;113;194;166;176;111;8;104;56;144;95;130;99;185;86;163;153;81;106;140;28;20;60;148;47;94;66;183;152;170;34;55;83;128;124;29;11;139;138;25;78;175;36;61;91;82;21;177;5,2439715457452956044,0.067000
steepest_intra:nodes_start:random,158,61240,35700,25540,1943500,129,180;176;113;26;103;187;146;153;106;124;62;83;18;55;34;189;15;3;70;149;28;20;140;155;145;195;168;143;159;89;165;127;137;114;86;95;130;183;152;170;35;109;0;160;144;104;8;21;61;177;11;139;13;132;169;135;38;16;1;117;193;78;175;80;190;198;156;27;63;122;147;6;188;134;118;51;90;121;25;82;77;81;194;166;185;179;94;47;148;29;33;138;182;54;31;73;5;36;141;163,514185726352626849,0.051000
steepest_intra:nodes_start:random,159,66268,40891,25377,2287350,152,134;190;80;175;127;89;163;77;117;198;193;136;45;78;5;177;138;104;21;61;36;91;141;187;103;194;166;86;124;109;29;49;11;33;160;0;35;18;55;34;145;132;13;195;168;139;182;25;54;31;73;62;95;185;179;94;47;148;20;28;140;183;152;170;191;90;122;107;40;100;63;102;32;135;131;121;106;176;113;153;81;118;51;133;10;147;143;159;111;82;8;144;189;155;15;3;70;169;188;6,2737832984190001051,0.061505
steepest_intra:nodes_start:random,160,66993,37886,29107,1883700,125,187;141;36;78;175;142;45;16;38;27;117;193;54;182;11;139;168;195;13;132;169;43;160;144;111;18;62;124;106;176;180;113;114;127;91;79;61;21;145;15;3;152;140;183;55;34;35;109;0;29;33;138;118;51;191;90;133;44;122;63;135;121;104;8;82;58;77;97;87;25;151;198;156;1;131;134;188;6;100;40;107;10;147;70;86;166;194;81;5;80;190;136;31;73;177;153;163;103;89;165,7158437428028430339,0.050000
steepest_intra:nodes_start:random,161,62306,36662,25644,2377050,158,6;147;107;40;63;118;138;111;124;128;95;130;99;22;81;77;97;187;89;127;114;166;185;86;194;113;103;163;106;189;155;170;34;109;0;160;144;56;33;11;139;168;195;13;134;74;182;104;8;82;21;177;121;135;122;133;10;29;35;143;180;176;62;83;18;55;3;70;15;145;25;54;31;193;117;1;131;90;191;51;5;78;175;36;61;91;141;153;179;94;47;148;60;20;140;183;152;132;169;188,4845343607701299436,0.063000
steepest_intra:nodes_start:random,162,67502,38645,28857,2317250,154,8;140;183;130;185;166;86;95;55;34;11;31;54;19;112;121;51;98;118;74;139;13;132;169;188;161;70;3;15;145;195;168;29;159;103;114;137;127;89;77;1;16;27;38;104;144;111;143;106;124;62;160;33;138;182;90;133;63;102;156;198;190;80;175;36;61;91;141;187;165;163;35;109;0;41;81;153;113;194;176;128;18;6;147;134;25;5;78;142;45;131;122;135;117;193;73;177;21;87;82,5191311147931992142,0.061603
steepest_intra:nodes_start:random,163,68347,40402,27945,1823900,121,194;153;81;8;56;144;41;159;86;185;130;95;55;147;191;90;131;31;54;121;51;170;148;47;94;66;172;52;137;114;113;180;176;62;189;3;70;161;132;169;126;143;106;124;128;9;199;152;155;15;188;6;134;43;139;11;138;182;25;73;117;198;193;5;36;61;187;127;89;103;163;35;29;160;104;177;190;80;175;21;18;183;140;34;109;0;111;82;141;97;77;33;168;195;13;145;28;20;179;166,8149422133110398393,0.047989
steepest_intra:nodes_start:random,164,65858,40841,25017,2018250,134,199;20;60;130;95;131;1;38;63;135;122;28;149;147;10;133;90;191;51;182;138;11;33;160;143;159;176;180;113;194;166;179;148;47;94;66;99;185;86;128;34;189;3;70;54;31;193;117;145;15;155;152;55;18;62;111;5;190;80;175;141;187;163;153;35;109;0;29;144;8;21;61;36;177;25;121;118;74;168;195;13;132;169;188;6;134;43;139;104;82;77;81;165;127;89;103;106;124;183;140,4126039934258691476,0.054002
steepest_intra:nodes_start:random,165,68756,41211,27545,2003300,133,190;80;188;169;132;13;145;161;70;15;109;29;168;126;195;166;113;103;163;153;77;81;143;106;176;89;127;187;141;73;54;173;25;182;49;55;18;83;62;0;11;51;90;131;45;175;78;5;104;160;33;139;134;133;107;40;63;102;135;122;147;6;3;140;183;148;94;179;185;95;86;124;138;31;193;117;121;155;152;34;35;144;56;8;36;61;79;91;58;111;82;87;21;177;1;16;38;27;156;198,5619194413525041196,0.052998
steepest_intra:nodes_start:random,166,64277,39632,24645,2287350,152,176;180;163;147;10;133;122;51;74;139;11;138;25;31;73;5;177;77;153;194;166;179;94;47;60;20;148;99;130;15;3;70;132;169;188;134;118;173;136;80;190;193;198;117;54;104;143;106;124;62;18;140;149;28;183;55;109;0;35;95;185;86;128;160;33;29;189;155;152;34;111;8;82;141;91;61;36;78;175;45;1;38;63;135;6;13;145;195;168;191;90;131;121;187;137;114;127;89;103;113,4652055680139461803,0.061506
steepest_intra:nodes_start:random,167,64970,39083,25887,2197650,146,139;11;49;29;0;111;8;104;121;131;135;122;90;147;188;169;132;34;55;183;20;60;148;47;94;99;130;95;189;3;70;13;195;1;198;117;190;80;163;103;114;113;194;166;172;179;176;77;91;61;21;82;143;106;86;185;128;124;62;18;35;109;118;51;54;31;193;164;73;168;145;15;155;184;152;149;28;140;5;78;175;36;141;187;127;89;153;81;177;123;25;138;144;160;33;182;74;134;6;43,601565065107198221,0.057999
steepest_intra:nodes_start:random,168,62029,37230,24799,2406950,160,193;190;80;175;78;141;77;81;165;127;89;163;153;146;187;137;114;194;166;179;183;152;155;3;70;132;169;188;6;85;134;43;13;145;34;55;86;176;113;26;103;106;124;62;18;143;111;144;0;35;185;130;95;109;29;138;182;11;139;168;195;15;140;20;148;47;94;99;121;1;38;63;40;107;122;135;131;177;21;82;91;61;36;31;117;54;104;8;160;33;49;147;10;133;90;191;51;25;5;136,6933414889777151256,0.064001
steepest_intra:nodes_start:random,169,56929,31523,25406,2571400,171,185;179;172;66;94;47;148;20;28;140;183;152;170;61;36;141;77;8;56;144;160;33;49;168;195;13;145;15;155;3;70;132;134;190;80;5;177;25;118;191;10;133;122;107;40;63;102;135;1;156;136;175;78;45;73;121;51;125;90;147;6;188;169;139;11;182;198;117;193;31;54;21;82;111;62;18;55;34;109;29;138;104;81;153;163;89;127;103;113;194;166;176;106;124;143;0;35;128;86;95,837429537178086587,0.068000
steepest_intra:nodes_start:random,170,59915,33071,26844,1988350,132,163;127;89;106;34;152;184;155;189;109;35;62;95;185;130;183;55;18;81;77;36;78;175;80;190;135;122;133;90;182;104;21;87;82;58;50;111;68;8;56;144;33;160;0;143;176;113;194;166;86;140;28;20;148;47;94;179;124;29;168;195;145;15;3;70;188;147;10;107;40;100;63;121;158;25;5;73;193;198;156;1;117;31;54;51;6;169;132;13;134;118;74;139;11;138;177;61;91;141;153,7777158427958954407,0.053000
steepest_intra:nodes_start:random,171,60969,35283,25686,2451800,163,78;21;87;82;77;81;153;185;20;148;47;94;179;172;114;103;163;106;124;3;70;15;145;195;168;169;188;147;10;133;134;139;143;176;180;113;194;166;86;95;62;18;55;183;140;152;170;34;189;184;155;132;6;90;122;63;102;135;51;89;127;165;187;141;177;54;117;193;31;73;136;190;80;5;138;11;182;118;131;38;27;1;198;121;25;104;111;35;109;0;29;49;33;160;144;56;8;61;36;175,6770320649115909648,0.066000
steepest_intra:nodes_start:random,172,61834,37643,24191,2676050,178,20;28;11;54;31;117;193;190;80;136;25;138;34;55;18;111;82;5;142;175;78;141;187;163;176;166;194;113;103;127;89;128;62;124;106;143;35;0;118;51;90;135;38;27;1;131;121;134;195;168;139;182;177;36;61;91;77;153;86;185;95;170;132;169;13;29;109;189;184;155;3;15;145;49;33;160;144;8;87;21;104;147;133;107;40;63;122;6;188;70;152;140;183;130;99;179;94;47;148;60,4617591384897254942,0.073000
steepest_intra:nodes_start:random,173,59292,34434,24858,2481700,165,5;177;82;95;130;94;154;66;179;166;194;180;176;99;148;28;149;140;183;152;62;128;124;106;153;81;77;111;0;35;18;55;34;109;29;160;33;144;163;113;103;89;127;165;187;141;175;80;190;193;198;117;54;31;73;121;168;155;20;60;47;185;86;143;11;139;134;133;10;147;6;195;13;145;15;3;70;161;132;169;188;107;40;63;135;1;131;122;90;51;118;74;182;138;104;56;8;21;61;36,1498486350717271205,0.069003
steepest_intra:nodes_start:random,174,62341,34743,27598,2242500,149,190;136;193;31;160;0;34;18;55;170;109;29;33;198;117;54;73;45;36;61;91;141;82;8;104;56;144;111;77;97;81;153;187;165;127;89;122;135;63;40;107;133;10;147;134;138;87;21;25;158;121;131;90;191;51;62;86;166;179;185;130;95;128;124;163;103;113;194;176;106;159;143;35;49;11;188;169;126;13;132;70;3;155;152;28;140;183;15;145;195;168;139;182;177;5;142;78;175;162;80,4986738351872071150,0.062996
steepest_intra:nodes_start:random,175,59271,33814,25457,2392000,159,82;141;77;97;187;163;106;124;62;18;34;55;95;130;22;179;66;94;47;148;60;20;99;185;86;166;194;113;176;153;81;111;160;33;49;29;0;109;170;4;149;28;143;21;45;190;80;175;78;36;61;145;15;70;3;155;152;140;183;35;182;131;135;63;38;27;1;112;25;138;144;104;177;5;118;6;188;169;132;13;195;168;43;51;191;90;121;73;54;31;193;117;198;122;133;147;134;139;11;8,6686724056945110335,0.067534
steepest_intra:nodes_start:random,176,57393,29869,27524,2915250,194,25;118;51;191;90;107;40;63;135;136;175;78;36;61;91;141;163;113;66;94;47;148;140;183;34;35;109;0;138;182;74;121;112;19;54;73;164;31;193;117;198;156;1;38;131;70;3;152;86;176;194;166;179;185;95;55;18;83;62;128;124;106;143;153;81;97;77;82;21;8;104;144;33;160;29;189;184;155;15;145;11;139;43;168;195;13;132;169;188;6;147;178;10;133;122;190;80;45;5;177,8236946539926142215,0.080000
steepest_intra:nodes_start:random,177,61335,35837,25498,2466750,164,160;11;168;195;155;4;149;101;28;140;183;152;109;0;35;18;62;143;97;141;61;36;175;78;21;8;29;34;55;124;106;128;185;94;47;148;20;132;169;188;6;134;191;90;135;63;38;190;80;5;177;104;33;138;182;139;13;145;189;95;86;166;194;176;15;3;70;147;10;133;122;131;1;24;156;198;117;193;31;54;73;112;121;100;40;107;125;51;25;82;77;153;163;113;103;89;127;187;81;111,5150597848693465419,0.065999
steepest_intra:nodes_start:random,178,59187,32686,26501,2332200,155,104;56;144;109;35;95;130;99;185;86;128;106;124;62;183;140;28;152;3;6;147;10;133;122;135;38;27;16;1;131;90;125;54;31;73;121;51;118;25;136;190;80;175;5;36;61;21;82;8;33;188;65;169;132;13;161;70;155;170;55;18;34;189;195;134;107;40;63;198;117;193;177;160;29;0;111;77;141;97;81;153;187;163;113;194;166;114;137;127;165;89;103;176;143;15;145;168;139;11;138,2377900636676919974,0.061505
steepest_intra:nodes_start:random,179,58627,32210,26417,2795650,186,43;139;11;144;111;86;185;130;95;124;134;118;51;133;10;147;70;3;15;132;126;13;145;155;184;189;8;87;21;177;5;78;175;80;190;73;164;193;156;1;38;63;135;122;121;25;104;160;33;138;182;49;29;34;55;18;62;128;176;194;166;170;152;183;140;20;148;94;179;113;153;81;77;82;0;109;35;143;106;163;89;127;187;141;61;36;45;136;31;54;117;198;131;90;191;6;188;169;195;168,789846052273442808,0.074000
steepest_intra:nodes_start:random,180,62430,35760,26670,2616250,174,28;149;140;152;155;177;78;175;142;173;112;121;147;6;188;195;168;29;153;163;113;103;89;127;187;146;97;77;81;41;111;144;160;33;49;11;139;182;73;193;31;54;169;132;13;145;109;0;35;82;21;61;36;91;141;99;148;47;94;179;166;194;176;86;185;95;55;34;18;62;128;124;106;159;143;8;104;138;25;198;1;135;122;70;3;15;134;118;51;191;90;131;117;136;190;80;45;5;183;20,3037979369140719156,0.070001
steepest_intra:nodes_start:random,181,66149,40830,25319,2093000,139,118;51;198;117;193;31;73;177;21;82;143;18;55;34;168;43;134;191;90;122;40;63;135;131;121;8;111;159;106;62;152;155;145;195;13;132;169;70;3;15;109;81;77;36;78;175;45;80;190;136;25;138;33;144;104;182;133;10;178;147;188;20;23;60;148;99;128;124;35;0;29;160;11;139;38;27;1;54;5;187;163;113;95;28;149;140;183;130;185;86;176;194;166;47;94;66;179;153;141;61,2362534411486700816,0.056645
steepest_intra:nodes_start:random,182,67506,42573,24933,2227550,148,16;1;198;117;36;187;89;163;106;159;143;111;8;177;73;31;54;112;121;131;122;188;169;134;25;5;175;78;21;124;86;148;60;20;199;140;183;166;176;113;153;77;141;91;61;136;193;135;63;133;132;13;195;145;34;55;28;149;4;152;155;15;11;33;160;144;104;138;182;51;90;191;139;109;35;62;95;99;47;94;66;179;185;18;3;70;40;107;10;147;6;168;29;0;45;80;190;156;27;38,344002816719452632,0.059000
steepest_intra:nodes_start:random,183,60019,35088,24931,2406950,160,109;34;94;66;179;185;86;124;106;166;194;113;114;137;103;180;176;29;11;139;168;195;160;33;5;45;142;175;78;36;61;21;8;104;138;51;107;40;147;188;152;130;99;22;47;148;20;28;149;4;140;183;95;128;62;83;55;18;143;81;97;77;145;13;132;169;70;3;15;155;35;153;163;89;127;187;141;193;198;117;54;31;73;112;121;90;191;10;133;122;135;63;38;1;190;80;177;82;111;0,5148094463280636182,0.064000
steepest_intra:nodes_start:random,184,60671,35357,25314,2287350,152,8;33;138;11;139;191;90;51;111;81;153;180;176;106;143;29;168;195;189;170;152;140;199;28;149;4;155;70;188;169;132;13;55;83;95;130;185;86;194;114;137;127;165;89;166;179;66;94;47;148;60;20;9;183;34;109;0;35;18;62;128;124;73;193;31;54;25;182;134;147;122;135;63;38;1;131;121;117;190;175;78;5;141;77;187;163;103;113;3;15;145;160;144;104;177;36;61;21;87;82,5223495126434552884,0.060000
steepest_intra:nodes_start:random,185,60162,35551,24611,2496650,166,33;160;95;148;47;94;99;121;131;135;122;90;51;11;29;0;34;18;62;128;86;166;179;185;189;169;188;6;139;104;8;82;77;81;143;35;109;15;3;70;132;13;195;168;145;155;184;152;28;20;140;183;55;124;106;153;163;127;114;113;194;176;180;103;89;187;141;36;175;78;5;177;61;21;111;144;25;54;31;198;156;27;63;38;16;1;117;193;136;45;142;162;80;190;133;10;147;134;182;138,173720243569026313,0.069001
steepest_intra:nodes_start:random,186,65025,40059,24966,2033200,135,27;131;121;182;138;25;136;190;80;5;104;160;33;11;54;73;45;175;36;61;91;141;77;20;148;47;94;185;130;95;86;166;194;176;180;159;143;111;8;81;163;114;113;172;179;183;140;21;177;78;142;90;191;147;134;139;29;0;109;34;18;62;124;106;188;6;10;133;135;1;198;117;193;31;112;51;189;155;152;55;103;89;127;137;165;187;153;35;145;15;3;70;13;195;168;132;169;122;63;38,5112098710702863036,0.055000
steepest_intra:nodes_start:random,187,63805,37283,26522,2227550,148,94;86;106;143;160;33;11;139;134;147;192;6;188;169;132;168;195;145;70;3;155;152;183;95;128;124;111;144;56;91;79;61;36;5;73;31;117;198;54;173;177;77;97;81;55;18;62;176;113;103;89;127;137;114;163;122;107;40;63;135;38;1;0;109;35;34;185;179;172;166;194;153;141;80;190;193;164;136;175;78;142;45;121;51;118;182;104;8;82;87;21;25;125;90;138;29;140;20;148;47,6400064057570542205,0.058999
steepest_intra:nodes_start:random,188,62949,37044,25905,2212600,147,124;117;198;1;131;51;90;122;133;147;168;195;62;95;185;166;113;103;163;77;111;0;35;18;55;34;170;152;184;155;3;169;10;107;40;63;135;132;13;138;5;142;175;78;21;82;8;144;29;49;33;160;56;104;157;25;158;121;182;11;139;43;134;6;188;161;70;15;145;109;81;153;89;127;165;187;141;61;36;73;54;31;193;190;80;45;177;159;143;106;176;194;86;183;140;28;20;148;47;94,6554614916785058663,0.060000
steepest_intra:nodes_start:random,189,62000,35345,26655,2466750,164,141;77;153;113;176;106;139;43;132;169;188;6;147;90;122;135;131;121;94;47;148;20;28;149;140;152;170;183;99;22;179;124;143;33;151;117;198;156;24;1;16;27;38;63;51;138;111;81;163;89;103;194;166;128;62;18;109;29;11;182;190;80;175;142;45;136;193;31;54;73;173;25;177;21;87;82;8;104;56;144;160;168;195;13;145;70;3;155;86;185;130;95;55;34;35;0;5;78;36;61,4809339210069960664,0.065000
steepest_intra:nodes_start:random,190,62599,37266,25333,2406950,160,103;113;176;194;166;185;99;140;183;55;78;175;36;61;91;141;77;82;160;29;109;35;0;144;56;111;143;159;106;124;155;145;135;102;63;122;90;191;6;15;3;70;147;10;133;51;118;134;132;13;195;121;73;54;31;193;190;80;177;95;130;20;148;47;94;179;86;128;62;18;34;131;38;27;1;198;117;136;45;5;25;182;138;104;21;8;33;11;139;188;169;168;81;153;187;163;89;127;137;114,2587692818661516733,0.064000
steepest_intra:nodes_start:random,191,66130,39713,26417,2182700,145,11;139;43;132;13;145;106;124;189;15;3;70;169;121;54;73;144;159;143;35;109;168;195;155;152;140;20;60;148;47;94;166;194;114;127;89;103;26;153;82;21;5;80;190;25;138;104;8;77;97;146;163;165;187;141;61;177;118;98;51;131;31;193;175;78;36;81;95;130;99;185;86;176;180;113;111;117;198;156;1;135;122;90;6;188;147;10;133;134;182;29;62;83;18;55;183;34;0;160;33,5414333908669252118,0.058509
steepest_intra:nodes_start:random,192,62750,36194,26556,2182700,145,55;18;83;62;111;190;80;175;78;5;21;82;8;160;29;152;140;148;47;99;130;95;168;195;169;188;6;147;131;1;24;156;198;117;193;31;54;25;138;33;106;176;113;103;89;163;153;187;141;79;61;36;45;136;73;118;134;132;70;3;124;128;194;166;183;28;20;60;154;94;66;179;185;86;81;77;91;177;19;112;121;51;90;122;135;63;38;27;16;104;144;159;143;35;0;109;145;15;155;34,3380018654197358089,0.058000
steepest_intra:nodes_start:random,193,61822,35733,26089,2511600,167,8;82;141;77;97;187;127;89;163;153;81;111;159;143;62;18;55;34;121;63;40;107;90;191;51;118;74;134;70;3;15;5;190;80;175;78;177;182;139;126;13;132;169;188;6;71;125;131;1;198;117;25;138;33;160;104;54;31;193;27;38;135;122;133;10;147;43;106;176;113;194;166;86;128;124;91;36;61;21;11;168;195;145;155;152;95;130;185;179;94;47;148;140;183;170;35;109;0;29;144,2694007530241535261,0.068000
steepest_intra:nodes_start:random,194,62484,37758,24726,2197650,146,31;54;121;134;168;94;47;148;60;20;28;143;78;175;36;61;91;141;187;127;114;103;89;163;153;109;145;15;155;95;179;166;194;113;180;176;106;159;11;139;138;8;21;82;111;144;104;25;117;198;1;38;135;147;6;188;169;70;3;29;81;77;177;131;102;63;40;107;122;90;51;118;182;33;124;128;86;185;99;130;9;183;140;4;152;170;34;55;18;62;35;0;160;5;45;162;80;190;136;193,2224048527722272381,0.058001
steepest_intra:nodes_start:random,195,64744,39102,25642,2137850,142,79;91;141;153;86;185;95;62;168;195;145;189;170;140;149;28;20;148;47;94;179;166;176;81;8;135;63;1;73;136;5;177;77;163;89;127;103;160;33;29;34;55;18;109;144;104;25;51;90;191;147;6;188;15;3;155;152;183;130;194;113;175;80;190;193;31;54;112;121;134;43;169;132;161;70;13;139;11;138;182;133;107;40;100;122;131;198;117;151;0;35;143;124;106;159;111;82;21;36;61,8523504357740172481,0.057000
steepest_intra:nodes_start:random,196,67269,41664,25605,1973400,131,191;90;125;131;54;31;193;73;118;74;139;11;33;56;8;61;141;77;81;143;170;152;145;195;168;106;194;166;94;47;148;20;28;160;144;104;25;177;21;82;124;174;140;183;86;114;127;165;89;163;153;111;0;35;18;55;34;134;51;121;198;117;190;80;187;103;113;180;176;128;62;83;95;130;99;185;36;175;5;182;138;15;70;3;155;189;109;29;122;133;107;40;63;135;38;1;169;188;6;147,7666864444113232784,0.052000
steepest_intra:nodes_start:random,197,62180,37046,25134,2631200,175,5;177;0;35;170;152;155;3;132;13;145;15;70;161;169;134;121;131;135;38;27;1;198;117;190;80;62;18;83;128;86;95;130;185;179;166;194;113;163;144;182;118;51;90;191;168;195;189;124;106;143;111;8;104;31;193;54;25;138;49;29;109;34;55;183;140;4;149;28;20;148;94;176;103;89;127;187;141;36;61;21;82;43;188;6;147;122;63;40;107;133;10;139;11;33;160;81;153;77;175,4384773138025597621,0.071003
steepest_intra:nodes_start:random,198,58655,32589,26066,2272400,151,55;140;20;148;94;179;128;106;176;113;194;86;185;166;114;187;141;91;61;21;8;56;104;25;158;121;198;117;193;136;5;36;77;153;165;127;89;103;163;81;50;82;177;54;31;73;45;142;173;19;131;135;90;51;6;188;169;29;109;34;95;130;183;152;155;3;70;145;195;168;144;111;78;175;80;190;1;27;38;63;40;107;122;133;10;147;134;139;11;182;138;49;33;160;0;35;143;124;62;18,8594792763242522184,0.060997
steepest_intra:nodes_start:random,199,62224,34732,27492,2466750,164,138;25;54;31;73;104;8;176;194;166;179;99;95;111;21;177;78;175;80;190;27;38;63;135;131;139;11;189;184;155;70;6;191;90;122;133;10;33;160;144;0;109;152;20;60;47;148;140;183;130;185;86;113;103;163;77;141;61;36;5;136;164;193;117;198;156;24;1;121;74;43;168;145;15;3;13;132;65;188;169;126;195;34;55;18;62;124;106;153;81;159;143;35;29;134;147;71;51;118;182,6817182463575480309,0.066000
steepest_intra:nodes_start:greedy,0,51482,18605,32877,119600,7,35;109;0;29;69;189;155;145;15;3;70;161;188;6;169;132;13;195;168;43;134;139;11;182;138;33;160;144;56;104;8;82;87;21;177;5;45;142;175;78;36;61;91;141;77;97;146;187;165;127;89;103;137;114;113;194;166;52;172;179;185;22;99;130;86;95;183;140;199;9;148;47;66;94;60;20;59;28;149;4;152;170;34;55;18;62;128;124;143;159;106;176;88;180;163;186;153;81;41;111,3396128104704959885,0.003000
steepest_intra:nodes_start:greedy,1,51190,18543,32647,164450,10,1;16;27;38;102;63;96;32;135;122;133;10;178;115;147;71;191;90;125;51;98;118;74;134;6;188;169;132;13;70;3;15;145;195;168;43;139;11;29;0;109;35;111;81;153;163;176;106;124;62;18;140;183;95;185;86;166;194;113;103;89;127;165;187;97;77;141;91;61;36;78;175;142;45;5;177;21;82;8;104;144;160;33;138;182;25;158;116;121;112;19;151;54;73;164;31;193;117;198;156,9375975647375767,0.004000
steepest_intra:nodes_start:greedy,2,48536,20058,28478,239200,15,43;134;74;118;121;51;191;90;131;54;73;31;193;117;198;156;1;16;27;38;135;63;100;40;107;72;122;133;10;178;147;6;188;169;132;13;70;3;15;145;195;168;29;0;109;35;111;81;153;163;176;106;124;62;18;55;34;170;152;140;183;95;130;99;22;179;185;86;166;194;113;103;89;127;165;187;146;97;77;141;91;61;36;78;175;142;45;5;177;21;82;8;104;144;160;33;138;182;11;139,8299330158777910634,0.006573
steepest_intra:nodes_start:greedy,3,49983,17472,32511,59800,3,3;155;184;170;152;140;183;95;130;22;99;9;199;4;149;28;59;20;60;148;47;94;66;57;172;52;179;185;86;166;194;176;180;113;26;103;114;137;127;89;163;165;187;146;153;81;77;97;141;91;79;61;36;78;175;142;45;5;177;21;87;82;111;144;56;8;104;138;182;139;11;49;33;160;29;0;109;35;143;159;106;124;128;62;18;55;34;189;15;145;195;168;126;13;132;169;6;188;161;70,4268737317639788805,0.001506
steepest_intra:nodes_start:greedy,4,46445,19928,26517,149500,9,4;149;28;59;20;60;148;47;94;66;57;172;179;185;22;99;130;95;86;166;194;176;113;26;103;114;137;127;89;163;187;153;81;77;141;91;61;36;78;175;142;45;5;177;21;82;111;8;104;138;182;139;168;195;145;15;3;70;13;132;169;188;6;147;178;10;133;122;135;63;38;1;117;31;54;121;90;51;118;74;134;11;33;160;29;0;109;35;143;106;124;128;62;18;55;34;170;152;183;140,7941890161955948670,0.004998
steepest_intra:nodes_start:greedy,5,51559,19902,31657,149500,9,5;177;21;104;138;182;139;168;195;145;15;3;70;161;13;132;169;188;6;192;147;178;10;133;122;72;107;40;100;63;135;38;27;16;1;156;198;117;193;31;73;54;151;19;112;131;125;90;191;120;51;121;118;74;134;11;49;33;160;29;0;109;35;111;144;8;82;58;77;81;153;163;176;106;124;62;18;140;183;95;185;86;166;194;113;103;89;127;165;187;146;97;141;91;61;36;78;175;142;45,7404522040181116103,0.005000
steepest_intra:nodes_start:greedy,6,48889,20411,28478,119600,7,6;188;169;132;13;70;3;15;145;195;168;29;0;109;35;111;81;153;163;176;106;124;62;18;55;34;170;152;140;183;95;86;130;99;22;185;179;166;194;113;103;89;127;165;187;146;97;77;141;91;61;36;78;175;142;45;5;177;21;82;8;104;144;160;33;138;182;11;139;43;134;74;118;121;51;191;90;131;54;73;31;193;117;198;156;1;16;27;38;135;63;100;40;107;72;122;133;10;178;147,7455263026568560290,0.004000
steepest_intra:nodes_start:greedy,7,52378,19392,32986,119600,7,7;78;175;142;45;5;177;21;104;138;182;139;168;195;145;15;3;70;161;13;132;169;188;6;192;147;178;10;133;122;72;107;40;100;63;135;38;27;16;1;156;198;117;193;31;73;54;151;19;112;131;125;90;191;120;51;121;118;74;134;11;49;33;160;29;0;109;35;111;144;8;82;58;77;81;153;163;176;106;124;62;18;95;130;185;86;166;194;113;103;89;127;165;187;146;97;141;91;61;36,3854644712772145813,0.003002
steepest_intra:nodes_start:greedy,8,48978,21071,27907,149500,9,8;104;138;182;139;168;195;145;15;3;70;13;132;169;188;6;147;178;10;133;122;107;40;63;135;38;27;16;1;156;198;117;193;31;54;73;121;131;90;51;118;74;134;11;33;160;29;109;35;0;144;111;41;81;153;163;176;106;124;62;18;55;34;170;152;140;183;95;86;130;99;22;185;179;172;166;194;113;114;137;103;89;127;165;187;146;97;77;141;91;61;36;78;175;142;45;5;177;21;82,8158866163025407608,0.005000
steepest_intra:nodes_start:greedy,9,46639,20370,26269,134550,8,9;148;47;94;60;20;59;28;149;4;140;183;152;170;34;55;18;62;128;124;106;143;35;109;0;29;160;33;11;134;74;118;51;90;121;73;54;31;193;117;1;38;63;135;122;133;10;178;147;6;188;169;132;13;70;3;15;145;195;168;139;182;138;104;8;111;82;21;177;5;45;142;175;78;36;61;91;141;77;81;153;187;163;89;127;137;114;103;26;113;176;194;166;86;95;185;179;22;99;130,4630045801369676198,0.003000
steepest_intra:nodes_start:greedy,10,51896,19072,32824,149500,9,10;178;147;192;6;188;169;132;161;70;3;15;145;13;195;168;43;11;29;0;109;35;111;81;153;163;176;106;124;62;18;95;185;86;166;194;113;103;89;127;165;187;97;77;141;91;61;36;78;175;142;45;5;177;21;82;8;104;144;160;33;138;182;139;134;85;74;118;98;51;116;121;112;19;151;54;73;164;31;193;117;198;156;1;16;27;38;131;125;191;90;135;102;63;100;40;107;72;122;133,4306814189804114078,0.004969
steepest_intra:nodes_start:greedy,11,51482,18605,32877,119600,7,11;182;138;33;160;144;56;104;8;82;87;21;177;5;45;142;175;78;36;61;91;141;77;97;146;187;165;127;89;103;137;114;113;194;166;52;172;179;185;22;99;130;86;95;183;140;199;9;148;47;66;94;60;20;59;28;149;4;152;170;34;55;18;62;128;124;143;159;106;176;88;180;163;186;153;81;41;111;35;109;0;29;69;189;155;145;15;3;70;161;188;6;169;132;13;195;168;43;134;139,7145561974109231166,0.003970
steepest_intra:nodes_start:greedy,12,51661,18658,33003,89700,5,12;111;41;81;153;186;163;180;88;176;106;159;143;124;128;62;18;55;34;170;152;4;149;28;59;20;60;94;66;47;148;9;199;140;183;95;86;130;99;22;185;179;172;166;194;113;114;137;103;89;127;165;187;146;97;77;141;91;61;36;78;175;142;45;5;177;21;87;82;8;104;56;144;160;33;138;182;11;139;134;43;168;195;13;132;169;6;188;161;70;3;15;145;155;189;69;29;109;35;0,1984709302264752674,0.002002
steepest_intra:nodes_start:greedy,13,48889,20411,28478,119600,7,13;70;3;15;145;195;168;29;0;109;35;111;81;153;163;176;106;124;62;18;55;34;170;152;140;183;95;86;130;99;22;185;179;166;194;113;103;89;127;165;187;146;97;77;141;91;61;36;78;175;142;45;5;177;21;82;8;104;144;160;33;138;182;11;139;43;134;74;118;121;51;191;90;131;54;73;31;193;117;198;156;1;16;27;38;135;63;100;40;107;72;122;133;10;178;147;6;188;169;132,8530565435502897580,0.003032
steepest_intra:nodes_start:greedy,14,51488,20978,30510,134550,8,82;81;153;163;180;88;176;106;143;124;128;62;18;55;34;170;152;140;183;95;86;130;99;22;185;179;172;166;194;113;114;137;103;89;127;165;187;146;97;77;141;36;21;8;104;138;182;139;168;195;145;15;3;70;13;132;169;188;6;192;147;178;10;133;122;72;107;40;100;63;135;38;27;16;1;156;198;117;193;31;73;54;151;19;131;90;191;51;121;118;74;134;11;33;160;29;0;109;35;111,9145288119789465992,0.004279
steepest_intra:nodes_start:greedy,15,49983,17472,32511,59800,3,15;145;195;168;126;13;132;169;6;188;161;70;3;155;184;170;152;140;183;95;130;22;99;9;199;4;149;28;59;20;60;148;47;94;66;57;172;52;179;185;86;166;194;176;180;113;26;103;114;137;127;89;163;165;187;146;153;81;77;97;141;91;79;61;36;78;175;142;45;5;177;21;87;82;111;144;56;8;104;138;182;139;11;49;33;160;29;0;109;35;143;159;106;124;128;62;18;55;34;189,8551922515983740134,0.001000
steepest_intra:nodes_start:greedy,16,53761,18845,34916,104650,6,16;27;38;92;102;63;96;32;135;122;133;10;178;115;147;71;191;90;51;125;131;121;112;19;151;54;31;164;73;136;45;5;177;21;104;138;182;139;168;195;145;15;3;70;161;13;132;169;188;6;134;11;49;33;160;29;0;109;35;111;144;8;82;58;77;81;153;163;176;86;95;130;185;179;166;194;113;103;89;127;165;187;146;97;141;91;61;36;78;175;142;162;80;190;193;117;198;156;24;1,8726658857314642950,0.003002
steepest_intra:nodes_start:greedy,17,51667,18843,32824,149500,9,72;107;40;100;63;102;135;122;90;191;125;131;38;27;16;1;156;198;117;193;31;164;73;54;151;19;112;121;116;51;98;118;74;85;134;139;182;138;33;160;144;104;8;82;21;177;5;45;142;175;78;36;61;91;141;77;97;187;165;127;89;103;113;194;166;86;185;95;18;62;124;106;176;163;153;81;111;35;109;0;29;11;43;168;195;13;145;15;3;70;161;132;169;188;6;192;147;178;10;133,1396764668947273395,0.004971
steepest_intra:nodes_start:greedy,18,50703,18111,32592,134550,8,18;34;55;83;128;86;176;180;113;194;166;52;172;179;185;22;99;130;95;183;140;199;9;148;47;66;94;60;20;59;28;149;4;152;170;184;155;189;3;70;15;145;13;132;169;188;6;134;43;195;168;139;11;182;138;33;160;144;56;104;8;82;87;21;177;5;45;142;175;78;36;61;79;91;141;77;97;146;187;165;137;114;127;89;103;163;186;153;81;41;111;29;0;109;35;143;159;106;124;62,5721599397205563506,0.004002
steepest_intra:nodes_start:greedy,19,53761,18845,34916,119600,7,19;112;121;131;125;51;90;191;71;147;115;178;10;133;122;135;32;96;63;102;92;38;27;16;1;24;156;198;117;193;190;80;162;142;175;78;36;61;91;141;97;146;187;165;127;89;103;113;194;166;179;185;130;95;86;176;163;153;81;77;58;82;8;144;111;35;109;0;29;160;33;49;11;134;6;188;169;132;13;161;70;3;15;145;195;168;139;182;138;104;21;177;5;45;136;73;164;31;54;151,4930393416588515202,0.003031
steepest_intra:nodes_start:greedy,20,46371,20200,26171,134550,8,20;60;94;66;47;148;99;22;179;185;130;95;86;166;194;176;113;26;103;114;137;127;89;163;187;153;81;77;141;91;61;36;78;175;142;45;5;177;21;82;111;8;104;138;182;139;168;195;145;15;3;70;13;132;169;188;6;147;178;10;133;122;135;63;38;1;117;193;31;54;73;121;90;51;118;74;134;11;33;160;29;0;109;35;143;106;124;128;62;18;55;34;170;152;183;140;4;149;28;59,6784813984860360815,0.004029
steepest_intra:nodes_start:greedy,21,51695,19176,32519,119600,7,21;87;82;111;8;104;56;144;33;160;29;0;35;109;69;189;155;145;15;3;70;161;188;6;169;132;13;195;168;43;134;139;11;138;182;25;177;5;45;142;175;78;36;61;91;141;97;146;187;165;127;89;103;137;114;113;194;166;172;179;185;22;99;130;86;95;183;140;199;9;148;47;66;94;60;20;59;28;149;4;152;170;34;55;18;62;128;124;143;159;106;176;88;180;163;186;153;81;77;58,2408892973210761722,0.003002
steepest_intra:nodes_start:greedy,22,47640,20408,27232,134550,8,99;22;130;95;183;140;152;170;34;55;18;62;128;124;106;143;35;109;0;29;160;33;11;134;74;118;51;90;121;117;1;38;63;135;122;133;10;178;147;6;188;169;132;13;70;3;15;145;195;168;139;182;138;104;8;111;82;21;177;5;45;142;175;78;36;61;91;141;77;81;153;187;163;89;127;137;114;103;26;113;176;194;166;86;185;179;172;57;66;94;47;148;60;20;59;28;149;4;199;9,2028659305845784125,0.004002
steepest_intra:nodes_start:greedy,23,46616,20138,26478,164450,10,23;20;59;28;149;4;140;183;152;170;34;55;18;62;128;124;106;143;35;109;0;29;160;33;11;134;74;118;51;90;121;54;31;193;117;1;38;63;135;122;133;10;178;147;6;188;169;132;13;70;3;15;145;195;168;139;182;138;104;8;111;82;21;177;5;45;142;175;78;36;61;91;141;77;81;153;187;163;89;127;137;114;103;26;113;176;194;166;86;95;130;185;179;22;99;148;47;66;94;60,1778917546976370960,0.004000
steepest_intra:nodes_start:greedy,24,51886,18023,33863,119600,7,24;1;16;27;38;102;63;96;32;135;122;133;10;178;115;147;71;191;90;125;51;98;118;74;134;6;188;169;132;13;70;3;15;145;195;168;43;139;11;29;0;109;35;111;81;153;163;176;106;124;62;18;95;130;185;86;166;194;113;103;89;127;165;187;97;77;141;91;61;36;78;175;142;45;5;177;21;82;8;104;144;160;33;138;182;25;158;116;121;112;19;151;54;73;164;31;193;117;198;156,3135207385184811772,0.003002
steepest_intra:nodes_start:greedy,25,52573,19350,33223,194350,12,177;5;45;142;175;78;7;36;61;91;141;97;146;187;165;127;89;103;113;194;166;86;185;95;18;62;124;106;176;163;153;81;77;58;82;8;144;111;35;109;0;29;160;33;49;11;134;74;118;121;51;120;191;90;125;131;112;19;151;54;73;31;193;117;198;156;1;16;27;38;135;63;100;40;107;72;122;133;10;178;147;192;6;188;169;132;13;161;70;3;15;145;195;168;139;182;138;104;87;21,3569270211485487941,0.005004
steepest_intra:nodes_start:greedy,26,50704,20982,29722,164450,10,26;103;114;137;127;89;163;165;187;146;97;77;141;36;21;8;104;138;182;139;168;195;145;15;3;70;13;132;169;188;6;147;178;10;133;122;135;63;38;1;117;31;54;121;90;51;118;74;134;11;33;160;29;0;109;35;111;81;153;129;180;88;176;106;159;143;124;128;62;18;55;34;170;152;4;149;28;59;20;60;94;66;47;148;9;199;140;183;95;86;130;99;22;185;179;172;52;166;194;113,1126682108840544504,0.003971
steepest_intra:nodes_start:greedy,27,53761,18845,34916,119600,7,27;16;1;24;156;198;117;193;190;80;162;142;175;78;36;61;91;141;97;146;187;165;127;89;103;113;194;166;179;185;130;95;86;176;163;153;81;77;58;82;8;144;111;35;109;0;29;160;33;49;11;134;6;188;169;132;13;161;70;3;15;145;195;168;139;182;138;104;21;177;5;45;136;73;164;31;54;151;19;112;121;131;125;51;90;191;71;147;115;178;10;133;122;135;32;96;63;102;92;38,2903396176240155901,0.004028
steepest_intra:nodes_start:greedy,28,46445,19928,26517,149500,9,28;149;4;140;183;152;170;34;55;18;62;128;124;106;143;35;109;0;29;160;33;11;134;74;118;51;90;121;54;31;117;1;38;63;135;122;133;10;178;147;6;188;169;132;13;70;3;15;145;195;168;139;182;138;104;8;111;82;21;177;5;45;142;175;78;36;61;91;141;77;81;153;187;163;89;127;137;114;103;26;113;176;194;166;86;95;130;99;22;185;179;172;57;66;94;47;148;60;20;59,7662276257383529219,0.005005
steepest_intra:nodes_start:greedy,29,51482,18605,32877,119600,7,29;0;109;35;111;41;81;153;186;163;180;88;176;106;159;143;124;128;62;18;55;34;170;152;4;149;28;59;20;60;94;66;47;148;9;199;140;183;95;86;130;99;22;185;179;172;52;166;194;113;114;137;103;89;127;165;187;146;97;77;141;91;61;36;78;175;142;45;5;177;21;87;82;8;104;56;144;160;33;138;182;11;139;134;43;168;195;13;132;169;6;188;161;70;3;15;145;155;189;69,3131289756400653675,0.003002
steepest_intra:nodes_start:greedy,30,51979,20005,31974,209300,13,42;190;80;162;142;175;78;36;61;91;141;97;146;187;165;127;89;103;113;194;166;86;185;130;95;18;62;124;106;176;163;153;81;77;58;82;8;144;111;35;109;0;29;160;33;49;11;134;74;118;121;51;120;191;90;125;131;135;102;63;100;40;107;72;122;133;10;178;147;192;6;188;169;132;13;161;70;3;15;145;195;168;139;182;138;104;21;177;5;45;136;73;164;31;54;193;117;198;1;156,8395334926537543044,0.005004
steepest_intra:nodes_start:greedy,31,50838,19816,31022,179400,11,73;164;31;54;117;198;193;190;80;162;142;175;78;36;61;91;141;97;146;187;165;127;89;103;113;194;166;86;185;130;95;183;140;55;18;62;124;106;176;163;153;81;77;58;82;8;144;111;35;109;0;29;160;33;49;11;134;74;118;121;51;120;191;90;125;131;135;102;63;100;40;107;72;122;133;10;178;147;192;6;188;169;132;13;161;70;3;15;145;195;168;139;182;138;104;21;177;5;45;136,2670546007855455726,0.005009
steepest_intra:nodes_start:greedy,32,52203,18845,33358,149500,9,32;102;63;100;40;107;72;133;10;178;147;192;6;188;169;132;161;70;3;15;145;13;195;168;43;11;29;0;109;35;111;81;153;163;176;106;124;62;18;185;86;166;194;113;103;89;127;165;187;97;77;141;91;61;36;78;175;142;45;5;177;21;82;8;104;144;160;33;138;182;139;134;85;74;118;98;51;116;121;112;19;151;54;73;164;31;193;117;198;156;1;16;27;38;131;125;191;90;122;135,8447240405203110763,0.004005
steepest_intra:nodes_start:greedy,33,51482,18605,32877,119600,7,33;160;144;56;104;8;82;87;21;177;5;45;142;175;78;36;61;91;141;77;97;146;187;165;127;89;103;137;114;113;194;166;52;172;179;185;22;99;130;86;95;183;140;199;9;148;47;66;94;60;20;59;28;149;4;152;170;34;55;18;62;128;124;143;159;106;176;88;180;163;186;153;81;41;111;35;109;0;29;69;189;155;145;15;3;70;161;188;6;169;132;13;195;168;43;134;139;11;182;138,2416156619784040383,0.004001
steepest_intra:nodes_start:greedy,34,50703,18111,32592,134550,8,55;83;128;86;176;180;113;194;166;52;172;179;185;22;99;130;95;183;140;199;9;148;47;66;94;60;20;59;28;149;4;152;170;184;155;189;3;70;15;145;13;132;169;188;6;134;43;195;168;139;11;182;138;33;160;144;56;104;8;82;87;21;177;5;45;142;175;78;36;61;79;91;141;77;97;146;187;165;137;114;127;89;103;163;186;153;81;41;111;29;0;109;35;143;159;106;124;62;18;34,4163773486673217009,0.004000
steepest_intra:nodes_start:greedy,35,51482,18605,32877,119600,7,109;0;29;69;189;155;145;15;3;70;161;188;6;169;132;13;195;168;43;134;139;11;182;138;33;160;144;56;104;8;82;87;21;177;5;45;142;175;78;36;61;91;141;77;97;146;187;165;127;89;103;137;114;113;194;166;52;172;179;185;22;99;130;86;95;183;140;199;9;148;47;66;94;60;20;59;28;149;4;152;170;34;55;18;62;128;124;143;159;106;176;88;180;163;186;153;81;41;111;35,2205745819738096634,0.003980
steepest_intra:nodes_start:greedy,36,51559,19902,31657,179400,11,91;141;97;146;187;165;127;89;103;113;194;166;86;185;95;183;140;18;62;124;106;176;163;153;81;77;58;82;8;144;111;35;109;0;29;160;33;49;11;134;74;118;121;51;120;191;90;125;131;112;19;151;54;73;31;193;117;198;156;1;16;27;38;135;63;100;40;107;72;122;133;10;178;147;192;6;188;169;132;13;161;70;3;15;145;195;168;139;182;138;104;21;177;5;45;142;175;78;36;61,8058015483852112242,0.005006
steepest_intra:nodes_start:greedy,37,48767,21052,27715,194350,12,144;35;109;0;29;160;33;11;134;74;118;51;90;131;121;73;54;31;193;117;198;156;1;16;27;38;135;63;40;107;100;122;133;10;178;147;6;188;169;132;13;70;3;15;145;195;168;139;182;138;104;8;82;21;177;5;45;142;175;78;36;61;91;141;77;97;146;187;165;127;89;103;137;114;113;194;166;172;179;185;22;99;130;86;95;183;140;152;170;34;55;18;62;124;106;176;163;153;81;111,6162896266991058243,0.005000
steepest_intra:nodes_start:greedy,38,51142,18651,32491,134550,8,38;102;63;100;40;107;72;133;10;178;147;192;6;188;169;132;161;70;3;15;145;13;195;168;43;11;29;0;109;35;111;81;153;163;176;106;124;62;18;95;130;185;86;166;194;113;103;89;127;165;187;97;77;141;91;61;36;78;175;142;45;5;177;21;82;8;104;144;160;33;138;182;139;134;85;74;118;98;51;125;191;90;122;135;131;121;112;19;151;54;73;164;31;193;117;198;156;1;16;27,1216615958435294924,0.003592
steepest_intra:nodes_start:greedy,39,51552,18738,32814,149500,9,49;29;0;35;109;69;189;155;145;15;3;70;161;188;6;169;132;13;195;168;43;134;139;11;182;138;104;56;8;82;87;21;177;5;45;142;175;78;36;61;91;141;77;97;146;187;165;127;89;103;137;114;113;194;166;172;179;185;22;99;130;86;95;183;140;199;9;148;47;66;94;60;20;59;28;149;4;152;170;34;55;18;62;128;124;143;159;106;176;88;180;163;186;153;81;41;111;144;160;33,3382353934533359157,0.004002
steepest_intra:nodes_start:greedy,40,51667,18843,32824,149500,9,40;100;63;102;135;122;90;191;125;131;38;27;16;1;156;198;117;193;31;164;73;54;151;19;112;121;116;51;98;118;74;85;134;139;182;138;33;160;144;104;8;82;21;177;5;45;142;175;78;36;61;91;141;77;97;187;165;127;89;103;113;194;166;86;185;95;18;62;124;106;176;163;153;81;111;35;109;0;29;11;43;168;195;13;145;15;3;70;161;132;169;188;6;192;147;178;10;133;72;107,235356859167138349,0.004011
steepest_intra:nodes_start:greedy,41,48324,19985,28339,149500,9,41;81;77;141;97;153;187;163;89;127;137;114;103;26;113;176;194;166;86;185;179;172;57;66;94;47;148;60;20;59;28;149;4;199;9;99;130;95;183;140;152;170;34;55;18;62;128;124;106;143;35;109;0;29;160;33;11;134;74;118;51;90;131;121;73;54;31;193;117;198;156;1;27;38;63;135;122;133;10;178;147;6;188;169;132;13;70;3;15;145;195;168;139;182;138;104;8;21;82;111,5376625392328304544,0.003923
steepest_intra:nodes_start:greedy,42,52368,20027,32341,209300,13,42;30;190;80;162;142;175;78;36;61;91;141;97;146;187;165;127;89;103;113;194;166;86;185;95;18;62;124;106;176;163;153;81;77;58;82;8;144;111;35;109;0;29;160;33;49;11;134;74;118;121;51;120;191;90;125;131;135;102;63;100;40;107;72;122;133;10;178;147;192;6;188;169;132;13;161;70;3;15;145;195;168;139;182;138;104;21;177;5;45;136;73;164;54;31;193;117;198;1;156,3703415104510345428,0.006001
steepest_intra:nodes_start:greedy,43,50079,20332,29747,149500,9,43;134;118;74;139;11;29;0;109;35;111;81;153;163;176;106;124;62;18;55;152;140;183;95;130;185;86;166;194;113;103;89;127;165;187;97;77;141;91;61;36;78;175;142;45;5;177;21;82;8;104;144;160;33;138;182;25;158;121;51;191;90;131;112;19;151;54;73;31;193;117;198;156;1;16;27;38;135;63;100;40;107;72;122;133;10;178;147;192;6;188;169;132;13;70;3;15;145;195;168,8066627649129053063,0.006993
steepest_intra:nodes_start:greedy,44,53429,18847,34582,74750,4,44;133;10;178;115;147;71;191;90;125;51;98;118;74;134;6;188;169;132;13;70;3;15;145;195;168;43;139;11;29;0;109;35;111;81;153;163;176;86;95;185;179;166;194;113;103;89;127;165;187;97;77;141;91;61;36;78;175;142;45;5;177;21;82;8;104;144;160;33;138;182;25;158;116;121;131;112;19;151;54;73;164;31;193;117;198;156;1;16;27;38;135;102;63;100;40;107;17;72;122,4520811118771053942,0.001000
steepest_intra:nodes_start:greedy,45,51559,19902,31657,149500,9,45;5;177;21;104;138;182;139;168;195;145;15;3;70;161;13;132;169;188;6;192;147;178;10;133;122;72;107;40;100;63;135;38;27;16;1;156;198;117;193;31;73;54;151;19;112;131;125;90;191;120;51;121;118;74;134;11;49;33;160;29;0;109;35;111;144;8;82;58;77;81;153;163;176;106;124;62;18;140;183;95;185;86;166;194;113;103;89;127;165;187;146;97;141;91;61;36;78;175;142,8684618878678958755,0.004000
steepest_intra:nodes_start:greedy,46,51285,19779,31506,179400,11,46;80;190;193;198;117;54;31;164;73;136;45;5;177;21;104;138;182;139;168;195;145;15;3;70;161;13;132;169;188;6;192;147;178;10;133;122;72;107;40;100;63;102;135;131;125;90;191;120;51;121;118;74;134;11;49;33;160;29;0;109;35;111;144;8;82;58;77;81;153;163;176;106;124;62;18;55;140;183;95;185;86;166;194;113;103;89;127;165;187;146;97;141;91;61;36;78;175;142;162,1207657118095080946,0.005000
steepest_intra:nodes_start:greedy,47,46445,19928,26517,179400,11,47;148;60;20;59;28;149;4;140;183;152;170;34;55;18;62;128;124;106;143;35;109;0;29;160;33;11;134;74;118;51;90;121;54;31;117;1;38;63;135;122;133;10;178;147;6;188;169;132;13;70;3;15;145;195;168;139;182;138;104;8;111;82;21;177;5;45;142;175;78;36;61;91;141;77;81;153;187;163;89;127;137;114;103;26;113;176;194;166;86;95;130;99;22;185;179;172;57;66;94,4812380110567974940,0.005000
steepest_intra:nodes_start:greedy,48,47966,20483,27483,149500,9,194;176;180;113;26;103;114;137;127;89;163;187;153;81;77;141;91;61;36;78;175;142;45;5;177;21;82;111;8;104;138;182;139;168;195;145;15;3;70;13;132;169;188;6;147;178;10;133;122;63;135;1;117;121;90;51;118;74;134;11;33;160;29;0;109;35;143;106;124;128;62;18;55;34;170;152;140;183;130;95;86;185;22;99;9;199;4;149;28;59;20;60;148;47;94;66;57;172;179;166,8347771239285650345,0.004001
steepest_intra:nodes_start:greedy,49,48765,20940,27825,179400,11,49;29;0;109;35;111;81;153;163;176;106;124;62;18;55;34;170;152;140;183;95;86;130;99;22;185;179;172;166;194;113;114;137;103;89;127;165;187;146;97;77;141;91;61;36;78;175;142;45;5;177;21;82;8;104;144;160;33;138;182;139;168;195;145;15;3;70;13;132;169;188;6;147;178;10;133;122;107;40;63;135;38;27;16;1;156;198;117;193;31;54;73;121;131;90;51;118;74;134;11,5489970598984834261,0.005000
steepest_intra:nodes_start:greedy,50,51488,20978,30510,134550,8,82;81;153;163;180;88;176;106;143;124;128;62;18;55;34;170;152;140;183;95;86;130;99;22;185;179;172;166;194;113;114;137;103;89;127;165;187;146;97;77;141;36;21;8;104;138;182;139;168;195;145;15;3;70;13;132;169;188;6;192;147;178;10;133;122;72;107;40;100;63;135;38;27;16;1;156;198;117;193;31;73;54;151;19;131;90;191;51;121;118;74;134;11;33;160;29;0;109;35;111,1449333255678160005,0.003997
steepest_intra:nodes_start:greedy,51,50622,19759,30863,149500,9,51;125;191;90;122;133;10;72;107;40;100;63;102;135;38;27;16;1;156;198;117;193;31;164;73;54;151;19;112;131;121;116;158;25;182;138;33;160;144;104;8;82;21;177;5;45;142;175;78;36;61;91;141;77;97;187;165;127;89;103;113;194;166;86;185;95;183;140;18;62;124;106;176;163;153;81;111;35;109;0;29;11;139;43;168;195;145;15;3;70;13;132;169;188;6;147;134;74;118;98,2098635519731259140,0.003999
steepest_intra:nodes_start:greedy,52,47838,20467,27371,119600,7,52;166;194;176;113;26;103;114;137;127;89;163;187;153;81;77;141;91;61;36;78;175;142;45;5;177;21;82;111;8;104;138;182;139;168;195;145;15;3;70;13;132;169;188;6;147;178;10;133;122;135;63;38;1;117;121;90;51;118;74;134;11;33;160;29;0;109;35;143;106;124;128;62;18;55;34;170;152;140;183;130;95;86;185;22;99;9;199;4;149;28;59;20;60;148;47;94;66;179;172,2093077983072870814,0.003000
steepest_intra:nodes_start:greedy,53,47804,20377,27427,119600,7,53;140;183;95;130;99;9;199;4;149;28;59;20;60;148;47;94;66;57;172;179;185;86;166;194;176;113;26;103;114;137;127;89;163;187;153;81;77;141;91;61;36;78;175;142;45;5;177;21;82;111;8;104;138;182;139;168;195;145;15;3;70;13;132;169;188;6;147;178;10;133;122;135;63;38;1;117;121;90;51;118;74;134;11;33;160;29;0;109;35;143;106;124;128;62;18;55;34;170;152,8305439081952268827,0.004002
steepest_intra:nodes_start:greedy,54,50838,19816,31022,164450,10,54;31;164;73;136;45;5;177;21;104;138;182;139;168;195;145;15;3;70;161;13;132;169;188;6;192;147;178;10;133;122;72;107;40;100;63;102;135;131;125;90;191;120;51;121;118;74;134;11;49;33;160;29;0;109;35;111;144;8;82;58;77;81;153;163;176;106;124;62;18;55;140;183;95;130;185;86;166;194;113;103;89;127;165;187;146;97;141;91;61;36;78;175;142;162;80;190;193;198;117,339242192752670429,0.005030
steepest_intra:nodes_start:greedy,55,50703,18111,32592,134550,8,34;55;83;128;86;176;180;113;194;166;52;172;179;185;22;99;130;95;183;140;199;9;148;47;66;94;60;20;59;28;149;4;152;170;184;155;189;3;70;15;145;13;132;169;188;6;134;43;195;168;139;11;182;138;33;160;144;56;104;8;82;87;21;177;5;45;142;175;78;36;61;79;91;141;77;97;146;187;165;137;114;127;89;103;163;186;153;81;41;111;29;0;109;35;143;159;106;124;62;18,6391396927216430030,0.004010
steepest_intra:nodes_start:greedy,56,55385,18495,36890,134550,8,56;144;111;35;109;0;29;160;33;49;11;139;134;85;74;118;98;121;51;120;71;191;90;125;131;112;19;151;54;73;164;31;193;117;198;156;1;16;27;38;135;102;63;100;40;107;72;122;133;10;178;115;147;192;6;188;169;132;13;161;70;3;15;145;195;168;43;182;138;104;25;177;5;45;142;175;78;36;61;91;141;97;146;187;165;127;89;103;113;194;166;176;163;153;81;77;82;87;21;8,971811035918278615,0.003003
steepest_intra:nodes_start:greedy,57,46445,19928,26517,149500,9,57;172;179;185;22;99;130;95;86;166;194;176;113;26;103;114;137;127;89;163;187;153;81;77;141;91;61;36;78;175;142;45;5;177;21;82;111;8;104;138;182;139;168;195;145;15;3;70;13;132;169;188;6;147;178;10;133;122;135;63;38;1;117;31;54;121;90;51;118;74;134;11;33;160;29;0;109;35;143;106;124;128;62;18;55;34;170;152;183;140;4;149;28;59;20;60;148;47;94;66,995982129386146229,0.004978
steepest_intra:nodes_start:greedy,58,51559,19902,31657,164450,10,58;82;8;144;111;35;109;0;29;160;33;49;11;134;74;118;121;51;120;191;90;125;131;112;19;151;54;73;31;193;117;198;156;1;16;27;38;135;63;100;40;107;72;122;133;10;178;147;192;6;188;169;132;13;161;70;3;15;145;195;168;139;182;138;104;21;177;5;45;142;175;78;36;61;91;141;97;146;187;165;127;89;103;113;194;166;86;185;95;183;140;18;62;124;106;176;163;153;81;77,1453973428828863043,0.004021
steepest_intra:nodes_start:greedy,59,46445,19928,26517,149500,9,59;28;149;4;140;183;152;170;34;55;18;62;128;124;106;143;35;109;0;29;160;33;11;134;74;118;51;90;121;54;31;117;1;38;63;135;122;133;10;178;147;6;188;169;132;13;70;3;15;145;195;168;139;182;138;104;8;111;82;21;177;5;45;142;175;78;36;61;91;141;77;81;153;187;163;89;127;137;114;103;26;113;176;194;166;86;95;130;99;22;185;179;172;57;66;94;47;148;60;20,7055337396549643243,0.003003
steepest_intra:nodes_start:greedy,60,46371,20200,26171,134550,8,60;94;66;47;148;99;22;179;185;130;95;86;166;194;176;113;26;103;114;137;127;89;163;187;153;81;77;141;91;61;36;78;175;142;45;5;177;21;82;111;8;104;138;182;139;168;195;145;15;3;70;13;132;169;188;6;147;178;10;133;122;135;63;38;1;117;193;31;54;73;121;90;51;118;74;134;11;33;160;29;0;109;35;143;106;124;128;62;18;55;34;170;152;183;140;4;149;28;59;20,4452543890704502960,0.003977
steepest_intra:nodes_start:greedy,61,51559,19902,31657,179400,11,61;36;78;175;142;45;5;177;21;104;138;182;139;168;195;145;15;3;70;161;13;132;169;188;6;192;147;178;10;133;122;72;107;40;100;63;135;38;27;16;1;156;198;117;193;31;73;54;151;19;112;131;125;90;191;120;51;121;118;74;134;11;49;33;160;29;0;109;35;111;144;8;82;58;77;81;153;163;176;106;124;62;18;140;183;95;185;86;166;194;113;103;89;127;165;187;146;97;141;91,5006748000983120002,0.004012
steepest_intra:nodes_start:greedy,62,50703,18111,32592,134550,8,62;124;106;159;143;35;109;0;29;111;41;81;153;186;163;103;89;127;114;137;165;187;146;97;77;141;91;79;61;36;78;175;142;45;5;177;21;87;82;8;104;56;144;160;33;138;182;11;139;168;195;43;134;6;188;169;132;13;145;15;70;3;189;155;184;170;152;4;149;28;59;20;60;94;66;47;148;9;199;140;183;95;130;99;22;185;179;172;52;166;194;113;180;176;86;128;83;55;34;18,2728947507835224666,0.004012
steepest_intra:nodes_start:greedy,63,51667,18843,32824,149500,9,63;100;40;107;72;133;10;178;147;192;6;188;169;132;161;70;3;15;145;13;195;168;43;11;29;0;109;35;111;81;153;163;176;106;124;62;18;95;185;86;166;194;113;103;89;127;165;187;97;77;141;91;61;36;78;175;142;45;5;177;21;82;8;104;144;160;33;138;182;139;134;85;74;118;98;51;116;121;112;19;151;54;73;164;31;193;117;198;156;1;16;27;38;131;125;191;90;122;135;102,6258013370061483342,0.004012
steepest_intra:nodes_start:greedy,64,50469,20591,29878,149500,9,88;86;95;128;106;159;143;124;62;18;55;34;170;152;174;183;140;199;4;149;28;59;20;60;148;47;94;66;22;99;130;185;179;172;52;166;194;113;26;103;114;137;127;89;163;165;187;146;97;77;141;36;21;8;104;138;182;139;168;195;145;15;3;70;13;132;169;188;6;147;178;10;133;122;135;63;38;1;117;31;54;121;90;51;118;74;134;11;33;160;29;0;109;35;111;81;153;129;180;176,3955828953864191489,0.003997
steepest_intra:nodes_start:greedy,65,50072,17420,32652,59800,3,65;188;6;169;132;13;126;168;195;145;15;189;34;55;18;62;128;124;106;159;143;35;109;0;29;160;33;49;11;139;182;138;104;8;56;144;111;82;87;21;177;5;45;142;175;78;36;61;79;91;141;97;77;81;153;146;187;165;163;89;127;137;114;103;26;113;180;176;194;166;86;185;179;172;57;66;94;47;148;60;20;59;28;149;4;199;9;99;22;130;95;183;140;152;170;184;155;3;70;161,4420156961994844112,0.001972
steepest_intra:nodes_start:greedy,66,46445,19928,26517,179400,11,66;57;172;179;185;22;99;130;95;86;166;194;176;113;26;103;114;137;127;89;163;187;153;81;77;141;91;61;36;78;175;142;45;5;177;21;82;111;8;104;138;182;139;168;195;145;15;3;70;13;132;169;188;6;147;178;10;133;122;135;63;38;1;117;31;54;121;90;51;118;74;134;11;33;160;29;0;109;35;143;106;124;128;62;18;55;34;170;152;183;140;4;149;28;59;20;60;148;47;94,4049759945551229071,0.006009
steepest_intra:nodes_start:greedy,67,53325,18881,34444,74750,4,67;120;51;98;118;74;134;6;188;169;132;13;70;3;15;145;195;168;43;139;11;29;0;109;35;111;81;153;163;176;86;95;130;185;179;166;194;113;103;89;127;165;187;97;77;141;91;61;36;78;175;142;45;5;177;21;82;8;104;144;160;33;138;182;25;158;116;121;131;112;19;151;54;73;164;31;193;117;198;156;1;16;27;38;135;102;63;100;40;107;17;72;122;133;10;178;90;191;147;71,1895344188482346810,0.002505
steepest_intra:nodes_start:greedy,68,52344,19369,32975,209300,13,56;144;111;35;109;0;29;160;33;49;11;134;74;118;121;51;120;191;90;125;131;112;19;151;54;73;31;193;117;198;156;1;16;27;38;135;63;100;40;107;72;122;133;10;178;147;192;6;188;169;132;13;161;70;3;15;145;195;168;139;182;138;104;87;21;177;5;45;142;175;78;36;61;91;141;97;146;187;165;127;89;103;113;194;166;86;185;95;18;62;124;106;176;163;153;81;77;58;82;8,5851060950691694467,0.005000
steepest_intra:nodes_start:greedy,69,51801,18119,33682,119600,7,0;109;35;12;111;41;81;153;186;163;180;88;176;106;159;143;124;128;62;18;55;34;170;152;4;149;28;59;20;60;94;66;47;148;9;199;140;183;95;86;130;99;22;185;179;172;52;166;194;113;26;114;137;103;89;127;165;187;146;97;77;141;91;79;61;36;78;175;142;45;5;177;21;87;82;8;104;56;144;160;33;138;182;11;139;134;43;168;195;13;132;169;6;188;161;70;3;15;145;29,8252240457903171100,0.002999
steepest_intra:nodes_start:greedy,70,49983,17472,32511,59800,3,70;161;188;6;169;132;13;126;168;195;145;15;189;34;55;18;62;128;124;106;159;143;35;109;0;29;160;33;49;11;139;182;138;104;8;56;144;111;82;87;21;177;5;45;142;175;78;36;61;79;91;141;97;77;81;153;146;187;165;163;89;127;137;114;103;26;113;180;176;194;166;86;185;179;52;172;57;66;94;47;148;60;20;59;28;149;4;199;9;99;22;130;95;183;140;152;170;184;155;3,2292233416461293289,0.002005
steepest_intra:nodes_start:greedy,71,50248,19260,30988,224250,14,71;147;192;6;188;169;132;161;70;3;15;145;13;195;168;43;11;29;0;109;35;111;81;153;163;176;106;124;62;18;55;140;183;95;185;86;166;194;113;103;89;127;165;187;97;77;141;91;61;36;78;175;142;45;5;177;21;82;8;104;144;160;33;138;182;139;134;74;118;98;51;125;131;121;112;54;73;164;31;193;117;198;156;1;16;27;38;135;102;63;100;40;107;72;122;133;10;178;90;191,8983058672918833185,0.006010
steepest_intra:nodes_start:greedy,72,51667,18843,32824,149500,9,72;107;40;100;63;102;135;122;90;191;125;131;38;27;16;1;156;198;117;193;31;164;73;54;151;19;112;121;116;51;98;118;74;85;134;139;182;138;33;160;144;104;8;82;21;177;5;45;142;175;78;36;61;91;141;77;97;187;165;127;89;103;113;194;166;86;185;95;18;62;124;106;176;163;153;81;111;35;109;0;29;11;43;168;195;13;145;15;3;70;161;132;169;188;6;192;147;178;10;133,6859641968775399117,0.004011
steepest_intra:nodes_start:greedy,73,50838,19816,31022,164450,10,31;164;73;136;45;5;177;21;104;138;182;139;168;195;145;15;3;70;161;13;132;169;188;6;192;147;178;10;133;122;72;107;40;100;63;102;135;131;125;90;191;120;51;121;118;74;134;11;49;33;160;29;0;109;35;111;144;8;82;58;77;81;153;163;176;106;124;62;18;55;140;183;95;130;185;86;166;194;113;103;89;127;165;187;146;97;141;91;61;36;78;175;142;162;80;190;193;198;117;54,7441606710101132357,0.005571
steepest_intra:nodes_start:greedy,74,50636,19911,30725,89700,5,74;118;98;51;125;90;191;10;133;122;72;107;40;100;63;102;135;131;121;158;25;182;138;33;160;144;104;8;82;87;21;177;5;45;142;175;78;36;61;91;141;77;97;146;187;165;127;89;103;137;114;113;194;166;172;179;185;22;99;130;86;95;183;140;152;170;34;55;18;62;128;124;106;176;180;163;153;81;111;35;109;0;29;49;11;139;43;168;195;145;15;3;70;13;132;169;188;6;147;134,2016156192571004651,0.003978
steepest_intra:nodes_start:greedy,75,51052,21058,29994,194350,12,75;114;88;194;166;179;172;57;66;94;47;148;60;20;59;28;149;4;199;9;99;22;185;86;95;130;183;140;152;170;34;55;18;62;128;124;143;159;106;176;180;113;26;103;163;186;153;81;111;35;109;0;29;160;33;11;134;74;118;51;90;121;31;117;1;38;63;135;122;133;10;178;147;6;188;169;132;13;70;3;15;145;195;168;139;182;138;104;8;21;36;141;77;97;146;187;165;89;127;137,4521451658185033467,0.006256
steepest_intra:nodes_start:greedy,76,50832,20554,30278,164450,10,194;166;52;172;179;185;22;99;130;95;183;140;199;9;148;47;66;94;60;20;59;28;149;4;53;152;170;34;55;18;62;124;143;159;106;128;86;88;176;180;113;26;103;163;186;153;81;111;35;109;0;29;160;33;11;134;74;118;51;90;121;31;117;1;38;63;135;122;133;10;178;147;6;188;169;132;13;70;3;15;145;195;168;139;182;138;104;8;21;36;141;77;97;146;187;165;89;127;137;114,6908955442835811096,0.004002
steepest_intra:nodes_start:greedy,77,50753,20967,29786,164450,10,141;36;21;8;104;138;182;139;168;195;145;15;3;70;13;132;169;188;6;147;178;10;133;122;135;63;38;1;117;31;54;121;90;51;118;74;134;11;33;160;29;0;109;35;111;81;153;186;163;180;88;176;106;159;143;124;128;62;18;55;34;170;152;4;149;28;59;20;60;94;66;47;148;9;199;140;183;95;86;130;99;22;185;179;172;52;166;194;113;26;114;137;103;89;127;165;187;146;97;77,1784775451316069401,0.004011
steepest_intra:nodes_start:greedy,78,51559,19902,31657,149500,9,78;36;61;91;141;97;146;187;165;127;89;103;113;194;166;86;185;95;183;140;18;62;124;106;176;163;153;81;77;58;82;8;144;111;35;109;0;29;160;33;49;11;134;74;118;121;51;120;191;90;125;131;112;19;151;54;73;31;193;117;198;156;1;16;27;38;135;63;100;40;107;72;122;133;10;178;147;192;6;188;169;132;13;161;70;3;15;145;195;168;139;182;138;104;21;177;5;45;142;175,6555058684032924578,0.003999
steepest_intra:nodes_start:greedy,79,52196,19371,32825,149500,9,61;79;91;141;97;146;187;165;127;89;103;113;194;166;86;185;130;95;18;62;124;106;176;163;153;81;77;58;82;8;144;111;35;109;0;29;160;33;49;11;134;74;118;121;51;120;191;90;125;131;112;19;151;54;73;31;193;117;198;156;1;16;27;38;135;63;100;40;107;72;122;133;10;178;147;192;6;188;169;132;13;161;70;3;15;145;195;168;139;182;138;104;21;177;5;45;142;175;78;36,3868577417326881543,0.004000
steepest_intra:nodes_start:greedy,80,50838,19816,31022,149500,9,80;162;142;175;78;36;61;91;141;97;146;187;165;127;89;103;113;194;166;86;185;130;95;183;140;55;18;62;124;106;176;163;153;81;77;58;82;8;144;111;35;109;0;29;160;33;49;11;134;74;118;121;51;120;191;90;125;131;135;102;63;100;40;107;72;122;133;10;178;147;192;6;188;169;132;13;161;70;3;15;145;195;168;139;182;138;104;21;177;5;45;136;73;164;31;54;117;198;193;190,5577971697344595460,0.005004
steepest_intra:nodes_start:greedy,81,50753,20967,29786,164450,10,81;153;186;163;180;88;176;106;159;143;124;128;62;18;55;34;170;152;4;149;28;59;20;60;94;66;47;148;9;199;140;183;95;86;130;99;22;185;179;172;52;166;194;113;26;114;137;103;89;127;165;187;146;97;77;141;36;21;8;104;138;182;139;168;195;145;15;3;70;13;132;169;188;6;147;178;10;133;122;135;63;38;1;117;31;54;121;90;51;118;74;134;11;33;160;29;0;109;35;111,1920393100080576219,0.005002
steepest_intra:nodes_start:greedy,82,51695,19176,32519,119600,7,82;87;21;58;77;81;153;186;163;180;88;176;106;159;143;124;128;62;18;55;34;170;152;4;149;28;59;20;60;94;66;47;148;9;199;140;183;95;86;130;99;22;185;179;172;166;194;113;114;137;103;89;127;165;187;146;97;141;91;61;36;78;175;142;45;5;177;25;182;138;11;139;134;43;168;195;13;132;169;6;188;161;70;3;15;145;155;189;69;109;35;0;29;160;33;144;56;104;8;111,7434288606606972064,0.003000
steepest_intra:nodes_start:greedy,83,47754,20377,27377,149500,9,34;170;152;140;183;95;130;99;9;199;4;149;28;59;20;60;148;47;94;66;57;172;179;185;86;166;194;176;113;26;103;114;137;127;89;163;187;153;81;77;141;91;61;36;78;175;142;45;5;177;21;82;111;8;104;138;182;139;168;195;145;15;3;70;13;132;169;188;6;147;178;10;133;122;135;63;38;1;117;121;90;51;118;74;134;11;33;160;29;0;109;35;143;106;124;128;62;83;18;55,6949731935918273710,0.004001
steepest_intra:nodes_start:greedy,84,51378,18501,32877,164450,10,3;70;161;15;145;13;132;169;188;6;134;43;195;168;139;11;182;138;33;160;144;56;104;8;82;87;21;177;5;45;142;175;78;36;61;91;141;77;97;146;187;165;127;89;103;137;114;113;194;166;52;172;179;185;22;99;130;86;95;183;140;199;9;148;47;66;94;60;20;59;28;149;4;152;170;34;55;18;62;128;124;143;159;106;176;88;180;163;186;153;81;41;111;29;0;35;109;69;189;155,7766462761103227748,0.004000
steepest_intra:nodes_start:greedy,85,48690,20024,28666,164450,10,85;74;118;121;51;191;90;131;54;73;31;193;117;198;156;1;16;27;38;135;63;100;40;107;72;122;133;10;178;147;6;188;169;132;70;3;15;145;13;195;168;29;0;109;35;111;81;153;163;176;106;124;62;18;55;34;170;152;140;183;95;130;99;179;185;86;166;194;113;103;89;127;165;187;146;97;77;141;91;61;36;78;175;142;45;5;177;21;82;8;104;144;160;33;138;182;11;139;43;134,9036905400340987775,0.005000
steepest_intra:nodes_start:greedy,86,47222,20403,26819,134550,8,95;86;185;179;172;166;194;176;113;26;103;114;137;127;89;163;187;153;81;77;141;91;61;36;78;175;142;45;5;177;21;82;111;8;104;138;182;139;168;195;145;15;3;70;13;132;169;188;6;147;178;10;133;122;135;63;38;1;117;31;121;90;51;118;74;134;11;33;160;29;0;109;35;143;106;124;128;62;18;55;34;170;152;140;183;9;199;4;149;28;59;20;60;148;47;94;66;22;99;130,6187662123481132056,0.004336
steepest_intra:nodes_start:greedy,87,51695,19176,32519,119600,7,87;82;111;8;104;56;144;33;160;29;0;35;109;69;189;155;145;15;3;70;161;188;6;169;132;13;195;168;43;134;139;11;138;182;25;177;5;45;142;175;78;36;61;91;141;97;146;187;165;127;89;103;137;114;113;194;166;172;179;185;22;99;130;86;95;183;140;199;9;148;47;66;94;60;20;59;28;149;4;152;170;34;55;18;62;128;124;143;159;106;176;88;180;163;186;153;81;77;58;21,6621014604092961902,0.004002
steepest_intra:nodes_start:greedy,88,47574,20437,27137,179400,11,113;103;114;127;89;163;187;153;81;77;141;91;61;36;78;175;142;45;5;177;21;82;111;8;104;138;182;139;168;195;145;15;3;70;13;132;169;188;6;147;178;10;133;122;135;63;38;1;117;31;121;90;51;118;74;134;11;33;160;29;0;109;35;143;106;124;128;62;18;55;34;170;152;140;183;130;95;86;185;22;99;9;199;4;149;28;59;20;60;148;47;94;66;57;172;179;166;194;176;180,656491329698085048,0.004971
steepest_intra:nodes_start:greedy,89,50704,20982,29722,164450,10,89;163;165;187;146;97;77;141;36;21;8;104;138;182;139;168;195;145;15;3;70;13;132;169;188;6;147;178;10;133;122;135;63;38;1;117;31;54;121;90;51;118;74;134;11;33;160;29;0;109;35;111;81;153;129;180;88;176;106;159;143;124;128;62;18;55;34;170;152;4;149;28;59;20;60;94;66;47;148;9;199;140;183;95;86;130;99;22;185;179;172;52;166;194;113;26;103;114;137;127,389005476732966160,0.005002
steepest_intra:nodes_start:greedy,90,50622,19759,30863,149500,9,90;191;125;51;98;118;74;134;147;6;188;169;132;13;70;3;15;145;195;168;43;139;11;29;0;109;35;111;81;153;163;176;106;124;62;18;140;183;95;185;86;166;194;113;103;89;127;165;187;97;77;141;91;61;36;78;175;142;45;5;177;21;82;8;104;144;160;33;138;182;25;158;116;121;131;112;19;151;54;73;164;31;193;117;198;156;1;16;27;38;135;102;63;100;40;107;72;10;133;122,5712795183630439228,0.002999
steepest_intra:nodes_start:greedy,91,51559,19902,31657,179400,11,36;61;91;141;97;146;187;165;127;89;103;113;194;166;86;185;95;183;140;18;62;124;106;176;163;153;81;77;58;82;8;144;111;35;109;0;29;160;33;49;11;134;74;118;121;51;120;191;90;125;131;112;19;151;54;73;31;193;117;198;156;1;16;27;38;135;63;100;40;107;72;122;133;10;178;147;192;6;188;169;132;13;161;70;3;15;145;195;168;139;182;138;104;21;177;5;45;142;175;78,3651329764358535767,0.005000
steepest_intra:nodes_start:greedy,92,52203,18845,33358,194350,12,102;32;135;122;90;191;125;131;38;27;16;1;156;198;117;193;31;164;73;54;151;19;112;121;116;51;98;118;74;85;134;139;182;138;33;160;144;104;8;82;21;177;5;45;142;175;78;36;61;91;141;77;97;187;165;127;89;103;113;194;166;86;185;18;62;124;106;176;163;153;81;111;35;109;0;29;11;43;168;195;13;145;15;3;70;161;132;169;188;6;192;147;178;10;133;72;107;40;100;63,2890909577553989095,0.005000
steepest_intra:nodes_start:greedy,93,52076,21033,31043,149500,9,76;75;137;114;127;89;165;187;146;97;77;141;36;21;8;104;138;182;139;168;195;145;15;3;70;13;132;169;188;6;147;178;10;133;122;63;135;1;117;121;90;51;118;74;134;11;33;160;29;0;109;35;111;81;153;186;163;103;26;113;180;176;194;86;128;106;159;143;124;62;18;55;34;170;152;53;4;149;28;59;20;60;94;66;47;148;9;199;140;183;95;130;99;22;185;179;172;52;166;48,5841788374173419987,0.003999
steepest_intra:nodes_start:greedy,94,46445,19928,26517,179400,11,94;66;57;172;179;185;22;99;130;95;86;166;194;176;113;26;103;114;137;127;89;163;187;153;81;77;141;91;61;36;78;175;142;45;5;177;21;82;111;8;104;138;182;139;168;195;145;15;3;70;13;132;169;188;6;147;178;10;133;122;135;63;38;1;117;31;54;121;90;51;118;74;134;11;33;160;29;0;109;35;143;106;124;128;62;18;55;34;170;152;183;140;4;149;28;59;20;60;148;47,1143233595733149658,0.005000
steepest_intra:nodes_start:greedy,95,47222,20403,26819,134550,8,86;95;130;99;22;66;94;47;148;60;20;59;28;149;4;199;9;183;140;152;170;34;55;18;62;128;124;106;143;35;109;0;29;160;33;11;134;74;118;51;90;121;31;117;1;38;63;135;122;133;10;178;147;6;188;169;132;13;70;3;15;145;195;168;139;182;138;104;8;111;82;21;177;5;45;142;175;78;36;61;91;141;77;81;153;187;163;89;127;137;114;103;26;113;176;194;166;172;179;185,6051465553298185976,0.005002
steepest_intra:nodes_start:greedy,96,51667,18843,32824,164450,10,102;135;122;90;191;125;131;38;27;16;1;156;198;117;193;31;164;73;54;151;19;112;121;116;51;98;118;74;85;134;139;182;138;33;160;144;104;8;82;21;177;5;45;142;175;78;36;61;91;141;77;97;187;165;127;89;103;113;194;166;86;185;95;18;62;124;106;176;163;153;81;111;35;109;0;29;11;43;168;195;13;145;15;3;70;161;132;169;188;6;192;147;178;10;133;72;107;40;100;63,501243851917997994,0.005000
steepest_intra:nodes_start:greedy,97,50753,20967,29786,164450,10,97;77;141;36;21;8;104;138;182;139;168;195;145;15;3;70;13;132;169;188;6;147;178;10;133;122;135;63;38;1;117;31;54;121;90;51;118;74;134;11;33;160;29;0;109;35;111;81;153;186;163;180;88;176;106;159;143;124;128;62;18;55;34;170;152;4;149;28;59;20;60;94;66;47;148;9;199;140;183;95;86;130;99;22;185;179;172;52;166;194;113;26;114;137;103;89;127;165;187;146,4016853672379872245,0.004033
steepest_intra:nodes_start:greedy,98,53088,18878,34210,74750,4,98;51;125;90;191;71;147;115;178;10;133;122;72;17;107;40;100;63;102;135;38;27;16;1;156;198;117;193;31;164;73;54;151;19;112;131;121;116;158;25;182;138;33;160;144;104;8;82;21;177;5;45;142;175;78;36;61;91;141;77;97;187;165;127;89;103;113;194;166;179;185;130;95;86;176;163;153;81;111;35;109;0;29;11;139;43;168;195;145;15;3;70;13;132;169;188;6;134;74;118,7143717514077062776,0.002000
steepest_intra:nodes_start:greedy,99,47292,20441,26851,119600,7,99;130;95;183;140;152;170;34;55;18;62;128;124;106;143;35;109;0;29;160;33;11;134;74;118;51;90;121;31;117;1;38;63;135;122;133;10;178;147;6;188;169;132;13;70;3;15;145;195;168;139;182;138;104;8;111;82;21;177;5;45;142;175;78;36;61;91;141;77;81;153;187;163;89;127;137;114;103;26;113;176;194;166;86;185;179;172;57;66;94;47;148;60;20;59;28;149;4;199;9,8360052701528093345,0.003003
steepest_intra:nodes_start:greedy,100,51667,18843,32824,179400,11,107;40;100;63;102;135;122;90;191;125;131;38;27;16;1;156;198;117;193;31;164;73;54;151;19;112;121;116;51;98;118;74;85;134;139;182;138;33;160;144;104;8;82;21;177;5;45;142;175;78;36;61;91;141;77;97;187;165;127;89;103;113;194;166;86;185;95;18;62;124;106;176;163;153;81;111;35;109;0;29;11;43;168;195;13;145;15;3;70;161;132;169;188;6;192;147;178;10;133;72,7253193312131317029,0.005005
steepest_intra:nodes_start:greedy,101,47056,19932,27124,149500,9,101;149;4;140;183;152;170;34;55;18;62;128;124;106;143;35;109;0;29;160;33;11;134;74;118;51;90;121;31;117;1;38;63;135;122;133;10;178;147;6;188;169;132;13;70;3;15;145;195;168;139;182;138;104;8;111;82;21;177;5;45;142;175;78;36;61;91;141;77;81;153;187;163;89;127;137;114;103;26;113;176;194;166;86;95;130;99;22;185;179;172;57;66;94;47;148;60;20;59;28,9089721754993485983,0.003973
steepest_intra:nodes_start:greedy,102,51667,18843,32824,149500,9,102;135;122;90;191;125;131;38;27;16;1;156;198;117;193;31;164;73;54;151;19;112;121;116;51;98;118;74;85;134;139;182;138;33;160;144;104;8;82;21;177;5;45;142;175;78;36;61;91;141;77;97;187;165;127;89;103;113;194;166;86;185;95;18;62;124;106;176;163;153;81;111;35;109;0;29;11;43;168;195;13;145;15;3;70;161;132;169;188;6;192;147;178;10;133;72;107;40;100;63,734062891262626405,0.004001
steepest_intra:nodes_start:greedy,103,50704,20982,29722,164450,10,103;114;137;127;89;163;165;187;146;97;77;141;36;21;8;104;138;182;139;168;195;145;15;3;70;13;132;169;188;6;147;178;10;133;122;135;63;38;1;117;31;54;121;90;51;118;74;134;11;33;160;29;0;109;35;111;81;153;129;180;88;176;106;159;143;124;128;62;18;55;34;170;152;4;149;28;59;20;60;94;66;47;148;9;199;140;183;95;86;130;99;22;185;179;172;52;166;194;113;26,3585093311132014418,0.005002
steepest_intra:nodes_start:greedy,104,48978,21071,27907,149500,9,104;138;182;139;168;195;145;15;3;70;13;132;169;188;6;147;178;10;133;122;107;40;63;135;38;27;16;1;156;198;117;193;31;54;73;121;131;90;51;118;74;134;11;33;160;29;109;35;0;144;111;41;81;153;163;176;106;124;62;18;55;34;170;152;140;183;95;86;130;99;22;185;179;172;166;194;113;114;137;103;89;127;165;187;146;97;77;141;91;61;36;78;175;142;45;5;177;21;82;8,1418030920690159043,0.004004
steepest_intra:nodes_start:greedy,105,51359,19920,31439,179400,11,105;136;73;164;31;54;117;198;193;45;5;177;21;104;138;182;139;168;195;145;15;3;70;161;13;132;169;188;6;192;147;178;10;133;122;72;107;40;100;63;102;135;131;125;90;191;120;51;121;118;74;134;11;49;33;160;29;0;109;35;111;144;8;82;58;77;81;153;163;176;106;124;62;18;55;140;183;95;185;86;166;194;113;103;89;127;165;187;146;97;141;91;61;36;78;175;142;162;80;190,2365072175871105333,0.005193
steepest_intra:nodes_start:greedy,106,46817,20352,26465,209300,13,124;128;86;95;183;140;4;149;28;59;20;60;148;47;94;66;99;130;185;179;172;166;194;176;113;26;103;114;137;127;89;163;187;153;81;77;141;91;61;36;78;175;142;45;5;177;21;82;8;111;144;104;138;182;139;168;195;145;15;3;70;13;132;169;188;6;147;178;10;133;122;135;63;38;1;198;117;193;31;54;73;121;90;51;118;74;134;11;33;160;29;0;109;35;34;55;18;62;143;106,8107405861245555715,0.006002
steepest_intra:nodes_start:greedy,107,51667,18843,32824,149500,9,107;72;133;10;178;147;192;6;188;169;132;161;70;3;15;145;13;195;168;43;11;29;0;109;35;111;81;153;163;176;106;124;62;18;95;185;86;166;194;113;103;89;127;165;187;97;77;141;91;61;36;78;175;142;45;5;177;21;82;8;104;144;160;33;138;182;139;134;85;74;118;98;51;116;121;112;19;151;54;73;164;31;193;117;198;156;1;16;27;38;131;125;191;90;122;135;102;63;100;40,9114003739616957203,0.003012
steepest_intra:nodes_start:greedy,108,52368,20027,32341,194350,12,30;190;80;162;142;175;78;36;61;91;141;97;146;187;165;127;89;103;113;194;166;86;185;95;18;62;124;106;176;163;153;81;77;58;82;8;144;111;35;109;0;29;160;33;49;11;134;74;118;121;51;120;191;90;125;131;135;102;63;100;40;107;72;122;133;10;178;147;192;6;188;169;132;13;161;70;3;15;145;195;168;139;182;138;104;21;177;5;45;136;73;164;31;54;193;117;198;1;156;42,2656816138928726964,0.004969
steepest_intra:nodes_start:greedy,109,51482,18605,32877,119600,7,0;29;69;189;155;145;15;3;70;161;188;6;169;132;13;195;168;43;134;139;11;182;138;33;160;144;56;104;8;82;87;21;177;5;45;142;175;78;36;61;91;141;77;97;146;187;165;127;89;103;137;114;113;194;166;52;172;179;185;22;99;130;86;95;183;140;199;9;148;47;66;94;60;20;59;28;149;4;152;170;34;55;18;62;128;124;143;159;106;176;88;180;163;186;153;81;41;111;35;109,7840347888639097953,0.003002
steepest_intra:nodes_start:greedy,110,50565,20693,29872,119600,7,110;128;106;159;143;124;62;18;55;34;170;152;4;149;28;59;20;60;94;66;47;148;9;199;140;183;95;130;99;22;185;179;172;52;166;194;113;26;103;114;137;127;89;163;165;187;146;97;77;141;36;21;8;104;138;182;139;168;195;145;15;3;70;13;132;169;188;6;147;178;10;133;122;135;63;38;1;117;31;54;121;90;51;118;74;134;11;33;160;29;0;109;35;111;81;153;129;180;176;86,3087739963320289933,0.003973
steepest_intra:nodes_start:greedy,111,48748,20821,27927,149500,9,111;35;109;0;29;160;33;11;134;74;118;51;90;131;121;73;54;31;193;117;198;156;1;16;27;38;135;63;100;40;107;72;122;133;10;178;147;6;188;169;132;13;70;3;15;145;195;168;139;182;138;104;8;82;21;177;5;45;142;175;78;36;61;91;141;77;97;146;187;165;127;89;103;137;114;113;194;166;172;179;185;22;99;130;86;95;183;140;152;170;34;55;18;62;124;106;176;163;153;81,7704773036732879683,0.004030
steepest_intra:nodes_start:greedy,112,53761,18845,34916,104650,6,112;19;151;54;31;164;73;136;45;5;177;21;104;138;182;139;168;195;145;15;3;70;161;13;132;169;188;6;134;11;49;33;160;29;0;109;35;111;144;8;82;58;77;81;153;163;176;86;95;130;185;179;166;194;113;103;89;127;165;187;146;97;141;91;61;36;78;175;142;162;80;190;193;117;198;156;24;1;16;27;38;92;102;63;96;32;135;122;133;10;178;115;147;71;191;90;51;125;131;121,62126812991835534,0.003030
steepest_intra:nodes_start:greedy,113,47794,20562,27232,119600,7,176;194;166;179;172;57;66;94;47;148;60;20;59;28;149;4;199;9;99;22;185;86;95;130;183;140;152;170;34;55;18;62;128;124;106;143;35;109;0;29;160;33;11;134;74;118;51;90;121;117;1;38;63;135;122;133;10;178;147;6;188;169;132;13;70;3;15;145;195;168;139;182;138;104;8;111;82;21;177;5;45;142;175;78;36;61;91;141;77;81;153;187;163;89;127;137;114;103;26;113,8237091957323139771,0.003999
steepest_intra:nodes_start:greedy,114,47232,20431,26801,134550,8,176;194;166;179;172;57;66;94;47;148;60;20;59;28;149;4;199;9;99;22;185;86;95;130;183;140;152;170;34;55;18;62;128;124;106;143;35;109;0;29;160;33;11;134;74;118;51;90;121;54;31;117;1;38;63;135;122;133;10;178;147;6;188;169;132;13;70;3;15;145;195;168;139;182;138;104;8;111;82;21;177;5;45;142;175;78;36;61;91;141;77;81;153;187;163;89;127;114;103;113,3202173750344039927,0.004012
steepest_intra:nodes_start:greedy,115,51896,19072,32824,149500,9,178;147;192;6;188;169;132;161;70;3;15;145;13;195;168;43;11;29;0;109;35;111;81;153;163;176;106;124;62;18;95;185;86;166;194;113;103;89;127;165;187;97;77;141;91;61;36;78;175;142;45;5;177;21;82;8;104;144;160;33;138;182;139;134;85;74;118;98;51;116;121;112;19;151;54;73;164;31;193;117;198;156;1;16;27;38;131;125;191;90;135;102;63;100;40;107;72;122;133;10,5172813724907767169,0.004003
steepest_intra:nodes_start:greedy,116,53088,18878,34210,74750,4,116;158;25;182;138;33;160;144;104;8;82;21;177;5;45;142;175;78;36;61;91;141;77;97;187;165;127;89;103;113;194;166;179;185;130;95;86;176;163;153;81;111;35;109;0;29;11;139;43;168;195;145;15;3;70;13;132;169;188;6;134;74;118;98;51;125;90;191;71;147;115;178;10;133;122;72;17;107;40;100;63;102;135;38;27;16;1;156;198;117;193;31;164;73;54;151;19;112;131;121,9192276056829712472,0.001999
steepest_intra:nodes_start:greedy,117,50838,19816,31022,164450,10,117;54;31;164;73;136;45;5;177;21;104;138;182;139;168;195;145;15;3;70;161;13;132;169;188;6;192;147;178;10;133;122;72;107;40;100;63;102;135;131;125;90;191;120;51;121;118;74;134;11;49;33;160;29;0;109;35;111;144;8;82;58;77;81;153;163;176;106;124;62;18;55;140;183;95;130;185;86;166;194;113;103;89;127;165;187;146;97;141;91;61;36;78;175;142;162;80;190;193;198,4718157998940742309,0.005002
steepest_intra:nodes_start:greedy,118,50622,19759,30863,149500,9,118;98;51;125;191;90;122;133;10;72;107;40;100;63;102;135;38;27;16;1;156;198;117;193;31;164;73;54;151;19;112;131;121;116;158;25;182;138;33;160;144;104;8;82;21;177;5;45;142;175;78;36;61;91;141;77;97;187;165;127;89;103;113;194;166;86;185;95;183;140;18;62;124;106;176;163;153;81;111;35;109;0;29;11;139;43;168;195;145;15;3;70;13;132;169;188;6;147;134;74,1694885876657501507,0.003004
steepest_intra:nodes_start:greedy,119,51008,18350,32658,134550,8,119;159;143;35;109;0;29;111;41;81;153;186;163;103;89;127;114;137;165;187;146;97;77;141;91;61;36;78;175;142;45;5;177;21;87;82;8;104;56;144;160;33;138;182;11;139;168;195;43;134;6;188;169;132;13;145;15;70;3;189;155;184;170;152;4;149;28;59;20;60;94;66;47;148;9;199;140;183;95;130;99;22;185;179;172;52;166;194;113;180;176;86;128;83;55;34;18;62;124;106,8146868713246256139,0.003004
steepest_intra:nodes_start:greedy,120,52138,19237,32901,134550,8,120;51;98;118;74;134;6;188;169;132;13;70;3;15;145;195;168;43;139;11;29;0;109;35;111;81;153;163;176;106;124;62;18;185;86;166;194;113;103;89;127;165;187;97;77;141;91;61;36;78;175;142;45;5;177;21;82;8;104;144;160;33;138;182;25;158;116;121;131;112;19;151;54;73;164;31;193;117;198;156;1;16;27;38;135;102;63;100;40;107;17;72;122;133;10;178;90;191;147;71,2263160688664838930,0.002979
steepest_intra:nodes_start:greedy,121,50622,19759,30863,149500,9,121;116;158;25;182;138;33;160;144;104;8;82;21;177;5;45;142;175;78;36;61;91;141;77;97;187;165;127;89;103;113;194;166;86;185;95;183;140;18;62;124;106;176;163;153;81;111;35;109;0;29;11;139;43;168;195;145;15;3;70;13;132;169;188;6;147;134;74;118;98;51;125;191;90;122;133;10;72;107;40;100;63;102;135;38;27;16;1;156;198;117;193;31;164;73;54;151;19;112;131,202851721500944451,0.005011
steepest_intra:nodes_start:greedy,122,51667,18843,32824,149500,9,122;90;191;125;131;38;27;16;1;156;198;117;193;31;164;73;54;151;19;112;121;116;51;98;118;74;85;134;139;182;138;33;160;144;104;8;82;21;177;5;45;142;175;78;36;61;91;141;77;97;187;165;127;89;103;113;194;166;86;185;95;18;62;124;106;176;163;153;81;111;35;109;0;29;11;43;168;195;13;145;15;3;70;161;132;169;188;6;192;147;178;10;133;72;107;40;100;63;102;135,6615151043707885921,0.004023
steepest_intra:nodes_start:greedy,123,52151,19398,32753,179400,11,177;5;45;142;175;78;36;61;91;141;97;146;187;165;127;89;103;113;194;166;86;185;130;95;18;62;124;106;176;163;153;81;77;58;82;8;144;111;35;109;0;29;160;33;49;11;134;74;118;121;51;120;191;90;125;131;112;19;151;54;73;31;193;117;198;156;1;16;27;38;135;63;100;40;107;72;122;133;10;178;147;192;6;188;169;132;13;161;70;3;15;145;195;168;139;182;138;104;87;21,4094942011374476097,0.005003
steepest_intra:nodes_start:greedy,124,46817,20352,26465,209300,13,106;143;62;18;55;34;35;109;0;29;160;33;11;134;74;118;51;90;121;73;54;31;193;117;198;1;38;63;135;122;133;10;178;147;6;188;169;132;13;70;3;15;145;195;168;139;182;138;104;144;111;8;82;21;177;5;45;142;175;78;36;61;91;141;77;81;153;187;163;89;127;137;114;103;26;113;176;194;166;172;179;185;130;99;66;94;47;148;60;20;59;28;149;4;140;183;95;86;128;124,4606321875206429410,0.005009
steepest_intra:nodes_start:greedy,125,51777,18920,32857,134550,8,125;122;133;10;72;107;40;100;63;102;135;38;27;16;1;156;198;117;193;31;164;73;54;151;19;112;131;121;116;51;98;118;74;85;134;139;182;138;33;160;144;104;8;82;21;177;5;45;142;175;78;36;61;91;141;77;97;187;165;127;89;103;113;194;166;86;185;95;18;62;124;106;176;163;153;81;111;35;109;0;29;11;43;168;195;13;145;15;3;70;161;132;169;188;6;192;147;71;191;90,423506541739744915,0.004005
steepest_intra:nodes_start:greedy,126,48688,20074,28614,164450,10,126;195;168;29;0;109;35;111;81;153;163;176;106;124;62;18;55;34;170;152;140;183;95;130;99;179;185;86;166;194;113;103;89;127;165;187;146;97;77;141;91;61;36;78;175;142;45;5;177;21;82;8;104;144;160;33;138;182;11;139;43;134;74;118;121;51;191;90;131;54;73;31;193;117;198;156;1;16;27;38;135;63;100;40;107;72;122;133;10;178;147;6;188;169;132;70;3;15;145;13,1521641863918016111,0.005002
steepest_intra:nodes_start:greedy,127,50704,20982,29722,164450,10,127;137;114;103;26;113;194;166;52;172;179;185;22;99;130;86;95;183;140;199;9;148;47;66;94;60;20;59;28;149;4;152;170;34;55;18;62;128;124;143;159;106;176;88;180;129;153;81;111;35;109;0;29;160;33;11;134;74;118;51;90;121;54;31;117;1;38;63;135;122;133;10;178;147;6;188;169;132;13;70;3;15;145;195;168;139;182;138;104;8;21;36;141;77;97;146;187;165;163;89,414513409125356656,0.004972
steepest_intra:nodes_start:greedy,128,50336,20753,29583,134550,8,128;88;176;180;129;153;81;111;35;109;0;29;160;33;11;134;74;118;51;90;121;54;31;117;1;38;63;135;122;133;10;178;147;6;188;169;132;13;70;3;15;145;195;168;139;182;138;104;8;21;36;141;77;97;146;187;165;163;89;127;137;114;103;26;113;194;166;86;185;179;172;57;66;94;47;148;60;20;59;28;149;4;199;9;99;22;130;95;183;140;152;170;34;55;18;62;124;143;159;106,4965834278512210595,0.004006
steepest_intra:nodes_start:greedy,129,49951,20736,29215,149500,9,129;153;81;111;35;109;0;29;160;33;11;134;74;118;51;90;121;54;31;193;117;1;38;63;135;122;133;10;178;147;6;188;169;132;13;70;3;15;145;195;168;139;182;138;104;8;21;36;141;77;97;146;187;165;163;89;127;137;114;103;26;113;194;166;52;172;179;185;22;99;130;95;183;140;199;9;148;47;66;94;60;20;59;28;149;4;152;170;34;55;18;62;124;143;159;106;128;86;176;180,519708867749993063,0.004166
steepest_intra:nodes_start:greedy,130,47292,20441,26851,119600,7,130;95;183;140;152;170;34;55;18;62;128;124;106;143;35;109;0;29;160;33;11;134;74;118;51;90;121;31;117;1;38;63;135;122;133;10;178;147;6;188;169;132;13;70;3;15;145;195;168;139;182;138;104;8;111;82;21;177;5;45;142;175;78;36;61;91;141;77;81;153;187;163;89;127;137;114;103;26;113;176;194;166;86;185;179;172;57;66;94;47;148;60;20;59;28;149;4;199;9;99,6375115476379574619,0.002999
steepest_intra:nodes_start:greedy,131,50622,19759,30863,149500,9,131;112;19;151;54;73;164;31;193;117;198;156;1;16;27;38;135;102;63;100;40;107;72;10;133;122;90;191;125;51;98;118;74;134;147;6;188;169;132;13;70;3;15;145;195;168;43;139;11;29;0;109;35;111;81;153;163;176;106;124;62;18;140;183;95;185;86;166;194;113;103;89;127;165;187;97;77;141;91;61;36;78;175;142;45;5;177;21;82;8;104;144;160;33;138;182;25;158;116;121,2287160580233541931,0.003998
steepest_intra:nodes_start:greedy,132,48889,20411,28478,119600,7,132;13;70;3;15;145;195;168;29;0;109;35;111;81;153;163;176;106;124;62;18;55;34;170;152;140;183;95;86;130;99;22;185;179;166;194;113;103;89;127;165;187;146;97;77;141;91;61;36;78;175;142;45;5;177;21;82;8;104;144;160;33;138;182;11;139;43;134;74;118;121;51;191;90;131;54;73;31;193;117;198;156;1;16;27;38;135;63;100;40;107;72;122;133;10;178;147;6;188;169,3257108310994451120,0.003000
steepest_intra:nodes_start:greedy,133,53088,18878,34210,74750,4,133;10;178;115;147;71;191;90;125;51;98;118;74;134;6;188;169;132;13;70;3;15;145;195;168;43;139;11;29;0;109;35;111;81;153;163;176;86;95;130;185;179;166;194;113;103;89;127;165;187;97;77;141;91;61;36;78;175;142;45;5;177;21;82;8;104;144;160;33;138;182;25;158;116;121;131;112;19;151;54;73;164;31;193;117;198;156;1;16;27;38;135;102;63;100;40;107;17;72;122,1380851174701084815,0.002006
steepest_intra:nodes_start:greedy,134,48492,20014,28478,224250,14,134;74;118;121;51;191;90;131;54;73;31;193;117;198;156;1;16;27;38;135;63;100;40;107;72;122;133;10;178;147;6;188;169;132;70;3;15;145;13;195;168;29;0;109;35;111;81;153;163;176;106;124;62;18;55;34;170;152;140;183;95;130;99;22;179;185;86;166;194;113;103;89;127;165;187;146;97;77;141;91;61;36;78;175;142;45;5;177;21;82;8;104;144;160;33;138;182;11;139;43,2065464275344192760,0.006004
steepest_intra:nodes_start:greedy,135,51667,18843,32824,149500,9,135;122;90;191;125;131;38;27;16;1;156;198;117;193;31;164;73;54;151;19;112;121;116;51;98;118;74;85;134;139;182;138;33;160;144;104;8;82;21;177;5;45;142;175;78;36;61;91;141;77;97;187;165;127;89;103;113;194;166;86;185;95;18;62;124;106;176;163;153;81;111;35;109;0;29;11;43;168;195;13;145;15;3;70;161;132;169;188;6;192;147;178;10;133;72;107;40;100;63;102,7191785803073336210,0.004008
steepest_intra:nodes_start:greedy,136,50838,19816,31022,149500,9,136;45;5;177;21;104;138;182;139;168;195;145;15;3;70;161;13;132;169;188;6;192;147;178;10;133;122;72;107;40;100;63;102;135;131;125;90;191;120;51;121;118;74;134;11;49;33;160;29;0;109;35;111;144;8;82;58;77;81;153;163;176;106;124;62;18;55;140;183;95;130;185;86;166;194;113;103;89;127;165;187;146;97;141;91;61;36;78;175;142;162;80;190;193;198;117;54;31;164;73,8336979015436675766,0.004140
steepest_intra:nodes_start:greedy,137,50280,20633,29647,194350,12,137;114;88;194;166;179;172;57;66;94;47;148;60;20;59;28;149;4;199;9;99;22;185;86;95;130;183;140;152;170;34;55;18;62;128;124;143;159;106;176;180;113;26;103;163;186;153;81;111;35;109;0;29;160;33;11;134;74;118;51;90;121;54;31;117;1;38;63;135;122;133;10;178;147;6;188;169;132;13;70;3;15;145;195;168;139;182;138;104;8;21;36;141;77;97;146;187;165;89;127,8664021709647594030,0.006005
steepest_intra:nodes_start:greedy,138,51482,18605,32877,119600,7,138;182;11;139;134;43;168;195;13;132;169;6;188;161;70;3;15;145;155;189;69;29;0;109;35;111;41;81;153;186;163;180;88;176;106;159;143;124;128;62;18;55;34;170;152;4;149;28;59;20;60;94;66;47;148;9;199;140;183;95;86;130;99;22;185;179;172;52;166;194;113;114;137;103;89;127;165;187;146;97;77;141;91;61;36;78;175;142;45;5;177;21;87;82;8;104;56;144;160;33,1478698479587282952,0.004033
steepest_intra:nodes_start:greedy,139,51491,18249,33242,134550,8,11;139;43;168;195;13;132;169;6;188;161;70;3;15;145;155;189;69;29;0;109;35;111;41;81;153;186;163;180;88;176;106;159;143;124;128;62;18;55;34;170;152;4;149;28;59;20;60;94;66;47;148;9;199;140;183;95;86;130;99;22;185;179;172;52;166;194;113;114;137;103;89;127;165;187;146;97;77;141;91;79;61;36;78;175;142;45;5;177;21;87;82;8;104;56;144;160;33;138;182,4299345801022842445,0.003002
steepest_intra:nodes_start:greedy,140,47292,20441,26851,119600,7,140;152;170;34;55;18;62;128;124;106;143;35;109;0;29;160;33;11;134;74;118;51;90;121;31;117;1;38;63;135;122;133;10;178;147;6;188;169;132;13;70;3;15;145;195;168;139;182;138;104;8;111;82;21;177;5;45;142;175;78;36;61;91;141;77;81;153;187;163;89;127;137;114;103;26;113;176;194;166;86;185;179;172;57;66;94;47;148;60;20;59;28;149;4;199;9;99;130;95;183,4448261880663646124,0.003000
steepest_intra:nodes_start:greedy,141,50753,20967,29786,164450,10,77;97;146;187;165;127;89;103;137;114;26;113;194;166;52;172;179;185;22;99;130;86;95;183;140;199;9;148;47;66;94;60;20;59;28;149;4;152;170;34;55;18;62;128;124;143;159;106;176;88;180;163;186;153;81;111;35;109;0;29;160;33;11;134;74;118;51;90;121;54;31;117;1;38;63;135;122;133;10;178;147;6;188;169;132;13;70;3;15;145;195;168;139;182;138;104;8;21;36;141,3646320879413882953,0.004000
steepest_intra:nodes_start:greedy,142,51559,19902,31657,149500,9,142;45;5;177;21;104;138;182;139;168;195;145;15;3;70;161;13;132;169;188;6;192;147;178;10;133;122;72;107;40;100;63;135;38;27;16;1;156;198;117;193;31;73;54;151;19;112;131;125;90;191;120;51;121;118;74;134;11;49;33;160;29;0;109;35;111;144;8;82;58;77;81;153;163;176;106;124;62;18;140;183;95;185;86;166;194;113;103;89;127;165;187;146;97;141;91;61;36;78;175,6043355291139502628,0.004002
steepest_intra:nodes_start:greedy,143,50703,18111,32592,134550,8,143;35;109;0;29;111;41;81;153;186;163;103;89;127;114;137;165;187;146;97;77;141;91;79;61;36;78;175;142;45;5;177;21;87;82;8;104;56;144;160;33;138;182;11;139;168;195;43;134;6;188;169;132;13;145;15;70;3;189;155;184;170;152;4;149;28;59;20;60;94;66;47;148;9;199;140;183;95;130;99;22;185;179;172;52;166;194;113;180;176;86;128;83;55;34;18;62;124;106;159,3707388304750844099,0.002999
steepest_intra:nodes_start:greedy,144,48978,21071,27907,149500,9,144;0;35;109;29;160;33;11;134;74;118;51;90;131;121;73;54;31;193;117;198;156;1;16;27;38;135;63;40;107;122;133;10;178;147;6;188;169;132;13;70;3;15;145;195;168;139;182;138;104;8;82;21;177;5;45;142;175;78;36;61;91;141;77;97;146;187;165;127;89;103;137;114;113;194;166;172;179;185;22;99;130;86;95;183;140;152;170;34;55;18;62;124;106;176;163;153;81;41;111,1076116883907929281,0.004988
steepest_intra:nodes_start:greedy,145,49983,17472,32511,59800,3,145;195;168;126;13;132;169;6;188;161;70;3;155;184;170;152;140;183;95;130;22;99;9;199;4;149;28;59;20;60;148;47;94;66;57;172;52;179;185;86;166;194;176;180;113;26;103;114;137;127;89;163;165;187;146;153;81;77;97;141;91;79;61;36;78;175;142;45;5;177;21;87;82;111;144;56;8;104;138;182;139;11;49;33;160;29;0;109;35;143;159;106;124;128;62;18;55;34;189;15,1966553004201488108,0.001997
steepest_intra:nodes_start:greedy,146,50753,20967,29786,164450,10,146;187;165;127;89;103;137;114;26;113;194;166;52;172;179;185;22;99;130;86;95;183;140;199;9;148;47;66;94;60;20;59;28;149;4;152;170;34;55;18;62;128;124;143;159;106;176;88;180;163;186;153;81;111;35;109;0;29;160;33;11;134;74;118;51;90;121;54;31;117;1;38;63;135;122;133;10;178;147;6;188;169;132;13;70;3;15;145;195;168;139;182;138;104;8;21;36;141;77;97,2101797977159412092,0.004000
steepest_intra:nodes_start:greedy,147,50740,19257,31483,194350,12,147;192;6;188;169;132;161;70;3;15;145;13;195;168;43;11;29;0;109;35;111;81;153;163;176;106;124;62;18;140;183;95;185;86;166;194;113;103;89;127;165;187;97;77;141;91;61;36;78;175;142;45;5;177;21;82;8;104;144;160;33;138;182;139;134;85;74;118;98;51;125;131;121;112;54;73;164;31;193;117;198;156;1;16;27;38;135;102;63;100;40;107;72;122;133;10;178;90;191;71,7909215370064179246,0.005000
steepest_intra:nodes_start:greedy,148,46371,20200,26171,134550,8,148;47;66;94;60;20;59;28;149;4;140;183;152;170;34;55;18;62;128;124;106;143;35;109;0;29;160;33;11;134;74;118;51;90;121;73;54;31;193;117;1;38;63;135;122;133;10;178;147;6;188;169;132;13;70;3;15;145;195;168;139;182;138;104;8;111;82;21;177;5;45;142;175;78;36;61;91;141;77;81;153;187;163;89;127;137;114;103;26;113;176;194;166;86;95;130;185;179;22;99,3002640179878086782,0.004001
steepest_intra:nodes_start:greedy,149,46445,19928,26517,149500,9,149;4;140;183;152;170;34;55;18;62;128;124;106;143;35;109;0;29;160;33;11;134;74;118;51;90;121;54;31;117;1;38;63;135;122;133;10;178;147;6;188;169;132;13;70;3;15;145;195;168;139;182;138;104;8;111;82;21;177;5;45;142;175;78;36;61;91;141;77;81;153;187;163;89;127;137;114;103;26;113;176;194;166;86;95;130;99;22;185;179;172;57;66;94;47;148;60;20;59;28,7566372600974269423,0.004000
steepest_intra:nodes_start:greedy,150,50606,19233,31373,209300,13,6;188;169;132;13;161;70;3;15;145;195;168;139;11;49;29;0;109;35;111;41;81;153;186;163;180;88;176;106;159;143;124;128;62;18;55;34;170;152;4;149;28;59;20;60;94;66;47;148;9;199;140;183;95;86;130;99;22;185;179;172;52;166;194;113;114;137;103;89;127;165;187;146;97;77;141;91;61;36;78;175;142;45;5;177;21;87;82;8;104;56;144;160;33;138;25;121;51;90;147,2707356199529223925,0.005002
steepest_intra:nodes_start:greedy,151,51190,18543,32647,164450,10,151;54;73;164;31;193;117;198;156;1;16;27;38;102;63;96;32;135;122;133;10;178;115;147;71;191;90;125;51;98;118;74;134;6;188;169;132;13;70;3;15;145;195;168;43;139;11;29;0;109;35;111;81;153;163;176;106;124;62;18;140;183;95;185;86;166;194;113;103;89;127;165;187;97;77;141;91;61;36;78;175;142;45;5;177;21;82;8;104;144;160;33;138;182;25;158;116;121;112;19,5494029820988797795,0.005000
steepest_intra:nodes_start:greedy,152,47292,20441,26851,119600,7,152;170;34;55;18;62;128;124;106;143;35;109;0;29;160;33;11;134;74;118;51;90;121;31;117;1;38;63;135;122;133;10;178;147;6;188;169;132;13;70;3;15;145;195;168;139;182;138;104;8;111;82;21;177;5;45;142;175;78;36;61;91;141;77;81;153;187;163;89;127;137;114;103;26;113;176;194;166;86;185;179;172;57;66;94;47;148;60;20;59;28;149;4;199;9;99;130;95;183;140,8504967871928672324,0.002999
steepest_intra:nodes_start:greedy,153,50753,20967,29786,164450,10,153;81;111;35;109;0;29;160;33;11;134;74;118;51;90;121;54;31;117;1;38;63;135;122;133;10;178;147;6;188;169;132;13;70;3;15;145;195;168;139;182;138;104;8;21;36;141;77;97;146;187;165;127;89;103;137;114;26;113;194;166;52;172;179;185;22;99;130;86;95;183;140;199;9;148;47;66;94;60;20;59;28;149;4;152;170;34;55;18;62;128;124;143;159;106;176;88;180;163;186,4044543017855960518,0.004220
steepest_intra:nodes_start:greedy,154,46944,19944,27000,179400,11,154;47;148;60;20;59;28;149;4;140;183;152;170;34;55;18;62;128;124;106;143;35;109;0;29;160;33;11;134;74;118;51;90;121;31;117;1;38;63;135;122;133;10;178;147;6;188;169;132;13;70;3;15;145;195;168;139;182;138;104;8;111;82;21;177;5;45;142;175;78;36;61;91;141;77;81;153;187;163;89;127;137;114;103;26;113;176;194;166;86;95;130;99;22;185;179;172;57;66;94,3651535317167419600,0.005000
steepest_intra:nodes_start:greedy,155,49983,17472,32511,59800,3,155;184;170;152;140;183;95;130;22;99;9;199;4;149;28;59;20;60;148;47;94;66;57;172;52;179;185;86;166;194;176;180;113;26;103;114;137;127;89;163;165;187;146;153;81;77;97;141;91;79;61;36;78;175;142;45;5;177;21;87;82;111;144;56;8;104;138;182;139;11;49;33;160;29;0;109;35;143;159;106;124;128;62;18;55;34;189;15;145;195;168;126;13;132;169;6;188;161;70;3,1854422045217150760,0.002000
steepest_intra:nodes_start:greedy,156,51190,18543,32647,164450,10,156;198;117;193;31;164;73;54;151;19;112;121;116;158;25;182;138;33;160;144;104;8;82;21;177;5;45;142;175;78;36;61;91;141;77;97;187;165;127;89;103;113;194;166;86;185;95;183;140;18;62;124;106;176;163;153;81;111;35;109;0;29;11;139;43;168;195;145;15;3;70;13;132;169;188;6;134;74;118;98;51;125;90;191;71;147;115;178;10;133;122;135;32;96;63;102;38;27;16;1,1228563321690218677,0.004000
steepest_intra:nodes_start:greedy,157,48968,21075,27893,224250,14,104;138;182;139;168;195;145;15;3;70;13;132;169;188;6;147;10;133;122;107;40;63;135;38;27;16;1;156;198;117;193;31;54;73;121;131;90;51;118;74;134;11;33;160;29;109;35;0;144;111;41;81;153;163;176;106;124;62;18;55;34;170;152;140;183;95;86;130;99;22;185;179;172;166;194;113;114;137;103;89;127;165;187;146;97;77;141;91;61;36;78;175;142;45;5;177;21;82;8;56,7971127968451900084,0.007004
steepest_intra:nodes_start:greedy,158,48755,19958,28797,164450,10,158;25;182;138;33;160;144;104;8;82;21;177;5;45;142;175;78;36;61;91;141;77;97;187;165;127;89;103;113;194;166;179;185;86;95;130;183;140;152;170;34;55;18;62;124;106;176;163;153;81;111;35;109;0;29;11;139;43;168;195;145;15;3;70;13;132;169;188;6;147;134;74;118;98;51;191;90;122;133;10;107;40;100;63;102;135;38;27;16;1;156;198;117;193;31;54;73;19;112;121,2443784489138146949,0.005010
steepest_intra:nodes_start:greedy,159,50703,18111,32592,134550,8,159;143;35;109;0;29;111;41;81;153;186;163;103;89;127;114;137;165;187;146;97;77;141;91;79;61;36;78;175;142;45;5;177;21;87;82;8;104;56;144;160;33;138;182;11;139;168;195;43;134;6;188;169;132;13;145;15;70;3;189;155;184;170;152;4;149;28;59;20;60;94;66;47;148;9;199;140;183;95;130;99;22;185;179;172;52;166;194;113;180;176;86;128;83;55;34;18;62;124;106,2294396843370112250,0.003987
steepest_intra:nodes_start:greedy,160,51482,18605,32877,119600,7,160;144;56;104;8;82;87;21;177;5;45;142;175;78;36;61;91;141;77;97;146;187;165;127;89;103;137;114;113;194;166;52;172;179;185;22;99;130;86;95;183;140;199;9;148;47;66;94;60;20;59;28;149;4;152;170;34;55;18;62;128;124;143;159;106;176;88;180;163;186;153;81;41;111;35;109;0;29;69;189;155;145;15;3;70;161;188;6;169;132;13;195;168;43;134;139;11;182;138;33,3286802751587253287,0.003002
steepest_intra:nodes_start:greedy,161,49983,17472,32511,59800,3,161;188;6;169;132;13;126;168;195;145;15;189;34;55;18;62;128;124;106;159;143;35;109;0;29;160;33;49;11;139;182;138;104;8;56;144;111;82;87;21;177;5;45;142;175;78;36;61;79;91;141;97;77;81;153;146;187;165;163;89;127;137;114;103;26;113;180;176;194;166;86;185;179;52;172;57;66;94;47;148;60;20;59;28;149;4;199;9;99;22;130;95;183;140;152;170;184;155;3;70,1112380725087170303,0.001002
steepest_intra:nodes_start:greedy,162,50838,19816,31022,149500,9,162;80;190;193;198;117;54;31;164;73;136;45;5;177;21;104;138;182;139;168;195;145;15;3;70;161;13;132;169;188;6;192;147;178;10;133;122;72;107;40;100;63;102;135;131;125;90;191;120;51;121;118;74;134;11;49;33;160;29;0;109;35;111;144;8;82;58;77;81;153;163;176;106;124;62;18;55;140;183;95;130;185;86;166;194;113;103;89;127;165;187;146;97;141;91;61;36;78;175;142,7472172431407596002,0.004003
steepest_intra:nodes_start:greedy,163,50704,20982,29722,164450,10,163;89;127;137;114;103;26;113;194;166;52;172;179;185;22;99;130;86;95;183;140;199;9;148;47;66;94;60;20;59;28;149;4;152;170;34;55;18;62;128;124;143;159;106;176;88;180;129;153;81;111;35;109;0;29;160;33;11;134;74;118;51;90;121;54;31;117;1;38;63;135;122;133;10;178;147;6;188;169;132;13;70;3;15;145;195;168;139;182;138;104;8;21;36;141;77;97;146;187;165,5898987822293322349,0.005002
steepest_intra:nodes_start:greedy,164,50838,19816,31022,164450,10,164;73;136;45;5;177;21;104;138;182;139;168;195;145;15;3;70;161;13;132;169;188;6;192;147;178;10;133;122;72;107;40;100;63;102;135;131;125;90;191;120;51;121;118;74;134;11;49;33;160;29;0;109;35;111;144;8;82;58;77;81;153;163;176;106;124;62;18;55;140;183;95;130;185;86;166;194;113;103;89;127;165;187;146;97;141;91;61;36;78;175;142;162;80;190;193;198;117;54;31,3167541048674399364,0.004306
steepest_intra:nodes_start:greedy,165,50753,20967,29786,164450,10,165;187;146;97;77;141;36;21;8;104;138;182;139;168;195;145;15;3;70;13;132;169;188;6;147;178;10;133;122;135;63;38;1;117;31;54;121;90;51;118;74;134;11;33;160;29;0;109;35;111;81;153;186;163;180;88;176;106;159;143;124;128;62;18;55;34;170;152;4;149;28;59;20;60;94;66;47;148;9;199;140;183;95;86;130;99;22;185;179;172;52;166;194;113;26;114;137;103;89;127,6364903485436248597,0.004971
steepest_intra:nodes_start:greedy,166,47794,20562,27232,119600,7,166;194;176;113;26;103;114;137;127;89;163;187;153;81;77;141;91;61;36;78;175;142;45;5;177;21;82;111;8;104;138;182;139;168;195;145;15;3;70;13;132;169;188;6;147;178;10;133;122;135;63;38;1;117;121;90;51;118;74;134;11;33;160;29;0;109;35;143;106;124;128;62;18;55;34;170;152;140;183;130;95;86;185;22;99;9;199;4;149;28;59;20;60;148;47;94;66;57;172;179,1116691054917728167,0.004011
steepest_intra:nodes_start:greedy,167,51647,18684,32963,134550,8,167;189;69;109;35;0;29;111;41;81;153;186;163;180;88;176;106;159;143;124;128;62;18;55;34;170;152;4;149;28;59;20;60;94;66;47;148;9;199;140;183;95;86;130;99;22;185;179;172;166;194;113;114;137;103;89;127;165;187;146;97;77;141;91;61;36;78;175;142;45;5;177;21;87;82;8;104;56;144;160;33;138;182;11;139;168;195;43;134;6;188;169;132;13;145;15;70;3;155;184,4563072424645100526,0.004246
steepest_intra:nodes_start:greedy,168,48889,20411,28478,119600,7,168;195;145;15;3;70;13;132;169;188;6;147;178;10;133;122;72;107;40;100;63;135;38;27;16;1;156;198;117;193;31;73;54;131;90;191;51;121;118;74;134;43;139;11;182;138;33;160;144;104;8;82;21;177;5;45;142;175;78;36;61;91;141;77;97;146;187;165;127;89;103;113;194;166;179;185;22;99;130;86;95;183;140;152;170;34;55;18;62;124;106;176;163;153;81;111;35;109;0;29,6261670980785764882,0.003003
steepest_intra:nodes_start:greedy,169,48889,20411,28478,119600,7,169;132;13;70;3;15;145;195;168;29;0;109;35;111;81;153;163;176;106;124;62;18;55;34;170;152;140;183;95;86;130;99;22;185;179;166;194;113;103;89;127;165;187;146;97;77;141;91;61;36;78;175;142;45;5;177;21;82;8;104;144;160;33;138;182;11;139;43;134;74;118;121;51;191;90;131;54;73;31;193;117;198;156;1;16;27;38;135;63;100;40;107;72;122;133;10;178;147;6;188,683344342200055139,0.003000
steepest_intra:nodes_start:greedy,170,47292,20441,26851,119600,7,170;34;55;18;62;128;124;106;143;35;109;0;29;160;33;11;134;74;118;51;90;121;31;117;1;38;63;135;122;133;10;178;147;6;188;169;132;13;70;3;15;145;195;168;139;182;138;104;8;111;82;21;177;5;45;142;175;78;36;61;91;141;77;81;153;187;163;89;127;137;114;103;26;113;176;194;166;86;185;179;172;57;66;94;47;148;60;20;59;28;149;4;199;9;99;130;95;183;140;152,4192931067151152344,0.003002
steepest_intra:nodes_start:greedy,171,51865,20013,31852,164450,10,25;121;182;138;11;139;134;43;168;195;13;132;169;6;188;161;70;3;15;145;155;189;69;109;35;0;29;160;33;144;56;104;8;111;82;87;21;58;77;81;153;186;163;180;88;176;106;143;124;128;62;18;55;34;170;152;4;149;28;59;20;60;94;66;47;148;9;199;140;183;95;86;130;99;22;185;179;172;166;194;113;114;137;103;89;127;165;187;146;97;141;91;61;36;78;175;142;45;5;177,5091935686671762286,0.004000
steepest_intra:nodes_start:greedy,172,47412,20593,26819,119600,7,172;166;194;176;113;26;103;114;137;127;89;163;187;153;81;77;141;91;61;36;78;175;142;45;5;177;21;82;111;8;104;138;182;139;168;195;145;15;3;70;13;132;169;188;6;147;178;10;133;122;135;63;38;1;117;31;121;90;51;118;74;134;11;33;160;29;0;109;35;143;106;124;128;62;18;55;34;170;152;140;183;130;95;86;185;22;99;9;199;4;149;28;59;20;60;148;47;94;66;179,3732869934178255662,0.004002
steepest_intra:nodes_start:greedy,173,51645,19341,32304,194350,12,173;73;164;31;54;193;117;198;156;24;1;16;27;38;63;135;122;133;10;178;147;71;51;191;90;125;131;121;112;158;25;177;21;104;138;182;139;168;195;145;15;3;70;161;13;132;169;188;6;134;11;49;33;160;29;0;109;35;111;144;8;82;58;77;81;153;163;176;106;124;62;18;95;130;185;86;166;194;113;103;89;127;165;187;146;97;141;91;61;36;7;5;45;142;78;175;162;80;190;136,7059820186391976172,0.004997
steepest_intra:nodes_start:greedy,174,48192,20580,27612,209300,13,174;55;18;62;124;106;128;86;95;130;99;22;185;179;172;166;194;176;113;26;103;114;137;127;89;163;187;153;81;77;141;91;61;36;78;175;142;45;5;177;21;82;8;111;144;104;138;182;139;168;195;145;15;3;70;13;132;169;188;6;147;178;10;133;122;107;40;63;135;38;27;16;1;156;198;117;193;31;54;73;121;131;90;51;118;74;134;11;33;160;29;0;109;35;143;34;170;152;140;183,5911661164282898023,0.006011
steepest_intra:nodes_start:greedy,175,51559,19902,31657,149500,9,175;78;36;61;91;141;97;146;187;165;127;89;103;113;194;166;86;185;95;183;140;18;62;124;106;176;163;153;81;77;58;82;8;144;111;35;109;0;29;160;33;49;11;134;74;118;121;51;120;191;90;125;131;112;19;151;54;73;31;193;117;198;156;1;16;27;38;135;63;100;40;107;72;122;133;10;178;147;192;6;188;169;132;13;161;70;3;15;145;195;168;139;182;138;104;21;177;5;45;142,5196974319447699859,0.004006
steepest_intra:nodes_start:greedy,176,47794,20562,27232,119600,7,113;26;103;114;137;127;89;163;187;153;81;77;141;91;61;36;78;175;142;45;5;177;21;82;111;8;104;138;182;139;168;195;145;15;3;70;13;132;169;188;6;147;178;10;133;122;135;63;38;1;117;121;90;51;118;74;134;11;33;160;29;0;109;35;143;106;124;128;62;18;55;34;170;152;140;183;130;95;86;185;22;99;9;199;4;149;28;59;20;60;148;47;94;66;57;172;179;166;194;176,6956664624523799996,0.003002
steepest_intra:nodes_start:greedy,177,51559,19902,31657,149500,9,177;21;104;138;182;139;168;195;145;15;3;70;161;13;132;169;188;6;192;147;178;10;133;122;72;107;40;100;63;135;38;27;16;1;156;198;117;193;31;73;54;151;19;112;131;125;90;191;120;51;121;118;74;134;11;49;33;160;29;0;109;35;111;144;8;82;58;77;81;153;163;176;106;124;62;18;140;183;95;185;86;166;194;113;103;89;127;165;187;146;97;141;91;61;36;78;175;142;45;5,6873476760307157664,0.004008
steepest_intra:nodes_start:greedy,178,53088,18878,34210,74750,4,178;10;133;122;72;17;107;40;100;63;102;135;38;27;16;1;156;198;117;193;31;164;73;54;151;19;112;131;121;116;158;25;182;138;33;160;144;104;8;82;21;177;5;45;142;175;78;36;61;91;141;77;97;187;165;127;89;103;113;194;166;179;185;130;95;86;176;163;153;81;111;35;109;0;29;11;139;43;168;195;145;15;3;70;13;132;169;188;6;134;74;118;98;51;125;90;191;71;147;115,1539365783855288670,0.002005
steepest_intra:nodes_start:greedy,179,47794,20562,27232,119600,7,179;166;194;176;113;26;103;114;137;127;89;163;187;153;81;77;141;91;61;36;78;175;142;45;5;177;21;82;111;8;104;138;182;139;168;195;145;15;3;70;13;132;169;188;6;147;178;10;133;122;135;63;38;1;117;121;90;51;118;74;134;11;33;160;29;0;109;35;143;106;124;128;62;18;55;34;170;152;140;183;130;95;86;185;22;99;9;199;4;149;28;59;20;60;148;47;94;66;57;172,3749159851124035774,0.003012
steepest_intra:nodes_start:greedy,180,47966,20483,27483,104650,6,180;176;194;166;179;172;57;66;94;47;148;60;20;59;28;149;4;199;9;99;22;185;86;95;130;183;140;152;170;34;55;18;62;128;124;106;143;35;109;0;29;160;33;11;134;74;118;51;90;121;117;1;135;63;122;133;10;178;147;6;188;169;132;13;70;3;15;145;195;168;139;182;138;104;8;111;82;21;177;5;45;142;175;78;36;61;91;141;77;81;153;187;163;89;127;137;114;103;26;113,4755864154124061884,0.003001
steepest_intra:nodes_start:greedy,181,47915,20513,27402,134550,8,174;183;140;152;170;34;55;18;62;128;124;106;143;35;109;0;29;160;33;11;134;74;118;51;90;121;117;1;38;63;135;122;133;10;178;147;6;188;169;132;13;70;3;15;145;195;168;139;182;138;104;8;111;82;21;177;5;45;142;175;78;36;61;91;141;77;81;153;187;163;89;127;137;114;103;26;113;176;194;166;86;185;179;172;57;66;94;47;148;60;20;59;28;149;4;199;9;99;130;95,5265215537732764693,0.004003
steepest_intra:nodes_start:greedy,182,51491,18249,33242,134550,8,182;11;139;43;168;195;13;132;169;6;188;161;70;3;15;145;155;189;69;29;0;109;35;111;41;81;153;186;163;180;88;176;106;159;143;124;128;62;18;55;34;170;152;4;149;28;59;20;60;94;66;47;148;9;199;140;183;95;86;130;99;22;185;179;172;52;166;194;113;114;137;103;89;127;165;187;146;97;77;141;91;79;61;36;78;175;142;45;5;177;21;87;82;8;104;56;144;160;33;138,8736381424066445215,0.003014
steepest_intra:nodes_start:greedy,183,47292,20441,26851,119600,7,183;95;130;99;9;199;4;149;28;59;20;60;148;47;94;66;57;172;179;185;86;166;194;176;113;26;103;114;137;127;89;163;187;153;81;77;141;91;61;36;78;175;142;45;5;177;21;82;111;8;104;138;182;139;168;195;145;15;3;70;13;132;169;188;6;147;178;10;133;122;135;63;38;1;117;31;121;90;51;118;74;134;11;33;160;29;0;109;35;143;106;124;128;62;18;55;34;170;152;140,2553547355717662623,0.003004
steepest_intra:nodes_start:greedy,184,47185,20864,26321,194350,12,184;170;152;140;183;95;130;99;9;199;28;20;60;148;47;94;66;57;172;179;185;86;166;194;176;113;103;127;89;163;187;153;81;77;141;91;61;36;78;175;142;45;5;177;21;82;111;8;104;138;182;139;11;33;160;29;0;109;35;143;106;124;128;62;18;55;34;189;195;168;43;134;74;118;51;90;121;54;31;193;117;1;38;63;135;122;133;10;178;147;6;188;169;132;13;145;15;70;3;155,2866242249308086394,0.006011
steepest_intra:nodes_start:greedy,185,47222,20403,26819,134550,8,185;86;95;130;99;22;66;94;47;148;60;20;59;28;149;4;199;9;183;140;152;170;34;55;18;62;128;124;106;143;35;109;0;29;160;33;11;134;74;118;51;90;121;31;117;1;38;63;135;122;133;10;178;147;6;188;169;132;13;70;3;15;145;195;168;139;182;138;104;8;111;82;21;177;5;45;142;175;78;36;61;91;141;77;81;153;187;163;89;127;137;114;103;26;113;176;194;166;172;179,464135999760862186,0.003029
steepest_intra:nodes_start:greedy,186,50753,20967,29786,164450,10,186;163;180;88;176;106;159;143;124;128;62;18;55;34;170;152;4;149;28;59;20;60;94;66;47;148;9;199;140;183;95;86;130;99;22;185;179;172;52;166;194;113;26;114;137;103;89;127;165;187;146;97;77;141;36;21;8;104;138;182;139;168;195;145;15;3;70;13;132;169;188;6;147;178;10;133;122;135;63;38;1;117;31;54;121;90;51;118;74;134;11;33;160;29;0;109;35;111;81;153,8281038054762181358,0.003998
steepest_intra:nodes_start:greedy,187,50753,20967,29786,164450,10,187;165;127;89;103;137;114;26;113;194;166;52;172;179;185;22;99;130;86;95;183;140;199;9;148;47;66;94;60;20;59;28;149;4;152;170;34;55;18;62;128;124;143;159;106;176;88;180;163;186;153;81;111;35;109;0;29;160;33;11;134;74;118;51;90;121;54;31;117;1;38;63;135;122;133;10;178;147;6;188;169;132;13;70;3;15;145;195;168;139;182;138;104;8;21;36;141;77;97;146,3431784228533951571,0.004000
steepest_intra:nodes_start:greedy,188,48889,20411,28478,119600,7,188;6;147;178;10;133;122;72;107;40;100;63;135;38;27;16;1;156;198;117;193;31;73;54;131;90;191;51;121;118;74;134;43;139;11;182;138;33;160;144;104;8;82;21;177;5;45;142;175;78;36;61;91;141;77;97;146;187;165;127;89;103;113;194;166;179;185;22;99;130;86;95;183;140;152;170;34;55;18;62;124;106;176;163;153;81;111;35;109;0;29;168;195;145;15;3;70;13;132;169,6301456853770334805,0.003000
steepest_intra:nodes_start:greedy,189,51435,18672,32763,134550,8,189;69;109;35;0;29;111;41;81;153;186;163;180;88;176;106;159;143;124;128;62;18;55;34;170;152;4;149;28;59;20;60;94;66;47;148;9;199;140;183;95;86;130;99;22;185;179;172;52;166;194;113;114;137;103;89;127;165;187;146;97;77;141;91;61;36;78;175;142;45;5;177;21;87;82;8;104;56;144;160;33;138;182;11;139;168;195;43;134;6;188;169;132;13;145;15;70;3;155;184,4053808143871981334,0.004000
steepest_intra:nodes_start:greedy,190,50838,19816,31022,149500,9,190;193;198;117;54;31;164;73;136;45;5;177;21;104;138;182;139;168;195;145;15;3;70;161;13;132;169;188;6;192;147;178;10;133;122;72;107;40;100;63;102;135;131;125;90;191;120;51;121;118;74;134;11;49;33;160;29;0;109;35;111;144;8;82;58;77;81;153;163;176;106;124;62;18;55;140;183;95;130;185;86;166;194;113;103;89;127;165;187;146;97;141;91;61;36;78;175;142;162;80,7773527461591740212,0.004047
steepest_intra:nodes_start:greedy,191,51249,18725,32524,134550,8,191;71;147;192;6;188;169;132;161;70;3;15;145;13;195;168;43;11;29;0;109;35;111;81;153;163;176;106;124;62;18;95;130;185;86;166;194;113;103;89;127;165;187;97;77;141;91;61;36;78;175;142;45;5;177;21;82;8;104;144;160;33;138;182;139;134;85;74;118;98;51;125;131;121;112;19;151;54;73;164;31;193;117;198;156;1;16;27;38;135;102;63;100;40;107;72;10;133;122;90,2754998821017375118,0.004011
steepest_intra:nodes_start:greedy,192,50606,19233,31373,209300,13,6;188;169;132;13;161;70;3;15;145;195;168;139;11;49;29;0;109;35;111;41;81;153;186;163;180;88;176;106;159;143;124;128;62;18;55;34;170;152;4;149;28;59;20;60;94;66;47;148;9;199;140;183;95;86;130;99;22;185;179;172;52;166;194;113;114;137;103;89;127;165;187;146;97;77;141;91;61;36;78;175;142;45;5;177;21;87;82;8;104;56;144;160;33;138;25;121;51;90;147,7947088439803450637,0.005972
steepest_intra:nodes_start:greedy,193,50838,19816,31022,179400,11,193;190;80;162;142;175;78;36;61;91;141;97;146;187;165;127;89;103;113;194;166;86;185;130;95;183;140;55;18;62;124;106;176;163;153;81;77;58;82;8;144;111;35;109;0;29;160;33;49;11;134;74;118;121;51;120;191;90;125;131;135;102;63;100;40;107;72;122;133;10;178;147;192;6;188;169;132;13;161;70;3;15;145;195;168;139;182;138;104;21;177;5;45;136;73;164;31;54;117;198,7567556527184854602,0.003997
steepest_intra:nodes_start:greedy,194,47794,20562,27232,119600,7,194;176;113;26;103;114;137;127;89;163;187;153;81;77;141;91;61;36;78;175;142;45;5;177;21;82;111;8;104;138;182;139;168;195;145;15;3;70;13;132;169;188;6;147;178;10;133;122;135;63;38;1;117;121;90;51;118;74;134;11;33;160;29;0;109;35;143;106;124;128;62;18;55;34;170;152;140;183;130;95;86;185;22;99;9;199;4;149;28;59;20;60;148;47;94;66;57;172;179;166,3274123748740940550,0.003001
steepest_intra:nodes_start:greedy,195,48889,20411,28478,119600,7,195;145;15;3;70;13;132;169;188;6;147;178;10;133;122;72;107;40;100;63;135;38;27;16;1;156;198;117;193;31;73;54;131;90;191;51;121;118;74;134;43;139;11;182;138;33;160;144;104;8;82;21;177;5;45;142;175;78;36;61;91;141;77;97;146;187;165;127;89;103;113;194;166;179;185;22;99;130;86;95;183;140;152;170;34;55;18;62;124;106;176;163;153;81;111;35;109;0;29;168,4631626908985194422,0.004002
steepest_intra:nodes_start:greedy,196,52368,20027,32341,209300,13,30;190;80;162;142;175;78;36;61;91;141;97;146;187;165;127;89;103;113;194;166;86;185;95;18;62;124;106;176;163;153;81;77;58;82;8;144;111;35;109;0;29;160;33;49;11;134;74;118;121;51;120;191;90;125;131;135;102;63;100;40;107;72;122;133;10;178;147;192;6;188;169;132;13;161;70;3;15;145;195;168;139;182;138;104;21;177;5;45;136;73;164;54;31;193;117;198;1;156;42,6135901497916172023,0.006003
steepest_intra:nodes_start:greedy,197,51886,18023,33863,134550,8,24;156;198;117;193;31;164;73;54;151;19;112;121;116;158;25;182;138;33;160;144;104;8;82;21;177;5;45;142;175;78;36;61;91;141;77;97;187;165;127;89;103;113;194;166;86;185;130;95;18;62;124;106;176;163;153;81;111;35;109;0;29;11;139;43;168;195;145;15;3;70;13;132;169;188;6;134;74;118;98;51;125;90;191;71;147;115;178;10;133;122;135;32;96;63;102;38;27;16;1,4728720100086098998,0.004000
steepest_intra:nodes_start:greedy,198,51190,18543,32647,164450,10,198;156;1;16;27;38;102;63;96;32;135;122;133;10;178;115;147;71;191;90;125;51;98;118;74;134;6;188;169;132;13;70;3;15;145;195;168;43;139;11;29;0;109;35;111;81;153;163;176;106;124;62;18;140;183;95;185;86;166;194;113;103;89;127;165;187;97;77;141;91;61;36;78;175;142;45;5;177;21;82;8;104;144;160;33;138;182;25;158;116;121;112;19;151;54;73;164;31;193;117,7583994845671599178,0.004999
steepest_intra:nodes_start:greedy,199,46434,20395,26039,134550,8,199;140;183;95;130;99;22;179;185;86;166;194;176;113;26;103;114;137;127;89;163;187;153;81;77;141;91;61;36;78;175;142;45;5;177;21;82;111;8;104;138;182;139;168;195;145;15;3;70;13;132;169;188;6;147;178;10;133;122;135;63;38;1;117;193;31;54;73;121;90;51;118;74;134;11;33;160;29;0;109;35;143;106;124;128;62;18;55;34;170;152;4;149;28;20;60;94;66;47;148,5336945019575848612,0.003000
steepest_intra:edges_start:random,0,48405,22010,26395,1898650,126,40;107;133;10;178;147;169;70;3;15;145;195;168;139;11;49;33;160;29;109;35;0;144;111;81;159;143;106;124;62;34;55;18;128;86;95;185;22;99;130;183;140;149;28;20;60;148;47;94;66;179;172;166;194;176;180;113;26;114;75;137;127;165;89;103;163;153;77;141;36;61;21;8;104;138;182;118;51;90;122;131;121;158;25;177;5;78;175;80;190;73;54;31;193;117;1;27;38;135;63,5643313416864817178,0.045004
steepest_intra:edges_start:random,1,48580,22579,26001,1928550,128,3;155;152;34;55;18;62;183;140;149;28;20;60;148;47;154;94;66;57;172;179;22;99;95;185;86;166;194;176;113;114;137;127;89;103;163;153;187;146;97;77;141;91;61;36;5;142;78;175;80;190;193;117;198;156;1;54;31;164;73;136;177;21;8;111;81;159;106;128;124;143;35;109;0;12;29;144;160;33;138;11;139;168;195;134;51;121;131;135;63;40;107;133;122;90;147;6;188;169;70,1897516260751758510,0.044996
steepest_intra:edges_start:random,2,48075,22726,25349,2018250,134,166;86;55;18;62;124;106;143;159;153;163;176;194;113;103;89;127;165;187;97;77;81;111;144;104;8;82;21;141;61;36;177;25;5;45;142;78;175;80;190;73;54;31;193;117;198;156;27;38;1;131;121;118;98;51;90;135;63;40;107;122;147;134;6;188;169;132;13;70;3;15;145;195;168;139;11;138;33;160;29;0;35;109;189;155;184;152;183;140;149;28;20;148;47;94;99;185;179;172;52,8964145017158106472,0.045000
steepest_intra:edges_start:random,3,49012,21219,27793,2003300,133,104;8;82;77;141;61;36;175;80;190;193;31;54;117;198;1;27;38;135;63;40;107;10;133;122;90;51;147;6;188;169;168;195;145;15;70;3;155;184;152;170;34;55;174;95;130;183;140;28;20;60;148;47;94;66;179;22;99;185;86;166;194;88;176;180;113;76;114;137;127;89;103;26;129;163;165;187;153;81;159;143;106;124;128;62;83;18;35;109;0;29;49;11;139;138;33;160;144;111;56,2880688343908198133,0.044000
steepest_intra:edges_start:random,4,47906,21935,25971,1898650,126,82;8;104;144;111;41;35;109;0;29;160;33;138;11;139;134;51;90;131;121;54;31;73;80;190;193;117;198;156;1;38;63;135;122;133;10;178;191;71;147;6;188;169;132;13;195;168;145;15;161;70;3;152;183;140;4;149;28;59;20;60;148;47;94;66;99;185;179;166;194;86;130;95;55;34;18;62;128;124;143;106;176;113;103;114;127;89;163;187;153;81;77;141;61;36;175;5;177;21;87,84188266073323610,0.040999
steepest_intra:edges_start:random,5,49955,21578,28377,1719250,114,11;33;160;144;111;8;104;138;182;25;177;5;78;175;36;61;91;141;97;77;82;81;153;163;89;127;103;113;180;176;194;166;86;64;119;159;143;106;124;128;95;130;185;179;172;57;66;94;47;148;60;23;20;28;149;4;199;140;183;152;55;18;83;62;34;35;109;0;12;29;168;195;13;145;15;3;70;161;132;169;188;147;10;133;122;63;135;117;193;190;80;31;54;121;90;191;51;118;134;139,1377581869401145170,0.037506
steepest_intra:edges_start:random,6,48812,21072,27740,1988350,132,145;13;195;168;139;11;33;111;77;141;36;61;21;8;104;138;182;25;123;177;5;78;175;80;190;136;73;54;31;193;117;198;1;63;135;131;121;51;90;122;133;10;147;188;169;132;70;3;15;155;152;55;18;62;95;130;185;22;99;9;183;140;4;149;28;20;23;60;148;47;154;94;66;57;172;179;52;166;194;114;137;127;165;89;163;103;26;113;180;176;86;110;128;124;106;143;35;109;0;29,8562135402722144778,0.043000
steepest_intra:edges_start:random,7,47300,20770,26530,2093000,139,86;166;194;176;180;113;103;89;163;153;106;124;62;18;55;34;35;109;0;12;29;160;33;144;111;81;77;141;61;36;5;78;175;80;190;73;54;31;193;117;198;121;131;1;16;27;38;135;63;100;40;107;133;122;90;191;125;51;98;118;25;177;21;82;8;56;104;138;182;11;139;134;6;188;169;168;195;13;145;15;70;3;155;152;183;140;199;4;149;28;20;148;47;94;66;179;22;99;95;185,781881216378470075,0.046000
steepest_intra:edges_start:random,8,47919,21134,26785,1868750,124,114;103;113;176;194;166;179;172;57;66;94;47;148;60;20;28;149;4;140;183;95;130;99;22;185;86;55;34;18;62;124;106;143;159;81;77;21;82;111;144;8;104;138;182;25;158;121;98;118;134;139;11;33;160;29;0;35;109;168;195;145;3;169;188;6;147;51;90;122;135;63;38;27;1;24;156;198;117;193;54;31;164;73;136;190;80;175;78;5;177;36;61;91;141;187;153;163;89;127;137,1011605187459963746,0.041000
steepest_intra:edges_start:random,9,47863,20955,26908,2167750,144,60;47;94;66;179;185;86;166;194;176;180;113;114;137;127;89;103;163;153;35;109;0;29;160;33;11;139;182;138;104;8;21;82;77;141;61;36;177;5;78;175;142;45;162;80;190;136;73;164;193;31;54;151;117;198;156;24;1;16;27;38;135;63;40;107;133;122;131;121;125;90;191;51;118;74;134;168;195;169;188;70;3;15;145;155;184;152;4;149;28;20;140;183;18;62;124;106;95;130;148,2002533110334195429,0.047505
steepest_intra:edges_start:random,10,47441,22718,24723,2093000,139,70;161;15;145;13;132;169;188;6;147;134;139;168;195;29;0;109;35;111;144;160;33;11;138;104;8;82;21;177;25;158;121;131;51;90;122;133;107;40;63;135;38;1;117;54;31;193;190;80;175;78;5;36;61;91;141;97;77;81;153;146;187;163;89;165;127;103;113;176;194;166;179;66;94;47;60;20;148;130;95;185;86;128;124;106;143;62;18;55;34;174;183;140;28;152;170;184;155;189;3,6067785302054476267,0.046000
steepest_intra:edges_start:random,11,47517,20263,27254,1943500,129,193;117;198;156;24;1;135;32;102;63;133;10;122;131;19;112;121;90;147;6;188;169;132;70;3;15;155;189;145;13;195;168;43;139;11;138;33;160;29;0;109;35;143;106;124;62;18;55;34;152;149;28;140;183;95;130;148;20;60;47;94;66;172;52;179;185;86;166;194;88;176;180;113;114;127;89;103;163;165;187;153;81;77;111;8;82;21;61;36;177;5;142;78;175;80;190;136;73;54;31,6208119975759731433,0.042000
steepest_intra:edges_start:random,12,47598,20088,27510,2137850,142,0;109;35;106;124;128;62;18;55;34;170;152;95;130;183;140;28;20;60;148;47;94;66;57;172;179;99;185;86;166;176;113;103;127;89;163;187;153;81;77;111;144;160;11;139;182;138;33;56;104;8;82;87;21;61;36;177;5;78;175;142;45;80;190;136;73;164;31;54;193;117;1;27;38;63;135;122;90;125;131;121;51;98;118;74;85;134;43;168;195;13;132;169;188;70;3;155;15;145;29,5530786138560594003,0.047001
steepest_intra:edges_start:random,13,50371,23882,26489,2018250,134,189;109;29;160;33;138;104;144;0;35;34;170;152;140;28;20;148;94;179;166;194;113;103;89;127;165;163;176;86;185;130;95;183;174;55;18;62;124;106;143;159;41;111;81;153;77;97;141;91;36;61;21;82;8;177;5;78;175;80;190;42;27;38;16;1;156;198;117;193;54;31;164;73;136;25;118;98;51;121;131;122;135;102;63;40;107;133;90;147;6;188;169;139;11;168;195;145;70;3;155,5202755479641869797,0.044000
steepest_intra:edges_start:random,14,46609,22038,24571,2033200,135,125;51;121;131;135;122;133;10;107;40;63;38;27;1;198;117;54;73;31;193;190;80;175;78;5;177;36;61;91;141;77;153;81;111;82;21;8;104;144;160;33;138;11;139;43;168;195;29;0;109;35;62;128;124;106;176;103;163;89;127;137;114;113;194;166;179;185;86;95;99;66;94;47;148;60;20;28;149;140;183;55;18;34;152;155;3;70;15;145;13;132;169;188;6;134;85;147;71;191;90,5105692815177464410,0.043000
steepest_intra:edges_start:random,15,48728,23503,25225,1973400,131,152;155;3;70;15;145;195;13;132;169;188;6;147;178;10;133;122;72;107;40;100;63;135;38;27;16;1;156;198;117;54;31;193;190;80;45;175;78;5;121;131;90;51;134;139;168;29;109;35;0;160;33;11;138;104;56;144;8;87;21;177;36;61;141;97;146;187;165;127;137;114;194;166;185;86;176;113;103;89;163;153;81;77;82;111;106;124;62;18;55;34;183;140;148;66;94;47;60;20;28,636141031959885726,0.043000
steepest_intra:edges_start:random,16,49768,22844,26924,1898650,126,74;134;139;11;49;29;109;35;0;160;33;138;182;157;104;56;144;8;21;177;36;61;141;77;187;165;127;89;103;163;186;153;81;111;159;143;18;62;124;106;176;113;166;86;95;130;99;185;179;172;66;94;47;60;20;148;9;199;28;149;4;140;183;34;152;155;3;70;15;145;168;195;13;132;169;188;6;147;10;133;107;40;63;135;90;191;51;121;198;117;193;31;54;73;190;80;175;5;25;118,7150657453500002290,0.042000
steepest_intra:edges_start:random,17,47018,20039,26979,1988350,132,20;28;149;140;183;34;55;18;62;95;86;128;124;106;143;111;35;109;0;29;160;33;104;8;82;87;21;138;182;11;139;168;195;13;145;15;3;70;132;169;188;6;134;147;10;133;72;17;107;40;100;63;135;122;90;191;71;120;51;125;121;131;1;198;117;193;54;31;164;73;136;190;80;45;175;78;5;177;36;61;91;141;77;153;163;89;103;113;176;194;166;185;99;179;172;66;94;47;148;60,4005864762624842850,0.043000
steepest_intra:edges_start:random,18,48084,21180,26904,2107950,140,80;190;45;5;177;8;104;56;144;160;33;138;182;25;158;121;112;73;54;31;193;117;198;156;1;27;38;102;63;32;135;131;122;133;10;90;191;51;118;134;147;6;188;169;132;161;70;3;15;145;13;195;168;43;139;11;29;0;109;35;143;159;106;124;128;62;18;55;34;170;152;183;140;28;20;60;148;47;94;185;86;166;194;176;113;103;89;163;153;187;141;77;81;111;82;21;61;36;78;175,2078398528393174781,0.047000
steepest_intra:edges_start:random,19,48303,20811,27492,1988350,132,28;149;4;140;183;95;130;185;86;124;62;18;55;34;170;152;184;155;3;70;15;145;195;168;132;169;188;147;178;10;133;72;17;107;40;100;122;90;135;63;38;27;16;197;1;24;156;198;117;193;31;164;136;73;54;19;112;121;25;138;33;160;29;0;109;35;111;104;8;82;21;177;5;45;190;80;175;78;36;141;97;77;153;163;89;127;137;114;103;113;176;194;166;179;66;94;47;148;60;20,1817322230982425677,0.042000
steepest_intra:edges_start:random,20,48852,20866,27986,2093000,139,8;82;21;177;5;136;73;31;54;117;193;190;80;45;175;78;36;61;91;141;97;77;81;153;163;89;127;103;113;180;176;194;166;86;95;130;185;179;94;47;148;20;28;140;183;62;18;55;152;155;3;70;145;13;195;168;169;188;6;147;10;133;122;135;32;63;102;38;27;1;131;121;90;191;71;67;120;51;98;118;74;134;139;11;138;33;104;144;160;29;0;109;35;124;128;106;143;159;41;111,7966956969090836597,0.045587
steepest_intra:edges_start:random,21,49411,21831,27580,1958450,130,10;133;63;122;90;191;125;51;98;118;116;121;131;135;1;198;117;54;73;31;193;190;80;175;5;177;25;182;138;33;144;160;49;29;12;0;109;35;111;56;104;8;82;21;141;97;77;81;153;187;163;89;127;103;113;176;166;86;106;159;143;124;62;18;34;55;95;185;179;94;47;148;60;20;28;149;140;183;152;170;184;155;189;3;70;15;145;11;139;168;195;13;132;169;188;6;134;85;147;178,7725434200553817486,0.042000
steepest_intra:edges_start:random,22,48697,21535,27162,1928550,128,121;131;135;63;38;1;156;198;117;193;190;80;46;162;175;78;7;36;61;91;141;21;82;8;111;81;77;97;146;187;153;163;89;165;127;114;103;113;176;194;166;86;128;106;124;62;18;55;95;130;185;179;66;94;154;47;148;60;20;28;149;140;183;174;34;170;152;184;155;3;70;145;195;168;169;188;6;147;90;51;134;139;11;29;109;35;0;144;160;33;138;25;177;5;142;45;136;73;31;54,494680429784664572,0.043000
steepest_intra:edges_start:random,23,46894,19296,27598,1973400,131,125;90;51;71;147;188;169;132;70;3;15;145;195;168;43;134;74;182;138;139;11;33;104;8;144;160;29;0;109;35;106;124;62;18;55;34;183;140;4;149;28;20;148;47;94;179;99;185;86;166;194;176;113;103;127;89;163;153;81;77;82;21;141;91;79;61;36;177;5;45;142;78;175;162;80;190;136;73;164;54;31;193;117;198;156;24;1;16;27;38;63;100;40;107;10;133;122;135;131;121,7759366465603574043,0.044000
steepest_intra:edges_start:random,24,46993,20993,26000,2048150,136,51;191;90;122;133;10;107;40;100;63;135;38;27;16;1;156;198;117;54;73;164;31;193;190;80;45;175;78;5;177;36;61;141;77;153;81;41;111;82;8;104;56;144;160;33;49;29;0;109;35;34;55;18;62;124;106;95;130;185;86;176;180;113;103;163;89;127;137;114;194;166;172;179;66;94;47;148;20;140;183;152;155;145;15;3;70;188;6;169;132;13;195;168;139;11;138;182;25;121;131,158653328360082404,0.045254
steepest_intra:edges_start:random,25,49446,21330,28116,2078050,138,47;94;66;172;52;179;185;99;130;95;86;166;194;113;103;127;89;163;187;153;180;176;128;62;18;55;34;124;106;159;143;35;109;0;29;111;77;97;141;21;87;82;8;104;56;144;160;33;11;138;182;25;177;61;36;5;78;175;80;190;136;73;54;31;193;117;1;16;27;38;102;63;135;122;131;121;116;118;74;98;51;191;90;133;10;178;147;188;169;70;3;155;152;183;140;149;28;20;60;148,7805921401497178606,0.047243
steepest_intra:edges_start:random,26,47846,20934,26912,1958450,130,190;73;54;31;193;117;198;156;24;1;197;16;27;38;92;63;102;135;122;90;191;147;188;169;168;195;145;15;70;3;155;152;170;34;55;18;62;183;140;149;28;20;60;148;47;94;185;95;86;166;194;176;180;113;114;137;103;163;89;127;165;187;153;106;124;143;35;109;0;29;160;33;138;182;11;139;134;74;118;98;51;121;177;21;82;8;104;144;111;81;77;97;141;91;61;36;5;78;175;80,4747603468674245972,0.044037
steepest_intra:edges_start:random,27,48528,21186,27342,1913600,127,170;34;55;18;83;62;128;124;106;111;8;144;0;35;109;29;160;33;138;182;11;139;168;195;126;132;13;145;15;3;70;169;188;6;147;51;118;74;25;158;121;131;125;90;122;135;63;38;1;24;156;198;117;54;31;193;190;80;162;175;78;142;45;5;177;21;61;36;141;153;163;103;89;127;137;114;113;176;166;86;95;185;179;66;94;47;148;60;20;28;199;9;99;130;183;140;4;152;184;155,2990396877365298504,0.043038
steepest_intra:edges_start:random,28,48169,21083,27086,2137850,142,1;156;198;117;54;31;193;190;80;175;5;36;61;141;77;97;187;153;186;163;103;89;165;127;137;114;113;180;176;194;166;86;95;130;185;179;66;94;47;148;20;140;183;174;34;55;18;83;62;128;124;106;143;159;81;111;29;0;35;109;170;152;184;155;15;3;70;188;169;132;13;195;168;139;11;138;33;160;144;104;8;82;21;177;25;121;51;191;90;131;135;122;107;40;63;102;92;38;27;16,6040533298895245787,0.050163
steepest_intra:edges_start:random,29,48373,21017,27356,1928550,128,179;166;194;114;127;89;163;103;26;113;180;176;106;143;153;81;77;82;111;144;39;29;160;33;49;11;139;138;104;56;8;21;177;5;78;175;80;190;136;73;54;31;193;117;198;1;27;38;131;122;135;63;40;107;133;10;90;121;51;71;147;6;188;169;132;168;195;145;15;70;3;155;184;189;69;109;0;35;34;55;18;62;124;128;86;185;99;130;95;183;140;4;149;28;59;20;60;148;47;94,7074507785572698921,0.040843
steepest_intra:edges_start:random,30,47357,20504,26853,2063100,137,140;183;152;34;55;18;62;124;106;159;143;35;109;0;29;49;11;139;168;195;145;15;3;70;132;169;188;6;147;71;51;90;10;133;107;40;100;122;135;63;38;27;1;131;121;112;19;151;198;117;54;73;164;31;193;190;80;175;5;25;182;138;33;160;144;56;104;8;111;82;21;177;36;61;141;77;81;153;187;163;89;127;103;113;176;194;166;86;185;94;47;148;60;20;59;199;28;101;149;4,6379294597378776676,0.045996
steepest_intra:edges_start:random,31,46995,21084,25911,2033200,135,153;159;143;106;124;62;18;55;34;183;140;28;20;60;148;47;94;66;179;22;99;130;95;185;86;166;194;176;180;113;103;114;137;127;89;163;187;141;36;175;78;5;177;25;158;121;54;31;73;190;80;193;117;198;156;1;38;135;63;100;40;107;133;122;90;51;71;147;134;6;188;169;132;70;3;15;145;13;195;168;139;11;138;33;160;49;29;109;35;0;12;111;144;104;8;21;87;82;77;81,2172063507407056585,0.047003
steepest_intra:edges_start:random,32,46625,21011,25614,2063100,137,195;168;139;11;49;29;0;109;35;143;106;124;62;18;55;34;152;140;149;28;20;60;94;66;47;148;9;183;95;86;185;179;172;52;166;194;176;113;114;137;127;165;89;103;163;153;81;77;141;36;61;21;82;8;104;144;160;33;138;25;177;5;78;175;80;190;73;54;31;193;117;1;131;121;51;191;90;122;135;63;100;40;107;133;10;147;98;118;74;85;134;6;188;169;132;70;3;15;145;13,7521484931973145125,0.046999
steepest_intra:edges_start:random,33,50962,22725,28237,1943500,129,149;28;20;60;94;47;148;140;183;185;179;172;166;194;113;103;89;127;165;163;176;86;18;62;124;106;159;143;35;109;0;29;160;33;144;111;8;104;21;82;58;77;14;81;153;187;97;141;61;36;5;177;25;121;54;31;73;78;175;80;190;193;117;1;38;135;122;63;100;40;107;133;10;115;178;191;90;125;51;120;71;147;6;188;65;169;132;13;195;168;145;15;161;70;3;189;155;184;170;152,8788072495364961266,0.043884
steepest_intra:edges_start:random,34,47348,20717,26631,1943500,129,113;103;114;137;127;89;163;187;153;81;111;82;77;141;36;61;21;8;104;144;160;33;138;182;11;139;118;51;121;158;25;177;5;78;175;80;190;73;164;31;54;193;117;198;1;38;135;63;100;40;107;72;10;133;122;90;147;85;134;6;188;169;132;70;3;145;13;195;168;29;12;0;109;35;143;159;106;124;62;18;55;183;140;149;28;20;60;148;47;154;94;66;179;99;185;86;166;194;176;180,7552630509683549495,0.045137
steepest_intra:edges_start:random,35,48187,21649,26538,2152800,143,198;117;193;54;31;164;73;136;190;80;175;78;142;45;5;36;141;77;81;111;8;82;87;21;104;138;33;160;29;0;109;35;124;106;153;146;187;163;89;165;127;137;75;114;103;26;113;180;176;194;166;86;95;130;185;179;94;47;148;60;20;140;183;55;83;62;18;34;170;152;155;145;15;3;70;188;169;132;13;195;168;134;6;147;10;133;107;40;100;63;135;122;131;90;191;125;51;121;1;156,2254283481800470467,0.049000
steepest_intra:edges_start:random,36,47674,21621,26053,1883700,125,127;89;103;163;187;153;77;141;91;61;36;78;175;80;190;193;117;198;1;16;27;38;131;135;63;40;107;122;133;10;147;71;120;51;191;90;125;121;54;31;73;136;5;177;21;87;82;8;104;33;138;182;11;139;134;6;188;169;132;70;3;15;145;13;126;195;168;160;29;0;109;35;143;106;124;128;62;83;18;55;34;155;184;152;183;140;20;148;47;94;179;185;130;95;86;166;194;176;113;114,2270984235662617867,0.041000
steepest_intra:edges_start:random,37,49062,21966,27096,1868750,124,130;95;152;34;55;18;62;124;106;111;82;8;104;138;33;160;29;0;35;109;189;155;3;70;15;145;13;132;169;188;6;126;195;168;11;139;134;51;90;191;147;10;133;122;107;40;63;102;32;135;38;27;16;42;156;198;117;193;31;73;54;151;1;131;121;112;19;158;25;177;5;78;175;36;61;141;77;153;163;89;103;113;180;176;194;166;86;185;99;179;172;66;94;47;148;60;20;28;140;183,441380867771082310,0.041000
steepest_intra:edges_start:random,38,48527,21403,27124,1958450,130,51;125;191;90;122;133;147;6;188;169;132;13;161;70;3;15;145;195;168;33;29;0;109;35;81;153;163;176;86;128;124;106;159;143;62;18;55;34;170;155;184;152;174;183;140;199;4;149;101;28;20;60;148;47;94;66;179;99;130;95;185;166;194;113;103;89;127;187;97;77;141;82;111;8;21;61;36;177;5;78;175;45;80;190;73;54;31;193;117;198;156;24;1;27;38;63;135;131;112;121,5020089246064617409,0.044000
steepest_intra:edges_start:random,39,49013,20786,28227,2033200,135,172;66;94;47;148;60;23;20;28;140;183;62;18;55;34;152;155;145;15;3;70;188;169;132;13;195;168;139;11;138;25;158;121;51;147;71;191;90;122;40;63;135;38;1;156;198;117;151;54;31;193;164;73;173;136;190;80;175;78;142;5;177;21;82;8;104;56;144;160;33;49;29;39;12;0;109;35;111;81;77;91;61;36;141;187;153;163;89;127;103;113;176;166;86;95;130;99;22;185;179,6780460371249031979,0.044506
steepest_intra:edges_start:random,40,49156,20904,28252,2093000,139,185;130;95;128;106;124;62;18;55;34;183;140;152;184;155;15;3;70;188;169;195;168;139;11;49;160;33;138;182;25;121;98;51;125;131;122;90;191;147;10;133;72;17;107;40;100;63;102;135;38;27;1;24;156;198;117;193;31;54;73;190;80;45;142;175;78;5;177;21;82;8;104;56;144;111;29;0;109;35;143;81;77;153;163;89;103;113;180;176;194;166;86;179;66;94;47;60;20;148;99,4187444117738137050,0.045000
steepest_intra:edges_start:random,41,48723,21184,27539,2078050,138,175;78;5;177;8;21;61;36;141;97;77;81;153;187;165;163;89;127;137;114;103;26;113;180;176;194;166;172;179;185;86;95;130;183;140;148;20;28;152;34;55;18;62;124;106;143;111;35;109;0;29;33;11;168;195;13;145;15;3;70;169;188;6;147;51;98;118;121;131;1;135;122;90;191;178;10;133;107;40;100;63;38;27;16;42;156;198;117;193;31;54;164;73;136;105;190;80;162;45;142,550730737489674481,0.045000
steepest_intra:edges_start:random,42,47759,21813,25946,2003300,133,35;109;0;160;33;138;182;134;139;11;29;189;184;155;3;70;15;145;195;168;132;169;188;6;147;191;90;51;121;131;135;32;122;133;10;72;17;107;40;100;63;38;27;1;198;117;193;31;54;164;73;190;80;175;78;5;177;36;21;8;104;144;111;82;141;77;81;153;146;187;163;89;127;114;103;113;176;166;86;95;185;94;47;148;60;20;28;140;183;152;170;34;55;18;62;128;124;106;159;143,4584658580136143397,0.044000
steepest_intra:edges_start:random,43,48470,21137,27333,1973400,131,34;183;148;47;60;20;28;149;4;140;152;184;155;3;145;195;168;132;169;188;147;10;133;122;135;63;102;38;27;1;131;90;191;51;121;112;19;151;156;42;198;117;193;31;54;164;73;136;190;80;175;5;177;36;61;79;91;141;77;82;21;8;104;160;33;138;139;11;29;0;109;35;111;153;187;163;89;127;137;114;103;26;113;180;176;194;166;179;185;22;99;130;95;86;128;106;124;62;18;55,1679780505994622541,0.045000
steepest_intra:edges_start:random,44,47647,20901,26746,1973400,131,185;95;183;140;149;28;20;148;47;94;66;179;172;166;194;176;113;103;163;89;127;165;187;153;97;141;77;81;41;111;35;109;0;29;144;56;160;33;138;104;8;82;87;21;91;61;36;177;5;80;190;73;164;54;31;193;117;198;1;27;38;135;102;63;100;40;107;133;122;90;121;51;98;118;134;139;11;168;195;13;132;169;6;188;70;3;15;145;155;152;34;55;18;62;143;159;106;124;128;86,2372456483187603265,0.043000
steepest_intra:edges_start:random,45,49468,20479,28989,2078050,138,113;180;176;88;194;166;86;95;130;185;179;66;94;47;148;20;140;183;55;18;83;62;128;124;106;159;143;12;39;29;0;109;35;34;170;152;184;155;3;70;15;145;195;168;169;188;6;134;147;51;118;74;139;11;138;25;158;121;131;90;191;178;10;133;122;135;1;198;117;54;73;31;193;190;80;175;78;5;177;36;61;141;77;82;21;8;104;33;160;144;111;41;14;81;153;163;89;165;127;103,4429557932030584061,0.044999
steepest_intra:edges_start:random,46,50081,21117,28964,2152800,143,169;126;168;195;13;132;161;70;3;15;145;155;152;183;140;28;20;148;47;94;185;86;95;55;34;18;62;124;143;106;166;194;176;113;103;127;89;163;153;111;35;109;0;29;160;33;11;138;104;8;21;61;36;5;78;175;142;45;162;80;190;136;73;54;31;193;117;198;156;24;1;151;19;112;173;177;25;158;116;121;131;122;135;102;63;40;107;133;10;178;191;90;125;51;118;74;134;147;6;188,6894124309828071904,0.047000
steepest_intra:edges_start:random,47,47401,21918,25483,1823900,121,177;36;61;141;77;81;153;163;89;127;114;103;26;113;180;176;88;194;166;172;179;94;47;148;20;28;149;140;183;95;130;99;185;86;106;124;62;18;55;34;152;155;3;70;15;145;13;132;169;188;195;168;134;6;147;51;90;122;133;10;72;107;40;100;63;135;38;27;156;198;117;193;136;190;80;175;78;142;5;73;164;31;54;1;131;121;138;139;11;29;0;109;35;111;144;160;33;104;8;21,6706834303329821842,0.040000
steepest_intra:edges_start:random,48,48689,21242,27447,2003300,133,70;15;145;168;195;13;132;169;65;188;6;147;90;122;107;40;63;135;1;117;193;190;80;162;45;142;175;78;36;61;177;5;136;73;164;31;54;19;112;121;51;118;182;138;139;11;33;104;8;77;153;81;111;144;160;29;0;109;35;143;159;106;124;62;18;34;55;83;128;176;180;163;89;127;103;113;194;166;86;185;179;66;94;47;148;20;28;149;4;140;99;130;95;183;152;170;184;155;189;3,1993645621588873512,0.045506
steepest_intra:edges_start:random,49,46974,21272,25702,2078050,138,61;21;87;82;8;111;35;109;0;29;11;33;160;144;104;138;182;25;177;5;80;190;193;31;54;117;198;156;1;16;27;38;63;40;107;100;135;122;90;51;134;139;168;195;188;169;132;13;145;15;70;3;155;184;152;4;149;28;140;183;34;55;18;62;143;106;124;128;86;185;95;130;99;148;20;23;60;47;94;66;179;166;194;176;180;113;114;137;127;103;163;89;165;187;153;81;77;141;91;36,3615003099234653850,0.046000
steepest_intra:edges_start:random,50,47627,21181,26446,2152800,143,147;6;188;169;168;195;145;15;70;3;155;152;170;34;55;18;83;62;124;128;86;185;99;130;95;183;140;149;28;20;60;148;47;94;66;179;172;52;166;194;176;180;113;103;127;89;163;153;106;143;81;77;82;111;35;109;0;12;29;144;160;33;11;138;104;8;21;141;61;36;177;25;121;112;54;31;164;73;136;45;5;142;78;175;162;80;190;193;117;198;1;135;102;63;40;107;10;133;122;90,7173741768665834225,0.047003
steepest_intra:edges_start:random,51,48919,21144,27775,1958450,130,11;168;195;13;145;15;3;70;132;169;65;188;6;147;134;118;51;191;90;131;135;122;178;10;133;72;17;107;40;100;63;38;27;16;1;156;198;117;121;112;73;54;31;193;190;80;45;175;78;5;177;25;138;104;21;36;61;79;91;141;97;77;153;113;176;166;86;95;130;99;185;179;94;47;148;60;20;28;140;183;152;170;34;55;18;62;128;124;106;159;143;35;109;0;29;111;8;144;160;33,6318689835348550368,0.041997
steepest_intra:edges_start:random,52,49830,22836,26994,1868750,124,3;155;152;183;140;149;28;20;60;148;47;94;179;185;130;95;86;166;194;176;180;113;114;127;89;103;163;187;141;61;36;78;175;142;45;80;190;136;164;193;117;198;1;27;38;135;102;63;40;107;122;131;121;112;19;54;31;73;5;177;25;51;125;90;191;71;147;188;169;168;139;182;138;11;49;33;160;39;29;109;35;0;12;144;104;8;111;82;21;77;81;153;106;62;18;55;34;145;15;70,389485762871660797,0.041001
steepest_intra:edges_start:random,53,47756,21294,26462,2063100,137,106;153;187;165;127;89;163;103;113;176;194;166;86;95;185;179;94;47;148;60;20;28;149;4;199;140;183;152;184;155;3;70;15;145;195;168;169;188;147;90;122;135;100;107;40;63;38;27;1;156;198;117;193;31;54;73;190;80;162;175;78;142;45;5;177;123;25;158;19;112;121;51;98;118;182;138;139;11;33;160;104;8;21;61;36;141;77;111;29;0;109;35;143;62;18;34;55;83;128;124,7134547533655633162,0.043999
steepest_intra:edges_start:random,54,49745,21166,28579,1928550,128,147;6;188;169;132;13;195;43;139;168;145;70;3;155;184;53;152;170;34;109;29;0;35;143;106;124;128;62;18;55;174;183;95;130;99;9;140;149;28;20;60;148;47;94;66;57;172;179;185;86;166;194;176;180;113;103;127;89;163;187;153;77;141;82;8;104;160;33;11;138;25;177;5;80;190;193;117;198;156;16;27;38;1;54;31;73;19;112;121;131;135;102;63;122;90;191;125;51;120;71,2284997883040253760,0.045000
steepest_intra:edges_start:random,55,47454,22012,25442,1988350,132,5;45;190;80;175;78;36;61;91;141;97;77;81;153;163;103;89;127;137;114;113;176;194;166;86;185;99;179;94;47;148;20;28;149;4;152;140;183;130;95;55;18;62;124;106;159;143;111;29;0;35;109;189;155;3;70;15;145;168;195;13;132;169;188;6;147;10;178;191;90;125;131;135;122;133;107;40;63;102;38;27;16;1;117;193;31;54;73;121;51;134;139;11;138;33;160;144;104;8;177,4971620129249210484,0.044001
steepest_intra:edges_start:random,56,48416,20532,27884,1838850,122,151;198;117;193;54;31;164;73;136;190;80;175;78;5;36;141;97;77;82;111;41;81;153;163;89;165;127;137;114;103;26;113;180;176;194;166;86;95;185;179;66;94;47;148;20;28;149;4;199;140;183;174;55;18;83;62;128;124;106;143;34;152;184;155;3;70;15;145;168;195;13;132;169;188;6;147;51;125;191;90;122;63;135;131;121;158;25;138;11;33;160;29;0;109;35;144;8;21;177;173,866628240879537973,0.039999
steepest_intra:edges_start:random,57,48727,22423,26304,2048150,136,11;139;134;74;118;51;191;90;122;135;102;63;40;107;133;10;147;6;188;169;132;13;195;168;145;3;155;152;170;34;55;18;83;62;128;95;185;22;99;130;183;140;20;148;47;94;179;86;166;194;176;180;113;103;114;127;89;163;187;97;141;91;61;36;5;78;175;80;190;31;54;117;1;27;38;131;121;177;21;82;77;81;153;106;124;159;143;35;109;0;29;160;33;144;111;8;56;104;138;182,6786304445271491269,0.044002
steepest_intra:edges_start:random,58,48941,20241,28700,1868750,124,139;43;169;188;6;134;118;98;51;125;90;191;120;71;147;10;133;122;72;107;40;100;63;102;135;131;121;112;19;151;1;156;198;117;193;31;54;164;73;190;80;175;5;177;36;141;77;153;163;89;127;103;113;176;194;166;86;95;130;185;179;52;172;66;94;47;148;20;28;149;4;199;140;183;55;18;83;62;124;106;143;34;152;155;3;70;15;145;132;13;195;168;29;0;109;35;111;8;33;11,5830185968481753444,0.039987
steepest_intra:edges_start:random,59,47486,21634,25852,2048150,136,33;11;139;138;182;25;177;5;78;175;80;190;73;54;31;193;117;198;156;1;38;135;102;63;100;40;107;133;122;90;191;147;51;125;131;112;121;116;98;118;134;6;188;169;168;195;145;70;3;155;184;152;183;140;149;28;20;148;47;94;66;179;185;130;95;86;166;194;176;180;113;114;103;89;127;165;163;187;153;143;106;124;62;18;55;34;35;109;0;29;111;81;77;141;91;36;61;21;8;104,1129986976993840290,0.044000
steepest_intra:edges_start:random,60,48912,21452,27460,1958450,130,152;184;155;170;34;55;18;62;128;124;106;159;143;111;82;21;8;104;138;11;33;160;0;35;109;29;168;195;145;15;3;70;132;169;188;6;147;71;67;120;51;191;90;122;133;107;40;63;135;38;27;16;156;1;131;125;121;112;19;151;198;117;193;31;54;164;73;136;190;80;175;5;36;141;77;81;153;146;187;165;127;89;163;103;113;176;194;166;172;179;94;47;60;20;148;185;86;95;183;140,1152204160545247025,0.042000
steepest_intra:edges_start:random,61,48745,21877,26868,1883700,125,164;73;136;45;5;78;175;162;80;190;193;117;198;156;1;38;63;40;107;122;135;131;90;191;51;147;6;188;169;132;145;70;3;155;152;34;55;18;62;183;9;199;140;149;28;59;20;23;60;148;47;154;94;66;57;172;179;22;99;130;95;185;86;166;176;113;103;127;89;163;106;124;143;153;77;141;61;36;177;21;8;104;33;160;111;35;109;0;29;195;168;11;138;182;25;121;112;19;54;31,9083129583543756458,0.041000
steepest_intra:edges_start:random,62,47473,22501,24972,2272400,151,193;190;80;45;142;175;78;5;36;61;141;77;81;153;159;143;106;124;128;62;18;34;55;83;95;130;86;176;163;89;103;113;194;166;185;179;66;94;47;148;60;20;28;149;140;183;152;109;35;0;29;168;195;13;145;15;3;70;132;169;188;6;134;139;11;182;138;33;160;144;111;104;8;82;21;177;25;121;131;1;135;122;90;191;125;51;147;10;133;107;40;63;38;27;156;198;117;54;73;31,2278113366477391587,0.050000
steepest_intra:edges_start:random,63,47506,20360,27146,1973400,131,11;139;168;195;145;15;3;70;169;188;6;147;71;67;120;51;98;121;112;19;131;125;90;191;10;133;122;135;107;40;63;102;38;27;16;1;117;193;31;54;73;136;190;80;45;142;175;78;5;177;36;61;141;21;82;8;111;77;97;81;153;187;163;103;89;127;114;113;180;176;194;166;86;95;185;179;94;47;148;20;28;140;183;152;34;55;18;62;128;124;106;159;143;35;109;0;29;33;138;182,4830133876401422426,0.043000
steepest_intra:edges_start:random,64,47718,20237,27481,2048150,136,121;125;122;135;102;63;100;40;107;72;133;10;178;90;191;51;120;71;147;6;188;169;70;3;145;195;168;139;11;182;138;33;160;29;0;109;35;34;183;140;4;149;28;20;148;47;94;66;179;22;99;95;185;86;55;18;62;124;106;143;159;180;176;166;194;113;103;114;127;89;163;187;153;81;77;82;8;104;21;141;91;61;36;177;5;78;175;80;190;136;73;164;31;54;193;117;198;156;1;131,4335858960444533977,0.045000
steepest_intra:edges_start:random,65,48780,20376,28404,1973400,131,98;51;131;135;63;40;107;133;122;90;191;120;67;71;147;134;6;188;169;132;70;3;145;13;195;168;139;11;182;138;104;8;21;82;111;144;33;160;29;0;109;35;62;18;55;183;140;4;149;28;20;148;47;94;179;185;95;86;166;194;176;113;114;103;89;127;165;163;153;81;77;141;61;36;177;5;78;175;142;45;136;190;80;42;16;27;38;1;156;198;117;193;164;73;31;54;112;121;116;118,1530654050065829209,0.045552
steepest_intra:edges_start:random,66,48543,23148,25395,1943500,129,156;198;117;193;190;80;175;78;36;61;79;91;21;87;82;141;97;77;153;163;165;127;89;103;113;180;176;194;166;179;94;47;148;60;20;28;149;152;170;140;183;185;86;106;124;62;18;55;34;155;189;145;15;3;70;188;6;147;10;133;107;40;100;63;135;122;131;121;51;90;191;71;134;169;132;13;195;168;139;11;182;138;33;160;29;0;109;35;111;8;104;25;177;5;73;31;54;1;38;27,9198307911636756245,0.042999
steepest_intra:edges_start:random,67,48644,20856,27788,1913600,127,177;5;78;175;80;190;73;164;31;54;193;117;198;1;16;27;38;102;96;63;40;122;135;131;121;90;191;71;147;51;118;182;138;104;56;111;35;109;0;29;160;144;33;49;11;139;168;195;13;132;169;6;188;161;70;3;15;145;189;155;152;183;140;4;149;101;28;20;148;47;94;179;185;130;95;55;34;18;83;62;124;106;86;166;176;113;103;89;127;165;163;153;81;77;97;141;82;8;21;36,1984101308555198183,0.042300
steepest_intra:edges_start:random,68,46705,21391,25314,2033200,135,99;179;94;47;148;60;20;140;183;95;128;106;124;62;18;55;152;155;3;70;15;145;168;195;13;132;169;188;6;192;147;134;139;11;29;109;35;0;160;33;138;182;51;90;122;133;107;40;100;63;135;131;121;112;19;1;38;27;156;198;117;193;31;54;73;136;190;80;162;175;78;142;45;5;177;36;61;91;141;21;104;8;82;77;81;153;187;163;103;89;127;137;114;113;180;176;194;166;86;185,8663295170130756288,0.044000
steepest_intra:edges_start:random,69,49076,21294,27782,2003300,133,78;5;177;36;61;141;187;153;81;77;82;21;8;111;35;109;0;29;160;33;144;104;138;168;195;145;15;189;167;170;34;55;18;62;95;130;99;185;86;124;106;163;89;127;103;113;176;194;166;179;66;94;47;148;20;28;149;4;199;140;183;152;184;155;3;70;169;188;6;134;85;147;71;191;90;125;120;51;121;112;19;131;122;135;63;38;27;16;1;24;156;198;117;193;31;54;73;190;80;175,7934740851336582884,0.043000
steepest_intra:edges_start:random,70,47705,20814,26891,2018250,134,107;40;63;135;131;121;117;54;31;190;80;45;175;78;5;177;36;61;141;97;77;82;21;8;104;144;160;33;138;11;29;0;109;35;124;128;106;143;159;41;111;81;153;187;165;163;89;127;137;114;103;113;180;176;194;166;86;185;95;130;99;179;94;47;148;60;20;28;149;4;140;183;174;55;18;62;34;170;152;184;155;3;145;195;168;132;169;188;6;134;85;74;118;98;51;191;90;122;133;10,3631138495741080373,0.044000
steepest_intra:edges_start:random,71,48783,21075,27708,2167750,144,95;183;140;55;18;62;34;155;184;152;149;28;20;148;47;94;66;179;166;194;176;180;113;103;163;153;81;77;141;61;36;175;5;177;21;82;8;104;56;111;144;160;33;138;121;112;54;31;164;73;80;190;193;117;198;156;1;27;38;135;32;102;63;100;40;107;72;10;133;122;90;191;51;98;118;134;6;188;169;126;168;195;13;132;70;3;15;145;29;0;109;35;143;106;124;128;86;185;99;130,6397699992960312506,0.046000
steepest_intra:edges_start:random,72,47912,21534,26378,1913600,127,8;111;81;153;187;163;89;127;137;114;103;113;176;194;166;86;185;179;94;47;148;60;20;28;149;4;199;140;183;95;124;106;143;62;18;55;34;152;155;145;15;3;70;188;169;195;168;29;0;109;35;12;160;33;144;104;138;11;139;134;118;98;51;121;131;90;10;133;72;107;40;100;122;32;96;63;102;135;38;1;24;156;198;117;193;31;54;73;136;190;80;175;5;177;36;61;141;77;82;21,4443777721267055243,0.043000
steepest_intra:edges_start:random,73,48479,20583,27896,2093000,139,85;134;6;188;169;132;13;70;3;15;145;195;168;139;182;138;11;49;29;0;109;35;34;55;18;62;128;86;185;99;130;95;183;140;28;20;148;47;94;179;172;52;166;194;113;180;176;106;124;143;111;160;33;104;8;82;77;81;153;163;103;89;127;187;141;91;36;61;21;177;25;158;121;5;142;78;175;80;190;73;54;31;193;117;198;156;1;16;27;38;102;63;32;135;122;90;51;98;118;74,6427168343513720337,0.046505
steepest_intra:edges_start:random,74,46350,21283,25067,1943500,129,82;21;8;104;144;33;160;29;0;109;35;143;159;81;153;163;165;127;89;103;114;113;176;194;166;86;185;179;94;47;148;60;20;28;149;140;183;130;95;128;106;124;62;18;55;34;152;155;3;70;15;145;195;168;126;13;132;169;188;6;134;139;138;182;25;121;131;122;90;191;51;147;10;133;107;40;63;135;38;27;1;156;198;117;193;54;31;164;73;136;190;80;45;175;78;5;36;61;141;77,8453551829679254259,0.042000
steepest_intra:edges_start:random,75,51416,21953,29463,2107950,140,98;118;74;182;138;33;160;104;8;35;109;0;29;11;139;168;195;13;132;169;188;70;3;15;145;155;184;152;140;183;148;94;179;185;86;166;176;106;124;62;18;143;81;153;163;89;127;165;187;97;77;141;82;21;91;61;36;177;5;45;142;78;175;162;80;190;136;73;164;31;54;193;117;198;156;1;27;38;63;135;122;100;40;107;72;133;10;147;71;191;90;125;131;151;19;112;121;158;25;51,4656449291663631242,0.045000
steepest_intra:edges_start:random,76,47450,21337,26113,1973400,131,18;55;34;170;152;155;189;109;35;0;29;160;33;138;11;139;168;195;126;13;145;15;3;70;132;169;188;6;147;191;90;125;51;121;131;122;40;63;135;1;156;198;117;151;54;31;193;164;73;136;190;80;175;78;142;5;177;36;21;8;104;56;144;111;143;106;176;113;26;103;163;153;77;141;187;89;127;137;114;194;166;179;66;94;47;148;20;28;149;140;183;95;130;99;185;86;128;124;62;83,4126752328907810835,0.043000
steepest_intra:edges_start:random,77,48699,21105,27594,2048150,136,172;52;179;22;185;86;166;194;114;137;165;187;146;153;163;89;127;103;26;113;88;180;176;128;124;106;35;109;0;29;33;8;77;141;61;36;177;5;78;175;45;80;190;136;73;54;31;193;117;198;156;1;16;27;38;135;131;19;112;121;51;191;90;122;63;40;107;133;147;6;188;169;168;195;13;145;70;3;155;152;34;55;18;62;83;95;130;99;9;183;140;149;28;20;60;148;47;154;94;66,3972750647736803004,0.046000
steepest_intra:edges_start:random,78,47656,21025,26631,2033200,135,128;62;83;18;55;34;170;152;53;174;183;140;4;149;28;20;60;148;47;94;185;95;86;166;194;176;113;103;163;89;127;137;165;187;153;77;141;91;36;61;87;21;177;5;142;78;175;80;190;193;31;164;73;54;151;117;198;156;27;38;1;121;131;122;135;63;40;107;133;90;191;51;182;138;11;188;169;132;70;3;15;145;13;195;168;109;35;0;29;160;33;144;56;104;8;82;111;143;106;124,6590259893483540054,0.045000
steepest_intra:edges_start:random,79,48865,22904,25961,1958450,130,187;153;81;159;143;34;55;18;62;124;106;163;103;89;127;137;114;113;180;176;194;166;86;95;130;99;22;185;179;94;47;148;20;28;149;4;199;140;183;152;170;184;155;3;70;145;13;195;168;169;147;90;10;133;40;107;122;135;63;38;1;198;117;193;31;54;73;190;80;175;78;142;45;5;121;139;11;29;109;35;0;160;144;111;8;104;33;138;182;25;123;177;36;61;21;82;141;77;97;146,9111435559390332203,0.043001
steepest_intra:edges_start:random,80,48623,20888,27735,1958450,130,140;28;20;148;47;94;185;95;86;166;194;114;127;89;103;113;176;128;124;106;163;187;153;81;77;97;141;91;36;61;21;82;8;104;138;182;139;134;118;98;51;121;112;158;25;177;5;78;175;80;190;136;73;54;31;193;117;198;156;1;16;27;38;135;102;63;40;107;100;122;44;133;10;178;90;191;71;147;6;188;169;132;70;3;15;145;13;195;168;11;33;160;144;29;0;109;35;62;18;183,6334231598656446607,0.042999
steepest_intra:edges_start:random,81,48077,20607,27470,2063100,137,190;80;162;45;142;175;78;5;177;123;25;21;61;36;141;187;163;89;127;114;103;113;176;194;166;86;185;94;47;148;20;28;149;140;183;152;170;34;55;18;62;124;106;153;77;82;8;104;144;111;35;109;0;29;160;33;138;11;139;168;195;145;3;70;132;169;188;6;147;71;120;51;125;90;191;178;10;133;107;40;63;102;135;122;131;121;112;1;197;16;38;27;156;198;117;193;31;54;73;136,6685270719451899882,0.046000
steepest_intra:edges_start:random,82,47546,21894,25652,2048150,136,54;31;193;117;1;16;27;38;135;63;40;122;90;147;6;188;169;168;195;13;145;70;3;155;184;170;152;183;140;149;28;20;60;148;47;94;66;179;22;99;130;95;185;166;194;86;128;83;18;55;34;62;124;106;176;180;113;103;163;89;127;165;187;153;81;159;143;35;109;0;29;49;11;139;138;33;160;144;111;8;104;21;87;82;77;141;91;61;36;78;175;80;190;136;45;5;177;25;121;73,1643126567514492211,0.044001
steepest_intra:edges_start:random,83,48553,20282,28271,1943500,129,33;160;144;56;104;138;182;11;139;43;168;195;13;145;15;155;3;70;132;169;188;6;147;90;51;121;131;135;63;38;27;1;156;198;117;193;31;54;164;73;190;80;175;78;5;177;36;61;79;91;141;77;153;81;82;87;21;8;111;143;124;106;176;113;194;166;179;66;94;154;47;148;60;23;20;28;149;4;53;152;170;140;199;9;183;95;130;99;185;86;128;62;18;55;34;35;109;0;29;49,1911777021096016382,0.042999
steepest_intra:edges_start:random,84,48798,20833,27965,1898650,126,153;81;111;160;33;29;0;35;109;189;184;155;3;70;15;145;13;195;168;126;132;169;188;6;147;90;133;122;135;32;96;63;102;38;27;1;117;193;31;54;121;25;104;8;21;177;5;45;142;175;78;36;61;141;77;97;146;187;165;89;163;103;127;137;114;113;180;176;194;166;86;185;179;22;99;130;95;183;9;148;66;94;47;60;23;20;28;149;140;152;170;34;55;18;83;62;128;124;106;143,2382447565179514000,0.043000
steepest_intra:edges_start:random,85,50023,22544,27479,1973400,131,152;183;140;149;28;20;148;47;94;66;99;22;185;179;166;194;176;180;113;26;103;114;137;127;89;163;165;187;153;81;77;97;141;91;61;36;177;5;80;190;31;54;117;121;25;21;87;82;111;8;104;144;160;33;138;11;139;134;118;98;51;125;191;90;122;135;1;16;27;38;63;100;40;107;133;10;178;147;188;169;70;3;29;0;109;35;143;159;106;124;128;86;130;95;62;18;55;34;155;184,3311151741792737006,0.043000
steepest_intra:edges_start:random,86,47381,20503,26878,1988350,132,141;187;89;127;114;194;166;86;95;130;99;22;185;179;52;172;57;66;94;47;148;20;28;149;4;199;140;183;174;152;170;34;55;18;62;124;106;176;180;113;103;163;153;81;111;8;104;56;144;12;35;109;0;29;160;33;138;11;139;168;195;145;15;3;70;13;132;169;188;147;71;191;90;51;121;131;135;122;40;63;38;27;1;198;117;193;31;54;73;190;80;175;5;177;36;61;91;21;82;77,7646006197970039274,0.043000
steepest_intra:edges_start:random,87,48988,21783,27205,2048150,136,51;98;118;74;182;138;139;11;29;0;109;35;41;111;144;160;33;56;104;8;82;141;77;81;153;187;165;163;89;127;137;114;103;26;113;180;176;194;166;86;185;179;22;99;95;128;106;143;124;62;18;55;34;183;148;47;60;20;140;152;155;3;70;15;145;195;168;132;169;188;147;133;122;100;107;40;63;135;38;27;1;156;198;117;193;54;31;164;190;80;175;78;142;5;136;73;121;131;90;191,381727869126004324,0.045000
steepest_intra:edges_start:random,88,48739,22023,26716,1898650,126,119;159;143;106;124;62;18;128;86;194;166;179;185;95;130;99;66;94;154;47;148;60;20;28;140;183;152;170;55;34;35;109;189;155;3;70;15;145;195;168;169;188;6;147;51;191;90;10;133;122;135;63;38;1;156;198;117;151;54;31;193;164;73;136;190;80;45;142;175;78;5;177;25;121;118;134;139;11;182;138;104;33;160;29;0;111;8;82;141;77;81;153;187;163;89;127;103;113;180;176,3497332254593270688,0.040571
steepest_intra:edges_start:random,89,48093,21487,26606,2152800,143,169;188;70;3;15;145;155;184;152;34;55;18;62;124;106;143;81;153;163;176;86;185;99;130;95;183;140;28;20;60;148;47;154;94;66;179;172;166;194;113;103;127;187;77;141;36;61;21;177;5;78;175;45;80;190;136;73;164;193;31;54;151;117;198;156;1;27;38;102;63;135;131;121;51;191;90;122;133;147;134;139;11;138;104;33;160;144;56;8;82;111;35;109;0;12;39;29;168;195;132,7055193329889146595,0.048000
steepest_intra:edges_start:random,90,46460,19560,26900,2003300,133,169;70;3;15;145;13;195;168;11;33;160;144;111;29;0;109;35;143;106;124;128;62;83;18;55;34;170;152;183;140;4;149;28;20;148;47;94;179;185;99;130;95;86;166;194;176;180;113;103;127;89;163;153;77;141;61;36;177;5;78;175;142;45;80;190;73;164;54;31;193;117;198;156;1;16;27;38;135;63;100;40;107;72;44;133;10;178;122;90;191;51;121;25;21;8;104;138;139;6;188,367141266569589353,0.044000
steepest_intra:edges_start:random,91,46394,19725,26669,2107950,140,177;5;175;80;190;193;31;54;117;198;1;27;38;135;63;100;40;107;72;122;133;10;178;191;90;131;121;51;147;6;188;169;132;70;3;15;145;195;168;139;11;29;0;109;35;143;159;106;124;128;62;18;55;34;170;152;183;140;4;149;28;20;60;148;47;154;94;66;57;172;52;179;99;130;95;185;86;166;194;176;180;113;103;127;89;163;187;153;81;77;97;141;21;82;8;104;144;160;33;138,923880814329965096,0.046000
steepest_intra:edges_start:random,92,48197,21932,26265,2063100,137,114;103;113;176;194;166;86;106;143;124;62;18;55;95;130;9;99;22;185;179;172;57;66;94;47;148;60;20;28;140;183;152;155;3;70;15;145;168;195;13;132;169;65;188;6;134;139;11;33;138;182;25;158;121;131;125;51;90;191;71;147;10;133;40;107;122;135;63;38;1;24;156;198;117;54;31;193;190;80;45;142;175;78;5;177;36;61;141;77;111;29;0;109;35;153;187;163;89;127;137,9169299560284123859,0.044999
steepest_intra:edges_start:random,93,46853,20015,26838,2122900,141,25;74;139;11;182;138;104;144;33;160;29;0;109;35;34;55;18;83;62;128;124;106;143;111;8;21;61;36;141;77;81;153;163;89;103;113;176;194;166;86;95;130;99;22;185;179;66;94;47;148;20;28;140;183;152;184;155;3;70;15;145;195;168;126;13;132;169;188;6;147;115;178;10;133;107;40;63;135;122;90;191;125;51;121;198;117;193;54;31;164;73;136;190;80;45;142;175;78;5;177,7291635609532080562,0.047271
steepest_intra:edges_start:random,94,49009,21391,27618,2018250,134,51;118;74;134;147;6;188;65;169;132;70;3;15;145;13;126;195;168;43;139;11;33;138;182;25;121;54;31;164;73;136;177;21;82;8;111;81;153;106;124;143;35;0;29;109;34;55;18;62;95;130;183;140;4;149;28;20;23;60;148;47;94;66;179;185;86;166;194;176;113;103;163;187;77;141;91;61;36;5;78;175;45;80;190;193;117;198;156;24;1;27;38;102;63;135;122;133;10;90;191,2319700472323804257,0.042965
steepest_intra:edges_start:random,95,46491,20682,25809,1988350,132,148;47;94;179;172;52;185;86;166;194;176;180;113;103;114;137;127;89;163;165;187;153;81;77;141;61;36;177;5;78;175;142;45;80;190;136;73;54;31;193;117;198;1;38;63;135;122;100;40;107;133;10;90;51;147;6;188;169;70;3;15;145;13;195;168;139;11;138;182;25;104;56;144;33;160;29;0;109;35;8;21;82;111;143;106;124;62;18;34;55;95;130;22;99;183;140;4;149;28;20,7807756720725719423,0.044001
steepest_intra:edges_start:random,96,47790,21323,26467,1853800,123,62;18;55;34;152;155;3;70;15;145;195;168;169;188;6;134;74;118;121;51;191;90;122;107;40;63;135;131;1;16;38;27;42;156;198;117;193;31;54;73;190;80;175;5;177;25;182;138;139;11;33;160;144;29;0;109;35;111;68;56;104;8;82;87;21;61;36;91;141;77;81;153;143;106;124;128;95;130;99;185;86;176;113;26;103;163;89;127;137;114;194;166;179;94;47;148;20;140;183;83,1421901855337096925,0.041001
steepest_intra:edges_start:random,97,46440,20520,25920,1958450,130,86;128;124;106;143;62;18;55;34;183;95;130;185;179;94;47;148;20;28;149;140;152;184;155;3;70;161;15;145;29;0;109;35;111;8;104;144;160;33;138;182;11;139;168;195;126;13;132;169;188;6;134;118;98;51;191;90;121;131;135;122;107;40;63;1;156;198;117;54;73;31;193;190;80;45;175;78;5;177;36;61;141;97;77;81;153;187;165;163;89;127;137;114;103;26;113;180;176;194;166,6238120923632106206,0.043572
steepest_intra:edges_start:random,98,48331,22479,25852,1973400,131,55;34;170;152;155;3;70;145;13;195;168;169;188;6;147;51;90;122;135;100;107;40;63;96;102;38;27;16;1;156;198;117;31;193;190;80;162;136;73;54;121;25;138;33;8;82;21;177;5;142;175;78;36;61;91;141;77;187;89;127;137;114;194;166;179;94;47;148;60;20;28;149;4;140;183;95;130;99;185;86;128;176;180;88;113;26;103;163;153;81;111;160;29;0;109;35;106;124;62;18,3401641760164325774,0.044007
steepest_intra:edges_start:random,99,46689,20300,26389,2197650,146,124;106;34;152;155;3;70;145;168;195;13;132;169;188;6;134;147;115;178;10;133;122;90;191;125;51;121;131;135;63;38;27;16;1;156;198;117;193;31;54;73;136;190;80;175;78;142;5;177;36;61;21;82;8;144;56;104;138;182;139;11;33;160;29;109;35;0;12;111;141;77;81;153;163;103;89;127;137;114;26;113;180;176;194;166;86;95;130;185;179;94;47;148;60;20;140;183;55;18;62,5627294685213711458,0.049609
steepest_intra:edges_start:random,100,48879,21828,27051,2003300,133,165;89;163;103;113;176;86;185;22;99;130;95;55;34;18;62;124;106;143;35;109;0;29;144;111;82;77;81;153;187;97;141;91;36;61;21;8;104;160;33;138;11;139;182;25;177;5;80;190;73;54;31;193;117;198;156;1;151;19;112;121;51;191;90;131;135;32;102;63;40;107;100;122;133;10;178;147;6;188;169;132;168;195;145;3;155;184;152;183;140;28;20;148;94;179;172;166;194;114;127,5487432323903665886,0.045240
steepest_intra:edges_start:random,101,46650,20409,26241,2063100,137,144;160;33;11;139;138;104;8;82;21;61;36;78;175;142;5;177;25;121;112;54;31;164;73;136;80;190;193;117;198;156;1;38;135;102;63;40;107;122;90;51;118;74;85;134;147;6;188;169;70;3;145;13;195;168;29;0;109;35;143;106;124;62;83;18;55;34;170;152;183;140;4;149;28;20;60;148;47;94;66;179;99;130;95;185;86;166;194;176;113;114;137;127;165;89;103;163;153;77;111,4069446171951501540,0.045259
steepest_intra:edges_start:random,102,47959,21341,26618,1898650,126,138;11;29;0;109;35;111;144;160;33;56;104;8;82;77;81;153;163;89;127;187;141;61;36;177;5;78;175;45;80;190;136;193;117;54;31;164;73;112;121;131;1;27;38;63;135;122;133;10;90;51;118;74;85;134;6;188;169;132;161;70;3;155;184;53;152;183;140;149;28;20;60;148;47;94;179;166;194;113;176;86;185;99;130;95;106;124;62;18;55;34;170;189;15;145;13;195;168;139;182,9134042963147701668,0.043001
steepest_intra:edges_start:random,103,49512,21607,27905,2003300,133,35;109;0;29;160;33;138;104;8;77;141;91;61;36;175;78;5;177;25;112;19;54;31;164;73;136;80;190;193;117;198;156;24;1;135;122;32;102;63;100;40;107;72;133;10;178;147;51;191;90;131;121;98;118;74;85;134;6;188;169;168;195;145;15;70;3;155;152;55;18;62;86;185;130;95;183;140;28;20;148;47;94;66;179;166;194;176;113;103;114;137;127;165;89;163;153;81;106;124;143,7460901310897530725,0.042999
steepest_intra:edges_start:random,104,48188,21381,26807,2167750,144,127;89;163;165;187;153;81;77;141;36;61;21;8;111;35;109;0;29;49;11;139;182;138;33;160;104;177;5;45;142;78;175;162;80;190;136;73;112;121;54;31;164;193;117;198;156;1;197;16;27;38;135;102;63;100;40;107;10;133;122;90;191;51;71;147;188;169;168;195;13;145;70;3;155;152;140;20;148;47;94;179;172;166;194;86;185;99;130;95;183;55;18;62;124;106;176;113;103;114;137,5660674777882739857,0.047000
steepest_intra:edges_start:random,105,48429,20309,28120,2137850,142,160;29;0;109;35;111;144;104;8;21;82;77;81;159;143;106;124;62;18;55;183;140;149;28;20;148;47;94;179;99;185;86;166;176;113;103;114;127;89;163;153;187;141;61;36;177;25;121;5;78;175;142;45;80;190;193;31;73;54;117;198;156;1;197;16;27;38;135;32;102;63;100;40;107;10;133;122;90;191;125;51;118;74;85;134;6;188;65;169;132;13;70;3;15;145;195;168;11;138;33,8591602838285507136,0.047000
steepest_intra:edges_start:random,106,50315,21928,28387,2018250,134,67;120;51;118;134;139;11;182;138;33;160;144;104;8;87;82;111;35;109;0;29;168;195;13;132;169;188;70;3;15;155;152;28;140;183;34;55;18;62;143;159;106;124;128;95;130;99;185;86;166;194;176;113;114;137;127;165;89;103;26;163;153;81;77;97;141;91;36;61;21;177;78;175;5;25;158;121;73;136;80;190;193;31;54;117;198;156;1;135;102;63;40;107;133;122;90;191;147;6;71,6363450499457333052,0.045000
steepest_intra:edges_start:random,107,48449,20289,28160,1823900,121,29;111;82;87;21;8;104;160;33;138;11;139;168;195;13;145;3;70;169;188;147;191;90;125;51;118;25;158;116;121;112;131;122;133;107;40;100;63;102;135;38;27;1;198;117;193;31;54;73;190;80;175;78;142;45;5;36;61;141;77;153;163;113;176;194;166;86;185;95;183;140;9;130;99;22;179;66;94;154;47;148;60;20;59;28;149;4;152;170;34;55;18;62;128;124;106;143;35;109;0,3846973721402214810,0.039000
steepest_intra:edges_start:random,108,48686,20817,27869,1838850,122,47;94;179;185;166;194;176;113;103;89;163;187;153;77;141;82;8;104;160;33;138;11;139;74;118;25;177;5;78;175;45;80;190;73;54;31;193;117;198;156;24;1;135;32;102;63;40;107;10;133;44;122;90;125;131;121;51;147;134;6;188;169;132;70;3;15;145;195;168;29;0;35;109;69;189;155;184;152;170;34;55;18;83;62;143;159;106;124;128;86;95;183;140;4;149;28;59;20;60;148,6356063019963859878,0.042004
steepest_intra:edges_start:random,109,46992,20535,26457,2048150,136,125;90;191;71;147;134;6;188;169;132;168;195;145;15;70;3;155;152;34;55;18;62;183;140;28;20;60;148;47;94;66;172;52;179;22;99;130;95;185;86;166;194;176;113;103;89;127;187;153;163;106;124;159;143;35;109;0;29;111;144;160;33;138;104;8;82;77;141;91;61;36;5;78;175;45;80;190;193;31;73;54;117;198;156;24;1;16;27;38;63;100;40;107;133;122;135;131;112;121;51,5886612302948717659,0.046000
steepest_intra:edges_start:random,110,46924,20325,26599,2018250,134,140;183;152;34;55;18;62;124;106;159;143;35;109;0;29;49;11;139;168;195;145;15;3;70;13;132;169;188;6;147;134;118;51;191;90;133;107;40;100;63;135;122;125;121;131;1;198;117;31;190;80;45;142;175;78;5;177;36;61;91;141;97;77;82;21;8;56;104;138;33;160;144;111;81;153;146;187;163;165;127;89;103;113;180;176;88;194;166;86;185;95;130;99;179;66;94;47;148;60;20,5218228992329777055,0.046619
steepest_intra:edges_start:random,111,46392,21157,25235,2122900,141,128;83;183;140;4;149;28;20;60;148;47;94;99;130;95;86;185;179;172;52;166;194;176;113;103;89;163;187;153;81;77;141;61;36;177;21;82;8;104;138;33;160;111;35;109;0;29;11;139;134;51;121;25;5;78;175;80;190;136;73;54;31;193;117;198;1;27;38;63;135;122;133;10;90;191;147;6;188;169;132;13;195;168;145;15;70;3;189;155;184;152;170;34;55;18;62;124;143;159;106,8815642505280651373,0.047972
steepest_intra:edges_start:random,112,48877,21816,27061,1913600,127,183;130;95;128;62;18;55;34;170;152;184;155;3;70;188;169;195;168;29;0;109;35;143;124;106;153;81;97;77;82;8;104;56;111;144;160;33;138;11;139;134;147;51;191;90;10;133;122;100;107;40;63;135;1;198;117;193;190;80;136;73;164;31;54;151;19;112;121;25;177;36;61;91;141;187;165;137;114;127;89;163;103;113;176;194;166;86;185;99;22;179;94;47;148;20;28;149;4;199;140,1932995715205633541,0.043008
steepest_intra:edges_start:random,113,48044,21487,26557,2122900,141,194;176;113;103;127;89;163;106;124;143;153;81;77;97;141;91;36;61;21;82;8;177;25;158;121;5;78;175;80;190;193;31;73;54;117;198;156;1;16;27;38;135;102;63;40;107;133;122;90;191;71;147;51;118;74;182;138;33;11;139;43;134;6;188;169;132;70;3;15;145;13;195;168;29;0;109;35;62;18;55;34;152;183;140;28;20;23;60;148;47;154;94;66;172;179;185;130;95;86;166,1996898131245457814,0.045987
steepest_intra:edges_start:random,114,47787,20927,26860,1973400,131,51;125;121;112;131;90;191;71;147;10;133;107;40;63;96;122;135;1;156;198;117;193;31;54;73;136;190;80;175;78;5;177;36;61;91;141;77;81;97;146;187;153;163;165;127;89;103;113;180;176;194;166;86;95;130;185;179;66;94;47;148;60;20;28;140;183;152;170;34;55;18;83;62;128;124;106;111;8;138;11;33;29;0;35;109;155;3;70;15;145;195;168;132;169;188;6;134;74;118;98,5490509852339579618,0.043001
steepest_intra:edges_start:random,115,48807,22242,26565,2048150,136,45;142;175;78;5;177;36;61;91;21;82;8;104;144;111;50;77;141;97;187;163;89;127;103;113;194;176;180;153;81;143;106;124;128;86;166;185;95;130;99;22;179;94;47;148;60;20;28;140;183;62;18;55;34;35;109;0;29;145;3;70;188;169;132;195;168;33;138;11;139;134;147;71;51;191;90;122;133;10;107;40;63;135;38;27;1;156;198;117;193;151;121;112;54;31;164;73;136;190;80,6941994141886561000,0.045000
steepest_intra:edges_start:random,116,50129,22954,27175,1943500,129,99;185;166;76;75;137;187;77;141;36;177;5;78;175;80;190;136;73;164;31;54;193;117;198;151;112;121;131;1;27;38;63;135;122;100;40;107;133;10;147;71;191;90;51;118;134;6;188;169;132;195;168;139;182;138;11;33;160;29;152;34;55;18;62;124;106;143;35;109;0;144;56;104;8;82;111;81;153;163;103;89;127;114;113;176;194;86;95;183;140;149;28;20;23;60;148;47;94;179;22,5423012754548805767,0.042000
steepest_intra:edges_start:random,117,46934,21291,25643,2093000,139,40;107;122;90;191;147;6;188;169;132;13;195;168;145;15;70;3;155;184;152;55;18;62;143;106;124;128;86;185;130;95;183;140;149;28;20;148;47;94;66;179;166;194;176;180;113;26;114;137;127;89;103;163;165;187;153;77;141;61;36;78;175;142;5;177;21;82;8;104;111;35;109;0;29;160;33;11;139;138;182;74;118;51;125;121;54;31;190;80;117;198;156;1;16;27;38;131;135;102;63,2353727903603299473,0.046000
steepest_intra:edges_start:random,118,48683,22125,26558,2212600,147,113;180;176;194;166;179;94;47;148;130;95;185;86;106;124;62;18;55;34;183;199;20;28;149;140;152;170;184;155;3;70;15;145;13;132;169;195;168;11;138;33;29;0;109;35;111;144;104;8;21;177;5;45;136;73;31;54;112;121;131;90;191;51;118;134;147;133;107;40;100;122;135;63;102;38;27;16;1;24;156;198;117;193;190;80;162;175;78;36;141;77;81;153;163;165;127;137;114;89;103,3289832037323343472,0.048508
steepest_intra:edges_start:random,119,49834,20588,29246,2048150,136,34;55;18;62;128;124;106;153;187;163;89;127;103;113;176;194;166;86;95;130;99;22;185;179;66;94;154;47;148;60;20;28;140;183;152;155;3;70;145;168;195;13;132;169;65;188;6;147;122;135;63;102;38;27;16;1;156;42;30;198;24;131;90;191;51;121;112;151;117;193;31;54;164;73;136;190;80;175;78;5;177;25;118;74;85;134;139;11;33;104;8;82;77;81;41;111;29;0;109;35,4209709427158405089,0.044003
steepest_intra:edges_start:random,120,48084,22854,25230,2003300,133,111;77;153;146;187;165;163;89;127;137;114;103;113;176;194;166;86;185;179;22;99;130;95;106;124;62;18;55;34;183;140;47;148;20;28;149;4;152;155;3;70;145;168;195;13;132;169;188;6;134;147;51;125;191;90;122;133;10;107;40;63;135;38;27;1;131;121;112;19;73;31;54;117;198;193;190;80;45;142;175;78;5;177;25;104;21;61;36;91;141;82;8;33;138;139;11;29;0;109;35,5235412357639881143,0.043329
steepest_intra:edges_start:random,121,48869,21401,27468,1973400,131,176;180;103;163;89;127;114;113;194;166;179;94;47;148;20;28;140;183;34;170;152;184;155;189;3;70;15;145;168;195;13;132;169;188;147;10;133;107;40;100;63;102;32;135;122;90;191;51;131;1;38;27;156;198;117;193;80;190;73;31;54;121;25;182;139;11;138;33;104;8;21;177;36;61;79;91;141;97;77;81;111;144;160;49;29;0;109;35;143;159;106;124;62;83;18;55;95;130;185;86,8417677688929337891,0.044450
steepest_intra:edges_start:random,122,45995,20118,25877,2152800,143,156;1;16;27;38;135;63;40;107;122;44;133;10;147;191;90;51;121;158;25;182;138;33;11;139;43;134;6;188;169;132;13;195;168;145;15;70;3;155;152;34;55;18;62;124;106;128;86;185;99;130;95;183;140;20;60;148;47;94;179;166;194;176;180;113;103;89;127;165;163;153;81;77;111;35;109;0;29;160;144;104;8;82;21;61;36;177;5;78;175;80;190;136;73;164;31;54;193;117;198,104141835878898862,0.048004
steepest_intra:edges_start:random,123,47804,22775,25029,1943500,129,158;121;51;191;90;122;135;63;100;40;107;133;10;147;6;188;169;134;139;168;195;13;132;145;15;70;3;155;109;35;0;29;160;33;8;111;143;106;124;128;62;18;55;34;152;95;130;183;140;4;149;28;20;60;148;47;94;66;179;99;185;86;166;194;88;176;180;113;26;114;137;127;89;103;163;187;153;77;141;91;61;36;78;175;80;190;193;198;156;1;117;54;31;73;5;177;138;11;182;25,2795557411774721477,0.042997
steepest_intra:edges_start:random,124,46647,20228,26419,1853800,123,144;104;8;111;39;29;0;109;35;143;106;124;62;18;34;55;95;86;185;183;140;149;28;20;148;47;94;99;22;179;166;194;176;180;113;26;103;114;137;127;89;163;187;153;81;77;141;36;177;5;78;175;45;162;80;190;73;54;31;193;117;198;156;24;1;27;38;135;63;100;40;107;133;122;131;121;51;90;147;6;188;169;132;161;70;3;155;15;145;13;126;195;168;43;139;11;182;138;33;160,2653361122219867134,0.041968
steepest_intra:edges_start:random,125,46834,20492,26342,2063100,137,88;176;180;113;114;127;165;89;103;163;187;153;81;77;141;91;61;36;177;5;78;175;142;45;80;190;136;73;164;54;31;193;117;198;1;16;27;38;63;135;131;19;112;121;51;90;122;133;10;147;134;139;11;138;33;160;104;8;82;111;35;109;0;29;168;169;188;70;3;15;145;155;152;183;140;4;149;28;20;148;47;94;66;172;179;22;99;185;130;95;55;34;18;62;124;143;106;86;166;194,3018521927774703933,0.046001
steepest_intra:edges_start:random,126,47990,20481,27509,2033200,135,163;153;111;8;77;141;91;61;36;177;5;78;175;142;45;162;80;190;136;73;164;54;31;193;117;198;156;24;1;135;102;63;40;107;100;122;133;10;147;71;120;51;191;90;131;121;158;25;138;33;11;139;168;195;13;132;169;6;188;70;3;15;145;29;0;109;35;143;106;124;86;185;130;95;62;18;55;34;152;183;140;28;20;148;47;94;66;99;179;172;166;194;88;176;180;113;114;127;89;103,6397337874156749196,0.045030
steepest_intra:edges_start:random,127,48278,21569,26709,2048150,136,55;18;62;124;106;143;81;153;187;163;89;127;114;103;113;176;194;166;86;95;130;185;179;94;47;148;60;20;28;149;4;199;140;183;152;170;184;155;3;70;13;132;169;188;6;134;85;147;115;178;10;133;191;90;125;51;98;118;121;131;135;122;107;40;63;38;1;117;54;31;190;80;175;36;61;141;77;82;8;104;56;144;111;35;109;0;29;160;33;138;182;11;139;43;168;195;145;15;189;34,5029109178425601935,0.045002
steepest_intra:edges_start:random,128,48347,21959,26388,1973400,131,136;73;164;31;54;151;19;112;121;25;177;36;61;91;21;82;8;104;138;182;74;118;85;134;139;11;33;160;144;56;111;29;0;109;35;124;106;143;81;77;141;153;163;89;103;113;180;176;194;166;86;185;179;94;47;148;20;28;140;183;62;18;55;34;152;155;3;70;15;145;168;195;13;132;169;188;6;147;51;191;90;122;107;40;63;135;131;38;27;16;1;198;117;193;190;80;175;78;5;45,7416975802680657813,0.043968
steepest_intra:edges_start:random,129,48472,21150,27322,1943500,129,168;169;188;6;134;74;118;98;51;125;90;191;147;178;10;133;122;135;63;38;27;16;131;121;1;156;198;117;54;31;193;190;80;175;5;177;36;61;141;97;77;153;81;111;82;21;8;144;104;138;139;11;33;160;29;0;109;35;143;159;106;124;62;18;34;55;83;95;130;99;185;86;176;180;103;163;89;127;114;113;194;166;94;47;148;20;28;149;4;140;183;174;152;170;184;155;3;70;145;195,812260034665354408,0.043032
steepest_intra:edges_start:random,130,47166,20581,26585,2167750,144,12;0;109;35;143;106;124;62;18;183;140;28;20;60;148;47;94;66;179;185;130;95;86;166;194;176;180;113;114;103;89;127;165;163;187;146;153;81;77;141;91;61;36;175;78;5;177;21;87;82;8;104;56;111;144;160;33;138;11;139;134;51;90;131;121;73;136;80;190;193;31;54;117;198;156;24;1;27;38;102;63;135;122;100;40;107;133;10;147;188;169;132;13;70;3;15;145;195;168;29,8027261288567217751,0.048000
steepest_intra:edges_start:random,131,50018,20814,29204,1958450,130,153;163;89;103;113;176;194;166;86;185;94;47;148;20;28;149;4;140;183;152;184;155;3;70;15;145;13;132;169;188;6;147;178;10;133;72;107;40;100;63;122;135;38;1;156;198;117;193;80;190;73;164;31;54;121;131;90;191;51;118;74;134;43;168;195;29;12;0;109;35;34;18;62;124;106;143;159;119;41;111;8;104;56;144;160;33;49;11;139;138;177;36;61;91;21;87;82;141;77;81,2273079577512220737,0.043585
steepest_intra:edges_start:random,132,47674,21104,26570,2302300,153,0;109;35;111;81;77;97;146;187;153;143;34;55;18;62;124;106;176;180;113;103;163;89;127;114;194;166;86;95;185;179;66;94;47;148;60;20;28;149;4;199;140;183;152;184;155;3;70;145;168;195;13;132;169;188;6;192;147;134;74;118;98;51;121;131;90;10;133;122;135;63;38;27;1;117;31;190;80;175;78;142;5;177;36;61;91;141;21;87;82;8;104;56;144;160;33;138;139;11;29,3049767030601381591,0.050645
steepest_intra:edges_start:random,133,47517,21655,25862,2107950,140,130;95;185;86;128;18;55;34;62;124;106;143;153;163;103;26;113;176;166;194;114;127;89;165;187;81;77;141;91;61;36;177;5;175;80;190;31;54;117;198;156;1;135;63;100;40;107;72;10;133;122;131;121;116;118;98;51;90;191;147;6;188;169;134;182;138;33;160;144;104;8;111;35;109;0;12;29;11;139;168;195;13;132;145;15;70;3;155;184;152;183;140;28;20;60;148;47;94;179;99,6019346104336911802,0.046002
steepest_intra:edges_start:random,134,49462,21730,27732,2078050,138,112;121;90;191;51;134;168;195;145;15;189;155;3;70;132;169;188;6;147;10;133;44;122;63;135;131;1;16;38;27;42;156;198;117;54;31;193;190;80;175;78;36;141;77;81;153;163;103;113;176;166;86;128;83;55;174;140;183;95;130;99;185;179;66;94;47;148;20;28;149;152;34;18;62;124;106;143;35;109;0;12;29;11;139;138;33;160;144;56;104;8;111;82;21;177;5;45;136;73;19,7356732180858999909,0.045033
steepest_intra:edges_start:random,135,47683,21690,25993,2078050,138,154;94;66;172;179;22;99;130;95;185;86;166;194;176;180;113;26;114;137;127;165;89;103;163;187;153;106;124;62;18;55;34;143;77;141;91;36;61;21;177;5;78;175;80;190;73;54;31;193;117;198;156;1;38;63;40;107;133;122;135;131;121;112;158;25;74;118;98;51;90;191;147;6;188;169;132;195;168;139;11;138;104;8;33;160;0;35;109;29;145;3;155;152;183;140;28;20;60;148;47,8973412786362914604,0.046997
steepest_intra:edges_start:random,136,48260,20178,28082,2107950,140,20;28;140;183;95;130;185;86;128;62;18;55;34;152;184;155;3;70;15;145;195;168;132;169;188;6;147;10;133;122;135;1;156;198;117;31;193;105;190;80;162;175;78;142;5;45;136;73;164;54;19;112;121;131;90;191;51;118;134;139;11;33;138;182;25;177;36;61;141;97;77;8;104;144;160;29;0;109;35;143;124;106;163;103;89;127;137;114;113;180;176;88;194;166;172;179;66;94;47;148,9219844110986805977,0.047002
steepest_intra:edges_start:random,137,49231,21839,27392,2107950,140,89;127;137;114;103;26;113;180;176;194;166;86;185;94;47;148;60;20;28;140;183;152;3;70;188;169;195;168;11;139;134;147;51;191;90;133;107;40;100;122;135;32;63;102;38;27;16;156;1;131;121;112;19;73;31;54;117;193;190;80;175;78;142;45;5;177;25;138;33;160;144;104;8;82;87;21;61;36;91;141;77;81;41;111;39;29;0;109;35;34;55;18;62;124;106;143;153;146;187;163,3543617139760946568,0.050001
steepest_intra:edges_start:random,138,48388,21511,26877,2018250,134,28;149;140;183;152;155;3;70;188;169;132;13;145;195;168;29;109;35;0;160;144;111;8;104;33;11;139;138;25;121;131;125;90;191;51;71;147;133;107;40;63;96;122;135;32;102;92;38;27;16;1;198;117;193;31;54;164;73;136;190;80;175;78;5;177;36;61;91;141;77;97;187;163;89;103;113;194;166;176;153;81;159;143;106;124;62;18;55;95;130;99;185;86;179;66;94;47;148;60;20,4730529628801673859,0.044000
steepest_intra:edges_start:random,139,46896,20723,26173,2003300,133,183;140;4;149;28;20;60;148;47;94;66;179;99;130;95;185;86;166;194;176;113;103;114;137;127;89;163;153;81;77;97;141;36;61;21;87;82;8;104;111;144;160;33;138;25;177;5;78;175;80;190;73;164;54;31;193;117;198;42;156;24;1;135;63;40;107;122;133;10;178;147;51;90;131;112;121;98;118;134;6;188;169;70;3;15;145;13;195;168;29;0;109;35;143;106;124;62;18;55;34,4168954990157083576,0.044998
steepest_intra:edges_start:random,140,47085,21024,26061,2003300,133,193;117;198;1;27;38;102;63;135;131;19;112;121;51;191;90;122;100;40;107;133;10;147;6;188;169;132;13;195;168;145;15;70;3;155;152;149;28;20;60;47;148;140;183;95;99;22;179;185;86;166;176;113;103;127;89;163;187;153;97;141;77;81;143;106;124;128;62;83;18;55;34;35;109;0;29;160;33;11;138;104;8;82;21;91;61;36;177;5;78;175;142;45;162;80;190;136;73;54;31,6220166262849778187,0.044000
steepest_intra:edges_start:random,141,47352,21606,25746,2018250,134,176;194;166;86;106;159;143;124;62;18;34;55;95;130;99;22;185;179;94;47;148;60;20;28;140;183;152;184;155;3;70;145;195;168;132;169;188;6;147;90;122;133;107;40;63;135;38;27;1;156;198;117;193;190;80;136;73;164;31;54;151;19;112;121;131;51;118;134;139;11;29;109;35;0;160;33;138;104;8;56;144;111;82;21;177;5;142;175;78;36;141;77;81;153;187;163;89;103;113;180,4756144133889086942,0.044004
steepest_intra:edges_start:random,142,49462,22497,26965,1868750,124,103;113;153;143;106;176;194;166;86;95;130;185;179;94;47;148;60;20;28;140;183;174;128;124;62;83;18;55;34;170;152;184;155;3;70;161;15;145;195;13;132;169;188;6;147;10;133;122;135;63;102;38;27;16;1;156;198;117;193;190;80;31;54;131;125;90;191;51;98;118;116;121;158;25;5;175;78;177;21;8;104;160;33;138;182;11;139;168;29;0;109;35;111;81;77;141;187;163;89;127,1556044369335676824,0.040962
steepest_intra:edges_start:random,143,49619,22903,26716,1898650,126,180;163;153;106;86;185;99;22;179;172;66;94;47;148;60;20;28;149;4;140;183;152;170;184;155;3;70;188;6;169;132;13;195;168;145;34;18;62;124;143;159;81;77;82;8;104;160;144;111;35;109;0;12;29;49;33;138;11;139;134;51;147;10;133;44;122;63;135;1;131;90;125;121;112;198;117;54;73;31;193;190;80;45;175;78;5;177;21;61;36;141;187;165;127;89;103;113;194;166;176,8973767277658149153,0.043002
steepest_intra:edges_start:random,144,49629,19339,30290,1943500,129,25;177;5;45;142;175;78;36;21;8;82;77;153;163;103;113;176;86;95;130;185;179;66;94;47;148;60;20;59;28;149;4;140;199;9;183;152;170;34;55;18;62;124;106;143;35;109;0;29;33;138;11;168;195;13;145;15;189;184;155;3;70;161;132;169;188;6;147;71;120;51;125;90;191;178;115;10;133;44;122;135;63;38;27;16;1;156;198;117;193;105;190;80;136;73;164;31;54;112;121,1584149168779930777,0.046033
steepest_intra:edges_start:random,145,48658,20665,27993,1958450,130,55;95;130;99;185;86;179;94;47;148;20;28;140;183;152;184;155;3;70;15;145;168;195;13;132;169;65;188;6;147;191;90;131;135;122;40;63;38;27;16;1;198;117;193;54;31;164;73;136;190;80;162;45;173;112;121;51;134;43;139;11;182;138;33;104;8;56;144;160;29;12;0;109;35;111;82;87;21;177;5;142;175;78;36;61;141;97;77;81;153;163;89;103;113;194;176;106;124;62;18,4792830945673911839,0.043005
steepest_intra:edges_start:random,146,47880,20561,27319,2048150,136,77;81;153;163;89;127;114;103;113;194;88;180;176;106;143;124;128;86;166;52;172;179;22;185;95;99;94;47;148;20;28;149;4;140;183;83;62;18;55;34;170;152;184;155;3;70;15;145;195;168;169;188;6;147;191;90;51;121;131;135;122;40;63;38;27;1;198;117;151;54;31;193;164;73;136;190;80;162;45;142;175;78;5;177;8;144;104;138;182;139;11;33;160;29;0;109;35;111;82;141,3857116308224824523,0.046554
steepest_intra:edges_start:random,147,49274,21579,27695,1988350,132,124;143;159;106;176;180;113;26;103;163;89;165;127;114;194;166;52;172;179;86;185;22;99;130;95;183;199;9;148;47;94;60;20;28;149;140;152;184;155;3;70;132;169;188;6;134;147;51;90;10;133;122;135;1;198;117;54;73;31;193;190;80;175;78;142;45;5;25;104;144;8;21;177;36;61;91;141;77;153;81;111;35;109;0;12;29;160;33;138;11;168;195;13;145;34;55;18;83;62;128,5353983160340942975,0.045002
steepest_intra:edges_start:random,148,48469,21645,26824,2063100,137,188;6;134;51;125;90;191;147;178;10;133;107;40;63;135;122;131;38;27;16;1;117;193;31;54;73;121;118;74;139;11;182;138;33;56;104;8;87;21;177;5;142;175;78;36;61;141;82;111;144;160;29;0;109;35;143;159;81;77;97;153;163;89;127;103;113;180;176;194;166;179;94;47;148;60;20;140;183;95;130;99;185;86;106;124;62;18;55;34;170;152;184;155;3;70;15;145;195;168;169,1826510735768228723,0.044996
steepest_intra:edges_start:random,149,49374,21648,27726,1973400,131,179;185;95;18;62;124;106;128;86;166;194;176;180;113;114;103;163;89;127;165;187;153;97;141;77;81;111;35;109;0;29;144;8;82;87;21;61;36;5;78;175;142;45;80;190;136;73;193;31;54;112;121;131;117;198;156;24;1;135;63;122;133;10;178;147;71;191;90;125;51;98;118;74;25;177;104;160;33;138;11;168;195;6;188;169;132;13;145;15;70;3;155;152;183;140;149;28;20;148;94,6188329166643208427,0.044002
steepest_intra:edges_start:random,150,47355,19775,27580,2152800,143,113;176;194;166;86;185;95;130;99;22;179;66;94;47;148;20;140;183;152;34;55;18;83;62;124;106;159;143;35;109;0;29;168;195;13;145;15;3;70;132;169;188;139;11;33;138;25;121;135;122;90;191;51;120;71;147;178;10;133;72;107;40;100;63;38;27;1;24;156;198;117;193;31;54;164;73;136;190;80;162;175;78;142;45;5;177;36;61;21;8;82;141;77;81;153;163;89;127;114;103,2454489251507699082,0.047999
steepest_intra:edges_start:random,151,48272,20054,28218,2048150,136,0;29;111;144;104;160;33;138;182;11;139;168;195;145;15;3;70;161;188;6;169;132;13;126;43;134;147;71;120;191;90;125;51;121;112;131;122;133;10;72;107;40;63;102;135;38;27;16;1;198;117;54;73;31;193;190;80;175;78;5;177;21;8;82;141;97;77;153;163;103;89;165;127;137;114;26;113;180;176;194;166;86;185;179;94;47;148;20;28;140;183;55;18;62;128;124;106;143;35;109,6113456251842496686,0.045082
steepest_intra:edges_start:random,152,48117,19791,28326,2003300,133,143;106;124;62;18;55;34;170;152;183;140;20;148;94;179;185;130;95;86;166;194;176;180;113;103;127;89;163;153;187;141;91;61;36;177;5;45;142;78;175;162;80;190;105;136;73;164;54;31;193;117;198;42;156;24;1;16;27;38;63;135;131;121;51;191;90;122;133;10;178;147;6;188;169;70;3;145;195;168;134;74;182;139;11;138;33;160;29;12;0;109;35;111;144;104;8;82;77;81;159,8316978567659620933,0.044002
steepest_intra:edges_start:random,153,47390,19729,27661,2003300,133,113;26;114;137;127;103;163;89;165;187;153;77;111;35;109;0;29;160;33;11;139;138;104;8;21;177;5;78;175;45;80;190;136;73;164;54;31;193;42;16;27;38;1;156;198;117;151;19;112;121;131;135;63;122;133;10;90;51;71;147;6;188;169;132;13;195;168;145;15;161;70;3;155;184;152;170;34;143;159;106;124;62;18;55;183;140;4;149;28;20;148;47;94;179;185;86;166;194;176;180,5975663468068210349,0.044965
steepest_intra:edges_start:random,154,47423,20573,26850,2242500,149,29;160;144;33;49;11;139;168;195;145;15;3;70;13;132;169;188;147;178;10;133;122;107;40;63;102;32;135;38;1;156;198;117;193;54;31;164;73;136;190;80;175;5;25;158;121;131;90;191;51;118;182;138;104;8;82;87;21;177;36;61;91;141;77;153;163;103;89;127;114;113;176;194;166;86;185;179;94;47;148;20;28;140;183;152;170;34;55;18;62;128;124;106;143;159;81;111;35;109;0,2244438814719722303,0.051024
steepest_intra:edges_start:random,155,49444,22729,26715,1838850,122,111;160;33;11;168;195;132;169;188;6;147;191;90;122;40;63;135;131;121;51;134;43;139;138;104;8;82;21;177;25;1;16;38;27;156;198;117;193;31;54;73;136;190;80;45;142;175;78;5;36;61;91;141;77;153;163;103;89;165;127;137;75;114;26;113;180;176;88;194;166;86;185;95;130;99;22;179;66;94;47;148;20;28;149;4;140;183;55;18;34;155;3;29;0;109;35;62;124;106;143,8350622975039606370,0.040876
steepest_intra:edges_start:random,156,48080,21450,26630,1973400,131,198;156;1;38;63;40;107;133;122;135;131;90;147;188;169;132;70;3;15;145;13;195;168;139;11;33;160;29;0;109;35;111;77;81;153;159;143;106;124;128;62;18;55;34;152;95;130;183;140;4;149;28;20;60;148;47;154;94;66;172;179;22;99;185;86;166;176;113;163;187;97;141;91;61;36;175;78;5;177;21;82;8;104;138;182;118;51;121;112;19;151;54;31;164;73;136;80;190;193;117,2824426122381955795,0.044000
steepest_intra:edges_start:random,157,48937,21368,27569,2018250,134,6;147;71;191;90;122;178;115;10;133;107;40;100;63;102;135;38;27;16;1;131;121;125;51;118;74;25;54;31;117;198;193;190;80;175;5;177;21;8;104;144;111;82;141;77;81;153;163;89;127;137;114;103;26;113;180;176;194;166;86;95;130;185;179;172;66;94;47;148;60;20;28;149;140;183;152;34;55;18;62;128;124;106;119;159;143;35;109;0;29;160;33;138;11;168;145;3;70;169;188,1236771089681042136,0.043508
steepest_intra:edges_start:random,158,48412,21475,26937,2078050,138,73;5;175;80;190;193;117;198;156;24;1;16;27;38;131;135;32;96;102;63;40;107;122;90;191;147;188;169;195;168;139;11;138;33;160;144;56;104;8;111;29;0;109;35;143;106;124;62;18;55;34;170;189;145;15;70;3;155;184;53;152;183;140;28;20;148;47;94;66;179;185;95;86;166;194;176;180;113;103;114;137;127;89;163;187;153;81;77;141;61;36;177;25;118;51;121;112;19;54;31,7388505289707363410,0.046001
steepest_intra:edges_start:random,159,47641,21515,26126,2048150,136,117;54;31;164;73;177;25;158;121;131;1;156;16;27;38;135;102;63;40;107;100;122;133;10;178;90;191;51;147;6;188;169;70;3;145;13;195;168;43;139;11;182;138;33;29;109;35;0;160;104;8;111;143;159;106;124;62;18;34;55;95;130;99;183;140;149;28;20;60;148;47;94;179;185;86;166;194;176;180;113;103;114;127;89;163;153;81;77;141;82;21;61;36;5;78;175;80;190;193;198,8067779567604253350,0.044999
steepest_intra:edges_start:random,160,47450,19873,27577,2018250,134,184;155;189;109;35;0;29;39;160;33;49;138;182;11;139;168;195;13;145;15;3;70;161;132;169;188;6;147;51;90;122;133;10;72;107;40;100;63;135;38;27;1;198;117;54;73;31;193;190;80;5;177;36;61;91;141;77;82;21;8;104;144;111;143;106;124;128;62;34;55;18;83;181;95;130;99;185;86;176;180;163;89;127;103;113;194;166;172;179;66;94;47;148;60;20;28;149;140;183;152,5508560203305237158,0.043001
steepest_intra:edges_start:random,161,47301,20947,26354,1913600,127,20;28;149;4;199;140;183;62;18;55;34;170;152;53;184;155;189;3;70;15;145;168;195;13;132;169;188;147;10;133;107;40;63;135;122;90;191;51;121;1;156;198;117;54;31;193;190;80;45;175;78;5;177;36;141;77;153;81;111;8;138;182;74;134;139;11;33;160;29;0;109;35;143;106;124;128;176;113;103;163;89;127;114;194;166;86;185;95;130;99;22;179;172;66;94;154;47;148;60;23,218372528417246587,0.041999
steepest_intra:edges_start:random,162,48444,21449,26995,1943500,129,166;194;176;113;103;127;89;163;153;81;77;141;91;61;36;177;21;8;104;56;144;111;35;109;0;29;160;33;11;139;138;182;25;112;19;54;31;164;73;136;5;78;175;142;45;80;190;193;117;198;156;24;1;38;131;121;51;125;191;90;122;135;63;100;40;107;72;133;10;178;147;188;169;132;13;195;168;145;15;70;3;152;149;28;20;140;183;55;18;62;124;106;86;185;148;60;47;94;66;179,1777142279209519163,0.044000
steepest_intra:edges_start:random,163,45903,19865,26038,2107950,140,16;1;156;198;117;193;31;54;73;136;190;80;175;78;5;36;61;79;91;141;77;81;153;163;89;165;127;137;114;103;113;180;176;194;166;86;95;185;179;66;94;47;148;60;20;28;149;140;183;152;34;55;18;62;124;106;143;35;109;0;29;11;139;138;33;160;104;8;82;87;21;177;121;131;90;191;51;118;134;168;195;13;145;15;3;70;132;169;188;6;147;10;133;122;135;32;63;102;38;27,3758807874402875491,0.046001
steepest_intra:edges_start:random,164,47273,22171,25102,1958450,130,168;195;13;145;15;189;184;155;3;70;132;169;188;6;147;133;122;100;107;40;63;135;38;1;198;117;193;31;54;73;136;190;80;162;175;78;142;45;5;177;36;61;141;77;81;153;163;103;89;127;137;114;113;180;176;88;194;166;52;172;179;94;47;148;60;20;28;140;152;170;183;95;130;185;86;55;34;18;62;124;106;143;111;8;35;109;0;29;160;33;11;139;138;25;121;131;90;51;118;134,7498662881729817906,0.042999
steepest_intra:edges_start:random,165,49211,20182,29029,2257450,150,60;148;47;94;179;185;86;166;194;176;180;113;103;127;89;163;153;106;124;35;109;0;29;160;33;11;139;182;138;104;56;144;111;8;82;87;21;61;36;177;25;74;118;51;191;90;125;131;121;5;45;142;78;175;162;80;190;136;73;54;31;193;117;198;156;24;1;16;27;38;102;63;32;135;122;100;40;107;133;147;6;188;65;169;132;13;126;168;195;145;15;70;3;155;152;55;18;62;183;20,8604276311006994789,0.050001
steepest_intra:edges_start:random,166,49049,20760,28289,1823900,121,177;25;118;98;51;90;121;5;78;175;142;45;80;190;193;31;54;117;198;156;24;1;197;16;27;38;102;63;32;135;122;133;10;147;188;169;195;168;139;11;182;138;104;8;144;160;33;49;29;0;35;109;145;70;3;155;184;152;170;34;55;18;62;86;185;95;183;140;149;28;20;148;47;94;66;99;179;172;166;194;176;180;113;103;127;89;163;106;124;143;159;119;153;81;77;141;91;36;61;21,893098968996669846,0.040000
steepest_intra:edges_start:random,167,48081,21839,26242,2302300,153,36;61;91;141;77;81;153;143;124;106;163;103;113;176;194;166;172;179;66;94;47;148;20;28;140;183;130;99;185;86;95;62;18;55;34;152;184;155;189;145;15;3;70;188;169;132;13;195;168;29;0;109;35;111;144;160;33;104;8;21;177;123;25;138;11;139;134;147;71;51;191;90;133;107;40;63;135;122;125;121;131;38;27;16;1;198;117;54;73;164;31;193;190;80;162;175;78;142;45;5,3999667027438240583,0.051000
steepest_intra:edges_start:random,168,48049,21188,26861,2018250,134,0;29;168;195;145;13;132;169;188;70;3;155;152;34;55;183;140;149;28;20;148;94;179;185;130;95;86;166;194;114;137;127;89;163;103;26;113;176;106;124;62;18;143;159;153;81;77;82;21;141;91;79;61;36;177;5;142;78;175;80;190;73;54;31;193;117;198;156;1;16;27;38;102;63;40;122;135;131;121;90;191;71;147;51;98;118;74;182;138;139;11;33;160;144;56;104;8;111;35;109,3227133665693647096,0.047001
steepest_intra:edges_start:random,169,49226,22175,27051,1853800,123,78;5;36;141;77;81;153;106;124;128;110;86;176;180;113;103;163;89;127;114;194;166;52;172;179;66;94;47;60;20;148;185;130;95;183;9;199;28;140;152;170;34;55;18;83;62;35;109;0;29;189;155;3;70;15;145;13;195;168;169;188;139;11;138;33;160;144;56;104;8;111;82;21;177;121;51;90;133;107;40;63;135;122;131;38;27;16;1;24;156;198;117;54;73;164;31;193;190;80;175,3459899363095902017,0.041614
steepest_intra:edges_start:random,170,47061,20930,26131,2033200,135,154;94;66;172;179;185;86;130;95;55;34;18;62;128;124;106;166;194;176;113;103;127;89;163;153;77;141;36;61;21;8;104;144;111;35;109;0;29;160;33;138;11;139;43;134;51;98;118;25;177;5;142;78;175;80;190;136;73;54;31;193;117;198;156;27;38;1;19;112;121;131;135;63;122;133;10;90;191;71;147;6;188;169;132;13;195;168;145;15;70;3;155;152;183;140;28;20;60;148;47,8888200871032649242,0.048000
steepest_intra:edges_start:random,171,48637,19334,29303,2137850,142,3;145;195;168;139;11;182;138;33;104;144;160;29;0;109;35;111;143;159;106;124;62;18;55;34;170;152;174;183;140;199;4;149;28;20;60;148;47;154;94;66;179;185;130;95;86;166;194;176;113;103;127;89;163;153;77;82;8;21;177;5;78;175;80;190;73;164;54;31;193;117;198;156;42;27;38;16;197;1;121;51;125;90;122;135;32;96;102;63;100;40;107;133;10;191;71;147;6;188;169,3443805931401505705,0.046766
steepest_intra:edges_start:random,172,47847,22279,25568,2063100,137,54;31;193;117;198;156;42;16;27;38;63;40;107;133;90;122;135;131;1;19;112;121;51;147;6;188;169;132;13;195;168;145;15;70;3;155;184;152;170;34;183;140;28;20;60;148;47;94;66;179;185;130;95;55;18;62;124;86;166;194;176;180;113;103;163;153;77;81;106;143;35;109;0;29;160;33;8;104;138;11;139;182;25;177;21;82;141;61;36;5;78;175;142;45;162;80;190;136;73;164,5331770456390363147,0.046005
steepest_intra:edges_start:random,173,46798,20263,26535,1988350,132,81;153;163;103;89;127;137;114;113;180;176;88;194;166;86;95;130;99;22;185;179;94;47;148;60;20;28;149;140;183;152;170;34;55;18;83;62;124;106;143;35;109;0;29;160;33;138;11;139;168;195;145;15;3;70;169;188;6;147;178;10;133;72;107;40;100;63;38;27;1;135;122;90;191;51;98;118;121;54;31;117;193;190;80;162;175;78;142;45;5;25;177;36;61;141;77;82;8;111;41,1511338675220034973,0.044996
steepest_intra:edges_start:random,174,46978,21334,25644,2152800,143,109;0;12;29;11;139;138;33;160;144;104;8;21;82;111;81;77;97;141;91;79;61;36;177;25;5;78;175;142;45;80;190;136;73;164;193;31;54;151;117;198;156;1;27;38;63;135;122;107;40;133;90;121;51;147;6;188;169;132;13;195;168;145;70;3;155;152;55;18;62;124;106;183;140;149;28;20;60;148;47;94;179;99;130;95;185;86;166;194;176;113;103;89;127;165;163;153;159;143;35,2888453162742769020,0.047001
steepest_intra:edges_start:random,175,47511,21202,26309,2063100,137,177;5;45;136;73;31;54;112;121;51;90;191;147;10;133;122;72;107;40;100;63;102;135;38;27;16;1;198;117;193;190;80;162;142;175;78;36;61;21;104;8;82;77;153;163;103;89;127;114;113;180;176;194;166;106;124;62;18;55;34;140;183;95;130;99;185;86;179;94;47;148;20;28;149;4;152;184;155;3;70;15;145;195;168;132;169;188;6;134;139;11;29;0;109;35;160;33;138;182;25,1369696713240915916,0.044999
steepest_intra:edges_start:random,176,48823,22085,26738,2078050,138,89;103;163;153;106;143;81;77;141;82;8;21;36;175;5;177;25;138;11;139;134;118;98;51;121;112;73;190;80;193;31;54;117;1;38;63;40;107;100;135;122;90;191;71;147;6;188;65;169;132;161;70;3;15;145;13;195;168;33;29;0;35;109;189;155;184;152;170;34;55;18;62;124;128;86;185;22;99;130;95;9;183;140;4;149;28;59;20;60;148;47;94;66;179;166;194;176;113;114;127,5999796389716768623,0.046998
steepest_intra:edges_start:random,177,49212,21669,27543,2078050,138,111;29;0;109;35;34;18;62;124;106;176;180;103;163;89;127;114;113;194;166;86;185;179;94;47;148;20;140;183;152;155;189;3;70;15;145;132;188;169;13;195;168;11;139;134;147;71;191;125;90;10;133;107;40;100;63;96;122;135;38;1;24;156;198;117;193;190;80;136;73;164;31;54;19;112;121;51;118;182;138;33;104;8;82;87;21;177;5;45;142;175;78;36;61;141;77;97;187;153;81,6864595633492863062,0.045666
steepest_intra:edges_start:random,178,48315,22309,26006,1988350,132,185;95;130;20;148;47;94;66;179;166;194;88;176;180;113;26;103;114;127;89;163;165;187;153;106;143;81;77;141;91;36;61;21;177;142;78;175;80;190;5;25;121;73;54;31;193;117;198;156;24;1;27;38;135;63;40;107;122;90;51;182;138;33;160;144;104;8;82;111;35;109;0;29;11;139;134;6;188;169;132;13;126;168;195;145;161;70;3;15;189;155;152;140;183;34;55;18;62;124;86,6665750643251623893,0.044002
steepest_intra:edges_start:random,179,48313,22026,26287,1913600,127,103;113;176;166;194;114;137;127;89;165;187;141;91;36;61;21;177;5;175;80;190;193;31;164;73;54;117;198;156;1;121;51;120;71;191;90;125;131;135;102;63;40;107;122;133;10;147;169;70;3;15;145;13;195;168;11;138;33;104;56;144;160;29;0;35;109;189;155;184;152;34;18;55;183;140;149;28;59;20;60;148;47;94;66;179;185;86;95;62;124;106;159;143;111;8;82;77;81;153;163,6389428226895753323,0.041521
steepest_intra:edges_start:random,180,48699,21891,26808,1898650,126,147;134;6;188;169;132;13;70;3;15;145;195;168;43;74;118;25;123;177;21;82;8;104;138;139;11;33;160;144;56;111;29;0;109;35;34;152;55;18;62;143;106;124;128;86;185;130;95;183;140;4;149;28;20;148;94;166;194;176;180;113;114;137;103;163;89;127;165;187;153;81;77;141;91;61;36;5;78;175;45;80;190;193;31;54;117;1;27;38;63;135;122;131;19;112;121;51;125;90;191,6495345244624711334,0.042997
steepest_intra:edges_start:random,181,48435,20919,27516,2107950,140,113;103;163;89;127;137;165;187;153;81;77;111;8;82;21;177;5;78;175;142;45;80;190;136;73;54;31;193;117;198;156;27;38;1;131;135;102;63;122;133;90;191;51;121;118;134;6;188;169;168;145;15;70;3;155;184;189;109;29;39;160;33;49;11;139;182;138;104;56;144;12;0;35;143;106;124;128;86;185;95;62;18;55;34;152;183;140;149;28;20;60;148;47;94;66;179;172;166;194;176,7830209346362330939,0.048222
steepest_intra:edges_start:random,182,49389,21524,27865,1898650,126,81;153;77;82;8;104;144;160;33;138;11;139;134;74;118;25;177;5;78;175;142;45;80;190;136;73;54;31;193;117;198;151;112;121;51;125;131;1;156;16;27;38;135;122;63;40;107;133;10;90;191;120;67;71;147;188;169;132;168;195;145;15;70;3;155;152;55;18;62;183;140;28;20;23;60;148;47;94;66;179;99;185;86;166;194;113;103;127;89;163;176;128;124;106;143;35;109;0;29;111,7970446528054433062,0.041635
steepest_intra:edges_start:random,183,49564,21605,27959,1853800,123,80;162;175;78;142;45;5;36;61;91;141;21;177;138;25;158;121;131;135;90;51;134;168;139;11;33;104;8;111;29;0;109;35;143;159;124;106;153;163;113;176;194;166;179;172;57;66;94;47;148;20;28;149;4;140;183;95;130;99;22;185;86;62;18;55;34;170;152;184;155;15;3;70;169;188;6;147;178;10;133;44;122;100;107;40;63;102;38;27;16;1;156;198;117;193;31;54;73;136;190,2836172370041780154,0.040526
steepest_intra:edges_start:random,184,47639,20695,26944,2362100,157,36;5;78;175;45;80;190;136;73;54;31;193;117;198;156;24;1;16;27;38;131;135;63;100;40;107;72;122;133;10;178;115;147;191;90;51;121;158;25;182;138;11;139;168;195;132;169;188;70;3;155;152;140;149;28;20;60;148;47;94;66;172;179;185;99;130;183;34;55;18;62;124;106;128;95;86;166;194;176;113;114;127;89;103;163;153;81;77;82;111;35;109;0;29;160;33;104;8;21;61,3110694686845083755,0.053969
steepest_intra:edges_start:random,185,46870,20134,26736,2078050,138,124;106;143;111;8;104;56;144;160;33;138;139;11;29;0;35;109;168;195;145;15;3;70;169;188;6;134;74;118;98;51;125;90;191;10;133;72;107;40;100;63;135;122;131;121;112;1;38;27;16;156;198;117;54;73;164;31;193;190;80;175;78;5;177;36;61;91;141;21;82;77;81;153;187;165;127;89;163;103;113;176;194;166;86;95;130;185;179;94;47;148;60;20;28;140;183;55;18;62;128,1731652230633658845,0.046031
steepest_intra:edges_start:random,186,47827,21219,26608,2003300,133,98;118;25;177;5;190;80;175;78;36;61;91;141;77;82;21;8;104;33;160;29;0;109;35;34;55;18;62;128;124;106;143;81;153;187;163;89;127;103;113;180;176;194;166;86;181;95;130;99;22;185;179;94;47;148;20;28;149;4;140;183;152;155;189;145;15;3;70;13;195;168;169;188;6;147;191;90;122;133;10;72;17;107;40;100;63;135;38;1;156;198;117;193;31;54;73;121;131;125;51,3180571164560161424,0.044004
steepest_intra:edges_start:random,187,48646,21365,27281,1913600,127,0;109;35;34;55;18;62;124;106;153;146;187;165;127;89;163;103;113;176;166;86;185;130;95;183;140;148;47;94;60;20;28;149;152;155;29;160;33;11;168;195;13;145;3;70;132;169;188;6;150;192;147;134;139;138;182;25;158;121;51;191;90;178;10;133;122;135;63;38;27;1;156;198;117;193;31;54;164;73;136;190;80;45;142;175;78;5;177;36;61;141;77;21;87;82;111;8;104;56;144,3393912134604130661,0.043000
steepest_intra:edges_start:random,188,48388,21509,26879,1988350,132,31;193;164;73;136;190;80;45;175;78;5;177;123;25;138;139;11;33;160;144;104;8;82;87;21;61;36;91;141;77;97;187;163;153;81;111;29;0;109;35;143;106;124;62;18;34;55;95;86;176;103;89;127;114;113;194;166;185;94;47;148;183;140;152;184;155;3;70;15;145;13;195;168;169;188;6;147;191;90;51;98;118;121;131;135;122;133;107;40;100;63;38;27;1;24;156;198;117;151;54,6724652109950956825,0.044000
steepest_intra:edges_start:random,189,48100,20676,27424,2093000,139,100;122;135;63;102;38;27;1;156;198;117;121;112;73;54;31;193;190;80;175;5;177;36;61;141;97;77;81;153;176;113;194;166;86;185;99;179;172;66;94;47;148;60;23;20;28;149;4;152;140;183;95;55;34;18;62;124;106;143;35;109;0;29;39;111;8;82;87;21;104;56;144;160;33;138;182;11;139;134;43;168;195;13;145;15;3;70;132;169;188;6;147;51;125;90;191;10;133;107;40,2121134139808676548,0.045998
steepest_intra:edges_start:random,190,48686,21540,27146,2078050,138,77;81;153;143;35;0;29;109;34;55;18;62;124;106;128;86;176;163;103;113;194;166;185;95;130;179;172;66;94;47;148;60;20;28;140;183;152;184;155;3;70;15;145;195;168;169;188;6;192;147;178;10;133;122;135;63;38;27;1;156;198;117;193;31;54;73;190;80;175;78;5;177;25;121;131;90;191;71;120;51;118;74;134;43;139;182;138;11;33;160;144;104;8;111;82;87;21;36;141;97,5897749589866860282,0.045625
steepest_intra:edges_start:random,191,47027,20683,26344,1958450,130,86;166;194;176;113;103;114;127;89;163;153;81;77;141;91;79;61;36;21;104;138;25;177;5;78;175;45;80;190;136;73;164;31;54;151;193;117;198;156;24;1;16;27;38;135;63;100;40;107;10;133;122;90;121;51;147;134;6;188;169;132;70;3;15;145;168;109;35;0;29;33;8;111;143;159;106;124;128;62;18;55;34;170;152;174;183;140;149;28;20;60;148;47;94;66;179;99;130;95;185,2312345343947947051,0.044966
steepest_intra:edges_start:random,192,48105,22037,26068,1988350,132,159;143;18;55;34;152;155;3;70;145;195;168;169;188;6;139;11;138;182;25;121;131;90;51;147;10;133;122;100;107;40;63;102;32;135;38;27;16;197;1;24;156;198;117;193;31;54;164;73;136;190;80;175;78;5;177;21;61;36;91;141;97;77;82;8;104;33;160;29;0;109;35;111;81;153;163;89;165;127;114;103;113;176;194;166;179;94;47;60;20;148;185;86;95;130;140;183;62;124;106,2607883147538627278,0.043036
steepest_intra:edges_start:random,193,47363,21070,26293,1928550,128,95;130;99;185;179;66;94;154;47;148;60;20;28;149;4;140;183;152;34;55;18;83;62;124;106;159;143;35;109;0;29;144;160;33;138;25;182;11;139;168;195;13;145;3;70;132;169;188;147;191;90;125;51;121;131;135;32;122;133;107;40;63;38;27;1;198;117;31;190;80;175;5;177;36;61;21;82;8;104;56;68;111;81;77;141;97;153;187;163;103;89;127;137;114;113;180;176;194;166;86,3112461150858704914,0.042999
steepest_intra:edges_start:random,194,47984,22149,25835,2003300,133,121;51;120;71;191;90;135;63;40;107;122;133;10;147;6;134;139;11;168;195;169;188;70;3;15;145;155;152;183;140;4;149;28;20;60;148;47;94;179;130;95;185;166;194;176;180;113;103;127;89;163;187;153;81;97;77;58;82;111;41;159;143;106;124;128;86;62;18;55;34;35;109;0;29;160;33;138;104;8;87;21;141;91;61;36;177;5;78;175;80;190;73;54;31;193;117;198;1;38;131,8743307554269641934,0.044000
steepest_intra:edges_start:random,195,48498,21236,27262,2033200,135,103;127;89;163;187;153;106;124;62;18;55;34;143;159;81;77;141;21;87;82;8;104;56;144;111;35;109;0;29;160;33;49;11;139;138;182;118;51;121;177;5;78;175;80;190;136;173;73;164;54;31;193;117;198;1;38;63;135;122;133;10;90;191;147;85;134;6;188;169;132;168;195;145;70;3;155;184;170;152;4;140;183;9;199;28;20;60;148;47;94;179;185;130;95;86;166;194;176;180;113,6823362791391184867,0.044586
steepest_intra:edges_start:random,196,47485,21374,26111,1943500,129,128;86;185;95;62;18;55;34;170;152;183;140;28;9;130;99;148;20;60;47;94;66;179;172;166;194;176;180;113;114;127;89;103;163;153;81;77;141;91;61;36;177;5;78;175;80;190;73;54;31;193;117;198;156;24;1;131;121;112;158;25;118;51;191;90;122;135;63;40;107;133;10;147;188;169;132;70;3;145;168;139;11;182;138;104;8;21;82;111;144;160;33;49;29;0;109;35;143;106;124,5808569674931234502,0.042900
steepest_intra:edges_start:random,197,48448,21670,26778,1973400,131,153;163;89;127;103;113;176;194;166;52;172;179;185;86;128;124;106;159;143;34;55;18;62;95;94;47;148;20;28;140;183;152;184;155;3;70;145;109;35;0;29;160;33;138;182;11;139;43;168;195;13;132;169;188;6;134;147;10;133;122;72;107;40;100;63;135;38;1;131;125;90;191;51;121;112;198;117;54;31;193;190;80;175;5;177;36;61;79;91;21;82;8;104;144;111;50;77;141;97;81,5752889476648035786,0.043965
steepest_intra:edges_start:random,198,49587,21887,27700,2003300,133,190;80;45;142;175;78;5;36;61;177;123;25;104;144;111;8;82;87;21;141;77;153;163;103;113;176;106;124;128;62;18;34;55;95;130;86;194;166;172;179;185;99;94;47;148;60;20;59;28;149;4;199;140;183;152;155;109;35;0;12;29;160;33;138;11;139;168;195;145;3;70;169;188;6;147;51;191;90;10;133;122;63;135;131;121;116;112;19;1;16;38;27;156;198;117;193;31;54;73;136,1512348517594209765,0.046034
steepest_intra:edges_start:random,199,46605,21546,25059,2033200,135,73;136;190;80;45;175;78;5;177;25;138;33;160;144;29;0;109;35;111;8;82;21;61;36;141;97;77;81;153;187;163;89;127;103;113;176;194;166;86;185;179;172;57;66;94;47;60;20;148;95;128;106;124;62;18;55;34;183;140;199;28;149;4;152;184;155;145;15;3;70;188;169;132;13;195;168;11;139;134;6;192;147;133;107;40;63;102;135;122;90;51;121;131;1;156;198;117;193;31;54,4327445458964081301,0.045662
steepest_intra:edges_start:greedy,0,51259,18382,32877,164450,10,0;29;69;189;155;145;15;3;70;161;188;6;169;132;13;195;168;43;134;139;11;182;138;33;160;144;56;104;8;82;87;21;177;5;45;142;175;78;36;61;91;141;77;97;146;187;165;127;89;103;137;114;113;194;166;86;185;52;172;179;22;99;130;95;183;140;199;9;148;47;66;94;60;20;59;28;149;4;152;170;34;55;18;62;128;124;143;159;106;176;88;180;163;186;153;81;41;111;35;109,7153515516937054859,0.003679
steepest_intra:edges_start:greedy,1,51190,18543,32647,164450,10,1;16;27;38;102;63;96;32;135;122;133;10;178;115;147;71;191;90;125;51;98;118;74;134;6;188;169;132;13;70;3;15;145;195;168;43;139;11;29;0;109;35;111;81;153;163;176;106;124;62;18;140;183;95;185;86;166;194;113;103;89;127;165;187;97;77;141;91;61;36;78;175;142;45;5;177;21;82;8;104;144;160;33;138;182;25;158;116;121;112;19;151;54;73;164;31;193;117;198;156,600134576955399108,0.003001
steepest_intra:edges_start:greedy,2,48258,19780,28478,239200,15,43;134;74;118;51;191;90;131;121;73;54;31;193;117;198;156;1;16;27;38;135;63;100;40;107;72;122;133;10;178;147;6;188;169;132;13;70;3;15;145;195;168;29;0;109;35;111;81;153;163;176;106;124;62;18;55;34;170;152;140;183;95;130;99;22;179;185;86;166;194;113;103;89;127;165;187;146;97;77;141;91;61;36;78;175;142;45;5;177;21;82;8;104;144;160;33;138;182;11;139,3520262196472637505,0.005000
steepest_intra:edges_start:greedy,3,49983,17472,32511,59800,3,3;155;184;170;152;140;183;95;130;22;99;9;199;4;149;28;59;20;60;148;47;94;66;57;172;52;179;185;86;166;194;176;180;113;26;103;114;137;127;89;163;165;187;146;153;81;77;97;141;91;79;61;36;78;175;142;45;5;177;21;87;82;111;144;56;8;104;138;182;139;11;49;33;160;29;0;109;35;143;159;106;124;128;62;18;55;34;189;15;145;195;168;126;13;132;169;6;188;161;70,8647181527210387911,0.001000
steepest_intra:edges_start:greedy,4,46330,19913,26417,164450,10,4;149;28;59;20;60;148;47;94;66;57;172;179;185;22;99;130;95;86;166;194;176;113;26;103;114;137;127;89;163;187;153;81;77;141;91;61;36;78;175;142;45;5;177;21;82;111;8;104;138;182;25;74;118;51;90;121;54;31;117;1;38;63;135;122;133;10;178;147;6;188;169;132;13;70;3;15;145;195;168;139;11;33;160;29;0;109;35;143;106;124;128;62;18;55;34;170;152;183;140,6388045255535502782,0.004000
steepest_intra:edges_start:greedy,5,50903,19838,31065,239200,15,5;177;21;104;138;182;25;74;118;51;120;191;90;125;131;121;112;19;151;54;73;31;193;117;198;156;1;16;27;38;135;63;100;40;107;72;122;133;10;178;147;134;6;188;169;132;13;161;70;3;15;145;195;168;139;11;49;33;160;29;0;109;35;111;144;8;82;58;77;81;153;163;176;106;124;62;18;140;183;95;185;86;166;194;113;103;89;127;165;187;146;97;141;91;61;36;78;175;142;45,9020475414770763296,0.004981
steepest_intra:edges_start:greedy,6,48258,19780,28478,209300,13,6;188;169;132;13;70;3;15;145;195;168;29;0;109;35;111;81;153;163;176;106;124;62;18;55;34;170;152;140;183;95;130;99;22;179;185;86;166;194;113;103;89;127;165;187;146;97;77;141;91;61;36;78;175;142;45;5;177;21;82;8;104;144;160;33;138;182;11;139;43;134;74;118;51;191;90;131;121;73;54;31;193;117;198;156;1;16;27;38;135;63;100;40;107;72;122;133;10;178;147,8476650451733245207,0.005033
steepest_intra:edges_start:greedy,7,51722,19328,32394,209300,13,7;78;175;142;45;5;177;21;104;138;182;25;74;118;51;120;191;90;125;131;121;112;19;151;54;73;31;193;117;198;156;1;16;27;38;135;63;100;40;107;72;122;133;10;178;147;134;6;188;169;132;13;161;70;3;15;145;195;168;139;11;49;33;160;29;0;109;35;111;144;8;82;58;77;81;153;163;176;106;124;62;18;95;130;185;86;166;194;113;103;89;127;165;187;146;97;141;91;61;36,2755131612457916453,0.004010
steepest_intra:edges_start:greedy,8,47350,21200,26150,299000,19,8;104;138;182;25;74;118;51;90;131;121;73;54;31;193;117;198;156;1;16;27;38;135;63;40;107;122;133;10;178;147;6;188;169;132;13;70;3;15;145;195;168;139;11;33;160;29;109;35;0;144;111;41;81;153;163;176;106;124;62;18;55;34;170;152;183;140;28;20;148;47;94;179;185;86;166;194;113;114;137;103;89;127;165;187;146;97;77;141;91;61;36;78;175;142;45;5;177;21;82,878883459007334517,0.005999
steepest_intra:edges_start:greedy,9,46524,20355,26169,164450,10,9;148;47;94;60;20;59;28;149;4;140;183;152;170;34;55;18;62;128;124;106;143;35;109;0;29;160;33;11;139;168;195;145;15;3;70;13;132;169;188;6;147;178;10;133;122;135;63;38;1;117;193;31;54;73;121;90;51;118;74;25;182;138;104;8;111;82;21;177;5;45;142;175;78;36;61;91;141;77;81;153;187;163;89;127;137;114;103;26;113;176;194;166;86;95;185;179;22;99;130,3942147830887965368,0.003012
steepest_intra:edges_start:greedy,10,51896,19072,32824,149500,9,10;178;147;192;6;188;169;132;161;70;3;15;145;13;195;168;43;11;29;0;109;35;111;81;153;163;176;106;124;62;18;95;185;86;166;194;113;103;89;127;165;187;97;77;141;91;61;36;78;175;142;45;5;177;21;82;8;104;144;160;33;138;182;139;134;85;74;118;98;51;116;121;112;19;151;54;73;164;31;193;117;198;156;1;16;27;38;131;125;191;90;135;102;63;100;40;107;72;122;133,1523904252243725768,0.003000
steepest_intra:edges_start:greedy,11,51259,18382,32877,164450,10,11;182;138;33;160;144;56;104;8;82;87;21;177;5;45;142;175;78;36;61;91;141;77;97;146;187;165;127;89;103;137;114;113;194;166;86;185;52;172;179;22;99;130;95;183;140;199;9;148;47;66;94;60;20;59;28;149;4;152;170;34;55;18;62;128;124;143;159;106;176;88;180;163;186;153;81;41;111;35;109;0;29;69;189;155;145;15;3;70;161;188;6;169;132;13;195;168;43;134;139,2675275407099480134,0.004000
steepest_intra:edges_start:greedy,12,51412,18409,33003,134550,8,12;111;41;81;153;186;163;180;88;176;106;159;143;124;128;62;18;55;34;170;152;4;149;28;59;20;60;94;66;47;148;9;199;140;183;95;130;99;22;179;172;185;86;166;194;113;114;137;103;89;127;165;187;146;97;77;141;91;61;36;78;175;142;45;5;177;21;87;82;8;104;56;144;160;33;138;182;11;139;134;43;168;195;13;132;169;6;188;161;70;3;15;145;155;189;69;29;109;35;0,2402612503269235630,0.002981
steepest_intra:edges_start:greedy,13,48258,19780,28478,209300,13,13;70;3;15;145;195;168;29;0;109;35;111;81;153;163;176;106;124;62;18;55;34;170;152;140;183;95;130;99;22;179;185;86;166;194;113;103;89;127;165;187;146;97;77;141;91;61;36;78;175;142;45;5;177;21;82;8;104;144;160;33;138;182;11;139;43;134;74;118;51;191;90;131;121;73;54;31;193;117;198;156;1;16;27;38;135;63;100;40;107;72;122;133;10;178;147;6;188;169;132,712697397226263909,0.005981
steepest_intra:edges_start:greedy,14,49305,21058,28247,388700,25,82;81;153;163;180;88;176;106;143;124;128;62;18;55;34;170;152;183;140;28;20;148;47;94;179;185;86;166;194;113;114;137;103;89;127;165;187;146;97;77;141;36;21;8;104;138;182;25;74;118;51;191;90;131;121;112;19;73;54;31;193;117;198;156;1;16;27;38;135;63;100;40;107;72;122;133;10;178;147;134;6;188;169;132;13;70;3;15;145;195;168;139;11;33;160;29;0;109;35;111,2797263706648048242,0.009027
steepest_intra:edges_start:greedy,15,49983,17472,32511,59800,3,15;145;195;168;126;13;132;169;6;188;161;70;3;155;184;170;152;140;183;95;130;22;99;9;199;4;149;28;59;20;60;148;47;94;66;57;172;52;179;185;86;166;194;176;180;113;26;103;114;137;127;89;163;165;187;146;153;81;77;97;141;91;79;61;36;78;175;142;45;5;177;21;87;82;111;144;56;8;104;138;182;139;11;49;33;160;29;0;109;35;143;159;106;124;128;62;18;55;34;189,7017084116599788124,0.002008
steepest_intra:edges_start:greedy,16,53667,18751,34916,119600,7,16;27;38;92;102;63;96;32;135;122;133;10;178;115;147;71;191;90;51;125;131;121;112;19;151;54;31;164;73;136;45;5;177;21;104;138;182;134;6;188;169;132;13;161;70;3;15;145;195;168;139;11;49;33;160;29;0;109;35;111;144;8;82;58;77;81;153;163;176;86;95;130;185;179;166;194;113;103;89;127;165;187;146;97;141;91;61;36;78;175;142;162;80;190;193;117;198;156;24;1,2285900070350564270,0.002999
steepest_intra:edges_start:greedy,17,51667,18843,32824,149500,9,72;107;40;100;63;102;135;122;90;191;125;131;38;27;16;1;156;198;117;193;31;164;73;54;151;19;112;121;116;51;98;118;74;85;134;139;182;138;33;160;144;104;8;82;21;177;5;45;142;175;78;36;61;91;141;77;97;187;165;127;89;103;113;194;166;86;185;95;18;62;124;106;176;163;153;81;111;35;109;0;29;11;43;168;195;13;145;15;3;70;161;132;169;188;6;192;147;178;10;133,38344214071207156,0.003014
steepest_intra:edges_start:greedy,18,50703,18111,32592,134550,8,18;34;55;83;128;86;176;180;113;194;166;52;172;179;185;22;99;130;95;183;140;199;9;148;47;66;94;60;20;59;28;149;4;152;170;184;155;189;3;70;15;145;13;132;169;188;6;134;43;195;168;139;11;182;138;33;160;144;56;104;8;82;87;21;177;5;45;142;175;78;36;61;79;91;141;77;97;146;187;165;137;114;127;89;103;163;186;153;81;41;111;29;0;109;35;143;159;106;124;62,4174864506549644557,0.002002
steepest_intra:edges_start:greedy,19,53667,18751,34916,134550,8,19;112;121;131;125;51;90;191;71;147;115;178;10;133;122;135;32;96;63;102;92;38;27;16;1;24;156;198;117;193;190;80;162;142;175;78;36;61;91;141;97;146;187;165;127;89;103;113;194;166;179;185;130;95;86;176;163;153;81;77;58;82;8;144;111;35;109;0;29;160;33;49;11;139;168;195;145;15;3;70;161;13;132;169;188;6;134;182;138;104;21;177;5;45;136;73;164;31;54;151,4984748716756890944,0.003221
steepest_intra:edges_start:greedy,20,45867,19796,26071,239200,15,20;60;148;47;94;66;179;22;99;130;95;185;86;166;194;176;113;26;103;114;137;127;89;163;187;153;81;77;141;91;61;36;78;175;142;45;5;177;21;82;111;8;104;138;182;25;74;118;51;90;121;73;54;31;193;117;1;38;63;135;122;133;10;178;147;6;188;169;132;13;70;3;15;145;195;168;139;11;33;160;29;0;109;35;143;106;124;128;62;18;55;34;170;152;183;140;4;149;28;59,76297620324053588,0.006003
steepest_intra:edges_start:greedy,21,51446,18927,32519,149500,9,21;87;82;111;8;104;56;144;33;160;29;0;35;109;69;189;155;145;15;3;70;161;188;6;169;132;13;195;168;43;134;139;11;138;182;25;177;5;45;142;175;78;36;61;91;141;97;146;187;165;127;89;103;137;114;113;194;166;86;185;172;179;22;99;130;95;183;140;199;9;148;47;66;94;60;20;59;28;149;4;152;170;34;55;18;62;128;124;143;159;106;176;88;180;163;186;153;81;77;58,2878905820763129473,0.003999
steepest_intra:edges_start:greedy,22,47525,20393,27132,164450,10,22;99;9;199;4;149;28;59;20;60;148;47;94;66;57;172;179;185;86;166;194;176;113;26;103;114;137;127;89;163;187;153;81;77;141;91;61;36;78;175;142;45;5;177;21;82;111;8;104;138;182;25;74;118;51;90;121;117;1;38;63;135;122;133;10;178;147;6;188;169;132;13;70;3;15;145;195;168;139;11;33;160;29;0;109;35;143;106;124;128;62;18;55;34;170;152;140;183;95;130,9132055967457724765,0.004001
steepest_intra:edges_start:greedy,23,46112,19734,26378,269100,17,23;20;59;28;149;4;140;183;152;170;34;55;18;62;128;124;106;143;35;109;0;29;160;33;11;139;168;195;145;15;3;70;13;132;169;188;6;147;178;10;133;122;135;63;38;1;117;193;31;54;121;90;51;118;74;25;182;138;104;8;111;82;21;177;5;45;142;175;78;36;61;91;141;77;81;153;187;163;89;127;137;114;103;26;113;176;194;166;86;185;95;130;99;22;179;66;94;47;148;60,2017558243812023255,0.005983
steepest_intra:edges_start:greedy,24,51886,18023,33863,119600,7,24;1;16;27;38;102;63;96;32;135;122;133;10;178;115;147;71;191;90;125;51;98;118;74;134;6;188;169;132;13;70;3;15;145;195;168;43;139;11;29;0;109;35;111;81;153;163;176;106;124;62;18;95;130;185;86;166;194;113;103;89;127;165;187;97;77;141;91;61;36;78;175;142;45;5;177;21;82;8;104;144;160;33;138;182;25;158;116;121;112;19;151;54;73;164;31;193;117;198;156,2033831540034144337,0.002000
steepest_intra:edges_start:greedy,25,51917,19286,32631,284050,18,87;21;177;5;45;142;175;78;7;36;61;91;141;97;146;187;165;127;89;103;113;194;166;86;185;95;18;62;124;106;176;163;153;81;77;58;82;8;144;111;35;109;0;29;160;33;49;11;139;168;195;145;15;3;70;161;13;132;169;188;6;134;147;178;10;133;122;72;107;40;100;63;135;38;27;16;1;156;198;117;193;31;73;54;151;19;112;121;131;125;90;191;120;51;118;74;25;182;138;104,947361105640010201,0.006000
steepest_intra:edges_start:greedy,26,50366,20744,29622,239200,15,26;103;114;137;127;89;163;165;187;146;97;77;141;36;21;8;104;138;182;25;74;118;51;90;121;54;31;117;1;38;63;135;122;133;10;178;147;6;188;169;132;13;70;3;15;145;195;168;139;11;33;160;29;0;109;35;111;81;153;129;180;88;176;106;159;143;124;128;62;18;55;34;170;152;4;149;28;59;20;60;94;66;47;148;9;199;140;183;95;130;99;22;179;172;52;185;86;166;194;113,7657351396328767859,0.005200
steepest_intra:edges_start:greedy,27,53667,18751,34916,134550,8,27;16;1;24;156;198;117;193;190;80;162;142;175;78;36;61;91;141;97;146;187;165;127;89;103;113;194;166;179;185;130;95;86;176;163;153;81;77;58;82;8;144;111;35;109;0;29;160;33;49;11;139;168;195;145;15;3;70;161;13;132;169;188;6;134;182;138;104;21;177;5;45;136;73;164;31;54;151;19;112;121;131;125;51;90;191;71;147;115;178;10;133;122;135;32;96;63;102;92;38,3427770113901805456,0.002000
steepest_intra:edges_start:greedy,28,46330,19913,26417,164450,10,28;149;4;140;183;152;170;34;55;18;62;128;124;106;143;35;109;0;29;160;33;11;139;168;195;145;15;3;70;13;132;169;188;6;147;178;10;133;122;135;63;38;1;117;31;54;121;90;51;118;74;25;182;138;104;8;111;82;21;177;5;45;142;175;78;36;61;91;141;77;81;153;187;163;89;127;137;114;103;26;113;176;194;166;86;95;130;99;22;185;179;172;57;66;94;47;148;60;20;59,3059932616452401805,0.003971
steepest_intra:edges_start:greedy,29,51259,18382,32877,164450,10,29;0;109;35;111;41;81;153;186;163;180;88;176;106;159;143;124;128;62;18;55;34;170;152;4;149;28;59;20;60;94;66;47;148;9;199;140;183;95;130;99;22;179;172;52;185;86;166;194;113;114;137;103;89;127;165;187;146;97;77;141;91;61;36;78;175;142;45;5;177;21;87;82;8;104;56;144;160;33;138;182;11;139;134;43;168;195;13;132;169;6;188;161;70;3;15;145;155;189;69,5491333287010292095,0.004000
steepest_intra:edges_start:greedy,30,51527,20145,31382,269100,17,42;190;80;162;142;175;78;36;61;91;141;97;146;187;165;127;89;103;113;194;166;86;185;130;95;18;62;124;106;176;163;153;81;77;58;82;8;144;111;35;109;0;29;160;33;49;11;139;168;195;145;15;3;70;161;13;132;169;188;6;134;147;178;10;133;122;72;107;40;100;63;102;135;131;121;125;90;191;120;51;118;74;25;182;138;104;21;177;5;45;136;73;164;31;54;193;117;198;1;156,7146821876502061788,0.005996
steepest_intra:edges_start:greedy,31,50386,19956,30430,254150,16,31;164;73;136;45;5;177;21;104;138;182;25;74;118;51;120;191;90;125;121;131;135;102;63;100;40;107;72;122;133;10;178;147;134;6;188;169;132;13;161;70;3;15;145;195;168;139;11;49;33;160;29;0;109;35;111;144;8;82;58;77;81;153;163;176;106;124;62;18;55;140;183;95;130;185;86;166;194;113;103;89;127;165;187;146;97;141;91;61;36;78;175;142;162;80;190;193;198;117;54,137174487364675510,0.005000
steepest_intra:edges_start:greedy,32,52203,18845,33358,149500,9,32;102;63;100;40;107;72;133;10;178;147;192;6;188;169;132;161;70;3;15;145;13;195;168;43;11;29;0;109;35;111;81;153;163;176;106;124;62;18;185;86;166;194;113;103;89;127;165;187;97;77;141;91;61;36;78;175;142;45;5;177;21;82;8;104;144;160;33;138;182;139;134;85;74;118;98;51;116;121;112;19;151;54;73;164;31;193;117;198;156;1;16;27;38;131;125;191;90;122;135,2737376538047199676,0.004000
steepest_intra:edges_start:greedy,33,51259,18382,32877,164450,10,33;160;144;56;104;8;82;87;21;177;5;45;142;175;78;36;61;91;141;77;97;146;187;165;127;89;103;137;114;113;194;166;86;185;52;172;179;22;99;130;95;183;140;199;9;148;47;66;94;60;20;59;28;149;4;152;170;34;55;18;62;128;124;143;159;106;176;88;180;163;186;153;81;41;111;35;109;0;29;69;189;155;145;15;3;70;161;188;6;169;132;13;195;168;43;134;139;11;182;138,3422237367212213044,0.003002
steepest_intra:edges_start:greedy,34,50703,18111,32592,134550,8,34;18;62;124;106;159;143;35;109;0;29;111;41;81;153;186;163;103;89;127;114;137;165;187;146;97;77;141;91;79;61;36;78;175;142;45;5;177;21;87;82;8;104;56;144;160;33;138;182;11;139;168;195;43;134;6;188;169;132;13;145;15;70;3;189;155;184;170;152;4;149;28;59;20;60;94;66;47;148;9;199;140;183;95;130;99;22;185;179;172;52;166;194;113;180;176;86;128;83;55,2894200990589562107,0.003005
steepest_intra:edges_start:greedy,35,51259,18382,32877,164450,10,35;111;41;81;153;186;163;180;88;176;106;159;143;124;128;62;18;55;34;170;152;4;149;28;59;20;60;94;66;47;148;9;199;140;183;95;130;99;22;179;172;52;185;86;166;194;113;114;137;103;89;127;165;187;146;97;77;141;91;61;36;78;175;142;45;5;177;21;87;82;8;104;56;144;160;33;138;182;11;139;134;43;168;195;13;132;169;6;188;161;70;3;15;145;155;189;69;29;0;109,3645870803963392975,0.003999
steepest_intra:edges_start:greedy,36,50903,19838,31065,269100,17,36;78;175;142;45;5;177;21;104;138;182;25;74;118;51;120;191;90;125;131;121;112;19;151;54;73;31;193;117;198;156;1;16;27;38;135;63;100;40;107;72;122;133;10;178;147;134;6;188;169;132;13;161;70;3;15;145;195;168;139;11;49;33;160;29;0;109;35;111;144;8;82;58;77;81;153;163;176;106;124;62;18;140;183;95;185;86;166;194;113;103;89;127;165;187;146;97;141;91;61,3521789990055542004,0.005000
steepest_intra:edges_start:greedy,37,47139,21181,25958,343850,22,144;35;109;0;29;160;33;11;139;168;195;145;15;3;70;13;132;169;188;6;147;178;10;133;122;100;107;40;63;135;38;27;16;1;156;198;117;193;31;54;73;121;131;90;51;118;74;25;182;138;104;8;82;21;177;5;45;142;175;78;36;61;91;141;77;97;146;187;165;127;89;103;137;114;113;194;166;86;185;179;94;47;148;20;28;140;183;152;170;34;55;18;62;124;106;176;163;153;81;111,249394739213600988,0.008000
steepest_intra:edges_start:greedy,38,51142,18651,32491,134550,8,38;102;63;100;40;107;72;133;10;178;147;192;6;188;169;132;161;70;3;15;145;13;195;168;43;11;29;0;109;35;111;81;153;163;176;106;124;62;18;95;130;185;86;166;194;113;103;89;127;165;187;97;77;141;91;61;36;78;175;142;45;5;177;21;82;8;104;144;160;33;138;182;139;134;85;74;118;98;51;125;191;90;122;135;131;121;112;19;151;54;73;164;31;193;117;198;156;1;16;27,7016748212654003692,0.003008
steepest_intra:edges_start:greedy,39,51303,18489,32814,179400,11,49;29;0;35;109;69;189;155;145;15;3;70;161;188;6;169;132;13;195;168;43;134;139;11;182;138;104;56;8;82;87;21;177;5;45;142;175;78;36;61;91;141;77;97;146;187;165;127;89;103;137;114;113;194;166;86;185;172;179;22;99;130;95;183;140;199;9;148;47;66;94;60;20;59;28;149;4;152;170;34;55;18;62;128;124;143;159;106;176;88;180;163;186;153;81;41;111;144;160;33,4769723130641220516,0.004000
steepest_intra:edges_start:greedy,40,51667,18843,32824,149500,9,40;100;63;102;135;122;90;191;125;131;38;27;16;1;156;198;117;193;31;164;73;54;151;19;112;121;116;51;98;118;74;85;134;139;182;138;33;160;144;104;8;82;21;177;5;45;142;175;78;36;61;91;141;77;97;187;165;127;89;103;113;194;166;86;185;95;18;62;124;106;176;163;153;81;111;35;109;0;29;11;43;168;195;13;145;15;3;70;161;132;169;188;6;192;147;178;10;133;72;107,3881157554325458052,0.003000
steepest_intra:edges_start:greedy,41,48209,19970,28239,179400,11,41;81;77;141;97;153;187;163;89;127;137;114;103;26;113;176;194;166;86;185;179;172;57;66;94;47;148;60;20;59;28;149;4;199;9;99;130;95;183;140;152;170;34;55;18;62;128;124;106;143;35;109;0;29;160;33;11;139;168;195;145;15;3;70;13;132;169;188;6;147;178;10;133;122;135;63;38;27;1;156;198;117;193;31;54;73;121;131;90;51;118;74;25;182;138;104;8;21;82;111,5938009956618414260,0.004031
steepest_intra:edges_start:greedy,42,51916,20167,31749,284050,18,42;30;190;80;162;142;175;78;36;61;91;141;97;146;187;165;127;89;103;113;194;166;86;185;95;18;62;124;106;176;163;153;81;77;58;82;8;144;111;35;109;0;29;160;33;49;11;139;168;195;145;15;3;70;161;13;132;169;188;6;134;147;178;10;133;122;72;107;40;100;63;102;135;131;121;125;90;191;120;51;118;74;25;182;138;104;21;177;5;45;136;73;164;54;31;193;117;198;1;156,6039596231021905498,0.007012
steepest_intra:edges_start:greedy,43,50079,20332,29747,149500,9,43;134;118;74;139;11;29;0;109;35;111;81;153;163;176;106;124;62;18;55;152;140;183;95;130;185;86;166;194;113;103;89;127;165;187;97;77;141;91;61;36;78;175;142;45;5;177;21;82;8;104;144;160;33;138;182;25;158;121;51;191;90;131;112;19;151;54;73;31;193;117;198;156;1;16;27;38;135;63;100;40;107;72;122;133;10;178;147;192;6;188;169;132;13;70;3;15;145;195;168,8678155448091212018,0.003008
steepest_intra:edges_start:greedy,44,53429,18847,34582,74750,4,44;133;10;178;115;147;71;191;90;125;51;98;118;74;134;6;188;169;132;13;70;3;15;145;195;168;43;139;11;29;0;109;35;111;81;153;163;176;86;95;185;179;166;194;113;103;89;127;165;187;97;77;141;91;61;36;78;175;142;45;5;177;21;82;8;104;144;160;33;138;182;25;158;116;121;131;112;19;151;54;73;164;31;193;117;198;156;1;16;27;38;135;102;63;100;40;107;17;72;122,4320096268714905542,0.001003
steepest_intra:edges_start:greedy,45,50903,19838,31065,239200,15,45;5;177;21;104;138;182;25;74;118;51;120;191;90;125;131;121;112;19;151;54;73;31;193;117;198;156;1;16;27;38;135;63;100;40;107;72;122;133;10;178;147;134;6;188;169;132;13;161;70;3;15;145;195;168;139;11;49;33;160;29;0;109;35;111;144;8;82;58;77;81;153;163;176;106;124;62;18;140;183;95;185;86;166;194;113;103;89;127;165;187;146;97;141;91;61;36;78;175;142,4699887751414248841,0.006002
steepest_intra:edges_start:greedy,46,50833,19919,30914,254150,16,46;80;190;193;198;117;54;31;164;73;136;45;5;177;21;104;138;182;25;74;118;51;120;191;90;125;121;131;135;102;63;100;40;107;72;122;133;10;178;147;134;6;188;169;132;13;161;70;3;15;145;195;168;139;11;49;33;160;29;0;109;35;111;144;8;82;58;77;81;153;163;176;106;124;62;18;55;140;183;95;185;86;166;194;113;103;89;127;165;187;146;97;141;91;61;36;78;175;142;162,4032205068749413623,0.005001
steepest_intra:edges_start:greedy,47,46330,19913,26417,194350,12,47;148;60;20;59;28;149;4;140;183;152;170;34;55;18;62;128;124;106;143;35;109;0;29;160;33;11;139;168;195;145;15;3;70;13;132;169;188;6;147;178;10;133;122;135;63;38;1;117;31;54;121;90;51;118;74;25;182;138;104;8;111;82;21;177;5;45;142;175;78;36;61;91;141;77;81;153;187;163;89;127;137;114;103;26;113;176;194;166;86;95;130;99;22;185;179;172;57;66;94,7225464710412691934,0.005004
steepest_intra:edges_start:greedy,48,47851,20468,27383,179400,11,180;113;26;103;114;137;127;89;163;187;153;81;77;141;91;61;36;78;175;142;45;5;177;21;82;111;8;104;138;182;25;74;118;51;90;121;117;1;135;63;122;133;10;178;147;6;188;169;132;13;70;3;15;145;195;168;139;11;33;160;29;0;109;35;143;106;124;128;62;18;55;34;170;152;140;183;130;95;86;185;22;99;9;199;4;149;28;59;20;60;148;47;94;66;57;172;179;166;194;176,853579618406184527,0.003972
steepest_intra:edges_start:greedy,49,47137,21069,26068,328900,21,49;29;0;109;35;111;81;153;163;176;106;124;62;18;55;34;170;152;183;140;28;20;148;47;94;179;185;86;166;194;113;114;137;103;89;127;165;187;146;97;77;141;91;61;36;78;175;142;45;5;177;21;82;8;104;144;160;33;138;182;25;74;118;51;90;131;121;73;54;31;193;117;198;156;1;16;27;38;135;63;40;107;122;133;10;178;147;6;188;169;132;13;70;3;15;145;195;168;139;11,8348887919739495334,0.008002
steepest_intra:edges_start:greedy,50,49305,21058,28247,388700,25,82;81;153;163;180;88;176;106;143;124;128;62;18;55;34;170;152;183;140;28;20;148;47;94;179;185;86;166;194;113;114;137;103;89;127;165;187;146;97;77;141;36;21;8;104;138;182;25;74;118;51;191;90;131;121;112;19;73;54;31;193;117;198;156;1;16;27;38;135;63;100;40;107;72;122;133;10;178;147;134;6;188;169;132;13;70;3;15;145;195;168;139;11;33;160;29;0;109;35;111,5652696035454805189,0.008000
steepest_intra:edges_start:greedy,51,50622,19759,30863,149500,9,51;125;191;90;122;133;10;72;107;40;100;63;102;135;38;27;16;1;156;198;117;193;31;164;73;54;151;19;112;131;121;116;158;25;182;138;33;160;144;104;8;82;21;177;5;45;142;175;78;36;61;91;141;77;97;187;165;127;89;103;113;194;166;86;185;95;183;140;18;62;124;106;176;163;153;81;111;35;109;0;29;11;139;43;168;195;145;15;3;70;13;132;169;188;6;147;134;74;118;98,9223012367986934305,0.002647
steepest_intra:edges_start:greedy,52,47723,20452,27271,149500,9,52;166;194;176;113;26;103;114;137;127;89;163;187;153;81;77;141;91;61;36;78;175;142;45;5;177;21;82;111;8;104;138;182;25;74;118;51;90;121;117;1;38;63;135;122;133;10;178;147;6;188;169;132;13;70;3;15;145;195;168;139;11;33;160;29;0;109;35;143;106;124;128;62;18;55;34;170;152;140;183;130;95;86;185;22;99;9;199;4;149;28;59;20;60;148;47;94;66;179;172,9157965579416503788,0.003001
steepest_intra:edges_start:greedy,53,47689,20362,27327,149500,9,53;140;183;95;130;99;9;199;4;149;28;59;20;60;148;47;94;66;57;172;179;185;86;166;194;176;113;26;103;114;137;127;89;163;187;153;81;77;141;91;61;36;78;175;142;45;5;177;21;82;111;8;104;138;182;25;74;118;51;90;121;117;1;38;63;135;122;133;10;178;147;6;188;169;132;13;70;3;15;145;195;168;139;11;33;160;29;0;109;35;143;106;124;128;62;18;55;34;170;152,3172310705901302818,0.002978
steepest_intra:edges_start:greedy,54,50386,19956,30430,239200,15,54;31;164;73;136;45;5;177;21;104;138;182;25;74;118;51;120;191;90;125;121;131;135;102;63;100;40;107;72;122;133;10;178;147;134;6;188;169;132;13;161;70;3;15;145;195;168;139;11;49;33;160;29;0;109;35;111;144;8;82;58;77;81;153;163;176;106;124;62;18;55;140;183;95;130;185;86;166;194;113;103;89;127;165;187;146;97;141;91;61;36;78;175;142;162;80;190;193;198;117,9204845219996425526,0.004996
steepest_intra:edges_start:greedy,55,50703,18111,32592,134550,8,55;34;18;62;124;106;159;143;35;109;0;29;111;41;81;153;186;163;103;89;127;114;137;165;187;146;97;77;141;91;79;61;36;78;175;142;45;5;177;21;87;82;8;104;56;144;160;33;138;182;11;139;168;195;43;134;6;188;169;132;13;145;15;70;3;189;155;184;170;152;4;149;28;59;20;60;94;66;47;148;9;199;140;183;95;130;99;22;185;179;172;52;166;194;113;180;176;86;128;83,2979187414537586302,0.002000
steepest_intra:edges_start:greedy,56,54814,17924,36890,179400,11,56;144;111;35;109;0;29;160;33;49;11;168;195;145;15;3;70;161;13;132;169;188;6;192;147;115;178;10;133;122;72;107;40;100;63;102;135;38;27;16;1;156;198;117;193;31;164;73;54;151;19;112;121;131;125;90;191;71;120;51;98;118;74;85;134;43;139;182;138;104;25;177;5;45;142;175;78;36;61;91;141;97;146;187;165;127;89;103;113;194;166;176;163;153;81;77;82;87;21;8,3532269979003277335,0.004000
steepest_intra:edges_start:greedy,57,46330,19913,26417,164450,10,57;172;179;185;22;99;130;95;86;166;194;176;113;26;103;114;137;127;89;163;187;153;81;77;141;91;61;36;78;175;142;45;5;177;21;82;111;8;104;138;182;25;74;118;51;90;121;54;31;117;1;38;63;135;122;133;10;178;147;6;188;169;132;13;70;3;15;145;195;168;139;11;33;160;29;0;109;35;143;106;124;128;62;18;55;34;170;152;183;140;4;149;28;59;20;60;148;47;94;66,925426990270774635,0.004000
steepest_intra:edges_start:greedy,58,50903,19838,31065,254150,16,58;82;8;144;111;35;109;0;29;160;33;49;11;139;168;195;145;15;3;70;161;13;132;169;188;6;134;147;178;10;133;122;72;107;40;100;63;135;38;27;16;1;156;198;117;193;31;73;54;151;19;112;121;131;125;90;191;120;51;118;74;25;182;138;104;21;177;5;45;142;175;78;36;61;91;141;97;146;187;165;127;89;103;113;194;166;86;185;95;183;140;18;62;124;106;176;163;153;81;77,7861338375149464463,0.005000
steepest_intra:edges_start:greedy,59,46330,19913,26417,164450,10,59;28;149;4;140;183;152;170;34;55;18;62;128;124;106;143;35;109;0;29;160;33;11;139;168;195;145;15;3;70;13;132;169;188;6;147;178;10;133;122;135;63;38;1;117;31;54;121;90;51;118;74;25;182;138;104;8;111;82;21;177;5;45;142;175;78;36;61;91;141;77;81;153;187;163;89;127;137;114;103;26;113;176;194;166;86;95;130;99;22;185;179;172;57;66;94;47;148;60;20,6376868122864368485,0.004000
steepest_intra:edges_start:greedy,60,45867,19796,26071,239200,15,60;148;47;94;66;179;22;99;130;95;185;86;166;194;176;113;26;103;114;137;127;89;163;187;153;81;77;141;91;61;36;78;175;142;45;5;177;21;82;111;8;104;138;182;25;74;118;51;90;121;73;54;31;193;117;1;38;63;135;122;133;10;178;147;6;188;169;132;13;70;3;15;145;195;168;139;11;33;160;29;0;109;35;143;106;124;128;62;18;55;34;170;152;183;140;4;149;28;59;20,5469375128249062488,0.005000
steepest_intra:edges_start:greedy,61,50903,19838,31065,269100,17,61;91;141;97;146;187;165;127;89;103;113;194;166;86;185;95;183;140;18;62;124;106;176;163;153;81;77;58;82;8;144;111;35;109;0;29;160;33;49;11;139;168;195;145;15;3;70;161;13;132;169;188;6;134;147;178;10;133;122;72;107;40;100;63;135;38;27;16;1;156;198;117;193;31;73;54;151;19;112;121;131;125;90;191;120;51;118;74;25;182;138;104;21;177;5;45;142;175;78;36,8654043823867922445,0.006001
steepest_intra:edges_start:greedy,62,50703,18111,32592,134550,8,62;124;106;159;143;35;109;0;29;111;41;81;153;186;163;103;89;127;114;137;165;187;146;97;77;141;91;79;61;36;78;175;142;45;5;177;21;87;82;8;104;56;144;160;33;138;182;11;139;168;195;43;134;6;188;169;132;13;145;15;70;3;189;155;184;170;152;4;149;28;59;20;60;94;66;47;148;9;199;140;183;95;130;99;22;185;179;172;52;166;194;113;180;176;86;128;83;55;34;18,3406550594535024500,0.003994
steepest_intra:edges_start:greedy,63,51667,18843,32824,149500,9,63;100;40;107;72;133;10;178;147;192;6;188;169;132;161;70;3;15;145;13;195;168;43;11;29;0;109;35;111;81;153;163;176;106;124;62;18;95;185;86;166;194;113;103;89;127;165;187;97;77;141;91;61;36;78;175;142;45;5;177;21;82;8;104;144;160;33;138;182;139;134;85;74;118;98;51;116;121;112;19;151;54;73;164;31;193;117;198;156;1;16;27;38;131;125;191;90;122;135;102,6875271457412364433,0.003002
steepest_intra:edges_start:greedy,64,50354,20576,29778,179400,11,88;86;95;128;106;159;143;124;62;18;55;34;170;152;174;183;140;199;4;149;28;59;20;60;148;47;94;66;22;99;130;185;179;172;52;166;194;113;26;103;114;137;127;89;163;165;187;146;97;77;141;36;21;8;104;138;182;25;74;118;51;90;121;54;31;117;1;38;63;135;122;133;10;178;147;6;188;169;132;13;70;3;15;145;195;168;139;11;33;160;29;0;109;35;111;81;153;129;180;176,2742966576519114322,0.003000
steepest_intra:edges_start:greedy,65,50072,17420,32652,59800,3,65;188;6;169;132;13;126;168;195;145;15;189;34;55;18;62;128;124;106;159;143;35;109;0;29;160;33;49;11;139;182;138;104;8;56;144;111;82;87;21;177;5;45;142;175;78;36;61;79;91;141;97;77;81;153;146;187;165;163;89;127;137;114;103;26;113;180;176;194;166;86;185;179;172;57;66;94;47;148;60;20;59;28;149;4;199;9;99;22;130;95;183;140;152;170;184;155;3;70;161,6406762379970723434,0.001000
steepest_intra:edges_start:greedy,66,46330,19913,26417,194350,12,66;57;172;179;185;22;99;130;95;86;166;194;176;113;26;103;114;137;127;89;163;187;153;81;77;141;91;61;36;78;175;142;45;5;177;21;82;111;8;104;138;182;25;74;118;51;90;121;54;31;117;1;38;63;135;122;133;10;178;147;6;188;169;132;13;70;3;15;145;195;168;139;11;33;160;29;0;109;35;143;106;124;128;62;18;55;34;170;152;183;140;4;149;28;59;20;60;148;47;94,9157965404852402764,0.004013
steepest_intra:edges_start:greedy,67,53325,18881,34444,74750,4,67;120;51;98;118;74;134;6;188;169;132;13;70;3;15;145;195;168;43;139;11;29;0;109;35;111;81;153;163;176;86;95;130;185;179;166;194;113;103;89;127;165;187;97;77;141;91;61;36;78;175;142;45;5;177;21;82;8;104;144;160;33;138;182;25;158;116;121;131;112;19;151;54;73;164;31;193;117;198;156;1;16;27;38;135;102;63;100;40;107;17;72;122;133;10;178;90;191;147;71,7774879378110885013,0.002011
steepest_intra:edges_start:greedy,68,51688,19305,32383,328900,21,56;144;111;35;109;0;29;160;33;49;11;139;168;195;145;15;3;70;161;13;132;169;188;6;134;147;178;10;133;122;72;107;40;100;63;135;38;27;16;1;156;198;117;193;31;73;54;151;19;112;121;131;125;90;191;120;51;118;74;25;182;138;104;87;21;177;5;45;142;175;78;36;61;91;141;97;146;187;165;127;89;103;113;194;166;86;185;95;18;62;124;106;176;163;153;81;77;58;82;8,6908154627077805965,0.007000
steepest_intra:edges_start:greedy,69,51534,17852,33682,179400,11,12;0;109;35;111;41;81;153;186;163;180;88;176;106;159;143;124;128;62;18;55;34;170;152;4;149;28;59;20;60;94;66;47;148;9;199;140;183;95;130;99;22;179;172;52;185;86;166;194;113;26;114;137;103;89;127;165;187;146;97;77;141;91;79;61;36;78;175;142;45;5;177;21;87;82;8;104;56;144;160;33;138;182;11;139;134;43;168;195;13;132;169;6;188;161;70;3;15;145;29,4878880452492730850,0.004001
steepest_intra:edges_start:greedy,70,49983,17472,32511,59800,3,70;161;188;6;169;132;13;126;168;195;145;15;189;34;55;18;62;128;124;106;159;143;35;109;0;29;160;33;49;11;139;182;138;104;8;56;144;111;82;87;21;177;5;45;142;175;78;36;61;79;91;141;97;77;81;153;146;187;165;163;89;127;137;114;103;26;113;180;176;194;166;86;185;179;52;172;57;66;94;47;148;60;20;59;28;149;4;199;9;99;22;130;95;183;140;152;170;184;155;3,7486917874998221928,0.001000
steepest_intra:edges_start:greedy,71,50248,19260,30988,224250,14,71;147;192;6;188;169;132;161;70;3;15;145;13;195;168;43;11;29;0;109;35;111;81;153;163;176;106;124;62;18;55;140;183;95;185;86;166;194;113;103;89;127;165;187;97;77;141;91;61;36;78;175;142;45;5;177;21;82;8;104;144;160;33;138;182;139;134;74;118;98;51;125;131;121;112;54;73;164;31;193;117;198;156;1;16;27;38;135;102;63;100;40;107;72;122;133;10;178;90;191,3325335517729996334,0.005001
steepest_intra:edges_start:greedy,72,51667,18843,32824,149500,9,72;107;40;100;63;102;135;122;90;191;125;131;38;27;16;1;156;198;117;193;31;164;73;54;151;19;112;121;116;51;98;118;74;85;134;139;182;138;33;160;144;104;8;82;21;177;5;45;142;175;78;36;61;91;141;77;97;187;165;127;89;103;113;194;166;86;185;95;18;62;124;106;176;163;153;81;111;35;109;0;29;11;43;168;195;13;145;15;3;70;161;132;169;188;6;192;147;178;10;133,6463987424618106081,0.003317
steepest_intra:edges_start:greedy,73,50386,19956,30430,239200,15,73;164;31;54;117;198;193;190;80;162;142;175;78;36;61;91;141;97;146;187;165;127;89;103;113;194;166;86;185;130;95;183;140;55;18;62;124;106;176;163;153;81;77;58;82;8;144;111;35;109;0;29;160;33;49;11;139;168;195;145;15;3;70;161;13;132;169;188;6;134;147;178;10;133;122;72;107;40;100;63;102;135;131;121;125;90;191;120;51;118;74;25;182;138;104;21;177;5;45;136,1224284063812408163,0.005016
steepest_intra:edges_start:greedy,74,49123,20055,29068,209300,13,74;118;98;51;125;90;191;10;133;122;72;107;40;100;63;102;135;131;121;158;25;182;138;33;160;144;104;8;82;87;21;177;5;45;142;175;78;36;61;91;141;77;97;146;187;165;127;89;103;137;114;113;194;166;86;185;179;94;47;148;20;28;140;183;152;170;34;55;18;62;128;124;106;176;180;163;153;81;111;35;109;0;29;49;11;139;43;168;195;145;15;3;70;13;132;169;188;6;147;134,5969993952026023986,0.004001
steepest_intra:edges_start:greedy,75,50894,21000,29894,239200,15,75;114;194;166;179;172;57;66;94;47;148;60;20;59;28;149;4;199;9;99;22;185;86;95;130;183;140;152;170;34;55;18;62;128;124;143;159;106;176;180;88;113;26;103;163;186;153;81;111;35;109;0;29;160;33;11;139;168;195;145;15;3;70;13;132;169;188;6;147;178;10;133;122;135;63;38;1;117;31;121;90;51;118;74;25;182;138;104;8;21;36;141;77;97;146;187;165;89;127;137,6296918988826232216,0.005000
steepest_intra:edges_start:greedy,76,50717,20539,30178,209300,13,88;86;128;106;159;143;124;62;18;55;34;170;152;53;4;149;28;59;20;60;94;66;47;148;9;199;140;183;95;130;99;22;185;179;172;52;166;194;114;137;127;89;165;187;146;97;77;141;36;21;8;104;138;182;25;74;118;51;90;121;31;117;1;38;63;135;122;133;10;178;147;6;188;169;132;13;70;3;15;145;195;168;139;11;33;160;29;0;109;35;111;81;153;186;163;103;26;113;180;176,144079821001051523,0.004269
steepest_intra:edges_start:greedy,77,50415,20729,29686,239200,15,77;97;146;187;165;127;89;103;137;114;26;113;194;166;86;185;52;172;179;22;99;130;95;183;140;199;9;148;47;66;94;60;20;59;28;149;4;152;170;34;55;18;62;128;124;143;159;106;176;88;180;163;186;153;81;111;35;109;0;29;160;33;11;139;168;195;145;15;3;70;13;132;169;188;6;147;178;10;133;122;135;63;38;1;117;31;54;121;90;51;118;74;25;182;138;104;8;21;36;141,242603729126348475,0.006010
steepest_intra:edges_start:greedy,78,50903,19838,31065,239200,15,78;36;61;91;141;97;146;187;165;127;89;103;113;194;166;86;185;95;183;140;18;62;124;106;176;163;153;81;77;58;82;8;144;111;35;109;0;29;160;33;49;11;139;168;195;145;15;3;70;161;13;132;169;188;6;134;147;178;10;133;122;72;107;40;100;63;135;38;27;16;1;156;198;117;193;31;73;54;151;19;112;121;131;125;90;191;120;51;118;74;25;182;138;104;21;177;5;45;142;175,3035114077396987622,0.004999
steepest_intra:edges_start:greedy,79,51540,19307,32233,224250,14,79;61;36;78;175;142;45;5;177;21;104;138;182;25;74;118;51;120;191;90;125;131;121;112;19;151;54;73;31;193;117;198;156;1;16;27;38;135;63;100;40;107;72;122;133;10;178;147;134;6;188;169;132;13;161;70;3;15;145;195;168;139;11;49;33;160;29;0;109;35;111;144;8;82;58;77;81;153;163;176;106;124;62;18;95;130;185;86;166;194;113;103;89;127;165;187;146;97;141;91,6994122447376816250,0.005000
steepest_intra:edges_start:greedy,80,50386,19956,30430,224250,14,80;162;142;175;78;36;61;91;141;97;146;187;165;127;89;103;113;194;166;86;185;130;95;183;140;55;18;62;124;106;176;163;153;81;77;58;82;8;144;111;35;109;0;29;160;33;49;11;139;168;195;145;15;3;70;161;13;132;169;188;6;134;147;178;10;133;122;72;107;40;100;63;102;135;131;121;125;90;191;120;51;118;74;25;182;138;104;21;177;5;45;136;73;164;31;54;117;198;193;190,3867105922275572927,0.005000
steepest_intra:edges_start:greedy,81,50415,20729,29686,239200,15,81;153;186;163;180;88;176;106;159;143;124;128;62;18;55;34;170;152;4;149;28;59;20;60;94;66;47;148;9;199;140;183;95;130;99;22;179;172;52;185;86;166;194;113;26;114;137;103;89;127;165;187;146;97;77;141;36;21;8;104;138;182;25;74;118;51;90;121;54;31;117;1;38;63;135;122;133;10;178;147;6;188;169;132;13;70;3;15;145;195;168;139;11;33;160;29;0;109;35;111,2305682274498133543,0.004998
steepest_intra:edges_start:greedy,82,51446,18927,32519,149500,9,82;87;21;58;77;81;153;186;163;180;88;176;106;159;143;124;128;62;18;55;34;170;152;4;149;28;59;20;60;94;66;47;148;9;199;140;183;95;130;99;22;179;172;185;86;166;194;113;114;137;103;89;127;165;187;146;97;141;91;61;36;78;175;142;45;5;177;25;182;138;11;139;134;43;168;195;13;132;169;6;188;161;70;3;15;145;155;189;69;109;35;0;29;160;33;144;56;104;8;111,5464602365910890759,0.003014
steepest_intra:edges_start:greedy,83,47639,20362,27277,179400,11,83;18;55;34;170;152;140;183;95;130;99;9;199;4;149;28;59;20;60;148;47;94;66;57;172;179;185;86;166;194;176;113;26;103;114;137;127;89;163;187;153;81;77;141;91;61;36;78;175;142;45;5;177;21;82;111;8;104;138;182;25;74;118;51;90;121;117;1;38;63;135;122;133;10;178;147;6;188;169;132;13;70;3;15;145;195;168;139;11;33;160;29;0;109;35;143;106;124;128;62,2653673538500048481,0.003971
steepest_intra:edges_start:greedy,84,51155,18278,32877,209300,13,161;70;3;155;189;69;109;35;0;29;111;41;81;153;186;163;180;88;176;106;159;143;124;128;62;18;55;34;170;152;4;149;28;59;20;60;94;66;47;148;9;199;140;183;95;130;99;22;179;172;52;185;86;166;194;113;114;137;103;89;127;165;187;146;97;77;141;91;61;36;78;175;142;45;5;177;21;87;82;8;104;56;144;160;33;138;182;11;139;168;195;43;134;6;188;169;132;13;145;15,9196818649548330607,0.005003
steepest_intra:edges_start:greedy,85,48412,19746,28666,209300,13,85;74;118;51;191;90;131;121;73;54;31;193;117;198;156;1;16;27;38;135;63;100;40;107;72;122;133;10;178;147;6;188;169;132;70;3;15;145;13;195;168;29;0;109;35;111;81;153;163;176;106;124;62;18;55;34;170;152;140;183;95;130;99;179;185;86;166;194;113;103;89;127;165;187;146;97;77;141;91;61;36;78;175;142;45;5;177;21;82;8;104;144;160;33;138;182;11;139;43;134,1560077122695741337,0.004026
steepest_intra:edges_start:greedy,86,47107,20388,26719,164450,10,86;95;130;99;22;66;94;47;148;60;20;59;28;149;4;199;9;183;140;152;170;34;55;18;62;128;124;106;143;35;109;0;29;160;33;11;139;168;195;145;15;3;70;13;132;169;188;6;147;178;10;133;122;135;63;38;1;117;31;121;90;51;118;74;25;182;138;104;8;111;82;21;177;5;45;142;175;78;36;61;91;141;77;81;153;187;163;89;127;137;114;103;26;113;176;194;166;172;179;185,3823336154176598273,0.004244
steepest_intra:edges_start:greedy,87,51446,18927,32519,149500,9,87;82;111;8;104;56;144;33;160;29;0;35;109;69;189;155;145;15;3;70;161;188;6;169;132;13;195;168;43;134;139;11;138;182;25;177;5;45;142;175;78;36;61;91;141;97;146;187;165;127;89;103;137;114;113;194;166;86;185;172;179;22;99;130;95;183;140;199;9;148;47;66;94;60;20;59;28;149;4;152;170;34;55;18;62;128;124;143;159;106;176;88;180;163;186;153;81;77;58;21,1555663538655663518,0.004000
steepest_intra:edges_start:greedy,88,47459,20422,27037,209300,13,180;113;103;114;127;89;163;187;153;81;77;141;91;61;36;78;175;142;45;5;177;21;82;111;8;104;138;182;25;74;118;51;90;121;31;117;1;38;63;135;122;133;10;178;147;6;188;169;132;13;70;3;15;145;195;168;139;11;33;160;29;0;109;35;143;106;124;128;62;18;55;34;170;152;140;183;130;95;86;185;22;99;9;199;4;149;28;59;20;60;148;47;94;66;57;172;179;166;194;176,2555342016507955494,0.004000
steepest_intra:edges_start:greedy,89,50366,20744,29622,239200,15,89;163;165;187;146;97;77;141;36;21;8;104;138;182;25;74;118;51;90;121;54;31;117;1;38;63;135;122;133;10;178;147;6;188;169;132;13;70;3;15;145;195;168;139;11;33;160;29;0;109;35;111;81;153;129;180;88;176;106;159;143;124;128;62;18;55;34;170;152;4;149;28;59;20;60;94;66;47;148;9;199;140;183;95;130;99;22;179;172;52;185;86;166;194;113;26;103;114;137;127,7288478422402573645,0.005002
steepest_intra:edges_start:greedy,90,50622,19759,30863,149500,9,90;191;125;51;98;118;74;134;147;6;188;169;132;13;70;3;15;145;195;168;43;139;11;29;0;109;35;111;81;153;163;176;106;124;62;18;140;183;95;185;86;166;194;113;103;89;127;165;187;97;77;141;91;61;36;78;175;142;45;5;177;21;82;8;104;144;160;33;138;182;25;158;116;121;131;112;19;151;54;73;164;31;193;117;198;156;1;16;27;38;135;102;63;100;40;107;72;10;133;122,3222061331585906823,0.002972
steepest_intra:edges_start:greedy,91,50903,19838,31065,269100,17,91;61;36;78;175;142;45;5;177;21;104;138;182;25;74;118;51;120;191;90;125;131;121;112;19;151;54;73;31;193;117;198;156;1;16;27;38;135;63;100;40;107;72;122;133;10;178;147;134;6;188;169;132;13;161;70;3;15;145;195;168;139;11;49;33;160;29;0;109;35;111;144;8;82;58;77;81;153;163;176;106;124;62;18;140;183;95;185;86;166;194;113;103;89;127;165;187;146;97;141,1245057510373626591,0.005975
steepest_intra:edges_start:greedy,92,52203,18845,33358,194350,12,102;32;135;122;90;191;125;131;38;27;16;1;156;198;117;193;31;164;73;54;151;19;112;121;116;51;98;118;74;85;134;139;182;138;33;160;144;104;8;82;21;177;5;45;142;175;78;36;61;91;141;77;97;187;165;127;89;103;113;194;166;86;185;18;62;124;106;176;163;153;81;111;35;109;0;29;11;43;168;195;13;145;15;3;70;161;132;169;188;6;192;147;178;10;133;72;107;40;100;63,4059321810636025780,0.004000
steepest_intra:edges_start:greedy,93,51961,21018,30943,179400,11,76;75;137;114;127;89;165;187;146;97;77;141;36;21;8;104;138;182;25;74;118;51;90;121;117;1;135;63;122;133;10;178;147;6;188;169;132;13;70;3;15;145;195;168;139;11;33;160;29;0;109;35;111;81;153;186;163;103;26;113;180;176;194;86;128;106;159;143;124;62;18;55;34;170;152;53;4;149;28;59;20;60;94;66;47;148;9;199;140;183;95;130;99;22;185;179;172;52;166;48,8622461990524790615,0.004001
steepest_intra:edges_start:greedy,94,46330,19913,26417,194350,12,94;66;57;172;179;185;22;99;130;95;86;166;194;176;113;26;103;114;137;127;89;163;187;153;81;77;141;91;61;36;78;175;142;45;5;177;21;82;111;8;104;138;182;25;74;118;51;90;121;54;31;117;1;38;63;135;122;133;10;178;147;6;188;169;132;13;70;3;15;145;195;168;139;11;33;160;29;0;109;35;143;106;124;128;62;18;55;34;170;152;183;140;4;149;28;59;20;60;148;47,7458566429831604648,0.004000
steepest_intra:edges_start:greedy,95,47107,20388,26719,164450,10,95;86;185;179;172;166;194;176;113;26;103;114;137;127;89;163;187;153;81;77;141;91;61;36;78;175;142;45;5;177;21;82;111;8;104;138;182;25;74;118;51;90;121;31;117;1;38;63;135;122;133;10;178;147;6;188;169;132;13;70;3;15;145;195;168;139;11;33;160;29;0;109;35;143;106;124;128;62;18;55;34;170;152;140;183;9;199;4;149;28;59;20;60;148;47;94;66;22;99;130,1703952305694167398,0.004274
steepest_intra:edges_start:greedy,96,51667,18843,32824,164450,10,102;135;122;90;191;125;131;38;27;16;1;156;198;117;193;31;164;73;54;151;19;112;121;116;51;98;118;74;85;134;139;182;138;33;160;144;104;8;82;21;177;5;45;142;175;78;36;61;91;141;77;97;187;165;127;89;103;113;194;166;86;185;95;18;62;124;106;176;163;153;81;111;35;109;0;29;11;43;168;195;13;145;15;3;70;161;132;169;188;6;192;147;178;10;133;72;107;40;100;63,611125307297263370,0.003973
steepest_intra:edges_start:greedy,97,50415,20729,29686,239200,15,97;77;141;36;21;8;104;138;182;25;74;118;51;90;121;54;31;117;1;38;63;135;122;133;10;178;147;6;188;169;132;13;70;3;15;145;195;168;139;11;33;160;29;0;109;35;111;81;153;186;163;180;88;176;106;159;143;124;128;62;18;55;34;170;152;4;149;28;59;20;60;94;66;47;148;9;199;140;183;95;130;99;22;179;172;52;185;86;166;194;113;26;114;137;103;89;127;165;187;146,838512001635326439,0.006011
steepest_intra:edges_start:greedy,98,53088,18878,34210,74750,4,98;51;125;90;191;71;147;115;178;10;133;122;72;17;107;40;100;63;102;135;38;27;16;1;156;198;117;193;31;164;73;54;151;19;112;131;121;116;158;25;182;138;33;160;144;104;8;82;21;177;5;45;142;175;78;36;61;91;141;77;97;187;165;127;89;103;113;194;166;179;185;130;95;86;176;163;153;81;111;35;109;0;29;11;139;43;168;195;145;15;3;70;13;132;169;188;6;134;74;118,5572430284678999915,0.002011
steepest_intra:edges_start:greedy,99,47177,20426,26751,149500,9,99;130;95;183;140;152;170;34;55;18;62;128;124;106;143;35;109;0;29;160;33;11;139;168;195;145;15;3;70;13;132;169;188;6;147;178;10;133;122;135;63;38;1;117;31;121;90;51;118;74;25;182;138;104;8;111;82;21;177;5;45;142;175;78;36;61;91;141;77;81;153;187;163;89;127;137;114;103;26;113;176;194;166;86;185;179;172;57;66;94;47;148;60;20;59;28;149;4;199;9,2717396346500256549,0.002999
steepest_intra:edges_start:greedy,100,51667,18843,32824,179400,11,100;40;107;72;133;10;178;147;192;6;188;169;132;161;70;3;15;145;13;195;168;43;11;29;0;109;35;111;81;153;163;176;106;124;62;18;95;185;86;166;194;113;103;89;127;165;187;97;77;141;91;61;36;78;175;142;45;5;177;21;82;8;104;144;160;33;138;182;139;134;85;74;118;98;51;116;121;112;19;151;54;73;164;31;193;117;198;156;1;16;27;38;131;125;191;90;122;135;102;63,238061639678546587,0.004010
steepest_intra:edges_start:greedy,101,46941,19917,27024,164450,10,101;149;4;140;183;152;170;34;55;18;62;128;124;106;143;35;109;0;29;160;33;11;139;168;195;145;15;3;70;13;132;169;188;6;147;178;10;133;122;135;63;38;1;117;31;121;90;51;118;74;25;182;138;104;8;111;82;21;177;5;45;142;175;78;36;61;91;141;77;81;153;187;163;89;127;137;114;103;26;113;176;194;166;86;95;130;99;22;185;179;172;57;66;94;47;148;60;20;59;28,4018791837500591681,0.004004
steepest_intra:edges_start:greedy,102,51667,18843,32824,149500,9,102;135;122;90;191;125;131;38;27;16;1;156;198;117;193;31;164;73;54;151;19;112;121;116;51;98;118;74;85;134;139;182;138;33;160;144;104;8;82;21;177;5;45;142;175;78;36;61;91;141;77;97;187;165;127;89;103;113;194;166;86;185;95;18;62;124;106;176;163;153;81;111;35;109;0;29;11;43;168;195;13;145;15;3;70;161;132;169;188;6;192;147;178;10;133;72;107;40;100;63,7411010858604718217,0.003000
steepest_intra:edges_start:greedy,103,50366,20744,29622,239200,15,103;114;137;127;89;163;165;187;146;97;77;141;36;21;8;104;138;182;25;74;118;51;90;121;54;31;117;1;38;63;135;122;133;10;178;147;6;188;169;132;13;70;3;15;145;195;168;139;11;33;160;29;0;109;35;111;81;153;129;180;88;176;106;159;143;124;128;62;18;55;34;170;152;4;149;28;59;20;60;94;66;47;148;9;199;140;183;95;130;99;22;179;172;52;185;86;166;194;113;26,6030583346496414544,0.006000
steepest_intra:edges_start:greedy,104,47350,21200,26150,299000,19,104;138;182;25;74;118;51;90;131;121;73;54;31;193;117;198;156;1;16;27;38;135;63;40;107;122;133;10;178;147;6;188;169;132;13;70;3;15;145;195;168;139;11;33;160;29;109;35;0;144;111;41;81;153;163;176;106;124;62;18;55;34;170;152;183;140;28;20;148;47;94;179;185;86;166;194;113;114;137;103;89;127;165;187;146;97;77;141;91;61;36;78;175;142;45;5;177;21;82;8,5665024530994823604,0.007000
steepest_intra:edges_start:greedy,105,50736,19889,30847,269100,17,105;193;198;117;54;31;164;73;136;45;5;177;21;104;138;182;25;74;118;51;120;191;90;125;121;131;135;102;63;100;40;107;72;122;133;10;178;147;134;6;188;169;132;13;161;70;3;15;145;195;168;139;11;49;33;160;29;0;109;35;111;144;8;82;58;77;81;153;163;176;106;124;62;18;55;140;183;95;185;86;166;194;113;103;89;127;165;187;146;97;141;91;61;36;78;175;142;162;80;190,3755422540038275707,0.005983
steepest_intra:edges_start:greedy,106,46597,20232,26365,239200,15,106;143;35;109;0;29;160;33;11;139;168;195;145;15;3;70;13;132;169;188;6;147;178;10;133;122;135;63;38;1;198;117;193;31;54;73;121;90;51;118;74;25;182;138;104;144;111;8;82;21;177;5;45;142;175;78;36;61;91;141;77;81;153;187;163;89;127;137;114;103;26;113;176;194;166;172;179;185;130;99;66;94;47;148;60;20;59;28;149;4;140;183;95;86;128;62;18;55;34;124,7296043660280553664,0.005011
steepest_intra:edges_start:greedy,107,51667,18843,32824,149500,9,107;72;133;10;178;147;192;6;188;169;132;161;70;3;15;145;13;195;168;43;11;29;0;109;35;111;81;153;163;176;106;124;62;18;95;185;86;166;194;113;103;89;127;165;187;97;77;141;91;61;36;78;175;142;45;5;177;21;82;8;104;144;160;33;138;182;139;134;85;74;118;98;51;116;121;112;19;151;54;73;164;31;193;117;198;156;1;16;27;38;131;125;191;90;122;135;102;63;100;40,6299423332655969072,0.003000
steepest_intra:edges_start:greedy,108,51916,20167,31749,269100,17,30;190;80;162;142;175;78;36;61;91;141;97;146;187;165;127;89;103;113;194;166;86;185;95;18;62;124;106;176;163;153;81;77;58;82;8;144;111;35;109;0;29;160;33;49;11;139;168;195;145;15;3;70;161;13;132;169;188;6;134;147;178;10;133;122;72;107;40;100;63;102;135;131;121;125;90;191;120;51;118;74;25;182;138;104;21;177;5;45;136;73;164;31;54;193;117;198;1;156;42,7325304442277851052,0.005011
steepest_intra:edges_start:greedy,109,51259,18382,32877,164450,10,109;35;111;41;81;153;186;163;180;88;176;106;159;143;124;128;62;18;55;34;170;152;4;149;28;59;20;60;94;66;47;148;9;199;140;183;95;130;99;22;179;172;52;185;86;166;194;113;114;137;103;89;127;165;187;146;97;77;141;91;61;36;78;175;142;45;5;177;21;87;82;8;104;56;144;160;33;138;182;11;139;134;43;168;195;13;132;169;6;188;161;70;3;15;145;155;189;69;29;0,2659913748758622204,0.002984
steepest_intra:edges_start:greedy,110,50450,20678,29772,149500,9,110;128;106;159;143;124;62;18;55;34;170;152;4;149;28;59;20;60;94;66;47;148;9;199;140;183;95;130;99;22;185;179;172;52;166;194;113;26;103;114;137;127;89;163;165;187;146;97;77;141;36;21;8;104;138;182;25;74;118;51;90;121;54;31;117;1;38;63;135;122;133;10;178;147;6;188;169;132;13;70;3;15;145;195;168;139;11;33;160;29;0;109;35;111;81;153;129;180;176;86,5150998482009365777,0.004000
steepest_intra:edges_start:greedy,111,47120,20950,26170,299000,19,111;35;109;0;29;160;33;11;139;168;195;145;15;3;70;13;132;169;188;6;147;178;10;133;122;72;107;40;100;63;135;38;27;16;1;156;198;117;193;31;54;73;121;131;90;51;118;74;25;182;138;104;8;82;21;177;5;45;142;175;78;36;61;91;141;77;97;146;187;165;127;89;103;137;114;113;194;166;86;185;179;94;47;148;20;28;140;183;152;170;34;55;18;62;124;106;176;163;153;81,2376039201285747814,0.007033
steepest_intra:edges_start:greedy,112,53667,18751,34916,119600,7,112;19;151;54;31;164;73;136;45;5;177;21;104;138;182;134;6;188;169;132;13;161;70;3;15;145;195;168;139;11;49;33;160;29;0;109;35;111;144;8;82;58;77;81;153;163;176;86;95;130;185;179;166;194;113;103;89;127;165;187;146;97;141;91;61;36;78;175;142;162;80;190;193;117;198;156;24;1;16;27;38;92;102;63;96;32;135;122;133;10;178;115;147;71;191;90;51;125;131;121,1003865799250298273,0.003002
steepest_intra:edges_start:greedy,113,47679,20547,27132,149500,9,113;26;103;114;137;127;89;163;187;153;81;77;141;91;61;36;78;175;142;45;5;177;21;82;111;8;104;138;182;25;74;118;51;90;121;117;1;38;63;135;122;133;10;178;147;6;188;169;132;13;70;3;15;145;195;168;139;11;33;160;29;0;109;35;143;106;124;128;62;18;55;34;170;152;140;183;130;95;86;185;22;99;9;199;4;149;28;59;20;60;148;47;94;66;57;172;179;166;194;176,1029523337813797749,0.003000
steepest_intra:edges_start:greedy,114,47117,20416,26701,164450,10,114;103;113;176;194;166;179;172;57;66;94;47;148;60;20;59;28;149;4;199;9;99;22;185;86;95;130;183;140;152;170;34;55;18;62;128;124;106;143;35;109;0;29;160;33;11;139;168;195;145;15;3;70;13;132;169;188;6;147;178;10;133;122;135;63;38;1;117;31;54;121;90;51;118;74;25;182;138;104;8;111;82;21;177;5;45;142;175;78;36;61;91;141;77;81;153;187;163;89;127,9152953495032704302,0.004000
steepest_intra:edges_start:greedy,115,51896,19072,32824,149500,9,178;147;192;6;188;169;132;161;70;3;15;145;13;195;168;43;11;29;0;109;35;111;81;153;163;176;106;124;62;18;95;185;86;166;194;113;103;89;127;165;187;97;77;141;91;61;36;78;175;142;45;5;177;21;82;8;104;144;160;33;138;182;139;134;85;74;118;98;51;116;121;112;19;151;54;73;164;31;193;117;198;156;1;16;27;38;131;125;191;90;135;102;63;100;40;107;72;122;133;10,7905963070652014097,0.003000
steepest_intra:edges_start:greedy,116,53088,18878,34210,74750,4,116;158;25;182;138;33;160;144;104;8;82;21;177;5;45;142;175;78;36;61;91;141;77;97;187;165;127;89;103;113;194;166;179;185;130;95;86;176;163;153;81;111;35;109;0;29;11;139;43;168;195;145;15;3;70;13;132;169;188;6;134;74;118;98;51;125;90;191;71;147;115;178;10;133;122;72;17;107;40;100;63;102;135;38;27;16;1;156;198;117;193;31;164;73;54;151;19;112;131;121,3319919795717289071,0.002000
steepest_intra:edges_start:greedy,117,50386,19956,30430,239200,15,117;54;31;164;73;136;45;5;177;21;104;138;182;25;74;118;51;120;191;90;125;121;131;135;102;63;100;40;107;72;122;133;10;178;147;134;6;188;169;132;13;161;70;3;15;145;195;168;139;11;49;33;160;29;0;109;35;111;144;8;82;58;77;81;153;163;176;106;124;62;18;55;140;183;95;130;185;86;166;194;113;103;89;127;165;187;146;97;141;91;61;36;78;175;142;162;80;190;193;198,3340699445908827384,0.004971
steepest_intra:edges_start:greedy,118,50622,19759,30863,149500,9,118;98;51;125;191;90;122;133;10;72;107;40;100;63;102;135;38;27;16;1;156;198;117;193;31;164;73;54;151;19;112;131;121;116;158;25;182;138;33;160;144;104;8;82;21;177;5;45;142;175;78;36;61;91;141;77;97;187;165;127;89;103;113;194;166;86;185;95;183;140;18;62;124;106;176;163;153;81;111;35;109;0;29;11;139;43;168;195;145;15;3;70;13;132;169;188;6;147;134;74,7142645354622334596,0.003000
steepest_intra:edges_start:greedy,119,51008,18350,32658,134550,8,119;159;143;35;109;0;29;111;41;81;153;186;163;103;89;127;114;137;165;187;146;97;77;141;91;61;36;78;175;142;45;5;177;21;87;82;8;104;56;144;160;33;138;182;11;139;168;195;43;134;6;188;169;132;13;145;15;70;3;189;155;184;170;152;4;149;28;59;20;60;94;66;47;148;9;199;140;183;95;130;99;22;185;179;172;52;166;194;113;180;176;86;128;83;55;34;18;62;124;106,8503831081839655910,0.003025
steepest_intra:edges_start:greedy,120,52138,19237,32901,134550,8,120;51;98;118;74;134;6;188;169;132;13;70;3;15;145;195;168;43;139;11;29;0;109;35;111;81;153;163;176;106;124;62;18;185;86;166;194;113;103;89;127;165;187;97;77;141;91;61;36;78;175;142;45;5;177;21;82;8;104;144;160;33;138;182;25;158;116;121;131;112;19;151;54;73;164;31;193;117;198;156;1;16;27;38;135;102;63;100;40;107;17;72;122;133;10;178;90;191;147;71,7092388019080574857,0.003288
steepest_intra:edges_start:greedy,121,50622,19759,30863,149500,9,121;116;158;25;182;138;33;160;144;104;8;82;21;177;5;45;142;175;78;36;61;91;141;77;97;187;165;127;89;103;113;194;166;86;185;95;183;140;18;62;124;106;176;163;153;81;111;35;109;0;29;11;139;43;168;195;145;15;3;70;13;132;169;188;6;147;134;74;118;98;51;125;191;90;122;133;10;72;107;40;100;63;102;135;38;27;16;1;156;198;117;193;31;164;73;54;151;19;112;131,5038633075621335478,0.003032
steepest_intra:edges_start:greedy,122,51667,18843,32824,149500,9,122;90;191;125;131;38;27;16;1;156;198;117;193;31;164;73;54;151;19;112;121;116;51;98;118;74;85;134;139;182;138;33;160;144;104;8;82;21;177;5;45;142;175;78;36;61;91;141;77;97;187;165;127;89;103;113;194;166;86;185;95;18;62;124;106;176;163;153;81;111;35;109;0;29;11;43;168;195;13;145;15;3;70;161;132;169;188;6;192;147;178;10;133;72;107;40;100;63;102;135,4718739976705916227,0.004031
steepest_intra:edges_start:greedy,123,51495,19334,32161,269100,17,87;21;177;5;45;142;175;78;36;61;91;141;97;146;187;165;127;89;103;113;194;166;86;185;130;95;18;62;124;106;176;163;153;81;77;58;82;8;144;111;35;109;0;29;160;33;49;11;139;168;195;145;15;3;70;161;13;132;169;188;6;134;147;178;10;133;122;72;107;40;100;63;135;38;27;16;1;156;198;117;193;31;73;54;151;19;112;121;131;125;90;191;120;51;118;74;25;182;138;104,3039023651685256008,0.006002
steepest_intra:edges_start:greedy,124,46597,20232,26365,239200,15,124;34;55;18;62;128;86;95;183;140;4;149;28;59;20;60;148;47;94;66;99;130;185;179;172;166;194;176;113;26;103;114;137;127;89;163;187;153;81;77;141;91;61;36;78;175;142;45;5;177;21;82;8;111;144;104;138;182;25;74;118;51;90;121;73;54;31;193;117;198;1;38;63;135;122;133;10;178;147;6;188;169;132;13;70;3;15;145;195;168;139;11;33;160;29;0;109;35;143;106,7441288991842194738,0.005002
steepest_intra:edges_start:greedy,125,51777,18920,32857,134550,8,125;122;133;10;72;107;40;100;63;102;135;38;27;16;1;156;198;117;193;31;164;73;54;151;19;112;131;121;116;51;98;118;74;85;134;139;182;138;33;160;144;104;8;82;21;177;5;45;142;175;78;36;61;91;141;77;97;187;165;127;89;103;113;194;166;86;185;95;18;62;124;106;176;163;153;81;111;35;109;0;29;11;43;168;195;13;145;15;3;70;161;132;169;188;6;192;147;71;191;90,7288723067398284149,0.003001
steepest_intra:edges_start:greedy,126,48410,19796,28614,209300,13,126;195;168;29;0;109;35;111;81;153;163;176;106;124;62;18;55;34;170;152;140;183;95;130;99;179;185;86;166;194;113;103;89;127;165;187;146;97;77;141;91;61;36;78;175;142;45;5;177;21;82;8;104;144;160;33;138;182;11;139;43;134;74;118;51;191;90;131;121;73;54;31;193;117;198;156;1;16;27;38;135;63;100;40;107;72;122;133;10;178;147;6;188;169;132;70;3;15;145;13,2809101194420245039,0.005003
steepest_intra:edges_start:greedy,127,50366,20744,29622,239200,15,127;137;114;103;26;113;194;166;86;185;52;172;179;22;99;130;95;183;140;199;9;148;47;66;94;60;20;59;28;149;4;152;170;34;55;18;62;128;124;143;159;106;176;88;180;129;153;81;111;35;109;0;29;160;33;11;139;168;195;145;15;3;70;13;132;169;188;6;147;178;10;133;122;135;63;38;1;117;31;54;121;90;51;118;74;25;182;138;104;8;21;36;141;77;97;146;187;165;163;89,4552804921397897265,0.006002
steepest_intra:edges_start:greedy,128,50221,20738,29483,164450,10,128;88;176;180;129;153;81;111;35;109;0;29;160;33;11;139;168;195;145;15;3;70;13;132;169;188;6;147;178;10;133;122;135;63;38;1;117;31;54;121;90;51;118;74;25;182;138;104;8;21;36;141;77;97;146;187;165;163;89;127;137;114;103;26;113;194;166;86;185;179;172;57;66;94;47;148;60;20;59;28;149;4;199;9;99;22;130;95;183;140;152;170;34;55;18;62;124;143;159;106,4224852698409768808,0.004030
steepest_intra:edges_start:greedy,129,49836,20721,29115,179400,11,129;153;81;111;35;109;0;29;160;33;11;139;168;195;145;15;3;70;13;132;169;188;6;147;178;10;133;122;135;63;38;1;117;193;31;54;121;90;51;118;74;25;182;138;104;8;21;36;141;77;97;146;187;165;163;89;127;137;114;103;26;113;194;166;52;172;179;185;22;99;130;95;183;140;199;9;148;47;66;94;60;20;59;28;149;4;152;170;34;55;18;62;124;143;159;106;128;86;176;180,7546056766429228183,0.003998
steepest_intra:edges_start:greedy,130,47177,20426,26751,149500,9,130;95;183;140;152;170;34;55;18;62;128;124;106;143;35;109;0;29;160;33;11;139;168;195;145;15;3;70;13;132;169;188;6;147;178;10;133;122;135;63;38;1;117;31;121;90;51;118;74;25;182;138;104;8;111;82;21;177;5;45;142;175;78;36;61;91;141;77;81;153;187;163;89;127;137;114;103;26;113;176;194;166;86;185;179;172;57;66;94;47;148;60;20;59;28;149;4;199;9;99,2465798464748204156,0.003000
steepest_intra:edges_start:greedy,131,50622,19759,30863,149500,9,131;112;19;151;54;73;164;31;193;117;198;156;1;16;27;38;135;102;63;100;40;107;72;10;133;122;90;191;125;51;98;118;74;134;147;6;188;169;132;13;70;3;15;145;195;168;43;139;11;29;0;109;35;111;81;153;163;176;106;124;62;18;140;183;95;185;86;166;194;113;103;89;127;165;187;97;77;141;91;61;36;78;175;142;45;5;177;21;82;8;104;144;160;33;138;182;25;158;116;121,6491305714848775534,0.003000
steepest_intra:edges_start:greedy,132,48258,19780,28478,209300,13,132;13;70;3;15;145;195;168;29;0;109;35;111;81;153;163;176;106;124;62;18;55;34;170;152;140;183;95;130;99;22;179;185;86;166;194;113;103;89;127;165;187;146;97;77;141;91;61;36;78;175;142;45;5;177;21;82;8;104;144;160;33;138;182;11;139;43;134;74;118;51;191;90;131;121;73;54;31;193;117;198;156;1;16;27;38;135;63;100;40;107;72;122;133;10;178;147;6;188;169,7479817416556427169,0.004000
steepest_intra:edges_start:greedy,133,53088,18878,34210,74750,4,133;10;178;115;147;71;191;90;125;51;98;118;74;134;6;188;169;132;13;70;3;15;145;195;168;43;139;11;29;0;109;35;111;81;153;163;176;86;95;130;185;179;166;194;113;103;89;127;165;187;97;77;141;91;61;36;78;175;142;45;5;177;21;82;8;104;144;160;33;138;182;25;158;116;121;131;112;19;151;54;73;164;31;193;117;198;156;1;16;27;38;135;102;63;100;40;107;17;72;122,3813461121703641702,0.002000
steepest_intra:edges_start:greedy,134,48214,19736,28478,224250,14,134;74;118;51;191;90;131;121;73;54;31;193;117;198;156;1;16;27;38;135;63;100;40;107;72;122;133;10;178;147;6;188;169;132;70;3;15;145;13;195;168;29;0;109;35;111;81;153;163;176;106;124;62;18;55;34;170;152;140;183;95;130;99;22;179;185;86;166;194;113;103;89;127;165;187;146;97;77;141;91;61;36;78;175;142;45;5;177;21;82;8;104;144;160;33;138;182;11;139;43,5574420430585200419,0.005000
steepest_intra:edges_start:greedy,135,51667,18843,32824,149500,9,135;122;90;191;125;131;38;27;16;1;156;198;117;193;31;164;73;54;151;19;112;121;116;51;98;118;74;85;134;139;182;138;33;160;144;104;8;82;21;177;5;45;142;175;78;36;61;91;141;77;97;187;165;127;89;103;113;194;166;86;185;95;18;62;124;106;176;163;153;81;111;35;109;0;29;11;43;168;195;13;145;15;3;70;161;132;169;188;6;192;147;178;10;133;72;107;40;100;63;102,956284015855198507,0.002999
steepest_intra:edges_start:greedy,136,50386,19956,30430,224250,14,136;45;5;177;21;104;138;182;25;74;118;51;120;191;90;125;121;131;135;102;63;100;40;107;72;122;133;10;178;147;134;6;188;169;132;13;161;70;3;15;145;195;168;139;11;49;33;160;29;0;109;35;111;144;8;82;58;77;81;153;163;176;106;124;62;18;55;140;183;95;130;185;86;166;194;113;103;89;127;165;187;146;97;141;91;61;36;78;175;142;162;80;190;193;198;117;54;31;164;73,6282407555612808221,0.005037
steepest_intra:edges_start:greedy,137,50122,20575,29547,239200,15,137;114;194;166;179;172;57;66;94;47;148;60;20;59;28;149;4;199;9;99;22;185;86;95;130;183;140;152;170;34;55;18;62;128;124;143;159;106;176;180;88;113;26;103;163;186;153;81;111;35;109;0;29;160;33;11;139;168;195;145;15;3;70;13;132;169;188;6;147;178;10;133;122;135;63;38;1;117;31;54;121;90;51;118;74;25;182;138;104;8;21;36;141;77;97;146;187;165;89;127,4702106371173204811,0.005997
steepest_intra:edges_start:greedy,138,51259,18382,32877,164450,10,138;182;11;139;134;43;168;195;13;132;169;6;188;161;70;3;15;145;155;189;69;29;0;109;35;111;41;81;153;186;163;180;88;176;106;159;143;124;128;62;18;55;34;170;152;4;149;28;59;20;60;94;66;47;148;9;199;140;183;95;130;99;22;179;172;52;185;86;166;194;113;114;137;103;89;127;165;187;146;97;77;141;91;61;36;78;175;142;45;5;177;21;87;82;8;104;56;144;160;33,7991533030280131061,0.004000
steepest_intra:edges_start:greedy,139,51268,18026,33242,179400,11,139;11;182;138;33;160;144;56;104;8;82;87;21;177;5;45;142;175;78;36;61;79;91;141;77;97;146;187;165;127;89;103;137;114;113;194;166;86;185;52;172;179;22;99;130;95;183;140;199;9;148;47;66;94;60;20;59;28;149;4;152;170;34;55;18;62;128;124;143;159;106;176;88;180;163;186;153;81;41;111;35;109;0;29;69;189;155;145;15;3;70;161;188;6;169;132;13;195;168;43,8689295712640691473,0.004002
steepest_intra:edges_start:greedy,140,47177,20426,26751,149500,9,140;152;170;34;55;18;62;128;124;106;143;35;109;0;29;160;33;11;139;168;195;145;15;3;70;13;132;169;188;6;147;178;10;133;122;135;63;38;1;117;31;121;90;51;118;74;25;182;138;104;8;111;82;21;177;5;45;142;175;78;36;61;91;141;77;81;153;187;163;89;127;137;114;103;26;113;176;194;166;86;185;179;172;57;66;94;47;148;60;20;59;28;149;4;199;9;99;130;95;183,1437145038707977004,0.003000
steepest_intra:edges_start:greedy,141,50415,20729,29686,239200,15,141;36;21;8;104;138;182;25;74;118;51;90;121;54;31;117;1;38;63;135;122;133;10;178;147;6;188;169;132;13;70;3;15;145;195;168;139;11;33;160;29;0;109;35;111;81;153;186;163;180;88;176;106;159;143;124;128;62;18;55;34;170;152;4;149;28;59;20;60;94;66;47;148;9;199;140;183;95;130;99;22;179;172;52;185;86;166;194;113;26;114;137;103;89;127;165;187;146;97;77,7459847010036266336,0.005004
steepest_intra:edges_start:greedy,142,50903,19838,31065,239200,15,142;45;5;177;21;104;138;182;25;74;118;51;120;191;90;125;131;121;112;19;151;54;73;31;193;117;198;156;1;16;27;38;135;63;100;40;107;72;122;133;10;178;147;134;6;188;169;132;13;161;70;3;15;145;195;168;139;11;49;33;160;29;0;109;35;111;144;8;82;58;77;81;153;163;176;106;124;62;18;140;183;95;185;86;166;194;113;103;89;127;165;187;146;97;141;91;61;36;78;175,5918247181761595438,0.005978
steepest_intra:edges_start:greedy,143,50703,18111,32592,134550,8,143;35;109;0;29;111;41;81;153;186;163;103;89;127;114;137;165;187;146;97;77;141;91;79;61;36;78;175;142;45;5;177;21;87;82;8;104;56;144;160;33;138;182;11;139;168;195;43;134;6;188;169;132;13;145;15;70;3;189;155;184;170;152;4;149;28;59;20;60;94;66;47;148;9;199;140;183;95;130;99;22;185;179;172;52;166;194;113;180;176;86;128;83;55;34;18;62;124;106;159,3827410347452086177,0.003005
steepest_intra:edges_start:greedy,144,47350,21200,26150,299000,19,144;0;35;109;29;160;33;11;139;168;195;145;15;3;70;13;132;169;188;6;147;178;10;133;122;107;40;63;135;38;27;16;1;156;198;117;193;31;54;73;121;131;90;51;118;74;25;182;138;104;8;82;21;177;5;45;142;175;78;36;61;91;141;77;97;146;187;165;127;89;103;137;114;113;194;166;86;185;179;94;47;148;20;28;140;183;152;170;34;55;18;62;124;106;176;163;153;81;41;111,7003932801975599570,0.006028
steepest_intra:edges_start:greedy,145,49983,17472,32511,59800,3,145;195;168;126;13;132;169;6;188;161;70;3;155;184;170;152;140;183;95;130;22;99;9;199;4;149;28;59;20;60;148;47;94;66;57;172;52;179;185;86;166;194;176;180;113;26;103;114;137;127;89;163;165;187;146;153;81;77;97;141;91;79;61;36;78;175;142;45;5;177;21;87;82;111;144;56;8;104;138;182;139;11;49;33;160;29;0;109;35;143;159;106;124;128;62;18;55;34;189;15,900642505263212688,0.001005
steepest_intra:edges_start:greedy,146,50415,20729,29686,239200,15,146;187;165;127;89;103;137;114;26;113;194;166;86;185;52;172;179;22;99;130;95;183;140;199;9;148;47;66;94;60;20;59;28;149;4;152;170;34;55;18;62;128;124;143;159;106;176;88;180;163;186;153;81;111;35;109;0;29;160;33;11;139;168;195;145;15;3;70;13;132;169;188;6;147;178;10;133;122;135;63;38;1;117;31;54;121;90;51;118;74;25;182;138;104;8;21;36;141;77;97,8490658594476258174,0.005003
steepest_intra:edges_start:greedy,147,50740,19257,31483,194350,12,147;192;6;188;169;132;161;70;3;15;145;13;195;168;43;11;29;0;109;35;111;81;153;163;176;106;124;62;18;140;183;95;185;86;166;194;113;103;89;127;165;187;97;77;141;91;61;36;78;175;142;45;5;177;21;82;8;104;144;160;33;138;182;139;134;85;74;118;98;51;125;131;121;112;54;73;164;31;193;117;198;156;1;16;27;38;135;102;63;100;40;107;72;122;133;10;178;90;191;71,8735301334828735373,0.004001
steepest_intra:edges_start:greedy,148,45867,19796,26071,239200,15,148;47;94;66;179;22;99;130;95;185;86;166;194;176;113;26;103;114;137;127;89;163;187;153;81;77;141;91;61;36;78;175;142;45;5;177;21;82;111;8;104;138;182;25;74;118;51;90;121;73;54;31;193;117;1;38;63;135;122;133;10;178;147;6;188;169;132;13;70;3;15;145;195;168;139;11;33;160;29;0;109;35;143;106;124;128;62;18;55;34;170;152;183;140;4;149;28;59;20;60,2513875184585586851,0.005003
steepest_intra:edges_start:greedy,149,46330,19913,26417,164450,10,149;4;140;183;152;170;34;55;18;62;128;124;106;143;35;109;0;29;160;33;11;139;168;195;145;15;3;70;13;132;169;188;6;147;178;10;133;122;135;63;38;1;117;31;54;121;90;51;118;74;25;182;138;104;8;111;82;21;177;5;45;142;175;78;36;61;91;141;77;81;153;187;163;89;127;137;114;103;26;113;176;194;166;86;95;130;99;22;185;179;172;57;66;94;47;148;60;20;59;28,586113222885846696,0.003973
steepest_intra:edges_start:greedy,150,50383,19010,31373,254150,16,90;51;121;25;138;33;160;144;56;104;8;82;87;21;177;5;45;142;175;78;36;61;91;141;77;97;146;187;165;127;89;103;137;114;113;194;166;86;185;52;172;179;22;99;130;95;183;140;199;9;148;47;66;94;60;20;59;28;149;4;152;170;34;55;18;62;128;124;143;159;106;176;88;180;163;186;153;81;41;111;35;109;0;29;49;11;139;168;195;145;15;3;70;161;13;132;169;188;6;147,4638037109392358645,0.007001
steepest_intra:edges_start:greedy,151,51190,18543,32647,164450,10,151;54;73;164;31;193;117;198;156;1;16;27;38;102;63;96;32;135;122;133;10;178;115;147;71;191;90;125;51;98;118;74;134;6;188;169;132;13;70;3;15;145;195;168;43;139;11;29;0;109;35;111;81;153;163;176;106;124;62;18;140;183;95;185;86;166;194;113;103;89;127;165;187;97;77;141;91;61;36;78;175;142;45;5;177;21;82;8;104;144;160;33;138;182;25;158;116;121;112;19,2300040162382003353,0.003011
steepest_intra:edges_start:greedy,152,47177,20426,26751,149500,9,152;170;34;55;18;62;128;124;106;143;35;109;0;29;160;33;11;139;168;195;145;15;3;70;13;132;169;188;6;147;178;10;133;122;135;63;38;1;117;31;121;90;51;118;74;25;182;138;104;8;111;82;21;177;5;45;142;175;78;36;61;91;141;77;81;153;187;163;89;127;137;114;103;26;113;176;194;166;86;185;179;172;57;66;94;47;148;60;20;59;28;149;4;199;9;99;130;95;183;140,3348815458057250930,0.004003
steepest_intra:edges_start:greedy,153,50415,20729,29686,239200,15,153;81;111;35;109;0;29;160;33;11;139;168;195;145;15;3;70;13;132;169;188;6;147;178;10;133;122;135;63;38;1;117;31;54;121;90;51;118;74;25;182;138;104;8;21;36;141;77;97;146;187;165;127;89;103;137;114;26;113;194;166;86;185;52;172;179;22;99;130;95;183;140;199;9;148;47;66;94;60;20;59;28;149;4;152;170;34;55;18;62;128;124;143;159;106;176;88;180;163;186,6671791740018888657,0.005267
steepest_intra:edges_start:greedy,154,46829,19929,26900,194350,12,154;47;148;60;20;59;28;149;4;140;183;152;170;34;55;18;62;128;124;106;143;35;109;0;29;160;33;11;139;168;195;145;15;3;70;13;132;169;188;6;147;178;10;133;122;135;63;38;1;117;31;121;90;51;118;74;25;182;138;104;8;111;82;21;177;5;45;142;175;78;36;61;91;141;77;81;153;187;163;89;127;137;114;103;26;113;176;194;166;86;95;130;99;22;185;179;172;57;66;94,412108436217475457,0.004001
steepest_intra:edges_start:greedy,155,49983,17472,32511,59800,3,155;184;170;152;140;183;95;130;22;99;9;199;4;149;28;59;20;60;148;47;94;66;57;172;52;179;185;86;166;194;176;180;113;26;103;114;137;127;89;163;165;187;146;153;81;77;97;141;91;79;61;36;78;175;142;45;5;177;21;87;82;111;144;56;8;104;138;182;139;11;49;33;160;29;0;109;35;143;159;106;124;128;62;18;55;34;189;15;145;195;168;126;13;132;169;6;188;161;70;3,235756536699258460,0.001000
steepest_intra:edges_start:greedy,156,51190,18543,32647,164450,10,156;198;117;193;31;164;73;54;151;19;112;121;116;158;25;182;138;33;160;144;104;8;82;21;177;5;45;142;175;78;36;61;91;141;77;97;187;165;127;89;103;113;194;166;86;185;95;183;140;18;62;124;106;176;163;153;81;111;35;109;0;29;11;139;43;168;195;145;15;3;70;13;132;169;188;6;134;74;118;98;51;125;90;191;71;147;115;178;10;133;122;135;32;96;63;102;38;27;16;1,3124055582849335119,0.003990
steepest_intra:edges_start:greedy,157,47340,21204,26136,373750,24,56;8;82;21;177;5;45;142;175;78;36;61;91;141;77;97;146;187;165;127;89;103;137;114;113;194;166;86;185;179;94;47;148;20;28;140;183;152;170;34;55;18;62;124;106;176;163;153;81;41;111;144;0;35;109;29;160;33;11;139;168;195;145;15;3;70;13;132;169;188;6;147;10;133;122;107;40;63;135;38;27;16;1;156;198;117;193;31;54;73;121;131;90;51;118;74;25;182;138;104,7257833032268562275,0.010036
steepest_intra:edges_start:greedy,158,48755,19958,28797,164450,10,158;25;182;138;33;160;144;104;8;82;21;177;5;45;142;175;78;36;61;91;141;77;97;187;165;127;89;103;113;194;166;179;185;86;95;130;183;140;152;170;34;55;18;62;124;106;176;163;153;81;111;35;109;0;29;11;139;43;168;195;145;15;3;70;13;132;169;188;6;147;134;74;118;98;51;191;90;122;133;10;107;40;100;63;102;135;38;27;16;1;156;198;117;193;31;54;73;19;112;121,6859863369276710870,0.003002
steepest_intra:edges_start:greedy,159,50703,18111,32592,134550,8,159;143;35;109;0;29;111;41;81;153;186;163;103;89;127;114;137;165;187;146;97;77;141;91;79;61;36;78;175;142;45;5;177;21;87;82;8;104;56;144;160;33;138;182;11;139;168;195;43;134;6;188;169;132;13;145;15;70;3;189;155;184;170;152;4;149;28;59;20;60;94;66;47;148;9;199;140;183;95;130;99;22;185;179;172;52;166;194;113;180;176;86;128;83;55;34;18;62;124;106,8195935293993703464,0.003011
steepest_intra:edges_start:greedy,160,51259,18382,32877,164450,10,160;144;56;104;8;82;87;21;177;5;45;142;175;78;36;61;91;141;77;97;146;187;165;127;89;103;137;114;113;194;166;86;185;52;172;179;22;99;130;95;183;140;199;9;148;47;66;94;60;20;59;28;149;4;152;170;34;55;18;62;128;124;143;159;106;176;88;180;163;186;153;81;41;111;35;109;0;29;69;189;155;145;15;3;70;161;188;6;169;132;13;195;168;43;134;139;11;182;138;33,4113558457527488008,0.004000
steepest_intra:edges_start:greedy,161,49983,17472,32511,59800,3,161;188;6;169;132;13;126;168;195;145;15;189;34;55;18;62;128;124;106;159;143;35;109;0;29;160;33;49;11;139;182;138;104;8;56;144;111;82;87;21;177;5;45;142;175;78;36;61;79;91;141;97;77;81;153;146;187;165;163;89;127;137;114;103;26;113;180;176;194;166;86;185;179;52;172;57;66;94;47;148;60;20;59;28;149;4;199;9;99;22;130;95;183;140;152;170;184;155;3;70,1530525443724351179,0.001000
steepest_intra:edges_start:greedy,162,50386,19956,30430,224250,14,162;80;190;193;198;117;54;31;164;73;136;45;5;177;21;104;138;182;25;74;118;51;120;191;90;125;121;131;135;102;63;100;40;107;72;122;133;10;178;147;134;6;188;169;132;13;161;70;3;15;145;195;168;139;11;49;33;160;29;0;109;35;111;144;8;82;58;77;81;153;163;176;106;124;62;18;55;140;183;95;130;185;86;166;194;113;103;89;127;165;187;146;97;141;91;61;36;78;175;142,5701305216564945689,0.006000
steepest_intra:edges_start:greedy,163,50366,20744,29622,239200,15,163;89;127;137;114;103;26;113;194;166;86;185;52;172;179;22;99;130;95;183;140;199;9;148;47;66;94;60;20;59;28;149;4;152;170;34;55;18;62;128;124;143;159;106;176;88;180;129;153;81;111;35;109;0;29;160;33;11;139;168;195;145;15;3;70;13;132;169;188;6;147;178;10;133;122;135;63;38;1;117;31;54;121;90;51;118;74;25;182;138;104;8;21;36;141;77;97;146;187;165,682887858196909799,0.005001
steepest_intra:edges_start:greedy,164,50386,19956,30430,239200,15,164;31;54;117;198;193;190;80;162;142;175;78;36;61;91;141;97;146;187;165;127;89;103;113;194;166;86;185;130;95;183;140;55;18;62;124;106;176;163;153;81;77;58;82;8;144;111;35;109;0;29;160;33;49;11;139;168;195;145;15;3;70;161;13;132;169;188;6;134;147;178;10;133;122;72;107;40;100;63;102;135;131;121;125;90;191;120;51;118;74;25;182;138;104;21;177;5;45;136;73,3363596271782921140,0.006000
steepest_intra:edges_start:greedy,165,50415,20729,29686,239200,15,165;187;146;97;77;141;36;21;8;104;138;182;25;74;118;51;90;121;54;31;117;1;38;63;135;122;133;10;178;147;6;188;169;132;13;70;3;15;145;195;168;139;11;33;160;29;0;109;35;111;81;153;186;163;180;88;176;106;159;143;124;128;62;18;55;34;170;152;4;149;28;59;20;60;94;66;47;148;9;199;140;183;95;130;99;22;179;172;52;185;86;166;194;113;26;114;137;103;89;127,460113249781974900,0.005268
steepest_intra:edges_start:greedy,166,47679,20547,27132,149500,9,166;194;176;113;26;103;114;137;127;89;163;187;153;81;77;141;91;61;36;78;175;142;45;5;177;21;82;111;8;104;138;182;25;74;118;51;90;121;117;1;38;63;135;122;133;10;178;147;6;188;169;132;13;70;3;15;145;195;168;139;11;33;160;29;0;109;35;143;106;124;128;62;18;55;34;170;152;140;183;130;95;86;185;22;99;9;199;4;149;28;59;20;60;148;47;94;66;57;172;179,806096556867305805,0.004000
steepest_intra:edges_start:greedy,167,51398,18435,32963,179400,11,167;189;69;109;35;0;29;111;41;81;153;186;163;180;88;176;106;159;143;124;128;62;18;55;34;170;152;4;149;28;59;20;60;94;66;47;148;9;199;140;183;95;130;99;22;179;172;185;86;166;194;113;114;137;103;89;127;165;187;146;97;77;141;91;61;36;78;175;142;45;5;177;21;87;82;8;104;56;144;160;33;138;182;11;139;168;195;43;134;6;188;169;132;13;145;15;70;3;155;184,254765863497458788,0.004000
steepest_intra:edges_start:greedy,168,48258,19780,28478,209300,13,168;195;145;15;3;70;13;132;169;188;6;147;178;10;133;122;72;107;40;100;63;135;38;27;16;1;156;198;117;193;31;54;73;121;131;90;191;51;118;74;134;43;139;11;182;138;33;160;144;104;8;82;21;177;5;45;142;175;78;36;61;91;141;77;97;146;187;165;127;89;103;113;194;166;86;185;179;22;99;130;95;183;140;152;170;34;55;18;62;124;106;176;163;153;81;111;35;109;0;29,3429728291572243051,0.004000
steepest_intra:edges_start:greedy,169,48258,19780,28478,209300,13,169;132;13;70;3;15;145;195;168;29;0;109;35;111;81;153;163;176;106;124;62;18;55;34;170;152;140;183;95;130;99;22;179;185;86;166;194;113;103;89;127;165;187;146;97;77;141;91;61;36;78;175;142;45;5;177;21;82;8;104;144;160;33;138;182;11;139;43;134;74;118;51;191;90;131;121;73;54;31;193;117;198;156;1;16;27;38;135;63;100;40;107;72;122;133;10;178;147;6;188,6613213003269089067,0.005164
steepest_intra:edges_start:greedy,170,47177,20426,26751,149500,9,170;34;55;18;62;128;124;106;143;35;109;0;29;160;33;11;139;168;195;145;15;3;70;13;132;169;188;6;147;178;10;133;122;135;63;38;1;117;31;121;90;51;118;74;25;182;138;104;8;111;82;21;177;5;45;142;175;78;36;61;91;141;77;81;153;187;163;89;127;137;114;103;26;113;176;194;166;86;185;179;172;57;66;94;47;148;60;20;59;28;149;4;199;9;99;130;95;183;140;152,5164171019887728791,0.004030
steepest_intra:edges_start:greedy,171,51616,19764,31852,194350,12,25;121;182;138;11;139;134;43;168;195;13;132;169;6;188;161;70;3;15;145;155;189;69;109;35;0;29;160;33;144;56;104;8;111;82;87;21;58;77;81;153;186;163;180;88;176;106;143;124;128;62;18;55;34;170;152;4;149;28;59;20;60;94;66;47;148;9;199;140;183;95;130;99;22;179;172;185;86;166;194;113;114;137;103;89;127;165;187;146;97;141;91;61;36;78;175;142;45;5;177,7527681694423017250,0.005032
steepest_intra:edges_start:greedy,172,47297,20578,26719,149500,9,172;166;194;176;113;26;103;114;137;127;89;163;187;153;81;77;141;91;61;36;78;175;142;45;5;177;21;82;111;8;104;138;182;25;74;118;51;90;121;31;117;1;38;63;135;122;133;10;178;147;6;188;169;132;13;70;3;15;145;195;168;139;11;33;160;29;0;109;35;143;106;124;128;62;18;55;34;170;152;140;183;130;95;86;185;22;99;9;199;4;149;28;59;20;60;148;47;94;66;179,2023117061883976846,0.003000
steepest_intra:edges_start:greedy,173,51598,19450,32148,179400,11,173;73;164;193;31;54;151;117;198;156;1;16;27;38;63;135;122;133;10;178;147;71;51;191;90;125;131;121;112;158;25;177;21;104;138;182;134;6;188;169;132;13;161;70;3;15;145;195;168;139;11;49;33;160;29;0;109;35;111;144;8;82;58;77;81;153;163;176;106;124;62;18;95;130;185;86;166;194;113;103;89;127;165;187;146;97;141;91;61;36;7;5;45;142;78;175;162;80;190;136,916115967188351881,0.004000
steepest_intra:edges_start:greedy,174,47961,20449,27512,254150,16,174;55;18;62;128;86;95;130;99;22;185;179;172;166;194;176;113;26;103;114;137;127;89;163;187;153;81;77;141;91;61;36;78;175;142;45;5;177;21;82;8;111;144;104;138;182;25;74;118;51;90;131;121;73;54;31;193;117;198;156;1;16;27;38;135;63;40;107;122;133;10;178;147;6;188;169;132;13;70;3;15;145;195;168;139;11;33;160;29;0;109;35;143;106;124;34;170;152;140;183,4671011237058699761,0.005002
steepest_intra:edges_start:greedy,175,50903,19838,31065,239200,15,175;78;36;61;91;141;97;146;187;165;127;89;103;113;194;166;86;185;95;183;140;18;62;124;106;176;163;153;81;77;58;82;8;144;111;35;109;0;29;160;33;49;11;139;168;195;145;15;3;70;161;13;132;169;188;6;134;147;178;10;133;122;72;107;40;100;63;135;38;27;16;1;156;198;117;193;31;73;54;151;19;112;121;131;125;90;191;120;51;118;74;25;182;138;104;21;177;5;45;142,6844085816070077116,0.005005
steepest_intra:edges_start:greedy,176,47679,20547,27132,149500,9,176;194;166;179;172;57;66;94;47;148;60;20;59;28;149;4;199;9;99;22;185;86;95;130;183;140;152;170;34;55;18;62;128;124;106;143;35;109;0;29;160;33;11;139;168;195;145;15;3;70;13;132;169;188;6;147;178;10;133;122;135;63;38;1;117;121;90;51;118;74;25;182;138;104;8;111;82;21;177;5;45;142;175;78;36;61;91;141;77;81;153;187;163;89;127;137;114;103;26;113,8298330848075617312,0.002999
steepest_intra:edges_start:greedy,177,50903,19838,31065,239200,15,177;21;104;138;182;25;74;118;51;120;191;90;125;131;121;112;19;151;54;73;31;193;117;198;156;1;16;27;38;135;63;100;40;107;72;122;133;10;178;147;134;6;188;169;132;13;161;70;3;15;145;195;168;139;11;49;33;160;29;0;109;35;111;144;8;82;58;77;81;153;163;176;106;124;62;18;140;183;95;185;86;166;194;113;103;89;127;165;187;146;97;141;91;61;36;78;175;142;45;5,4214461168986918456,0.005039
steepest_intra:edges_start:greedy,178,53088,18878,34210,74750,4,178;10;133;122;72;17;107;40;100;63;102;135;38;27;16;1;156;198;117;193;31;164;73;54;151;19;112;131;121;116;158;25;182;138;33;160;144;104;8;82;21;177;5;45;142;175;78;36;61;91;141;77;97;187;165;127;89;103;113;194;166;179;185;130;95;86;176;163;153;81;111;35;109;0;29;11;139;43;168;195;145;15;3;70;13;132;169;188;6;134;74;118;98;51;125;90;191;71;147;115,6138551450546640976,0.002032
steepest_intra:edges_start:greedy,179,47679,20547,27132,149500,9,179;166;194;176;113;26;103;114;137;127;89;163;187;153;81;77;141;91;61;36;78;175;142;45;5;177;21;82;111;8;104;138;182;25;74;118;51;90;121;117;1;38;63;135;122;133;10;178;147;6;188;169;132;13;70;3;15;145;195;168;139;11;33;160;29;0;109;35;143;106;124;128;62;18;55;34;170;152;140;183;130;95;86;185;22;99;9;199;4;149;28;59;20;60;148;47;94;66;57;172,1757669847499812186,0.003998
steepest_intra:edges_start:greedy,180,47851,20468,27383,134550,8,180;113;26;103;114;137;127;89;163;187;153;81;77;141;91;61;36;78;175;142;45;5;177;21;82;111;8;104;138;182;25;74;118;51;90;121;117;1;135;63;122;133;10;178;147;6;188;169;132;13;70;3;15;145;195;168;139;11;33;160;29;0;109;35;143;106;124;128;62;18;55;34;170;152;140;183;130;95;86;185;22;99;9;199;4;149;28;59;20;60;148;47;94;66;57;172;179;166;194;176,5345460072119486015,0.003000
steepest_intra:edges_start:greedy,181,47800,20498,27302,164450,10,174;183;140;152;170;34;55;18;62;128;124;106;143;35;109;0;29;160;33;11;139;168;195;145;15;3;70;13;132;169;188;6;147;178;10;133;122;135;63;38;1;117;121;90;51;118;74;25;182;138;104;8;111;82;21;177;5;45;142;175;78;36;61;91;141;77;81;153;187;163;89;127;137;114;103;26;113;176;194;166;86;185;179;172;57;66;94;47;148;60;20;59;28;149;4;199;9;99;130;95,2119429334981155220,0.003002
steepest_intra:edges_start:greedy,182,51268,18026,33242,179400,11,182;11;139;43;168;195;13;132;169;6;188;161;70;3;15;145;155;189;69;29;0;109;35;111;41;81;153;186;163;180;88;176;106;159;143;124;128;62;18;55;34;170;152;4;149;28;59;20;60;94;66;47;148;9;199;140;183;95;130;99;22;179;172;52;185;86;166;194;113;114;137;103;89;127;165;187;146;97;77;141;91;79;61;36;78;175;142;45;5;177;21;87;82;8;104;56;144;160;33;138,3349964323039052186,0.004000
steepest_intra:edges_start:greedy,183,47177,20426,26751,149500,9,183;95;130;99;9;199;4;149;28;59;20;60;148;47;94;66;57;172;179;185;86;166;194;176;113;26;103;114;137;127;89;163;187;153;81;77;141;91;61;36;78;175;142;45;5;177;21;82;111;8;104;138;182;25;74;118;51;90;121;31;117;1;38;63;135;122;133;10;178;147;6;188;169;132;13;70;3;15;145;195;168;139;11;33;160;29;0;109;35;143;106;124;128;62;18;55;34;170;152;140,4231803495401143462,0.003000
steepest_intra:edges_start:greedy,184,47185,20864,26321,194350,12,184;170;152;140;183;95;130;99;9;199;28;20;60;148;47;94;66;57;172;179;185;86;166;194;176;113;103;127;89;163;187;153;81;77;141;91;61;36;78;175;142;45;5;177;21;82;111;8;104;138;182;139;11;33;160;29;0;109;35;143;106;124;128;62;18;55;34;189;195;168;43;134;74;118;51;90;121;54;31;193;117;1;38;63;135;122;133;10;178;147;6;188;169;132;13;145;15;70;3;155,4742868317119340984,0.004009
steepest_intra:edges_start:greedy,185,47107,20388,26719,164450,10,185;86;95;130;99;22;66;94;47;148;60;20;59;28;149;4;199;9;183;140;152;170;34;55;18;62;128;124;106;143;35;109;0;29;160;33;11;139;168;195;145;15;3;70;13;132;169;188;6;147;178;10;133;122;135;63;38;1;117;31;121;90;51;118;74;25;182;138;104;8;111;82;21;177;5;45;142;175;78;36;61;91;141;77;81;153;187;163;89;127;137;114;103;26;113;176;194;166;172;179,4310896351882553515,0.004000
steepest_intra:edges_start:greedy,186,50415,20729,29686,239200,15,186;163;180;88;176;106;159;143;124;128;62;18;55;34;170;152;4;149;28;59;20;60;94;66;47;148;9;199;140;183;95;130;99;22;179;172;52;185;86;166;194;113;26;114;137;103;89;127;165;187;146;97;77;141;36;21;8;104;138;182;25;74;118;51;90;121;54;31;117;1;38;63;135;122;133;10;178;147;6;188;169;132;13;70;3;15;145;195;168;139;11;33;160;29;0;109;35;111;81;153,2786744183518900622,0.006001
steepest_intra:edges_start:greedy,187,50415,20729,29686,239200,15,187;165;127;89;103;137;114;26;113;194;166;86;185;52;172;179;22;99;130;95;183;140;199;9;148;47;66;94;60;20;59;28;149;4;152;170;34;55;18;62;128;124;143;159;106;176;88;180;163;186;153;81;111;35;109;0;29;160;33;11;139;168;195;145;15;3;70;13;132;169;188;6;147;178;10;133;122;135;63;38;1;117;31;54;121;90;51;118;74;25;182;138;104;8;21;36;141;77;97;146,8528489221480298774,0.006031
steepest_intra:edges_start:greedy,188,48258,19780,28478,209300,13,188;6;147;178;10;133;122;72;107;40;100;63;135;38;27;16;1;156;198;117;193;31;54;73;121;131;90;191;51;118;74;134;43;139;11;182;138;33;160;144;104;8;82;21;177;5;45;142;175;78;36;61;91;141;77;97;146;187;165;127;89;103;113;194;166;86;185;179;22;99;130;95;183;140;152;170;34;55;18;62;124;106;176;163;153;81;111;35;109;0;29;168;195;145;15;3;70;13;132;169,81156516518486008,0.004017
steepest_intra:edges_start:greedy,189,51212,18449,32763,179400,11,189;69;109;35;0;29;111;41;81;153;186;163;180;88;176;106;159;143;124;128;62;18;55;34;170;152;4;149;28;59;20;60;94;66;47;148;9;199;140;183;95;130;99;22;179;172;52;185;86;166;194;113;114;137;103;89;127;165;187;146;97;77;141;91;61;36;78;175;142;45;5;177;21;87;82;8;104;56;144;160;33;138;182;11;139;168;195;43;134;6;188;169;132;13;145;15;70;3;155;184,5767015571268258399,0.003999
steepest_intra:edges_start:greedy,190,50386,19956,30430,224250,14,190;193;198;117;54;31;164;73;136;45;5;177;21;104;138;182;25;74;118;51;120;191;90;125;121;131;135;102;63;100;40;107;72;122;133;10;178;147;134;6;188;169;132;13;161;70;3;15;145;195;168;139;11;49;33;160;29;0;109;35;111;144;8;82;58;77;81;153;163;176;106;124;62;18;55;140;183;95;130;185;86;166;194;113;103;89;127;165;187;146;97;141;91;61;36;78;175;142;162;80,7501822366883935655,0.005002
steepest_intra:edges_start:greedy,191,51249,18725,32524,134550,8,191;71;147;192;6;188;169;132;161;70;3;15;145;13;195;168;43;11;29;0;109;35;111;81;153;163;176;106;124;62;18;95;130;185;86;166;194;113;103;89;127;165;187;97;77;141;91;61;36;78;175;142;45;5;177;21;82;8;104;144;160;33;138;182;139;134;85;74;118;98;51;125;131;121;112;19;151;54;73;164;31;193;117;198;156;1;16;27;38;135;102;63;100;40;107;72;10;133;122;90,8513327163757896356,0.003973
steepest_intra:edges_start:greedy,192,50383,19010,31373,254150,16,90;51;121;25;138;33;160;144;56;104;8;82;87;21;177;5;45;142;175;78;36;61;91;141;77;97;146;187;165;127;89;103;137;114;113;194;166;86;185;52;172;179;22;99;130;95;183;140;199;9;148;47;66;94;60;20;59;28;149;4;152;170;34;55;18;62;128;124;143;159;106;176;88;180;163;186;153;81;41;111;35;109;0;29;49;11;139;168;195;145;15;3;70;161;13;132;169;188;6;147,4383429670727431402,0.006036
steepest_intra:edges_start:greedy,193,50386,19956,30430,254150,16,193;190;80;162;142;175;78;36;61;91;141;97;146;187;165;127;89;103;113;194;166;86;185;130;95;183;140;55;18;62;124;106;176;163;153;81;77;58;82;8;144;111;35;109;0;29;160;33;49;11;139;168;195;145;15;3;70;161;13;132;169;188;6;134;147;178;10;133;122;72;107;40;100;63;102;135;131;121;125;90;191;120;51;118;74;25;182;138;104;21;177;5;45;136;73;164;31;54;117;198,1124139031487968371,0.005997
steepest_intra:edges_start:greedy,194,47679,20547,27132,149500,9,194;176;113;26;103;114;137;127;89;163;187;153;81;77;141;91;61;36;78;175;142;45;5;177;21;82;111;8;104;138;182;25;74;118;51;90;121;117;1;38;63;135;122;133;10;178;147;6;188;169;132;13;70;3;15;145;195;168;139;11;33;160;29;0;109;35;143;106;124;128;62;18;55;34;170;152;140;183;130;95;86;185;22;99;9;199;4;149;28;59;20;60;148;47;94;66;57;172;179;166,5594369709645104288,0.002999
steepest_intra:edges_start:greedy,195,48258,19780,28478,209300,13,195;145;15;3;70;13;132;169;188;6;147;178;10;133;122;72;107;40;100;63;135;38;27;16;1;156;198;117;193;31;54;73;121;131;90;191;51;118;74;134;43;139;11;182;138;33;160;144;104;8;82;21;177;5;45;142;175;78;36;61;91;141;77;97;146;187;165;127;89;103;113;194;166;86;185;179;22;99;130;95;183;140;152;170;34;55;18;62;124;106;176;163;153;81;111;35;109;0;29;168,6658756752663957525,0.005001
steepest_intra:edges_start:greedy,196,51916,20167,31749,284050,18,30;190;80;162;142;175;78;36;61;91;141;97;146;187;165;127;89;103;113;194;166;86;185;95;18;62;124;106;176;163;153;81;77;58;82;8;144;111;35;109;0;29;160;33;49;11;139;168;195;145;15;3;70;161;13;132;169;188;6;134;147;178;10;133;122;72;107;40;100;63;102;135;131;121;125;90;191;120;51;118;74;25;182;138;104;21;177;5;45;136;73;164;54;31;193;117;198;1;156;42,7604896621844682141,0.007003
steepest_intra:edges_start:greedy,197,51886,18023,33863,134550,8,24;156;198;117;193;31;164;73;54;151;19;112;121;116;158;25;182;138;33;160;144;104;8;82;21;177;5;45;142;175;78;36;61;91;141;77;97;187;165;127;89;103;113;194;166;86;185;130;95;18;62;124;106;176;163;153;81;111;35;109;0;29;11;139;43;168;195;145;15;3;70;13;132;169;188;6;134;74;118;98;51;125;90;191;71;147;115;178;10;133;122;135;32;96;63;102;38;27;16;1,5241053940881383867,0.003999
steepest_intra:edges_start:greedy,198,51190,18543,32647,164450,10,198;156;1;16;27;38;102;63;96;32;135;122;133;10;178;115;147;71;191;90;125;51;98;118;74;134;6;188;169;132;13;70;3;15;145;195;168;43;139;11;29;0;109;35;111;81;153;163;176;106;124;62;18;140;183;95;185;86;166;194;113;103;89;127;165;187;97;77;141;91;61;36;78;175;142;45;5;177;21;82;8;104;144;160;33;138;182;25;158;116;121;112;19;151;54;73;164;31;193;117,8432855836443956051,0.004003
steepest_intra:edges_start:greedy,199,46319,20380,25939,164450,10,199;140;183;95;130;99;22;179;185;86;166;194;176;113;26;103;114;137;127;89;163;187;153;81;77;141;91;61;36;78;175;142;45;5;177;21;82;111;8;104;138;182;25;74;118;51;90;121;73;54;31;193;117;1;38;63;135;122;133;10;178;147;6;188;169;132;13;70;3;15;145;195;168;139;11;33;160;29;0;109;35;143;106;124;128;62;18;55;34;170;152;4;149;28;20;60;94;66;47;148,553984491499331477,0.003999
greedy_intra:nodes_start:random,0,57935,31600,26335,837453,465,194;166;172;179;66;94;99;130;9;140;183;55;18;62;95;86;114;137;127;89;103;113;163;187;141;78;175;142;5;177;87;82;8;111;35;143;185;47;148;20;109;0;29;144;160;33;11;195;168;139;182;73;31;54;121;51;120;71;191;133;122;90;77;81;153;146;97;91;36;61;21;104;138;25;136;80;190;193;117;1;135;63;40;107;10;147;169;70;3;15;145;155;184;152;170;34;124;106;176;180,7723116708667137196,0.084641
greedy_intra:nodes_start:random,1,62631,36046,26585,450344,463,189;3;70;107;40;63;135;148;20;28;149;4;152;155;15;139;11;182;138;33;104;87;21;5;80;190;136;121;125;191;90;131;1;117;193;45;142;175;78;36;61;91;124;140;183;95;185;86;106;143;35;109;0;29;169;65;188;6;147;10;133;122;51;132;13;145;195;168;134;74;118;25;173;54;31;73;177;160;18;62;128;176;103;113;194;166;114;127;165;89;163;153;81;77;141;82;8;111;55;34,417652293548154386,0.077733
greedy_intra:nodes_start:random,2,57774,31822,25952,542731,495,62;111;8;104;33;182;25;121;112;19;54;31;164;73;5;142;78;175;80;190;38;63;135;122;90;51;29;109;0;144;160;11;139;169;188;6;147;191;131;1;198;117;193;177;36;61;138;168;195;13;145;15;155;183;179;172;166;194;180;176;106;159;143;35;70;3;34;55;83;18;170;152;140;149;28;20;60;148;47;94;66;99;185;163;153;77;141;21;82;81;124;128;86;113;127;165;89;103;130;95,112392355550751081,0.083939
greedy_intra:nodes_start:random,3,62044,36847,25197,884101,488,82;87;91;21;104;11;139;134;6;188;169;132;161;70;4;149;28;20;199;183;55;111;61;36;141;77;153;187;163;89;165;127;103;113;109;168;43;147;131;38;27;1;190;80;5;177;86;185;166;194;176;144;33;138;182;121;117;193;31;54;73;25;160;29;0;35;143;106;128;124;62;18;34;170;155;3;15;13;195;145;95;130;99;179;94;47;148;140;152;133;107;40;100;63;135;122;90;51;118;8,6470753695825674727,0.085260
greedy_intra:nodes_start:random,4,61082,35169,25913,612641,469,61;36;78;175;142;45;5;177;82;81;153;111;0;29;145;168;195;13;132;70;3;15;33;104;144;35;109;155;152;170;18;62;8;25;73;54;121;182;138;160;34;55;83;95;130;99;185;166;194;180;176;106;124;143;159;119;163;113;114;103;89;127;165;187;141;21;51;107;40;188;169;6;147;90;131;31;164;193;117;1;38;63;135;122;133;10;134;139;11;86;179;94;47;148;20;140;183;128;77;91,6657852715537818358,0.079454
greedy_intra:nodes_start:random,5,60566,35001,25565,783160,483,62;143;159;106;128;95;183;140;28;149;152;121;54;31;193;136;175;78;5;25;118;6;188;169;132;195;168;43;11;144;111;8;104;182;51;90;117;190;80;45;177;21;35;170;130;99;66;94;47;148;60;20;155;145;15;3;70;13;49;33;160;29;0;109;124;86;185;179;166;194;165;187;77;141;36;138;139;134;147;10;133;107;40;63;135;153;163;26;103;114;137;127;89;113;180;176;83;55;34;18,2421187756989127967,0.091246
greedy_intra:nodes_start:random,6,64875,38275,26600,581009,417,113;103;163;35;11;139;13;161;70;65;188;169;132;145;15;34;62;128;95;130;55;18;124;106;143;8;82;21;121;131;135;63;40;107;122;133;10;147;168;195;114;137;127;89;187;160;33;0;109;29;43;134;51;90;191;6;3;155;184;189;182;190;80;175;78;5;177;183;20;28;140;152;138;25;54;31;117;193;164;73;104;56;144;111;41;153;81;77;91;61;36;141;97;176;86;185;99;179;166;194,3613156531057616303,0.068876
greedy_intra:nodes_start:random,7,58503,31364,27139,783795,506,94;124;159;81;77;153;163;127;187;141;91;61;36;78;175;142;162;45;5;177;8;55;18;89;103;113;180;176;194;166;172;179;86;106;143;139;134;51;191;90;131;121;112;19;151;198;1;135;147;6;188;169;132;168;11;49;144;104;182;138;33;160;35;109;0;29;195;126;13;145;15;70;3;155;152;95;130;99;185;62;111;25;73;164;31;54;117;193;190;80;136;21;82;34;183;140;28;20;148;47,1529488248709183986,0.084453
greedy_intra:nodes_start:random,8,62285,35393,26892,875536,465,80;190;136;73;193;31;54;121;134;6;188;15;3;189;130;185;86;141;36;142;5;182;139;132;169;147;191;90;51;118;74;104;82;8;56;144;49;13;161;70;155;152;140;4;149;28;20;148;47;94;66;183;145;195;168;143;159;35;0;109;29;111;77;81;153;163;176;113;103;89;165;127;114;194;166;95;55;34;11;138;21;61;177;112;131;122;135;1;198;117;25;33;160;18;62;124;106;91;78;175,8982788762010290371,0.090168
greedy_intra:nodes_start:random,9,62704,35847,26857,965298,493,169;135;63;122;147;188;140;148;47;94;179;124;143;111;144;56;8;82;21;61;91;77;81;41;0;109;35;153;163;103;89;127;114;137;187;141;36;5;45;162;80;190;193;31;164;25;182;139;168;195;161;70;3;15;34;18;29;11;138;173;73;54;121;51;125;191;90;131;1;156;198;117;136;142;175;78;177;104;33;160;189;155;170;55;95;185;86;128;62;145;132;13;106;176;113;194;166;130;183;152,8295802232909940803,0.098914
greedy_intra:nodes_start:random,10,62550,37318,25232,739851,492,190;80;136;25;138;33;111;77;141;91;36;61;21;195;145;106;89;127;103;176;128;62;18;34;3;70;188;169;166;194;113;163;153;81;198;1;131;90;191;133;122;135;63;40;107;10;147;51;121;118;182;160;29;109;152;140;4;149;28;199;95;130;99;94;66;179;22;185;86;124;143;35;0;144;5;175;78;55;183;47;148;20;155;15;132;13;168;139;11;104;8;82;87;177;73;164;31;54;117;193,7812354457400735373,0.084349
greedy_intra:nodes_start:random,11,63825,38265,25560,659504,479,78;175;61;91;165;127;89;103;163;77;82;8;104;56;144;0;109;35;34;55;170;155;189;25;173;54;31;193;73;136;36;141;187;137;114;95;183;152;145;134;90;131;1;198;117;190;80;45;21;111;41;81;153;113;172;179;66;94;47;166;194;176;86;185;148;60;20;140;124;106;29;11;139;74;98;118;182;138;62;18;6;147;122;63;135;121;51;168;195;13;132;169;188;70;3;15;160;33;177;5,3449047753902846721,0.087487
greedy_intra:nodes_start:random,12,60365,34428,25937,762158,494,177;61;36;141;187;165;89;127;137;114;166;172;179;66;94;47;148;20;147;90;133;122;135;1;198;117;31;73;5;91;77;153;163;103;113;81;111;144;33;11;139;168;195;34;18;83;55;170;152;155;3;70;161;132;13;189;62;124;35;169;188;6;134;118;74;160;143;106;176;180;194;86;95;183;140;130;185;99;28;149;15;145;109;0;29;182;121;54;193;190;80;175;78;21;82;8;56;104;138;25,2350104993483423871,0.085975
greedy_intra:nodes_start:random,13,61807,34049,27758,690274,509,56;87;21;141;77;111;144;33;138;182;25;5;177;91;61;36;78;175;142;183;20;28;140;152;184;155;70;161;132;169;188;6;147;121;131;1;117;31;54;135;122;133;90;118;104;8;82;81;153;180;176;166;194;113;26;103;89;127;137;114;106;124;34;189;3;15;145;143;159;187;165;163;128;18;62;109;11;139;74;98;51;85;134;43;55;95;185;148;47;94;66;179;86;35;0;29;13;195;168;160,4452057252563562669,0.084148
greedy_intra:nodes_start:random,14,64442,38747,25695,489724,432,89;165;127;137;114;103;163;153;41;0;35;83;95;185;86;106;143;109;195;126;132;169;188;6;51;136;190;80;5;177;104;145;15;3;13;168;139;144;8;111;29;189;70;147;135;63;40;107;133;122;90;191;134;152;183;159;77;81;124;9;148;47;94;60;20;28;140;21;61;36;141;187;166;179;22;99;130;160;33;11;138;182;25;54;31;193;117;121;155;184;170;34;55;18;62;128;176;180;194;113,8610788846661232755,0.067807
greedy_intra:nodes_start:random,15,65720,35790,29930,799673,507,8;21;78;175;162;80;190;33;62;83;55;34;189;15;3;155;170;18;124;106;143;159;81;77;97;153;146;187;165;176;113;26;103;89;163;111;41;35;0;29;195;168;139;5;142;45;43;169;132;13;145;70;161;188;6;147;134;25;177;36;61;91;104;138;182;118;51;191;90;131;121;11;128;185;86;82;87;136;193;198;117;54;31;164;73;141;127;137;114;194;166;179;130;95;183;140;152;109;160;144,491538495506308624,0.093727
greedy_intra:nodes_start:random,16,64098,38736,25362,822156,517,153;81;77;91;36;61;21;138;11;168;195;145;15;3;49;33;8;82;111;143;106;124;176;180;113;187;141;1;27;38;63;135;122;90;155;28;20;148;94;179;166;194;159;182;51;191;133;10;147;188;70;13;132;169;6;134;139;0;109;95;130;99;185;86;62;35;25;121;54;31;190;80;45;175;78;5;177;160;29;144;56;104;73;193;117;198;131;34;55;183;140;149;4;152;170;18;103;127;89;163,4380441042173049543,0.088301
greedy_intra:nodes_start:random,17,58690,30653,28037,977592,498,195;11;138;182;25;173;73;54;31;136;5;177;104;139;134;118;51;90;122;135;1;117;193;190;80;45;175;78;21;8;56;168;169;188;6;147;121;112;19;36;61;91;141;165;127;137;114;103;163;153;81;50;82;77;97;146;187;89;113;94;148;20;140;55;34;189;145;13;132;3;155;184;170;152;183;130;185;95;18;0;29;49;33;160;144;111;159;106;124;62;86;166;194;176;143;35;109;15;70;161,5890963358584044855,0.097852
greedy_intra:nodes_start:random,18,62493,33945,28548,766025,458,61;141;77;153;176;180;113;194;166;143;109;126;188;169;132;13;3;15;145;0;29;49;11;139;51;125;131;117;190;80;5;177;123;25;73;164;193;31;54;112;134;43;168;195;189;95;130;99;185;86;18;62;124;106;163;103;89;127;187;82;21;78;175;45;121;90;10;133;122;135;63;38;27;16;104;8;33;74;98;118;182;138;160;144;111;35;34;55;183;140;152;155;70;6;147;1;156;198;136;36,2715020882928367197,0.077284
greedy_intra:nodes_start:random,19,59486,32365,27121,607464,472,190;80;162;175;78;187;163;89;103;113;176;180;49;11;51;131;135;63;40;122;121;118;33;160;56;144;39;29;0;109;195;145;15;3;155;189;35;111;104;8;82;81;153;194;166;130;95;70;161;132;134;90;191;147;6;188;169;13;168;139;73;164;31;193;117;54;25;182;138;21;87;159;106;86;185;179;94;47;148;20;28;183;140;152;55;34;18;62;128;124;143;77;141;91;79;61;36;177;5;45,5841825610489577197,0.082905
greedy_intra:nodes_start:random,20,60480,32213,28267,458119,488,132;169;188;6;147;10;133;131;121;112;54;117;31;73;21;187;165;127;89;113;103;153;81;160;33;11;49;29;35;124;185;179;166;194;176;163;97;77;141;61;36;45;5;177;56;144;109;0;104;142;78;175;80;190;25;182;138;8;82;111;143;106;128;86;95;183;140;168;43;134;118;51;191;90;122;63;135;1;198;193;136;139;195;70;3;15;145;189;34;62;83;18;55;170;152;53;184;155;13;126,4661176558989064747,0.080334
greedy_intra:nodes_start:random,21,60072,32817,27255,721349,453,177;21;8;56;104;11;145;15;3;155;170;55;34;189;51;98;118;74;29;109;62;86;176;180;194;166;179;185;35;0;144;160;33;138;182;139;134;188;169;132;13;126;195;168;82;61;91;141;97;77;81;153;18;183;20;28;140;152;70;6;147;121;117;198;131;90;122;135;63;38;27;16;1;54;31;193;190;80;136;73;173;25;111;159;143;124;106;113;163;89;103;114;127;187;36;5;45;142;175;78,1748426818702918907,0.078004
greedy_intra:nodes_start:random,22,60552,35537,25015,615162,471,51;121;131;1;198;117;193;90;10;133;63;135;122;147;18;55;34;170;184;155;195;168;139;25;54;31;73;136;175;78;36;141;97;77;29;145;70;3;15;8;21;61;177;5;80;190;160;0;35;124;66;94;47;60;20;148;179;166;194;113;103;89;127;114;137;128;62;83;130;99;185;86;95;183;140;152;111;82;81;153;187;163;180;88;176;106;143;109;134;6;188;169;132;13;11;33;104;138;182;118,5516879645772172753,0.075504
greedy_intra:nodes_start:random,23,64183,37712,26471,662387,453,89;103;113;194;166;179;94;47;148;152;155;70;188;6;134;74;118;51;90;135;63;102;38;27;1;117;31;177;104;144;0;62;18;3;15;145;29;111;141;78;175;80;190;193;54;121;139;11;189;170;140;20;28;122;107;40;133;147;169;132;13;195;168;49;33;56;8;21;61;36;5;142;45;25;160;83;95;128;124;106;159;41;138;182;82;77;81;153;176;86;185;130;183;55;34;69;109;35;143;163,1957776071967566224,0.079274
greedy_intra:nodes_start:random,24,58740,31624,27116,654808,461,25;182;138;139;43;168;11;33;29;35;143;159;106;124;128;62;18;83;95;130;185;86;55;152;155;147;191;90;51;121;131;1;198;117;193;31;61;127;137;114;194;166;179;22;99;47;94;66;172;176;163;153;81;77;82;87;8;160;15;3;70;188;169;132;13;195;145;109;0;12;144;104;5;142;78;175;162;80;190;45;36;141;187;89;103;26;113;148;60;20;28;149;140;183;34;111;21;177;73;54,7510220920789770081,0.074372
greedy_intra:nodes_start:random,25,60571,34674,25897,900167,512,36;78;175;142;21;8;104;25;73;54;31;193;117;1;131;121;134;195;29;12;0;109;35;62;83;18;55;34;170;184;155;3;15;145;189;86;128;124;106;143;153;163;103;176;185;95;130;179;166;194;113;26;114;137;127;89;187;81;132;169;188;168;160;111;77;82;144;33;43;6;147;90;122;135;63;38;190;80;45;5;177;138;139;13;70;152;140;20;148;47;94;183;11;182;118;98;51;141;91;61,4815205928010408631,0.094299
greedy_intra:nodes_start:random,26,59624,34982,24642,600846,445,28;149;4;140;183;152;155;188;40;107;133;147;195;34;55;18;62;106;143;81;77;5;45;190;80;141;187;103;113;176;95;130;185;179;166;86;124;35;109;134;125;135;63;122;90;191;6;169;132;13;70;3;15;145;168;138;33;160;104;78;175;142;136;31;54;112;121;25;177;36;61;91;87;21;73;193;117;198;1;131;51;118;139;11;29;0;8;82;111;153;163;89;165;127;114;194;94;47;148;20,1682684847801949743,0.079096
greedy_intra:nodes_start:random,27,60056,35448,24608,773812,488,124;106;163;89;127;141;61;36;78;175;80;190;136;104;143;128;95;130;185;86;176;180;194;113;26;103;137;114;166;179;66;94;47;15;3;70;13;195;168;138;177;5;45;121;125;51;134;139;25;54;31;193;117;198;156;1;38;63;133;147;188;6;90;122;135;131;11;29;0;111;8;87;21;82;77;81;146;187;153;109;189;155;152;140;28;148;60;20;183;18;55;35;144;160;33;169;132;145;34;62,9029252799580083118,0.092220
greedy_intra:nodes_start:random,28,60443,34541,25902,1050592,497,155;29;160;33;11;139;182;138;5;78;45;135;122;90;191;51;0;109;35;89;127;137;114;194;166;86;55;34;168;195;13;132;6;188;169;126;43;134;118;121;73;136;177;21;82;143;124;106;103;26;113;176;179;22;99;130;95;185;180;163;187;146;153;77;141;91;61;36;175;80;190;193;31;54;25;104;8;144;145;15;3;70;147;131;1;198;117;111;62;18;94;47;148;60;23;20;28;140;183;152,1536143911395592284,0.095999
greedy_intra:nodes_start:random,29,58450,32824,25626,585439,433,170;152;4;149;28;140;183;155;70;169;188;134;51;71;147;6;132;13;145;15;3;189;0;111;82;87;21;177;73;193;190;80;36;61;91;141;144;160;33;138;5;78;175;136;31;54;25;143;124;128;95;130;185;86;103;89;127;165;163;22;99;47;148;20;60;94;66;179;172;166;194;113;180;176;106;195;168;109;35;153;187;81;77;8;104;121;117;198;156;1;135;122;90;139;11;29;62;18;55;34,4853085428227739920,0.082000
greedy_intra:nodes_start:random,30,61182,34182,27000,865567,488,29;155;184;170;55;18;109;0;35;62;95;20;148;47;94;179;176;180;137;114;166;185;86;194;113;163;153;111;144;160;33;139;134;188;169;145;15;3;189;34;124;106;103;89;127;187;141;36;78;175;162;80;190;193;31;131;122;135;1;198;117;54;112;121;147;6;4;149;28;140;183;152;70;161;191;90;51;182;138;143;159;81;77;177;5;45;136;73;25;104;8;56;168;195;13;132;126;43;11;49,3015688636657413096,0.092258
greedy_intra:nodes_start:random,31,60990,35375,25615,517322,447,179;94;47;189;13;132;43;139;11;82;77;141;187;127;89;103;176;185;130;183;140;55;18;34;33;138;121;131;90;51;98;118;25;177;36;61;5;175;80;190;117;63;100;40;107;72;32;135;122;133;147;6;188;169;70;3;15;155;152;95;86;194;137;114;113;180;106;124;143;109;29;168;195;126;145;4;149;28;20;60;148;99;62;111;8;104;56;144;35;0;12;160;31;193;54;21;81;153;163;166,1300340638037399374,0.070509
greedy_intra:nodes_start:random,32,59188,31796,27392,766581,508,31;54;73;25;104;144;35;62;148;47;60;20;130;95;185;179;166;86;18;55;34;170;184;155;15;3;70;132;126;49;160;111;82;50;81;77;36;78;190;80;162;175;45;117;198;1;135;122;133;10;178;6;188;169;43;139;29;0;33;138;11;168;195;13;145;152;140;183;194;113;103;176;124;106;159;143;109;134;147;90;121;51;98;118;74;182;8;21;61;91;141;187;127;89;163;153;177;5;136;193,2413677742234965483,0.086032
greedy_intra:nodes_start:random,33,60007,34591,25416,716293,504,41;111;82;8;33;11;138;182;177;78;175;80;190;5;21;77;81;153;106;124;143;144;56;104;160;183;94;47;148;20;28;140;152;70;188;6;169;132;13;29;109;134;107;40;63;135;122;131;121;158;25;173;136;193;117;54;31;73;139;168;195;145;15;3;155;34;18;62;86;113;114;127;165;91;61;36;141;187;163;89;103;180;176;194;166;179;22;99;185;95;55;147;10;133;90;51;118;74;0;35,6635242312145781662,0.090733
greedy_intra:nodes_start:random,34,62808,37707,25101,534874,443,166;99;130;185;86;176;141;78;175;80;190;147;6;188;169;132;168;11;138;5;45;136;193;117;1;90;191;10;133;122;63;135;131;121;25;74;118;98;51;134;139;33;160;143;106;35;109;0;29;144;8;21;82;77;153;187;137;114;172;179;66;94;60;20;28;199;95;103;127;89;163;128;18;62;124;61;36;104;195;13;145;70;3;155;152;140;148;47;9;183;174;55;34;111;54;31;73;177;113;194,3121768704657402488,0.065836
greedy_intra:nodes_start:random,35,60317,33164,27153,885385,523,18;55;34;189;3;70;161;169;188;6;147;191;90;131;1;198;117;193;190;80;136;11;29;109;15;145;195;43;134;118;51;122;135;121;124;95;185;94;47;148;20;28;140;183;152;170;184;155;132;13;168;139;182;25;5;78;187;127;137;114;103;89;36;175;142;45;31;54;73;177;81;153;163;113;176;166;86;106;143;159;97;141;91;79;61;21;87;8;104;138;33;160;144;82;77;111;12;0;35;62,216046499738272574,0.092183
greedy_intra:nodes_start:random,36,60494,34222,26272,607016,451,0;33;74;118;51;71;147;6;169;132;188;134;139;11;138;182;25;5;78;142;45;164;31;73;21;166;194;113;103;89;163;187;177;27;38;131;121;54;193;117;198;1;135;63;122;90;81;153;176;62;18;152;170;35;109;29;160;104;56;144;111;8;82;77;141;61;36;175;80;190;136;43;168;161;70;3;184;155;15;13;126;195;145;189;34;55;95;86;185;179;94;47;148;20;28;140;183;124;106;143,6890097630803529166,0.080518
greedy_intra:nodes_start:random,37,61500,34248,27252,603070,447,190;193;31;54;117;198;151;112;121;131;133;10;147;29;69;34;55;128;163;89;165;127;103;113;176;194;166;86;185;95;170;184;189;195;145;15;3;155;152;4;149;28;140;70;6;122;135;63;38;27;1;177;77;81;143;159;18;62;124;106;35;109;0;12;111;8;25;118;51;90;191;132;13;183;20;148;153;141;36;61;21;82;138;182;134;188;169;168;139;11;33;160;144;104;5;78;175;142;45;80,6670625771412585142,0.079594
greedy_intra:nodes_start:random,38,60219,33337,26882,643554,481,133;63;40;107;10;147;6;132;15;3;70;169;188;134;74;118;158;25;45;5;21;163;113;194;166;94;47;148;20;18;62;35;109;0;111;77;97;141;91;61;36;78;142;175;80;190;136;182;43;168;195;145;155;34;55;86;176;103;127;89;153;11;139;51;122;135;1;117;193;31;138;104;8;82;50;81;143;159;106;124;185;130;95;183;140;152;29;160;33;144;56;177;73;164;54;121;131;125;191;90,2051450282007674707,0.076453
greedy_intra:nodes_start:random,39,62528,35740,26788,623432,501,25;11;189;34;18;62;82;45;80;190;193;54;121;122;133;10;90;147;144;81;153;176;86;179;66;154;94;47;60;20;148;124;111;8;104;138;139;43;6;188;161;70;3;170;152;149;28;140;183;55;77;141;78;175;142;5;177;36;61;91;21;56;168;126;13;132;169;134;74;182;33;29;0;35;109;195;145;15;155;184;95;130;185;166;113;103;163;106;143;160;118;51;125;131;135;63;1;117;31;73,116967337345004801,0.095682
greedy_intra:nodes_start:random,40,62064,36330,25734,489779,445,36;5;142;175;78;141;185;47;94;148;20;28;152;155;15;145;169;188;6;122;63;135;131;121;82;77;187;165;127;137;114;113;86;95;62;124;106;89;163;189;3;70;132;13;109;35;34;55;174;140;183;83;18;143;111;104;138;139;11;33;160;81;176;180;194;166;179;172;26;103;153;0;29;8;21;45;80;190;193;156;1;24;198;117;31;54;51;134;43;168;195;147;10;133;90;125;25;177;61;91,6415823647222280966,0.078913
greedy_intra:nodes_start:random,41,60412,34916,25496,733641,537,180;111;144;182;131;122;133;147;134;25;5;78;175;80;190;136;45;21;81;153;127;89;106;189;3;70;15;145;33;104;177;117;1;63;135;90;191;51;98;118;121;54;31;193;73;139;168;195;13;155;170;34;55;18;83;62;86;166;103;163;143;35;109;0;29;160;8;82;77;141;91;36;61;138;11;188;169;132;152;20;60;148;183;140;149;28;130;99;22;47;94;66;179;185;95;128;124;176;194;113,7390907152366864105,0.091076
greedy_intra:nodes_start:random,42,59970,34563,25407,687352,437,66;94;47;183;140;152;170;49;160;33;138;182;139;74;118;134;43;168;195;29;109;35;0;12;144;104;111;81;153;113;194;166;86;189;15;3;70;145;8;82;77;141;61;177;21;143;55;34;13;132;169;188;6;147;131;198;117;193;31;54;1;135;63;40;107;122;133;155;149;28;20;148;179;185;62;18;11;51;90;125;121;190;80;175;78;142;5;36;187;163;89;127;103;180;176;106;124;95;130;99,5665645182833998651,0.077556
greedy_intra:nodes_start:random,43,55866,29597,26269,622212,535,54;31;193;117;198;1;156;136;45;5;173;19;131;135;63;122;90;28;20;60;47;148;9;183;140;152;70;188;169;132;13;195;168;145;15;3;155;34;166;194;176;113;103;89;114;137;127;165;163;153;141;36;177;190;80;162;175;78;142;112;121;51;191;71;147;134;139;11;138;104;8;144;33;160;0;35;111;77;81;143;106;124;95;130;185;99;94;66;179;86;128;62;18;55;109;29;49;182;25;73,7722844318029985676,0.106410
greedy_intra:nodes_start:random,44,62397,35733,26664,484824,398,135;131;121;158;104;56;111;163;113;194;166;86;49;11;33;160;144;8;21;177;5;78;175;45;31;54;1;63;122;133;147;168;195;155;148;47;94;179;185;130;95;41;82;58;141;91;79;61;36;138;182;139;189;152;140;28;20;183;55;143;159;124;62;18;128;176;103;127;89;106;34;145;132;169;188;134;51;198;117;193;190;80;136;73;25;87;77;97;187;153;81;35;109;0;29;15;3;70;6;90,383330161537788140,0.066168
greedy_intra:nodes_start:random,45,61423,33146,28277,545393,472,25;173;73;117;198;156;1;16;27;38;63;133;168;195;132;70;3;155;152;55;34;35;109;0;29;104;21;61;36;78;175;142;45;5;158;116;51;98;118;134;13;145;15;140;183;148;47;185;95;128;62;18;11;139;74;122;135;131;177;141;187;163;113;194;166;172;179;86;176;153;97;91;80;190;136;164;31;193;54;19;112;121;90;191;147;6;188;169;33;160;144;8;111;143;124;106;81;77;82;138,6548386414825658071,0.080328
greedy_intra:nodes_start:random,46,60463,35202,25261,894716,498,190;80;175;5;177;8;86;185;95;124;106;159;119;81;77;153;103;113;114;137;127;89;163;187;141;91;21;87;104;33;49;195;168;182;31;54;73;25;138;160;144;111;180;176;128;62;18;143;82;61;36;97;194;166;172;179;130;189;15;70;3;155;152;183;140;149;28;20;60;94;66;47;148;55;34;121;131;135;63;122;90;51;134;139;11;29;0;35;109;145;13;132;169;188;6;147;1;198;117;193,4893692609753394130,0.091366
greedy_intra:nodes_start:random,47,62725,36131,26594,391374,394,35;106;86;185;130;95;83;55;18;183;148;47;66;94;154;60;20;28;140;124;143;104;8;77;97;187;165;127;89;103;176;128;34;189;13;195;168;29;0;144;160;33;11;139;138;182;51;122;135;1;198;117;193;5;141;166;194;113;163;153;145;15;70;3;155;152;170;41;111;21;61;36;78;175;80;190;169;188;6;147;191;90;131;121;98;118;74;158;25;54;31;73;136;177;82;81;179;99;62;109,3123810021909907369,0.064900
greedy_intra:nodes_start:random,48,57485,32606,24879,660290,466,141;91;79;61;36;175;78;182;139;168;195;43;134;51;121;131;135;122;90;6;188;70;3;155;152;170;189;15;132;169;13;145;34;55;166;194;106;109;29;11;147;10;133;107;40;63;1;198;117;5;177;21;104;33;138;25;80;190;193;31;54;73;160;0;62;18;83;183;140;149;28;20;60;148;47;94;66;179;86;176;113;103;127;89;163;130;99;185;95;124;111;8;144;35;143;159;153;81;77;97,6746322105569220460,0.074174
greedy_intra:nodes_start:random,49,59731,32558,27173,822822,511,81;77;45;80;190;136;73;25;182;138;139;11;144;111;159;143;124;106;89;127;103;113;180;176;35;0;74;118;122;135;63;133;10;147;191;90;198;117;121;43;145;15;189;152;183;140;20;148;47;94;185;130;95;86;166;194;163;153;141;91;61;36;7;78;175;142;5;21;87;8;104;160;33;70;161;132;13;29;109;62;55;18;34;155;3;169;188;6;195;168;134;51;125;131;1;193;31;54;177;82,479839457372338243,0.090994
greedy_intra:nodes_start:random,50,61837,34433,27404,980616,487,130;99;94;47;148;20;28;149;70;147;90;135;1;190;80;162;79;77;159;143;35;0;109;62;18;55;95;185;22;179;166;194;113;89;163;195;6;188;155;184;152;140;183;103;127;165;187;146;97;141;91;87;82;8;144;104;21;61;36;175;78;25;139;168;11;160;33;138;182;51;121;117;193;54;31;164;73;173;136;45;142;5;177;111;106;124;128;86;176;153;81;29;145;15;13;169;132;3;189;34,5707851245767140317,0.093467
greedy_intra:nodes_start:random,51,57456,31911,25545,551013,466,160;29;145;70;3;15;195;168;74;118;134;43;126;13;132;188;169;6;192;147;133;122;107;40;63;135;198;117;193;31;54;73;104;8;21;36;61;82;111;144;138;182;51;191;90;121;131;38;27;16;1;106;124;86;166;176;163;153;141;77;81;35;0;109;34;183;140;149;28;20;148;47;94;127;89;103;113;194;179;185;99;130;95;18;83;62;55;170;152;155;139;11;177;5;78;175;80;190;25;33,1963189725167902027,0.074011
greedy_intra:nodes_start:random,52,63276,35626,27650,637884,509,155;152;140;20;28;149;4;170;74;118;182;138;33;11;139;134;147;122;135;90;51;21;91;61;36;73;31;54;117;193;190;80;45;142;175;78;5;177;35;34;55;174;183;95;185;99;148;47;94;179;86;121;131;1;198;151;112;158;25;0;18;62;124;143;159;106;176;113;103;163;153;81;77;141;87;82;8;104;168;126;195;160;144;111;166;194;127;89;109;188;169;132;13;145;29;69;189;15;70;3,5850675068719936270,0.082300
greedy_intra:nodes_start:random,53,59950,35588,24362,785683,510,190;193;131;147;6;188;169;168;153;187;163;89;127;103;113;194;47;60;20;28;148;94;179;81;36;175;78;5;73;31;54;25;33;160;144;111;77;141;91;61;21;8;104;139;11;29;109;143;176;166;185;99;183;140;174;124;35;0;138;182;121;117;198;1;135;63;40;107;10;133;122;90;51;134;34;55;83;62;18;189;145;195;13;132;161;70;3;15;155;184;152;170;95;130;86;128;106;82;177;80,7703002362719792280,0.085763
greedy_intra:nodes_start:random,54,59991,33575,26416,904598,499,35;106;113;103;163;153;81;159;143;62;18;55;34;189;15;161;70;3;155;184;152;140;183;130;95;86;166;194;176;182;121;131;1;198;117;193;31;54;73;25;139;145;132;13;195;168;11;138;5;142;175;78;91;141;97;77;111;144;56;104;8;82;87;61;36;162;80;190;45;177;21;160;33;169;188;6;147;133;122;63;135;29;109;124;185;179;94;47;148;60;20;28;149;134;191;90;51;118;74;0,3419217420075530071,0.095179
greedy_intra:nodes_start:random,55,62980,35942,27038,774540,501,5;78;175;80;190;117;198;156;1;131;90;51;182;104;56;33;160;170;152;140;183;9;99;130;95;86;166;194;113;176;193;31;54;121;158;25;123;177;138;195;13;70;3;15;155;189;168;43;139;11;34;55;18;62;109;29;12;0;35;143;159;106;153;81;77;111;144;8;82;87;91;36;61;21;134;6;188;169;132;145;69;124;128;185;179;94;47;148;60;20;28;147;133;122;135;163;89;127;187;141,7094845730485307599,0.087225
greedy_intra:nodes_start:random,56,65161,39346,25815,662712,478,183;95;86;176;113;103;78;175;45;25;104;144;124;62;189;15;145;195;13;132;169;188;6;134;118;74;43;168;34;55;185;179;166;194;106;0;160;11;139;147;133;122;135;90;191;51;182;138;33;29;109;35;159;153;81;97;77;8;111;143;18;4;149;28;20;60;99;130;128;141;91;61;36;5;177;21;82;163;89;127;165;187;80;190;136;193;117;31;54;121;66;94;47;148;140;152;155;70;3;170,8326142969026614415,0.083205
greedy_intra:nodes_start:random,57,61428,35403,26025,505668,449,70;132;13;160;21;61;36;91;87;11;168;169;188;6;147;134;118;51;90;122;40;63;135;1;190;80;175;62;128;176;194;113;163;187;111;144;56;104;25;158;121;54;117;193;31;73;5;177;143;124;106;153;81;35;109;0;8;82;141;77;86;179;66;94;20;28;140;29;49;33;138;182;139;195;145;15;3;155;184;152;170;34;18;83;55;174;183;148;47;22;185;103;89;127;114;166;99;130;95;189,4560027942523243760,0.072660
greedy_intra:nodes_start:random,58,62425,36984,25441,625612,439,0;29;160;33;121;131;135;63;100;40;107;6;188;169;132;13;86;166;194;111;118;51;120;71;191;90;122;133;10;147;134;139;138;21;36;61;91;141;77;153;179;94;47;148;60;20;28;140;183;155;15;145;195;144;104;80;190;25;182;11;109;128;130;99;185;95;83;55;34;3;70;43;5;78;175;193;117;54;31;177;82;8;168;189;184;152;170;18;62;124;106;176;113;114;127;89;103;163;143;35,3830287750364917985,0.071950
greedy_intra:nodes_start:random,59,64206,36307,27899,621944,483,15;161;70;3;155;184;152;170;34;29;49;11;139;43;134;169;132;126;195;168;182;5;175;78;21;82;111;143;106;180;103;89;127;163;35;109;0;160;33;56;144;124;86;185;99;130;95;62;18;13;188;6;147;71;51;118;189;28;20;148;140;183;55;73;193;31;54;25;138;104;8;77;97;81;153;113;194;166;176;114;137;187;141;80;190;117;135;102;63;122;133;90;121;177;36;61;79;91;87;145,5273649147633032238,0.083795
greedy_intra:nodes_start:random,60,66557,40153,26404,724355,474,144;8;104;33;160;124;128;95;130;185;187;141;36;80;190;45;61;77;153;81;21;142;175;78;82;111;18;55;34;189;168;43;134;121;1;38;27;198;117;193;31;54;139;11;195;145;15;155;170;86;166;113;103;163;138;182;74;118;25;177;5;131;135;63;122;147;188;70;3;152;28;20;148;140;183;143;159;89;165;127;137;114;194;180;176;106;13;132;169;6;191;90;51;98;29;83;62;35;109;0,2475979179701623680,0.077959
greedy_intra:nodes_start:random,61,60370,36524,23846,729575,455,28;20;60;148;47;94;179;166;194;5;80;190;177;104;55;34;6;147;133;107;40;63;122;191;90;131;198;117;193;31;54;175;78;36;61;91;21;82;143;62;18;170;155;184;152;4;149;140;183;189;15;134;51;125;135;38;27;1;121;25;8;81;153;163;187;141;77;111;144;160;195;13;168;139;11;138;33;29;0;35;109;145;132;169;188;70;3;185;86;113;127;89;103;176;106;124;95;130;99;9,7063894302703627254,0.087252
greedy_intra:nodes_start:random,62,60528,34170,26358,917548,482,18;189;3;15;145;43;134;51;121;131;1;156;198;117;190;80;136;193;31;54;73;25;182;138;104;8;82;87;21;111;95;130;185;86;81;177;5;78;175;45;122;63;135;90;109;179;94;47;148;20;140;183;152;155;70;132;169;188;6;13;34;55;62;124;176;180;153;97;77;79;61;36;91;141;146;187;165;137;114;113;194;166;106;143;35;0;29;160;144;56;33;195;168;139;11;49;163;89;127;103,8512531067025106578,0.085095
greedy_intra:nodes_start:random,63,59053,33447,25606,599377,501,128;86;166;179;185;95;55;109;29;43;134;6;188;169;70;152;140;4;149;28;20;148;47;94;183;34;155;195;168;11;21;61;36;91;141;97;77;81;0;145;15;3;176;194;113;103;89;163;187;146;153;159;143;62;83;18;35;8;82;78;175;5;139;13;132;147;191;90;51;182;138;33;160;144;104;177;45;136;73;193;117;198;54;31;164;190;80;156;1;38;135;63;40;122;131;121;25;111;106;124,6869560625785138897,0.081104
greedy_intra:nodes_start:random,64,58926,32227,26699,659627,501,31;193;198;117;54;73;61;79;77;141;91;36;78;175;142;5;25;74;134;155;28;20;140;55;18;35;0;29;11;139;168;195;6;188;169;132;13;15;145;33;104;8;144;160;109;34;170;152;183;95;185;148;47;94;179;138;182;121;51;120;71;191;90;135;102;63;122;133;147;70;3;189;62;86;166;128;124;106;159;143;111;81;153;187;165;127;89;176;194;113;103;163;82;21;177;45;80;190;136;164,3308327473334093280,0.088922
greedy_intra:nodes_start:random,65,60401,36289,24112,571044,387,61;36;91;82;77;163;103;113;114;137;127;165;89;153;81;8;104;191;90;122;135;38;27;51;168;195;29;109;95;130;99;179;166;194;55;152;155;145;15;3;70;6;147;134;43;139;182;138;11;33;160;106;86;185;183;140;20;60;148;47;94;176;187;141;175;78;25;13;132;169;188;74;118;121;117;198;156;1;63;40;107;133;131;54;31;190;80;5;177;144;0;35;34;18;62;124;143;111;87;21,4061856576367490321,0.070983
greedy_intra:nodes_start:random,66,65497,36819,28678,669370,463,87;21;157;104;56;8;91;61;177;139;168;132;169;65;188;6;134;51;118;74;138;144;143;124;106;159;5;78;175;80;190;45;36;141;97;81;119;128;62;83;18;35;109;34;55;183;140;148;47;60;20;28;70;161;3;15;13;90;1;198;117;193;31;54;182;189;155;184;95;130;185;86;166;194;160;33;11;195;145;53;152;170;0;29;147;10;133;122;63;135;131;121;25;111;176;113;163;153;77;82,944426510553572349,0.077271
greedy_intra:nodes_start:random,67,59111,33301,25810,970044,495,56;104;177;5;142;175;78;36;141;81;106;124;62;18;34;189;145;134;51;118;33;55;183;140;28;20;148;47;94;99;22;179;172;166;194;176;113;103;127;89;153;80;190;136;25;182;138;11;139;168;195;126;13;15;3;70;169;188;6;147;191;90;135;63;38;27;1;131;121;132;155;184;152;170;111;82;77;97;187;163;86;185;95;128;143;31;193;117;54;73;61;91;21;8;35;109;0;29;160;144,3972479408119369086,0.096981
greedy_intra:nodes_start:random,68,62232,36659,25573,436751,414,191;90;133;10;147;3;155;152;28;20;60;148;99;18;35;109;144;8;82;111;41;81;97;141;91;61;5;45;193;117;1;63;40;122;135;131;51;43;189;170;47;66;94;179;185;166;103;163;153;77;177;25;182;138;159;143;62;124;106;176;113;194;86;95;130;183;140;55;34;15;145;168;33;56;21;36;78;175;80;190;136;121;118;134;139;11;29;0;160;104;73;31;54;6;188;169;132;70;13;195,2606738755519529061,0.063630
greedy_intra:nodes_start:random,69,59590,33478,26112,599682,457,21;61;177;73;31;193;190;80;175;78;5;169;188;6;51;121;112;19;136;45;36;141;77;176;113;163;186;153;81;146;187;165;127;89;103;194;166;185;183;140;20;60;148;47;94;66;179;86;82;8;104;138;182;134;147;133;40;107;122;90;131;135;63;1;198;117;54;25;18;55;34;69;29;0;109;35;143;128;62;170;152;155;70;3;189;124;106;159;41;111;144;160;33;11;195;13;15;145;168;139,8537517182766459168,0.071780
greedy_intra:nodes_start:random,70,62120,36237,25883,737937,502,134;133;122;107;40;63;135;104;144;143;106;86;185;94;47;148;20;179;166;194;34;3;70;188;6;147;121;198;117;175;78;142;5;177;8;55;140;183;95;130;124;82;21;61;36;91;141;77;15;145;13;169;132;43;139;182;25;54;31;73;136;80;190;193;131;90;191;125;51;138;33;160;170;152;184;155;109;35;111;81;97;153;187;163;89;127;103;113;180;176;128;62;18;195;168;29;0;39;49;11,2787530809854743320,0.086341
greedy_intra:nodes_start:random,71,59144,32774,26370,681534,474,94;47;148;60;20;140;152;55;83;95;130;166;194;103;127;89;155;15;145;195;168;109;35;0;144;56;104;138;182;139;43;132;70;3;189;69;29;11;134;51;135;63;1;198;117;193;31;54;25;33;160;143;106;124;62;34;13;169;188;147;90;122;131;121;73;190;80;36;61;141;97;77;81;153;187;163;113;176;128;18;174;183;99;22;179;172;185;86;82;21;177;5;45;142;175;78;8;111;159;66,5468177471458401254,0.076902
greedy_intra:nodes_start:random,72,63670,37252,26418,842543,490,95;189;3;15;145;144;8;21;87;111;35;0;29;188;6;90;131;190;80;175;78;36;61;33;168;169;132;161;70;13;195;43;134;121;54;31;136;45;5;104;56;11;139;51;135;63;122;147;155;184;170;152;4;149;140;183;28;20;148;94;179;77;141;91;177;1;156;198;117;193;73;187;127;89;163;153;159;143;106;124;86;166;194;113;176;81;82;25;118;74;182;138;160;109;34;55;18;62;185;130,8747602420958925413,0.087456
greedy_intra:nodes_start:random,73,64331,38973,25358,728025,504,195;168;111;81;187;127;114;194;166;176;153;77;141;36;61;21;138;182;74;134;139;29;35;143;124;128;185;179;172;57;66;94;47;130;95;55;109;0;160;144;8;177;190;80;162;175;78;82;62;18;34;155;15;3;70;169;188;51;54;73;25;183;140;152;170;189;33;104;5;45;136;31;193;117;121;28;20;60;148;99;86;163;89;103;26;113;180;106;159;11;90;135;63;122;133;147;6;132;13;145,1979903425633508122,0.085346
greedy_intra:nodes_start:random,74,65908,36481,29427,527113,404,121;112;173;45;5;177;21;104;56;144;160;33;49;138;25;73;164;54;31;117;198;193;136;87;82;8;168;195;13;145;55;95;86;18;189;15;3;70;132;126;169;188;6;43;29;35;185;179;99;130;183;140;152;170;109;0;111;78;175;36;141;77;153;124;62;34;184;155;147;107;40;63;135;163;103;113;176;106;159;143;81;91;61;142;80;190;156;1;98;134;139;11;182;118;51;191;90;133;122;131,2495478765437745918,0.069315
greedy_intra:nodes_start:random,75,56930,30917,26013,417298,475,31;73;136;45;142;175;78;36;141;77;81;143;34;152;184;155;3;132;169;90;122;63;133;10;178;147;6;188;70;29;109;35;0;144;160;33;121;131;1;16;27;38;135;51;168;195;145;55;83;62;176;113;103;194;166;106;124;18;183;95;130;99;22;185;86;179;94;47;148;60;20;28;140;127;89;163;153;41;111;104;8;82;87;21;91;61;177;5;80;190;193;117;54;25;182;138;11;139;118;112,147951110309556164,0.065000
greedy_intra:nodes_start:random,76,60851,33849,27002,632368,488,109;69;189;170;34;106;103;89;163;33;11;139;168;126;188;6;147;134;85;74;118;98;51;90;122;131;198;117;193;31;141;77;153;180;176;194;166;94;148;20;28;29;160;144;104;138;182;195;13;161;70;169;132;145;15;3;155;152;140;183;55;18;62;143;159;111;8;25;73;136;190;80;175;78;36;61;91;21;177;54;156;1;63;135;121;45;5;82;124;128;95;185;86;113;114;127;187;81;35;0,7676049948258783203,0.081843
greedy_intra:nodes_start:random,77,64704,36407,28297,624657,404,127;114;113;176;124;3;70;132;169;188;36;61;91;104;56;160;39;12;0;35;41;77;141;175;80;190;193;31;73;136;25;55;34;15;6;147;133;122;63;135;131;90;191;182;138;168;195;13;145;109;29;11;139;118;121;38;27;16;1;24;156;198;117;54;112;51;134;95;185;179;166;86;106;159;111;8;144;143;62;18;83;183;140;20;28;152;155;189;33;5;142;78;177;21;82;81;153;163;103;89,8680278671996796071,0.075925
greedy_intra:nodes_start:random,78,63978,33854,30124,680574,439,36;61;111;35;0;29;25;1;156;80;190;193;198;117;31;5;177;87;8;168;195;13;132;145;15;70;3;189;155;152;170;109;49;33;160;41;81;153;119;159;11;139;134;51;98;118;21;91;141;77;163;89;127;103;113;176;194;183;140;55;18;144;56;104;157;138;182;90;122;135;131;112;142;175;78;82;143;106;124;62;83;128;95;130;185;179;166;86;34;169;188;6;147;121;151;54;164;73;136;45,8780162050834820673,0.082972
greedy_intra:nodes_start:random,79,61686,33539,28147,621207,490,6;188;15;189;106;143;182;25;73;117;198;1;63;135;131;121;112;45;175;78;177;144;35;140;183;185;86;95;170;155;3;70;161;169;132;13;145;184;152;20;148;47;94;179;166;194;176;113;103;89;163;160;138;139;11;29;124;128;62;18;55;34;109;0;12;111;81;153;97;77;82;8;104;21;5;80;190;134;195;168;49;33;56;91;141;61;36;136;164;193;31;54;151;19;118;98;51;90;191;147,6112920383653868516,0.078197
greedy_intra:nodes_start:random,80,59509,33921,25588,529349,425,81;163;103;89;127;187;141;36;80;190;193;198;117;54;31;164;73;182;139;11;124;95;20;60;94;66;47;148;183;140;152;184;155;132;169;10;133;122;63;135;1;156;136;175;78;142;45;5;177;104;144;159;113;180;176;128;34;189;3;70;161;188;6;147;90;51;121;25;21;61;91;77;97;153;137;114;194;166;106;143;35;109;0;29;168;195;13;15;145;55;185;86;62;18;82;8;138;33;160;111,973366285704273002,0.067400
greedy_intra:nodes_start:random,81,59569,34164,25405,636123,457,134;188;169;70;149;28;20;60;66;179;185;130;95;111;21;61;36;91;77;81;153;62;83;183;140;148;47;94;99;152;155;3;132;6;147;10;133;122;63;135;90;51;118;138;33;160;195;13;126;168;0;35;143;176;194;166;86;128;124;106;129;163;103;180;18;55;109;29;145;15;189;34;113;114;137;127;89;165;187;141;175;80;190;1;131;121;73;31;54;117;193;136;5;177;8;104;11;139;182;74,2895039651578339168,0.078824
greedy_intra:nodes_start:random,82,64160,38553,25607,644305,481,3;34;55;18;62;143;159;153;163;103;113;176;194;166;179;66;94;47;148;130;109;138;121;156;1;63;135;90;51;89;127;165;187;141;78;175;131;122;133;147;6;188;169;132;43;139;11;182;25;73;164;136;5;91;77;81;106;183;4;149;28;20;140;152;155;168;134;54;31;33;29;0;35;124;128;95;185;86;111;45;80;190;193;117;198;173;177;36;61;21;87;82;8;104;144;160;195;13;145;70,8463599489072998835,0.077051
greedy_intra:nodes_start:random,83,62593,37438,25155,671684,466,82;21;31;54;117;121;182;139;43;188;169;132;13;195;168;33;160;144;81;153;89;127;103;113;194;166;47;60;20;148;99;185;130;95;183;34;109;104;190;80;61;91;97;77;50;111;0;35;106;176;163;187;141;36;45;136;193;198;1;131;51;29;86;179;66;94;28;140;152;170;8;177;78;175;5;25;138;11;145;15;3;6;147;10;133;122;63;135;90;191;134;161;70;155;184;55;18;62;124;143,8432859695079536864,0.075702
greedy_intra:nodes_start:random,84,59683,32687,26996,557116,424,168;15;3;70;161;188;6;169;29;104;177;36;61;21;82;163;89;127;165;187;97;8;144;160;33;11;139;134;43;195;13;132;145;189;86;166;194;113;103;153;81;77;141;91;5;25;155;184;152;140;183;174;35;0;109;69;170;34;55;18;62;124;106;159;41;111;143;128;95;185;99;20;60;148;47;94;179;176;175;80;190;136;73;164;193;31;54;151;117;198;1;51;90;122;63;135;131;121;182;138,4460050858415549535,0.071159
greedy_intra:nodes_start:random,85,59653,33237,26416,681974,478,193;190;80;45;175;78;5;177;36;141;77;153;106;124;62;18;55;183;140;189;145;13;195;81;163;89;127;114;166;179;20;28;149;4;152;170;34;109;0;111;82;21;8;144;56;104;49;11;139;168;132;15;70;161;169;65;188;6;180;176;103;26;113;194;86;185;66;94;47;148;60;155;3;134;51;121;54;31;25;182;138;33;160;39;29;35;143;159;128;95;99;130;147;90;122;107;40;63;135;117,8957671187302160208,0.084842
greedy_intra:nodes_start:random,86,60441,34148,26293,845365,461,73;168;145;15;3;189;109;0;35;143;106;86;185;130;95;83;18;55;144;56;104;21;61;36;91;141;81;183;140;28;152;170;34;8;87;82;77;187;127;103;113;194;176;163;153;111;195;13;132;155;20;148;47;94;66;179;166;128;160;33;138;182;25;5;142;175;78;177;124;62;29;11;139;43;74;118;121;51;134;169;70;161;188;6;147;191;90;122;135;63;38;1;198;117;190;80;136;193;31;54,4581274814553145452,0.085959
greedy_intra:nodes_start:random,87,60810,34478,26332,1179613,540,29;160;138;182;121;54;31;193;73;25;104;33;11;139;131;1;198;117;5;78;175;36;61;79;82;111;148;47;94;66;99;95;62;109;134;90;122;133;10;188;169;132;13;161;70;145;15;3;34;55;18;86;194;166;179;185;130;183;199;20;28;140;8;87;21;91;141;77;81;153;187;163;89;127;114;103;113;180;176;106;124;143;35;189;155;184;152;170;0;144;177;80;190;136;51;147;6;43;168;195,8375235403992643702,0.105817
greedy_intra:nodes_start:random,88,63173,34952,28221,583469,469,70;188;147;40;107;122;90;51;138;182;56;160;49;195;126;168;109;163;89;153;91;61;36;141;187;127;103;113;176;166;143;35;0;144;8;87;21;177;45;136;198;1;135;131;121;18;62;124;106;159;37;111;41;14;81;97;77;82;104;33;11;139;134;85;74;118;158;25;5;78;175;80;190;193;117;31;54;29;34;149;28;20;148;47;94;179;185;86;55;189;13;169;132;145;15;3;155;183;140;152,8937477216680364343,0.080562
greedy_intra:nodes_start:random,89,53417,28780,24637,751418,491,95;66;94;47;148;60;20;199;140;152;53;4;149;28;183;124;143;35;0;109;34;170;155;15;145;195;168;77;153;187;163;89;127;137;114;103;113;176;194;166;86;185;179;99;130;128;106;111;29;160;138;182;25;121;131;122;135;63;38;27;16;1;156;198;117;177;36;61;91;141;82;8;104;33;11;139;134;51;73;54;31;193;136;45;5;78;175;80;190;90;147;6;188;169;132;70;3;55;18;62,496816640102760526,0.088707
greedy_intra:nodes_start:random,90,62430,35398,27032,790953,482,195;168;134;51;121;131;135;63;38;1;156;198;117;138;109;62;86;194;176;106;124;143;0;29;11;139;188;6;147;90;133;122;151;73;45;142;175;177;104;56;8;82;77;141;91;87;111;159;18;55;34;35;21;61;36;78;5;193;31;54;33;160;144;81;153;163;89;127;103;113;166;185;47;148;20;140;183;162;80;190;136;173;25;182;189;170;95;130;99;152;184;155;145;15;3;70;161;169;132;13,6988076149989480866,0.093872
greedy_intra:nodes_start:random,91,71474,41149,30325,525593,391,153;163;103;113;176;106;124;12;39;29;0;35;34;170;147;90;51;118;11;55;18;111;21;78;175;36;141;91;79;61;177;5;45;193;198;117;54;82;81;185;47;148;20;28;140;8;136;73;164;31;112;6;188;169;132;126;13;145;69;143;159;189;15;70;3;155;184;152;183;130;95;62;109;139;85;134;43;168;195;49;160;33;138;182;74;25;104;56;144;128;86;166;194;187;80;190;1;131;121;77,2717955230798096497,0.063918
greedy_intra:nodes_start:random,92,58617,33386,25231,620512,520,153;166;22;148;20;60;47;94;66;179;86;111;25;190;80;45;5;177;104;8;82;21;142;175;78;36;61;91;187;103;113;176;35;168;195;132;169;134;121;54;31;193;117;198;1;27;38;63;135;122;182;138;33;0;109;29;11;139;51;125;90;191;147;6;188;70;3;15;145;34;62;128;185;99;130;95;152;184;155;189;143;159;106;163;89;165;127;137;114;194;9;140;183;55;18;124;81;77;141;97,4798282080243102911,0.088369
greedy_intra:nodes_start:random,93,60681,32026,28655,965483,501,6;147;90;121;198;117;54;136;141;153;113;176;86;95;183;140;34;5;142;78;175;80;190;193;31;164;73;25;182;139;134;118;74;138;104;56;143;18;55;170;184;155;3;15;145;13;132;126;195;168;29;109;129;163;103;114;137;127;165;187;89;194;166;179;185;124;106;8;177;36;61;91;77;81;119;159;41;111;82;87;21;144;160;33;11;49;0;35;62;99;94;47;148;20;28;152;189;70;169;188,6263959743805185644,0.095030
greedy_intra:nodes_start:random,94,65794,36510,29284,714032,461,77;34;170;152;155;147;191;90;122;135;131;125;51;185;179;166;194;114;127;89;165;146;97;177;21;82;111;18;55;183;140;149;28;20;148;62;35;121;117;31;80;190;175;78;5;36;187;153;81;119;159;143;106;95;130;86;128;124;0;109;15;161;70;3;189;176;113;103;163;160;33;138;11;168;195;29;144;56;104;25;158;118;74;85;134;43;6;188;169;132;13;145;139;182;8;87;61;79;91;141,276548388001315567,0.081001
greedy_intra:nodes_start:random,95,58716,32795,25921,697634,494,38;63;135;122;133;90;191;51;139;62;86;185;60;20;130;95;128;124;81;77;141;82;13;145;15;3;70;132;169;188;6;147;134;168;195;153;163;103;89;165;127;137;114;113;180;176;194;166;179;148;47;94;66;99;18;34;33;25;121;112;136;162;80;190;105;193;54;31;164;73;45;175;78;5;36;61;55;183;140;152;35;0;160;144;111;143;159;106;109;29;11;182;138;104;8;21;177;117;198;1,565175260301034005,0.080656
greedy_intra:nodes_start:random,96,57962,31992,25970,782639,491,91;61;141;187;165;127;89;175;80;190;45;5;36;21;82;29;13;169;188;147;71;51;118;182;138;124;62;128;95;99;94;47;148;60;20;28;149;4;199;9;140;183;189;15;145;195;168;134;90;122;63;135;1;131;121;132;70;3;155;152;170;34;55;18;35;109;0;104;177;136;73;193;117;31;54;19;112;25;139;11;33;160;144;56;8;111;143;106;176;180;113;194;166;179;185;86;103;163;153;77,2406563720544989415,0.085804
greedy_intra:nodes_start:random,97,62028,33127,28901,730166,480,177;36;61;91;141;87;21;5;73;193;31;54;121;125;90;191;71;120;51;98;118;74;134;188;13;0;153;163;89;127;103;113;194;166;176;135;122;147;29;109;152;140;20;60;47;154;94;66;148;155;145;15;3;70;132;169;6;131;1;198;117;190;80;45;142;175;78;104;56;8;82;111;41;37;35;34;62;124;81;77;159;18;55;183;95;185;86;106;143;144;160;33;11;168;195;126;43;139;138;25,7746626723664583565,0.090607
greedy_intra:nodes_start:random,98,62180,35990,26190,800051,494,160;81;163;176;86;95;183;3;70;15;145;6;147;192;188;169;132;13;195;134;98;51;90;131;193;31;54;121;118;43;168;139;11;182;138;144;111;159;106;143;35;56;104;5;78;175;142;45;80;190;136;33;34;55;18;62;61;36;21;8;0;189;155;184;152;140;20;148;47;94;179;185;166;194;82;177;73;117;198;1;135;63;122;133;10;25;91;141;77;153;187;127;89;103;114;113;124;109;29;49,4598690869998545968,0.086998
greedy_intra:nodes_start:random,99,66244,41263,24981,489867,443,83;55;18;177;73;54;25;11;189;152;149;28;140;183;170;34;62;124;106;97;141;77;81;153;187;127;89;179;66;94;47;148;20;155;145;195;31;193;136;78;36;61;15;3;70;13;168;5;45;190;80;175;21;82;111;109;29;138;117;198;156;1;38;135;63;40;107;6;169;188;132;143;163;103;113;180;176;194;166;35;0;160;33;51;191;90;122;133;10;178;147;125;131;121;104;8;86;185;130;95,1324888937027981146,0.066551
greedy_intra:nodes_start:random,100,60875,33490,27385,792190,459,139;134;6;188;169;132;138;36;61;91;141;77;81;143;62;18;34;35;109;0;49;74;118;121;131;90;51;147;133;122;135;1;117;193;31;54;73;25;43;13;195;168;182;5;177;21;124;128;95;183;152;170;55;185;179;166;194;113;163;97;175;78;145;15;70;3;155;184;189;29;56;104;8;87;82;41;159;106;130;99;94;47;148;20;28;149;140;86;176;103;127;89;165;187;153;111;144;160;33;11,46186451220449635,0.083329
greedy_intra:nodes_start:random,101,62254,37136,25118,794499,510,33;160;56;8;82;21;177;78;175;142;5;104;144;0;29;145;195;168;11;138;61;36;80;190;136;31;54;25;13;70;3;15;109;35;111;41;81;106;124;18;55;34;183;20;60;179;86;153;73;193;117;1;63;135;155;149;28;140;130;185;166;194;113;103;89;165;163;159;143;170;152;148;47;94;99;95;62;128;176;180;114;127;187;97;141;77;132;169;188;6;51;121;131;122;133;90;191;147;134;139,4203166212185551463,0.093646
greedy_intra:nodes_start:random,102,66328,41200,25128,580438,426,90;122;133;147;70;152;183;99;130;95;29;11;139;121;198;156;1;131;51;134;168;34;55;18;62;103;127;89;163;153;97;77;81;119;106;124;86;185;128;160;33;177;142;5;182;138;56;8;82;61;36;91;141;187;137;114;113;176;194;166;94;47;148;20;140;170;109;21;78;175;136;193;31;54;25;104;111;159;143;35;0;144;45;80;190;117;169;188;6;107;40;63;135;195;145;15;189;155;3;132,2319426803453702263,0.072480
greedy_intra:nodes_start:random,103,59616,33233,26383,893173,511,194;113;176;111;138;51;71;147;6;188;70;3;145;195;182;25;177;5;136;193;198;156;1;117;173;21;8;33;160;49;11;139;134;191;90;122;135;131;121;104;56;144;0;109;183;140;28;20;60;148;130;95;152;184;155;15;132;169;13;168;29;35;143;159;124;62;18;55;34;82;45;190;80;175;78;36;61;73;164;31;54;91;141;187;165;127;89;163;153;97;77;81;106;86;185;99;47;94;179;166,7648065728420059782,0.104212
greedy_intra:nodes_start:random,104,60096,34362,25734,743116,536,20;28;177;5;136;73;164;54;31;190;80;175;78;36;187;165;127;176;86;185;95;55;189;43;134;188;169;132;155;18;62;124;106;159;143;144;160;33;195;13;70;3;15;145;139;11;49;29;152;140;183;34;35;0;109;168;6;147;10;133;122;135;38;1;198;117;193;112;121;98;118;74;182;138;104;21;141;97;77;82;25;63;40;107;90;191;51;8;111;153;163;89;103;113;194;166;179;94;47;148,4154028159744547755,0.089998
greedy_intra:nodes_start:random,105,64255,39804,24451,568055,463,86;95;62;143;111;8;177;5;36;61;77;81;183;140;9;47;94;66;172;163;187;82;21;25;121;131;122;133;10;191;90;125;51;139;11;169;188;6;147;40;63;135;138;29;34;55;130;99;148;60;20;28;152;155;189;145;132;13;35;153;89;127;141;78;73;31;193;190;80;175;104;0;109;15;3;70;195;168;134;198;117;54;33;160;18;185;22;179;166;194;114;137;103;26;113;180;176;106;124;128,657722015269486644,0.079191
greedy_intra:nodes_start:random,106,61263,35278,25985,816257,500,60;148;183;140;34;160;33;11;168;195;132;169;188;134;85;118;98;51;90;10;133;182;138;144;111;8;25;158;125;191;147;6;70;3;189;95;86;166;194;176;113;103;89;127;163;187;77;81;153;106;143;35;29;139;107;40;63;135;122;131;45;5;61;36;78;175;136;31;73;177;21;124;62;18;55;109;0;104;198;117;193;80;190;54;121;74;43;126;13;145;15;155;152;149;28;20;185;179;94;47,2558918031885530581,0.091793
greedy_intra:nodes_start:random,107,62115,35842,26273,533151,482,111;77;81;153;35;109;0;82;21;61;36;5;45;164;193;31;73;182;29;34;55;183;28;20;60;94;47;148;140;152;184;155;54;117;135;122;90;51;169;65;188;6;147;178;10;133;191;25;91;141;187;194;166;179;185;86;163;165;127;89;103;113;176;106;124;62;18;15;145;168;136;190;80;175;78;177;8;104;160;33;138;11;139;134;118;98;116;121;131;63;40;107;132;161;70;3;13;195;49;144,924022265866103328,0.076402
greedy_intra:nodes_start:random,108,60758,34275,26483,726507,489,95;130;86;128;18;55;34;62;124;153;165;137;187;81;160;188;169;132;70;3;155;152;149;28;20;148;140;183;170;111;177;5;45;162;136;164;54;31;193;117;198;156;1;63;135;131;121;25;82;77;141;87;21;91;79;61;36;8;104;144;29;0;33;139;134;43;13;145;15;163;89;127;103;113;194;185;99;179;166;176;106;143;35;109;195;168;11;138;182;142;78;175;80;190;73;90;133;10;147;6,3512220522102103150,0.080154
greedy_intra:nodes_start:random,109,61025,34262,26763,665817,504,31;164;136;190;80;175;78;18;140;28;20;183;62;124;106;143;35;109;29;139;43;126;132;13;195;168;11;138;33;160;0;128;86;153;81;77;141;91;25;118;51;147;6;169;15;189;152;184;155;3;70;188;191;90;100;40;107;10;133;122;63;135;131;121;111;163;89;127;103;113;180;176;194;166;179;185;99;130;95;55;34;145;134;198;117;193;45;5;177;104;87;21;36;61;82;8;144;182;73;54,4255852881318168409,0.080823
greedy_intra:nodes_start:random,110,62018,36656,25362,701270,492,189;184;155;145;15;3;70;188;6;134;121;25;177;36;61;141;77;187;163;153;35;109;170;152;95;130;185;148;20;60;47;94;179;62;18;144;56;8;104;138;43;169;132;13;195;168;139;182;11;28;149;140;183;55;34;29;33;160;143;124;86;166;194;176;81;111;74;118;98;51;191;90;131;135;63;122;133;147;0;113;114;137;127;165;89;103;180;106;159;82;54;31;117;193;190;80;175;78;5;21,3834488050345615406,0.083456
greedy_intra:nodes_start:random,111,62051,35423,26628,698526,499,43;6;147;90;122;63;135;131;121;117;193;54;31;164;73;136;177;104;106;124;95;130;185;99;152;155;145;56;8;81;153;163;187;97;77;111;15;3;70;13;78;175;142;25;74;134;188;169;132;195;168;29;12;159;143;0;35;109;34;28;20;148;47;94;66;179;128;62;18;55;174;140;183;86;166;194;176;61;36;141;165;127;113;103;89;82;21;5;45;80;190;51;118;182;138;144;160;33;11;139,8434779133344162735,0.099857
greedy_intra:nodes_start:random,112,64579,38601,25978,680191,452,47;148;95;109;29;158;121;45;142;5;177;104;56;0;35;21;78;190;80;175;163;103;113;176;153;81;25;73;54;31;193;117;1;40;107;188;169;140;183;55;34;98;51;90;135;63;122;147;6;43;139;11;49;33;138;182;74;118;134;132;70;155;170;18;62;124;143;111;82;8;144;160;168;195;13;145;15;3;189;184;152;149;28;20;99;185;86;106;159;77;91;61;36;141;187;127;194;166;179;94,7134795306512325849,0.078001
greedy_intra:nodes_start:random,113,69007,42578,26429,862198,453,145;15;124;180;113;114;103;163;153;177;31;54;117;193;5;187;127;89;35;109;189;155;184;152;170;34;0;29;49;168;188;6;147;90;51;134;43;18;55;3;70;132;169;126;33;21;91;61;121;131;135;1;198;175;78;36;141;106;183;140;28;20;60;130;95;62;144;56;104;8;82;77;81;159;143;138;182;25;190;80;45;99;148;47;166;194;176;86;179;66;94;185;128;41;111;160;11;139;195;13,2765191378716237959,0.082358
greedy_intra:nodes_start:random,114,59623,33852,25771,671043,496,127;82;21;25;131;135;63;122;133;147;188;169;132;139;5;45;162;80;190;136;193;117;54;31;73;36;61;91;141;187;89;103;113;194;52;172;179;185;176;163;153;35;145;15;70;3;155;149;28;95;86;106;159;81;97;77;111;143;124;62;18;55;174;183;140;152;109;0;29;8;177;78;175;142;121;90;51;182;138;33;160;11;168;195;13;34;130;9;199;60;20;148;47;94;66;99;22;166;114;137,5828641659380595655,0.092923
greedy_intra:nodes_start:random,115,58758,32973,25785,784975,485,83;185;179;66;94;60;20;152;170;111;77;81;153;127;89;163;109;145;15;169;134;51;121;117;1;135;122;90;191;147;6;188;124;176;113;103;114;137;165;187;141;78;175;142;5;177;21;91;61;36;45;80;190;193;31;54;25;139;13;132;70;3;155;149;28;148;47;99;130;95;183;140;62;128;86;166;194;106;143;35;0;144;56;104;138;182;11;49;160;33;8;82;39;29;168;195;189;34;55;18,8696412369950632462,0.090679
greedy_intra:nodes_start:random,116,62424,35068,27356,668192,446,74;182;138;25;73;117;198;193;136;187;194;166;128;124;143;35;121;131;90;191;10;133;122;63;135;139;34;55;18;62;106;81;175;78;5;177;56;144;68;87;21;61;36;91;141;77;82;8;104;147;192;6;188;169;132;195;168;49;33;160;111;153;163;89;127;103;113;176;86;185;179;94;47;148;20;28;140;183;152;155;11;80;190;31;54;19;112;29;0;109;189;3;70;15;145;13;134;51;98;118,7295131299875534163,0.078421
greedy_intra:nodes_start:random,117,61629,34920,26709,654430,493,180;159;143;111;8;25;121;122;135;1;198;117;131;90;191;134;168;195;15;3;70;161;132;13;139;182;5;78;175;36;61;21;183;94;47;148;20;140;152;170;34;55;83;18;128;113;114;137;127;89;163;81;29;169;188;6;147;51;98;118;74;138;160;62;124;106;153;187;97;77;82;0;109;35;26;103;165;141;73;54;31;193;190;80;45;177;104;144;33;11;145;155;184;95;86;185;179;166;194;176,7407836232035195475,0.083544
greedy_intra:nodes_start:random,118,65669,38964,26705,490069,418,29;43;132;13;126;168;195;155;184;152;28;140;34;111;175;162;80;190;117;198;1;63;135;121;158;25;138;104;8;56;160;169;188;6;134;139;11;49;39;0;35;144;33;182;51;90;10;133;122;131;193;136;45;61;153;113;194;176;124;106;159;143;189;145;15;70;3;103;89;163;77;177;73;54;31;20;148;47;94;179;99;130;183;95;185;86;166;127;187;141;36;78;142;5;21;82;62;18;55;109,3181288751292352716,0.071514
greedy_intra:nodes_start:random,119,67723,40057,27666,684438,448,155;152;28;20;148;47;94;15;3;70;188;6;147;10;133;63;38;190;80;175;141;97;77;50;111;81;153;163;113;103;89;127;187;5;73;54;182;49;170;140;183;185;95;145;13;195;168;139;11;33;160;56;104;131;135;32;122;124;86;166;176;106;143;132;169;134;118;98;51;121;193;31;125;191;90;1;198;117;25;138;35;62;18;55;34;109;0;12;29;144;8;87;21;177;36;61;79;91;82;189,4094331881741249157,0.076204
greedy_intra:nodes_start:random,120,62966,37031,25935,559824,477,0;35;55;34;15;3;70;161;169;188;6;147;191;90;122;135;63;40;107;131;112;177;36;61;21;87;82;18;62;143;159;111;144;8;77;141;187;127;89;106;124;128;86;194;176;81;104;182;118;74;139;168;195;126;132;134;51;121;45;175;78;5;25;138;140;28;149;4;155;145;13;109;29;11;33;160;153;163;103;113;166;179;66;94;47;148;185;95;183;152;189;73;54;31;193;117;1;198;190;80,6239184630881055897,0.083493
greedy_intra:nodes_start:random,121,57635,29600,28035,602008,488,90;51;121;118;139;195;13;145;15;189;62;128;180;113;103;89;165;187;141;61;36;175;80;190;193;198;117;54;31;73;5;25;182;138;11;29;0;160;33;104;144;109;35;18;95;130;99;124;106;81;77;153;86;185;183;140;174;170;152;53;4;149;28;20;148;47;94;66;179;114;137;127;163;159;143;8;177;21;87;82;111;176;88;194;166;55;34;155;3;70;161;132;126;168;43;134;169;188;6;147,4055753368750224454,0.087969
greedy_intra:nodes_start:random,122,63812,36938,26874,470219,437,51;188;169;132;155;18;83;62;128;124;143;182;118;74;43;145;15;3;70;184;152;183;55;34;170;189;82;21;177;5;31;193;190;80;95;130;148;20;140;144;160;33;56;111;41;81;8;104;138;11;139;168;195;13;126;6;147;71;120;85;134;29;0;109;35;153;163;89;127;137;114;194;166;179;94;47;185;86;106;77;141;187;103;113;176;61;36;78;175;73;54;117;1;90;133;122;63;135;131;121,4298329607792486695,0.071970
greedy_intra:nodes_start:random,123,60854,33835,27019,496956,460,185;130;95;33;158;112;151;198;117;193;164;136;5;36;61;106;124;62;18;55;34;145;168;195;13;15;3;155;152;140;183;99;166;194;113;8;56;104;177;78;175;80;190;121;51;90;122;135;63;38;1;156;31;54;73;25;82;77;146;187;153;81;160;139;134;6;188;169;132;70;28;20;148;47;94;179;103;127;89;163;97;141;21;138;182;11;49;29;109;143;159;41;111;144;0;35;128;180;176;86,5621600055429741853,0.074065
greedy_intra:nodes_start:random,124,59748,32675,27073,895481,476,195;168;126;169;188;6;147;51;118;134;139;11;33;138;182;54;31;136;142;78;175;162;80;190;45;5;104;144;160;29;34;28;20;148;47;94;61;36;141;77;111;145;161;70;3;155;184;4;149;140;124;106;21;177;73;193;117;131;125;71;191;90;122;63;135;121;25;8;82;81;153;159;143;35;12;0;109;170;152;183;86;163;89;127;103;113;176;194;166;179;185;130;95;62;18;55;189;15;132;13,4717798330072900806,0.090283
greedy_intra:nodes_start:random,125,61332,34574,26758,655785,497,113;103;89;127;165;163;195;145;86;194;166;179;94;47;148;20;28;149;70;169;188;54;117;193;31;164;73;25;138;33;144;160;49;168;13;132;15;3;155;184;152;140;183;174;55;34;35;109;0;56;104;177;5;45;190;80;162;175;78;36;61;91;141;21;139;134;6;147;122;63;135;111;143;95;130;185;128;124;106;153;187;146;81;77;82;8;182;74;118;121;131;90;191;51;98;11;29;18;62;176,1629479419219229487,0.079644
greedy_intra:nodes_start:random,126,60682,33971,26711,630497,474,103;86;185;95;183;140;124;62;18;55;34;35;160;33;90;135;63;1;198;136;78;142;45;73;31;54;117;193;5;177;82;81;153;94;148;20;28;121;131;122;133;10;147;51;25;104;111;143;106;179;22;99;130;174;152;170;184;167;189;155;15;3;70;161;145;13;132;126;195;168;138;182;74;134;6;188;169;43;139;11;29;109;0;144;8;21;61;36;175;190;80;141;77;163;176;166;194;113;127;89,2095807382292783149,0.082741
greedy_intra:nodes_start:random,127,63987,37864,26123,418997,459,175;78;111;62;18;185;130;95;55;189;145;15;3;70;147;191;90;125;131;121;51;98;6;188;169;132;168;11;104;82;91;36;61;21;8;56;160;39;29;49;182;138;33;163;113;166;194;114;137;127;89;103;176;152;184;155;34;124;143;80;190;193;31;5;177;144;0;109;35;183;140;28;20;148;47;94;66;179;86;106;25;54;117;135;63;40;122;118;74;134;139;43;126;13;195;81;187;153;77;141,2244633871806488648,0.070047
greedy_intra:nodes_start:random,128,61343,34005,27338,466010,453,80;190;5;77;81;146;187;127;89;103;163;153;111;104;51;121;25;87;21;73;54;31;193;117;138;109;62;183;140;20;148;47;94;179;166;194;113;176;180;128;124;106;159;143;35;0;49;33;82;141;61;36;78;175;198;1;135;63;122;90;147;145;86;185;99;130;95;18;55;34;168;43;6;134;74;182;139;11;189;170;152;184;155;132;169;188;70;3;15;13;126;195;29;12;39;160;144;8;177;45,3182039136038530753,0.071467
greedy_intra:nodes_start:random,129,60058,32302,27756,425729,444,95;124;106;103;89;165;127;114;113;176;180;153;141;91;177;123;25;125;90;10;133;122;135;1;117;193;5;82;77;163;194;166;86;183;140;152;155;195;168;134;51;147;6;188;169;132;74;118;121;112;54;31;73;136;182;139;138;104;56;8;87;21;61;36;78;175;80;190;45;142;144;160;29;189;145;15;3;70;161;13;11;33;111;143;18;20;148;47;94;179;55;34;0;12;109;35;62;185;99;130,924048985856387448,0.065180
greedy_intra:nodes_start:random,130,59450,34167,25283,694944,425,60;20;183;95;124;62;18;55;140;28;149;152;34;29;182;51;90;135;38;27;1;177;21;87;82;8;104;138;25;121;131;198;117;190;80;175;78;142;45;136;73;164;193;31;54;77;127;137;114;176;86;172;179;166;194;113;103;89;163;81;111;0;160;144;56;33;11;139;74;118;134;168;195;35;153;187;146;97;141;36;61;5;63;40;107;122;147;6;188;169;70;3;109;143;106;185;99;94;47;148,5020369001645250732,0.081061
greedy_intra:nodes_start:random,131,61439,35164,26275,759052,468,70;132;13;195;168;104;36;61;91;141;77;159;143;189;169;188;147;133;122;90;134;139;11;33;160;62;179;94;47;148;20;28;149;4;155;15;145;29;0;35;106;103;89;127;114;194;166;176;113;163;153;81;82;21;177;136;80;190;193;117;198;156;27;38;16;1;121;158;25;5;78;175;142;45;51;118;182;138;34;55;18;109;144;73;31;54;8;111;124;128;86;185;95;170;152;140;183;99;130;3,3244288213501118065,0.088512
greedy_intra:nodes_start:random,132,62612,37232,25380,644299,468,148;183;18;109;160;144;56;87;21;190;80;175;61;77;86;185;130;95;55;34;29;11;121;54;31;117;131;133;122;135;102;63;40;107;10;147;85;134;6;188;169;132;13;70;3;103;89;127;187;141;36;78;5;177;25;182;138;139;118;51;1;156;16;27;38;90;191;195;168;33;104;8;82;143;62;140;20;28;152;155;15;145;189;124;106;163;153;81;111;0;35;159;176;180;113;194;166;179;94;47,6800374664604113400,0.087778
greedy_intra:nodes_start:random,133,61156,35346,25810,664847,474,8;160;169;188;6;147;133;107;40;63;122;182;138;49;109;62;18;83;183;140;20;148;47;94;179;166;194;113;176;124;106;159;143;111;31;54;121;134;132;13;195;29;0;144;142;78;175;80;190;136;164;73;5;36;61;21;104;33;11;139;51;90;191;168;189;170;152;184;155;3;70;15;145;34;55;95;130;99;22;185;86;35;25;193;117;198;1;38;135;131;112;177;141;187;89;163;153;81;77;82,6991016992167078599,0.077018
greedy_intra:nodes_start:random,134,62393,33911,28482,610354,437,111;144;160;49;145;15;3;70;161;132;134;118;121;198;117;193;54;182;33;0;35;109;29;74;98;133;107;40;63;135;122;10;147;169;34;55;18;62;51;90;191;71;6;188;155;184;170;143;82;177;45;190;80;162;175;78;36;61;91;21;138;11;139;43;126;13;195;168;189;152;140;183;95;185;86;128;124;106;166;194;176;113;103;89;163;153;77;8;104;25;173;73;31;136;5;141;187;165;127;81,9068557232993279101,0.071820
greedy_intra:nodes_start:random,135,61015,35260,25755,610290,458,103;127;89;62;83;18;111;82;21;177;78;175;142;5;104;8;81;153;113;194;166;172;179;94;47;148;20;140;183;121;90;191;147;70;3;15;145;13;195;29;160;33;138;182;11;139;168;126;43;134;118;51;6;188;169;132;155;152;170;124;106;109;35;143;159;176;180;163;187;77;117;198;1;38;135;63;40;107;122;131;61;79;141;91;36;45;80;190;193;31;54;73;25;0;34;55;95;130;185;86,8372384873047235095,0.081130
greedy_intra:nodes_start:random,136,61287,35937,25350,815102,507,95;124;106;143;159;153;81;8;104;138;10;133;40;107;122;90;51;147;6;169;188;126;132;70;3;15;155;152;18;83;62;128;86;185;179;94;47;183;55;34;35;160;33;144;0;109;29;11;182;25;31;193;117;198;1;63;135;131;111;103;113;194;166;176;177;5;80;190;77;163;89;187;97;141;61;36;78;175;136;73;54;121;118;134;43;13;145;195;168;139;21;87;82;140;4;149;28;20;148;130,7394980325162357496,0.088797
greedy_intra:nodes_start:random,137,58663,32270,26393,530579,460,45;5;124;128;86;185;95;55;152;70;147;115;178;10;133;122;63;135;1;198;117;193;31;54;73;77;97;141;91;61;36;138;182;25;121;90;51;134;139;81;153;187;165;89;127;103;163;106;34;170;155;3;13;126;6;188;169;132;145;15;189;109;0;35;111;144;8;82;21;104;56;160;33;49;195;168;43;11;29;143;176;113;194;166;179;94;47;148;20;140;183;18;62;177;142;78;175;80;190;136,9118082052898688941,0.070966
greedy_intra:nodes_start:random,138,62476,37530,24946,523674,479,78;36;61;141;113;194;166;148;47;94;179;114;103;127;89;187;111;8;144;34;140;183;95;86;176;180;163;153;104;25;73;136;80;190;27;38;122;90;147;188;169;132;15;170;152;184;155;3;70;134;121;54;31;193;117;1;131;125;51;6;13;145;189;124;106;168;195;55;130;99;185;128;62;18;35;109;0;29;11;139;10;133;107;40;63;135;182;138;33;160;143;159;81;77;82;21;177;5;142;175,8693922960204265365,0.072708
greedy_intra:nodes_start:random,139,62354,36219,26135,565852,427,34;6;147;107;40;63;135;90;3;155;184;152;170;95;130;86;128;62;189;132;169;188;134;142;175;78;177;8;104;11;145;15;70;161;13;126;195;168;43;139;29;0;109;35;82;21;61;36;141;97;81;159;106;124;143;111;56;144;160;33;49;138;182;25;54;31;193;73;77;176;166;194;113;103;163;153;51;121;131;1;198;117;190;80;45;5;187;127;89;183;140;20;148;47;94;66;179;185;18;55,3191701678992078076,0.077863
greedy_intra:nodes_start:random,140,59238,31234,28004,687488,459,106;89;103;113;176;86;185;99;179;166;194;163;153;81;77;87;21;177;78;175;80;190;31;54;19;112;121;131;63;122;90;191;51;134;189;170;152;140;183;148;20;28;155;3;13;132;169;161;70;15;160;8;82;141;91;61;36;138;182;25;198;156;1;135;133;147;6;188;145;34;55;18;83;62;124;29;195;126;168;139;11;56;104;5;142;45;136;73;193;117;151;118;74;33;144;111;0;109;35;143,9155730552811969828,0.081953
greedy_intra:nodes_start:random,141,57383,30642,26741,490393,468,121;51;98;118;74;134;139;29;0;109;155;184;152;170;34;35;33;138;182;73;54;31;117;198;131;90;191;10;133;122;63;135;147;6;195;124;128;95;130;99;185;194;114;127;89;176;86;183;140;148;47;94;179;166;113;103;163;153;141;177;25;104;56;143;62;18;55;83;106;81;77;111;160;11;168;188;169;132;70;3;145;15;144;8;82;21;91;61;36;78;175;142;5;45;162;80;190;193;156;1,8973618902421998725,0.076067
greedy_intra:nodes_start:random,142,61303,35516,25787,799807,482,55;128;124;61;78;175;136;73;90;191;147;134;6;188;169;132;70;34;170;152;140;183;148;47;94;185;86;95;109;0;29;168;43;139;11;182;54;31;193;117;198;156;1;131;121;25;104;144;8;82;77;153;194;166;106;35;33;138;122;107;40;63;135;51;195;13;189;184;155;3;15;145;49;160;111;81;187;165;127;137;114;113;26;103;89;163;180;176;21;177;5;190;80;36;91;141;97;143;62;18,2847294218711291252,0.080636
greedy_intra:nodes_start:random,143,59945,33672,26273,729553,490,0;109;3;70;132;6;147;90;122;40;63;135;38;1;198;117;35;62;95;86;113;114;137;127;153;81;77;8;56;104;25;177;36;61;79;82;111;143;130;185;166;194;180;176;128;106;124;18;55;34;183;140;148;20;28;152;155;15;145;195;168;139;182;74;118;51;131;121;112;19;54;31;193;73;136;190;80;45;5;163;103;89;187;141;91;21;87;144;160;13;169;188;134;142;175;78;138;11;33;29,6600524853580121886,0.099195
greedy_intra:nodes_start:random,144,57933,31364,26569,954499,493,184;170;55;86;194;166;179;94;47;148;20;140;183;152;121;1;198;117;193;136;177;61;21;87;82;8;144;111;0;35;143;159;106;124;128;95;130;185;176;113;103;62;18;34;109;29;160;33;11;139;138;182;104;81;153;187;146;97;77;168;188;6;147;122;63;135;90;191;51;98;118;74;25;78;175;142;45;80;190;31;54;73;5;36;91;141;165;127;89;163;189;195;169;132;13;145;15;70;3;155,2765985190522814556,0.087000
greedy_intra:nodes_start:random,145,62355,34619,27736,783799,445,135;122;90;147;62;86;166;194;176;153;111;160;134;6;188;161;70;152;140;28;20;148;47;94;179;185;103;89;165;187;81;50;8;104;56;144;33;138;182;25;177;36;61;21;82;143;124;18;55;183;95;128;77;141;91;175;78;5;73;54;34;170;155;3;15;195;168;29;39;12;0;109;35;163;127;137;114;113;180;106;189;145;13;132;169;126;43;49;11;139;74;118;51;121;136;80;190;193;31;117,7942685904205389033,0.084276
greedy_intra:nodes_start:random,146,62736,36940,25796,770069,459,177;142;175;78;182;168;15;3;70;195;104;36;61;79;91;82;144;160;11;139;134;90;122;135;51;0;128;86;179;99;95;124;143;159;35;109;170;152;149;28;140;183;130;185;176;180;194;166;94;47;148;60;20;155;29;33;138;131;38;1;25;81;153;165;127;163;106;145;13;132;169;188;6;147;121;117;193;31;54;164;73;136;190;80;5;21;87;141;77;97;187;89;103;113;62;18;55;34;111;8,5523629864835250608,0.086177
greedy_intra:nodes_start:random,147,60429,35501,24928,599923,506,60;94;179;128;124;62;18;55;111;104;182;90;135;63;100;40;107;122;70;3;15;145;195;13;132;188;169;126;168;109;35;176;113;26;103;159;143;106;166;194;114;127;89;163;187;153;77;141;177;5;78;175;36;61;8;144;160;33;11;139;134;51;71;147;6;189;155;184;152;183;148;47;99;95;185;86;82;21;80;190;0;29;49;138;25;73;193;31;54;117;198;156;1;131;121;34;140;149;28;20,1194883795834894302,0.084718
greedy_intra:nodes_start:random,148,55786,30323,25463,557363,465,38;63;40;107;122;135;131;121;112;73;136;190;80;175;78;36;61;21;8;104;160;33;195;145;189;34;62;18;55;170;3;70;155;184;152;183;95;130;99;22;185;86;194;166;179;66;94;47;35;0;111;143;106;124;148;20;140;109;29;11;139;43;168;13;169;188;134;138;182;74;118;51;90;147;6;132;15;83;128;176;113;103;127;89;163;187;153;81;77;97;141;177;5;54;31;193;117;198;1;27,719867831385339361,0.073023
greedy_intra:nodes_start:random,149,65405,39306,26099,639186,430,126;195;168;109;166;194;176;153;175;80;190;182;11;139;134;43;145;189;140;28;149;70;191;90;131;117;193;31;5;36;61;141;77;81;143;18;55;34;35;0;29;144;104;8;62;83;170;152;174;95;86;113;103;187;97;25;158;121;51;138;33;160;111;165;127;89;163;15;3;155;130;185;179;66;94;47;148;60;20;199;183;128;124;106;82;87;21;177;73;54;1;135;63;122;147;6;188;169;132;13,6187435112140554151,0.069540
greedy_intra:nodes_start:random,150,64086,37691,26395,567961,465,152;140;47;94;8;177;5;45;142;78;36;89;127;165;187;141;175;162;80;190;193;31;54;117;198;1;135;63;122;90;51;118;11;106;176;113;194;166;124;35;109;138;182;139;169;188;6;147;191;131;121;134;132;70;3;143;159;153;81;77;91;61;21;82;18;55;174;183;83;62;0;29;49;33;160;104;56;144;111;163;103;185;148;60;20;28;15;145;13;195;168;95;130;86;128;34;170;189;155;184,3949992033877192574,0.075798
greedy_intra:nodes_start:random,151,59132,34064,25068,663381,506,94;47;148;140;183;34;55;18;62;124;143;144;160;168;169;188;6;147;63;38;27;1;131;11;29;109;0;111;81;77;141;187;163;89;165;127;137;114;113;103;153;35;13;132;145;155;152;95;130;185;86;166;194;176;106;15;3;70;161;195;33;104;21;36;175;80;190;193;31;54;73;5;45;136;117;198;135;122;90;191;51;177;61;82;8;138;139;134;118;121;112;19;158;25;182;4;149;28;20;60,4111230961304916903,0.090865
greedy_intra:nodes_start:random,152,60454,31337,29117,953075,499,152;140;183;95;86;106;143;132;169;188;134;118;121;193;117;198;156;1;135;122;11;33;8;82;77;153;187;97;141;91;21;87;104;138;51;191;90;133;10;147;6;70;3;189;62;124;163;89;127;103;128;55;34;145;13;195;168;49;111;81;176;180;113;114;194;166;185;99;130;18;35;109;0;12;29;160;144;56;177;61;36;80;190;164;31;54;73;136;45;175;78;5;25;182;139;43;126;15;155;184,8960675451578304358,0.091892
greedy_intra:nodes_start:random,153,64537,39740,24797,529948,494,60;20;183;106;153;81;159;143;111;104;138;182;90;122;107;40;63;8;163;89;127;187;77;21;177;54;117;193;31;73;5;61;91;82;34;140;28;149;4;145;126;195;168;49;29;109;35;176;113;194;166;0;160;33;11;139;43;134;51;121;1;27;38;135;147;188;70;155;152;148;47;94;66;95;55;18;62;124;141;36;78;175;45;80;190;25;118;6;169;132;13;15;3;189;86;185;130;99;22;179,5968903899434985019,0.089547
greedy_intra:nodes_start:random,154,60622,32566,28056,592335,491,87;82;143;124;94;47;148;20;140;109;0;35;62;86;185;95;183;15;145;132;65;169;126;195;13;161;70;3;155;55;18;34;152;170;8;61;36;78;175;45;193;1;38;63;135;131;117;31;54;19;112;121;122;133;10;90;191;51;106;176;166;194;113;103;127;89;163;153;159;29;168;188;6;134;43;11;33;160;104;144;111;41;81;77;97;141;91;177;5;80;190;136;73;25;118;74;139;182;138;21,991525607707536981,0.093381
greedy_intra:nodes_start:random,155,55727,31153,24574,562544,510,3;155;152;170;34;55;18;62;106;143;144;8;21;91;141;97;89;127;165;187;146;81;111;35;0;29;15;145;195;168;160;33;11;139;134;51;90;122;135;63;40;107;133;10;191;71;147;169;132;13;109;124;128;95;140;183;20;60;148;47;94;179;185;86;166;194;176;82;177;78;175;36;61;77;163;103;113;153;104;138;182;25;73;54;31;136;5;45;80;190;193;117;198;156;1;131;121;6;188;70,8467242545788977541,0.092617
greedy_intra:nodes_start:random,156,61083,35377,25706,534694,448,35;0;160;49;11;121;54;31;73;136;177;21;87;82;8;111;62;18;140;149;28;20;183;106;77;61;142;175;78;36;141;153;194;166;86;55;34;13;195;168;43;25;5;45;133;10;147;6;188;70;15;145;132;169;51;135;63;122;90;125;131;1;156;198;117;193;190;80;104;144;33;138;182;74;118;134;139;29;109;3;155;152;128;176;113;114;127;89;163;103;185;179;94;47;148;99;130;95;124;143,996674102619542096,0.072010
greedy_intra:nodes_start:random,157,59666,34369,25297,1025908,491,183;140;55;34;109;29;168;132;169;188;6;147;125;131;193;190;80;5;177;130;94;47;148;60;20;28;152;155;189;124;103;89;127;165;153;111;144;104;8;87;21;91;61;36;175;78;182;138;33;160;82;77;97;81;106;128;86;176;180;113;194;166;179;22;99;185;163;187;141;73;31;54;25;70;3;15;145;13;195;43;134;51;191;90;122;63;135;1;198;117;121;118;139;11;0;35;143;62;18;95,2680802812222778724,0.093386
greedy_intra:nodes_start:random,158,62435,36645,25790,731408,455,15;3;70;188;6;134;74;91;61;36;175;80;190;45;5;177;104;56;8;21;87;82;144;160;33;11;168;195;139;182;138;49;29;109;18;55;34;170;152;20;166;194;113;103;77;73;54;135;63;107;40;133;122;90;111;81;153;163;89;127;187;141;31;193;117;198;1;131;121;51;169;132;13;145;43;25;142;78;159;106;176;86;128;124;143;35;0;62;148;47;94;179;22;99;185;130;95;183;140;155,7054106943684539132,0.077374
greedy_intra:nodes_start:random,159,55247,28651,26596,1102999,575,80;45;177;61;21;82;8;104;144;111;153;163;103;26;106;124;143;159;81;77;141;36;78;175;142;5;25;118;51;135;122;90;191;147;6;188;169;132;3;15;145;195;168;54;31;117;193;73;138;11;29;109;0;33;160;35;34;55;83;18;62;128;183;95;130;185;86;166;194;176;180;113;89;127;114;179;66;94;22;99;9;4;149;101;28;20;60;47;148;140;152;155;70;13;139;182;121;131;1;190,3104931989250494789,0.106670
greedy_intra:nodes_start:random,160,61245,32458,28787,930616,488,77;82;87;141;91;61;36;5;173;19;112;121;118;132;161;70;3;15;143;159;35;0;29;109;34;95;130;183;152;155;147;122;135;90;51;98;74;134;195;126;168;139;11;138;182;6;188;169;13;145;166;194;113;153;81;111;104;157;33;49;160;144;56;8;21;177;136;31;117;198;156;1;73;45;78;175;162;80;190;193;54;25;170;140;20;148;94;179;185;86;106;124;62;18;55;176;103;127;89;163,5600206556511624036,0.099710
greedy_intra:nodes_start:random,161,62556,35539,27017,697233,475,198;193;190;80;136;145;189;130;185;95;55;139;74;51;118;11;35;143;124;62;18;34;109;0;12;29;168;195;13;15;152;140;94;47;148;20;28;106;81;77;97;187;127;89;103;163;153;111;121;90;10;133;122;63;135;131;112;158;25;138;182;134;6;188;169;33;8;82;87;21;78;175;142;5;177;104;56;144;160;49;126;132;70;3;155;183;99;179;86;166;194;176;113;141;61;36;73;31;54;117,6206877333675375094,0.082768
greedy_intra:nodes_start:random,162,61014,33665,27349,721648,493,34;170;155;3;15;145;189;86;166;194;176;113;103;127;89;153;77;61;175;162;45;173;158;139;11;29;109;35;0;160;74;51;191;90;131;54;31;164;182;138;33;49;168;195;126;13;132;169;188;6;134;118;121;136;190;80;21;82;111;20;148;47;94;179;185;95;128;62;18;143;159;119;106;124;180;163;187;141;36;78;142;5;177;8;104;144;25;73;193;117;1;135;63;122;147;70;152;140;183;55,9142900467619724405,0.085491
greedy_intra:nodes_start:random,163,64158,36638,27520,625621,419,103;106;143;35;109;11;139;134;43;168;195;189;170;34;83;124;81;61;45;80;190;121;74;182;138;82;77;187;165;127;89;163;153;0;29;126;188;169;132;13;145;161;70;3;155;152;140;179;172;166;194;176;159;111;8;104;160;33;147;90;51;118;25;5;78;175;36;141;128;66;94;47;183;174;55;18;62;21;177;73;54;31;193;117;6;15;28;20;23;60;148;99;130;95;185;86;180;113;114;137,4450624653276125500,0.071889
greedy_intra:nodes_start:random,164,58857,33037,25820,697573,492,184;152;34;55;18;83;95;130;185;86;166;194;160;33;138;25;73;54;31;136;45;36;153;163;89;127;137;114;113;176;180;103;187;97;77;82;8;144;111;0;35;143;106;179;66;94;47;148;20;140;183;128;124;62;109;29;11;139;134;188;169;132;13;145;195;168;147;135;122;133;10;90;121;5;78;175;80;190;177;182;15;3;70;6;51;131;1;156;198;117;193;104;56;87;21;61;91;141;81;155,9216185478825526675,0.090054
greedy_intra:nodes_start:random,165,62249,35482,26767,401043,451,53;170;34;109;29;121;131;117;190;80;198;1;38;63;135;122;90;51;18;62;95;86;128;124;111;144;104;87;21;91;61;36;177;5;78;175;136;73;164;193;31;54;173;25;182;139;11;138;8;82;141;77;33;160;81;187;127;89;103;148;47;94;66;179;185;22;99;130;183;155;15;70;3;140;199;60;20;28;149;4;189;69;35;143;176;180;113;163;153;0;145;132;169;195;168;106;194;166;55;152,6503106299774172729,0.067467
greedy_intra:nodes_start:random,166,63739,38558,25181,614527,491,4;152;191;90;51;121;131;135;63;122;147;6;145;128;113;89;127;165;187;141;36;5;136;73;54;117;198;134;188;169;170;95;185;179;94;47;148;60;20;183;21;61;91;77;153;163;103;114;137;81;82;104;25;31;193;190;80;175;78;177;182;139;168;195;29;176;194;166;86;62;18;55;34;3;15;13;132;70;155;184;189;69;109;35;0;160;33;138;11;124;106;159;143;111;8;56;144;140;28;149,1693486797040127057,0.080299
greedy_intra:nodes_start:random,167,65393,40038,25355,700115,467,28;149;4;170;109;0;29;126;13;70;3;15;145;139;182;121;54;117;193;31;73;136;21;82;8;144;160;33;11;168;195;132;169;188;6;147;51;25;104;111;113;194;176;63;40;107;133;10;62;128;124;106;143;159;81;77;61;36;141;153;187;165;127;89;163;103;166;185;130;95;83;18;34;184;189;138;177;5;190;80;175;78;55;183;199;140;152;155;43;134;90;122;135;35;86;179;94;47;148;20,1521997144564082127,0.081930
greedy_intra:nodes_start:random,168,61544,35620,25924,857974,520,99;185;86;166;194;176;124;70;169;188;6;134;139;11;160;33;118;51;121;158;25;182;138;104;21;61;36;91;8;144;109;189;155;170;34;35;0;12;29;147;90;122;63;135;177;82;77;97;81;153;106;143;111;73;54;31;193;190;80;175;78;142;5;168;195;126;132;13;145;15;3;28;20;60;47;148;183;140;152;131;1;156;198;117;136;141;187;163;89;127;103;113;180;128;62;18;55;95;130;179,2816333030781337701,0.094375
greedy_intra:nodes_start:random,169,59795,32651,27144,714034,492,141;36;61;21;82;25;158;121;51;98;118;74;85;134;43;139;11;168;195;132;169;6;147;133;122;135;90;188;70;3;189;170;130;99;179;94;47;148;60;20;152;155;15;145;13;117;193;31;54;81;86;185;95;18;109;39;49;182;138;33;160;56;104;142;78;175;80;190;45;5;177;8;144;111;159;124;62;183;28;140;55;34;29;0;35;143;106;176;113;114;137;127;166;194;103;89;163;153;77;97,8083297738704859372,0.084808
greedy_intra:nodes_start:random,170,61564,35028,26536,454952,434,38;27;193;190;80;45;21;144;33;138;182;25;5;177;104;56;160;15;3;169;131;1;156;198;117;36;77;103;113;176;106;143;0;29;145;13;132;126;195;168;43;134;191;122;135;90;51;118;74;189;152;140;183;148;94;179;185;166;194;86;128;124;159;111;8;82;81;153;163;89;114;137;127;165;187;141;61;78;175;136;31;54;121;139;11;49;109;35;62;18;55;34;155;70;188;6;147;10;133;63,6737499823928648788,0.066988
greedy_intra:nodes_start:random,171,57422,32017,25405,699756,495,55;183;140;99;22;185;86;81;77;97;187;89;103;113;176;160;33;11;29;0;35;62;83;130;95;128;106;111;177;78;175;36;61;91;141;82;87;21;5;80;190;193;31;54;117;198;156;24;1;135;63;100;40;107;122;90;147;6;188;169;132;189;34;124;143;109;195;145;15;3;13;168;139;138;182;25;136;73;121;51;134;70;155;152;20;148;47;94;66;179;166;194;114;127;163;153;8;104;144;18,8739971333353399279,0.088531
greedy_intra:nodes_start:random,172,59996,33024,26972,644721,496,12;56;104;5;175;78;21;87;82;91;61;36;177;123;25;121;135;63;122;90;131;117;193;80;190;31;54;73;45;142;141;176;166;179;66;94;47;183;152;155;15;145;168;43;182;138;33;144;111;106;86;185;130;95;35;0;29;49;11;139;134;6;188;189;124;113;114;127;163;153;81;159;143;62;18;55;34;3;70;161;169;132;13;195;160;8;77;187;89;103;194;99;148;60;20;28;149;140;170;109,9082299831936505146,0.082865
greedy_intra:nodes_start:random,173,61617,35489,26128,741138,453,187;127;89;103;113;194;166;180;176;62;18;34;155;70;188;169;132;6;134;121;54;31;117;193;73;25;104;56;144;160;111;81;153;163;179;66;94;47;99;130;185;86;124;106;159;143;131;135;122;133;10;147;152;95;148;60;20;28;140;183;55;109;139;191;90;51;98;118;74;29;0;35;8;21;91;61;36;80;190;45;5;177;182;138;11;49;33;78;175;142;168;195;13;145;15;3;189;82;77;141,1354752694596274754,0.078254
greedy_intra:nodes_start:random,174,59841,33056,26785,357092,420,142;45;80;190;193;198;156;24;1;51;98;118;121;54;31;164;73;136;5;177;139;11;29;189;184;155;3;15;145;109;0;35;34;18;62;124;106;176;180;194;113;187;146;97;77;82;21;8;183;148;47;179;103;127;89;163;111;144;160;33;56;104;138;25;151;117;131;90;6;188;70;152;140;28;20;60;94;66;99;95;185;86;166;153;81;141;36;61;168;195;13;132;169;147;10;133;122;135;175;78,8581864262145692207,0.058189
greedy_intra:nodes_start:random,175,65882,37692,28190,716588,486,79;91;141;77;81;50;82;87;177;73;198;156;1;134;168;195;109;89;127;163;35;0;182;25;80;190;105;193;117;135;122;155;20;148;47;94;179;95;29;11;138;5;78;142;45;121;131;90;51;71;147;188;169;132;70;3;15;145;13;139;74;118;54;31;164;136;175;36;153;124;128;34;170;152;55;18;62;143;111;8;104;56;144;159;106;86;176;103;113;194;166;185;99;130;183;140;160;33;21;61,4449309802535707291,0.081237
greedy_intra:nodes_start:random,176,61714,35838,25876,565545,465,194;127;89;77;61;36;5;78;175;45;182;43;15;3;70;161;145;109;35;0;29;160;33;49;11;139;134;51;191;178;133;10;147;6;188;169;132;13;126;168;144;111;143;124;62;128;26;103;180;176;113;114;137;165;153;81;82;25;121;90;122;63;135;1;117;54;73;177;21;18;95;130;185;179;94;47;148;20;28;55;34;31;193;190;80;141;187;163;183;140;152;155;195;138;104;8;159;106;86;166,6713927688696469683,0.073131
greedy_intra:nodes_start:random,177,61924,35571,26353,712990,489,103;89;127;165;187;141;78;175;142;136;73;31;193;54;25;138;33;160;0;109;170;152;140;183;130;99;185;128;124;145;161;70;84;184;95;86;166;194;113;176;106;15;3;155;18;62;143;159;35;29;122;135;63;133;10;90;51;182;82;77;81;111;144;139;43;6;188;169;132;134;118;121;198;117;190;80;45;5;177;179;94;47;148;20;28;55;34;189;13;195;168;11;104;8;21;61;36;91;153;163,634583561291200140,0.080472
greedy_intra:nodes_start:random,178,59595,34830,24765,807501,511,132;169;195;168;109;35;81;77;141;187;89;127;114;166;185;179;66;94;47;148;60;20;28;140;183;83;62;128;86;130;95;170;152;184;155;3;15;177;5;80;190;1;63;135;131;121;25;182;138;160;12;0;29;43;134;147;133;40;107;122;90;51;118;139;11;33;144;176;194;113;111;56;104;8;82;153;163;103;106;124;70;188;6;198;117;193;31;54;73;175;78;36;61;91;21;143;18;55;34;145,8847358226710037993,0.094649
greedy_intra:nodes_start:random,179,65768,38360,27408,796447,487,177;82;111;144;104;25;158;112;121;131;90;147;169;70;3;28;20;148;47;94;185;166;124;106;143;145;15;155;152;183;174;170;189;168;182;54;117;193;31;73;136;81;77;5;45;190;80;141;97;153;62;18;55;34;35;160;33;138;11;184;4;149;140;95;86;176;113;103;127;89;163;187;1;135;122;133;6;188;43;134;51;98;118;139;29;0;109;13;132;195;8;87;21;91;79;61;36;78;142;175,1805541557604033518,0.084519
greedy_intra:nodes_start:random,180,64882,37328,27554,546388,463,163;141;80;190;193;54;31;164;45;142;175;78;5;177;138;33;49;168;195;13;6;147;90;131;112;121;125;51;98;118;74;139;11;170;34;176;194;113;35;29;160;144;56;104;25;73;136;36;77;81;143;106;124;62;18;55;95;86;166;179;185;99;130;155;70;161;3;183;47;148;20;140;152;132;134;117;198;1;135;122;133;188;169;182;21;61;91;111;0;109;189;15;145;8;82;97;153;89;127;103,4135871482193169436,0.073512
greedy_intra:nodes_start:random,181,60052,33434,26618,774672,442,147;10;133;90;51;134;29;124;106;77;141;91;61;36;78;175;142;5;97;187;103;26;159;143;35;0;109;62;18;55;34;152;122;135;63;38;27;16;1;198;45;177;104;33;11;195;13;132;15;3;155;184;189;145;168;139;25;73;31;54;117;193;190;80;136;112;121;118;182;138;8;21;87;82;81;176;194;166;179;148;20;60;47;94;185;95;86;113;127;89;163;153;111;144;160;70;161;169;188;6,4013593569705973267,0.078703
greedy_intra:nodes_start:random,182,61307,34619,26688,797449,460,82;77;81;106;128;62;143;159;124;183;140;149;28;20;148;47;94;66;179;109;29;145;15;3;70;132;169;147;133;122;90;125;25;87;21;142;175;78;36;61;153;86;95;34;195;168;139;11;182;54;117;193;31;164;73;141;187;163;176;180;103;89;165;127;137;114;113;194;166;185;130;152;184;155;188;6;134;51;98;118;74;138;104;8;144;111;18;55;35;0;160;33;177;5;80;190;136;198;1;121,7856888068206322063,0.075917
greedy_intra:nodes_start:random,183,64077,37181,26896,812596,467,130;95;185;86;166;194;113;176;131;135;122;133;10;161;70;3;15;145;13;132;169;121;54;31;73;25;138;8;82;141;91;36;61;87;21;177;78;142;5;104;144;183;20;60;94;47;148;155;188;6;147;90;51;134;139;11;29;170;152;4;149;28;140;109;0;12;39;111;153;163;103;89;127;187;175;80;190;198;117;193;136;45;77;81;34;55;18;83;62;128;124;106;143;35;160;33;49;168;195;189,2884291069678389965,0.091832
greedy_intra:nodes_start:random,184,63752,36090,27662,527715,449,13;169;147;133;122;90;51;6;188;132;155;34;83;130;99;185;128;111;177;78;175;142;45;5;61;36;80;190;193;31;73;25;21;87;77;153;113;194;176;106;159;41;160;33;49;11;138;182;139;145;161;70;3;15;189;109;29;118;1;156;198;117;54;104;143;124;62;18;55;170;152;28;140;183;95;86;166;114;137;127;103;35;0;144;56;8;82;81;163;89;165;187;141;121;135;63;131;134;168;195,26143924738129670,0.068823
greedy_intra:nodes_start:random,185,59437,33602,25835,884191,492,109;0;111;144;160;33;11;139;43;134;85;51;191;90;122;131;121;98;118;182;49;29;35;194;166;179;66;94;47;60;20;148;113;103;127;89;163;180;176;168;6;147;133;107;40;63;135;1;5;61;77;97;141;36;175;80;190;136;25;138;104;8;21;177;54;31;193;117;188;169;132;13;126;195;145;15;161;70;3;155;152;18;62;124;128;86;185;130;95;183;55;34;143;81;153;106;28;149;4;140,2543231583105586943,0.090533
greedy_intra:nodes_start:random,186,63772,38040,25732,627347,477,122;63;38;27;1;156;31;136;175;141;77;159;143;106;124;35;111;82;21;177;78;142;45;74;134;43;29;0;81;153;86;185;130;183;140;109;139;118;51;191;90;135;131;54;73;5;36;61;145;15;3;13;33;160;144;104;8;55;18;62;128;176;163;89;127;103;113;194;166;6;147;121;198;117;193;190;80;173;158;25;182;138;11;168;195;34;95;99;179;94;47;148;60;20;152;155;70;169;188;133,4778683188937833523,0.087291
greedy_intra:nodes_start:random,187,62969,35196,27773,606790,468,103;89;127;94;47;148;185;81;77;111;145;15;13;126;43;134;85;6;147;191;90;51;118;33;56;104;25;158;98;74;182;138;160;109;55;34;184;155;195;168;11;139;131;135;63;122;133;10;188;169;132;161;70;3;18;62;95;99;22;179;166;194;113;163;153;21;61;78;175;80;190;45;5;177;8;144;170;152;140;183;86;176;187;141;36;136;73;31;54;193;117;198;121;49;29;0;35;143;124;106,4685445612301990378,0.076508
greedy_intra:nodes_start:random,188,59167,33509,25658,593592,483,132;13;195;33;160;29;109;18;55;28;20;60;148;47;94;179;86;77;141;175;80;190;78;177;8;111;82;91;61;36;21;87;104;25;5;45;136;73;54;31;193;117;121;131;135;63;122;133;70;3;155;184;34;62;128;124;35;0;49;11;139;51;90;147;6;188;169;106;163;103;113;180;176;159;143;144;138;182;74;118;134;43;168;189;170;152;140;183;95;130;185;166;194;89;127;187;153;81;145;15,3947806571530002982,0.073883
greedy_intra:nodes_start:random,189,61249,33990,27259,922379,523,127;165;141;36;193;117;54;31;73;160;0;29;188;6;147;90;133;122;135;1;190;80;175;5;177;21;87;104;56;8;82;77;81;146;187;153;106;124;35;109;11;139;168;15;155;152;140;148;47;94;99;34;33;138;182;43;195;126;132;169;161;70;13;145;143;159;163;89;103;113;176;62;18;55;41;111;144;25;158;121;51;134;3;4;149;28;20;199;183;83;128;86;95;130;185;179;166;194;114;137,2832929182928958478,0.100115
greedy_intra:nodes_start:random,190,60281,33707,26574,710346,455,20;148;47;94;179;185;86;128;62;18;21;78;175;31;54;90;133;10;178;147;51;111;163;89;103;113;176;194;166;183;140;152;155;3;70;15;145;13;195;168;43;134;74;182;33;160;144;56;8;5;45;80;190;177;104;11;139;6;188;169;132;126;77;97;81;153;159;143;106;124;95;130;55;34;35;0;12;82;141;91;61;36;193;117;1;63;40;107;122;135;131;121;158;25;138;49;29;109;170;28,5894246801626490007,0.078150
greedy_intra:nodes_start:random,191,67772,40539,27233,730289,474,135;25;127;114;113;88;176;106;124;145;15;3;152;149;28;140;143;159;160;33;11;195;168;139;36;61;21;87;8;77;97;141;175;80;190;54;121;6;188;70;128;180;103;89;163;153;81;111;56;144;12;34;55;170;155;189;29;0;109;35;62;18;83;183;20;60;148;47;94;95;82;177;73;31;198;117;193;136;45;5;86;185;99;22;179;166;194;104;138;182;51;90;191;134;13;132;169;147;133;122,785515567075645182,0.080459
greedy_intra:nodes_start:random,192,61733,34819,26914,670479,490,18;128;86;185;179;66;94;47;148;20;140;109;0;12;29;43;134;147;122;63;135;90;191;51;25;77;187;165;127;35;13;132;126;195;168;11;138;33;160;104;8;82;87;21;79;61;5;78;175;36;91;141;113;176;111;177;45;73;54;31;193;117;198;1;131;121;112;19;173;136;190;80;139;155;184;152;183;62;143;81;153;106;124;95;130;99;166;194;103;89;163;3;70;188;6;169;145;15;34;55,8967967081600518096,0.079776
greedy_intra:nodes_start:random,193,63680,37404,26276,733578,460,187;165;127;89;103;163;111;8;82;87;21;61;36;141;97;77;81;119;143;159;106;124;128;62;83;18;138;182;118;51;134;43;145;155;152;140;28;149;3;169;6;135;63;122;133;90;147;188;15;189;55;34;13;132;161;70;183;20;148;47;94;95;80;190;193;31;54;117;198;1;131;121;104;113;194;166;179;99;185;86;176;144;160;33;11;49;0;35;109;29;195;168;139;25;5;142;175;78;177;153,6150054036987980407,0.079281
greedy_intra:nodes_start:random,194,64341,38106,26235,422287,468,127;114;166;179;94;47;148;99;185;124;29;168;195;15;3;70;132;13;11;49;128;176;180;106;111;78;175;5;177;25;138;182;90;133;10;147;188;155;152;183;130;95;55;18;62;35;109;0;8;21;87;82;187;165;163;153;81;144;43;134;74;118;121;112;156;1;38;63;135;122;139;33;104;61;36;141;77;159;143;189;145;169;6;51;131;198;117;193;31;54;160;34;140;28;20;86;194;113;103;89,8470417304155287049,0.081538
greedy_intra:nodes_start:random,195,59205,32418,26787,737028,430,109;195;145;95;130;86;128;124;106;159;82;87;21;91;141;97;77;35;189;184;152;170;34;55;18;62;83;183;140;99;185;194;113;114;137;127;89;165;187;61;177;73;31;117;135;122;90;51;98;118;121;136;80;190;193;54;182;33;29;0;160;144;56;8;104;138;25;5;45;142;175;78;36;176;166;179;66;94;47;148;60;20;28;155;132;169;188;70;3;15;13;168;139;11;111;81;153;163;103;143,1796824793621475224,0.075115
greedy_intra:nodes_start:random,196,62805,34697,28108,606965,455,175;162;80;190;45;5;177;33;138;182;74;118;134;139;11;56;104;158;121;112;91;141;81;143;106;128;86;130;95;18;55;183;140;34;15;3;70;161;13;132;169;188;6;147;117;193;31;54;111;0;35;124;62;51;90;122;135;131;21;153;163;113;176;185;148;47;94;179;166;194;103;89;127;165;187;97;77;82;8;144;160;49;29;109;189;155;184;152;170;145;195;168;25;173;73;164;136;61;36;78,7092831795557237342,0.078754
greedy_intra:nodes_start:random,197,63619,38008,25611,638293,434,62;18;130;185;99;148;60;20;28;33;25;54;117;193;190;80;143;124;128;95;86;103;89;127;187;77;82;144;168;195;13;132;169;188;70;3;15;106;176;113;97;5;73;31;136;45;175;78;142;121;131;135;63;51;118;182;104;8;21;141;91;61;36;177;56;183;140;47;94;179;166;194;163;153;81;111;138;139;11;43;134;147;133;122;90;191;6;145;155;184;152;170;109;0;29;160;12;35;34;55,5991444416579159142,0.076360
greedy_intra:nodes_start:random,198,59408,33458,25950,1074106,489,193;164;73;173;109;0;12;160;144;8;82;61;36;21;104;33;145;15;3;34;55;18;124;106;176;180;163;153;97;77;81;41;111;29;168;195;169;188;6;147;90;131;121;118;134;132;70;155;152;140;183;148;47;94;179;114;127;89;165;177;45;80;190;117;198;1;156;136;175;78;5;141;187;103;113;194;166;86;185;99;130;95;62;143;35;10;133;107;40;63;135;122;51;139;11;138;182;25;54;31,820349851560883459,0.093763
greedy_intra:nodes_start:random,199,56202,29460,26742,708258,454,131;121;116;112;19;173;136;190;80;175;78;36;61;91;141;103;113;176;194;166;185;179;94;47;148;20;28;140;183;99;22;130;95;62;18;55;145;132;169;188;13;29;0;35;153;81;111;144;160;104;8;143;106;124;128;86;163;187;77;82;87;21;171;25;182;138;139;134;51;90;135;63;40;107;122;147;6;126;195;168;11;33;49;15;161;70;3;155;152;34;109;177;5;73;54;31;193;117;198;1,1532817597368919868,0.086728
greedy_intra:nodes_start:greedy,0,51554,18677,32877,38905,5,35;0;109;29;69;189;155;145;15;3;70;161;188;6;169;132;13;195;168;43;134;139;11;182;138;33;160;144;56;104;8;82;87;21;177;5;45;142;78;175;36;61;91;141;77;97;146;187;165;127;89;103;137;114;113;194;166;52;172;179;185;22;99;130;95;86;183;140;199;9;148;47;66;94;60;20;59;28;149;4;152;170;34;55;18;62;128;124;143;159;106;176;88;180;163;186;153;81;41;111,2896989411727976059,0.001769
greedy_intra:nodes_start:greedy,1,51220,18573,32647,49805,8,1;16;27;38;102;63;96;32;135;122;133;10;178;115;147;71;191;90;125;51;98;118;74;134;6;188;169;132;13;70;3;15;145;195;168;43;139;11;29;109;35;0;111;81;153;163;176;106;124;62;18;140;183;95;185;86;166;194;113;103;89;127;165;187;97;77;141;91;61;36;78;175;142;45;5;177;21;82;8;104;144;160;33;138;182;25;158;116;121;112;19;151;54;73;164;31;193;117;198;156,7498976447150709358,0.002002
greedy_intra:nodes_start:greedy,2,48848,20427,28421,109804,12,43;134;74;118;121;51;191;90;131;54;73;31;193;117;198;156;1;16;27;38;135;63;100;40;107;72;122;133;10;178;147;6;188;169;132;13;70;3;15;145;195;168;29;0;109;35;111;81;153;163;176;106;124;62;18;55;34;170;152;140;183;99;130;95;86;185;179;172;166;194;113;103;89;127;165;187;146;97;77;141;91;61;36;78;175;142;45;5;177;21;82;8;104;144;160;33;138;182;11;139,2954311638559646797,0.005953
greedy_intra:nodes_start:greedy,3,49983,17472,32511,45005,3,3;155;184;170;152;140;183;95;130;22;99;9;199;4;149;28;59;20;60;148;47;94;66;57;172;52;179;185;86;166;194;176;180;113;26;103;114;137;127;89;163;165;187;146;153;81;77;97;141;91;79;61;36;78;175;142;45;5;177;21;87;82;111;144;56;8;104;138;182;139;11;49;33;160;29;0;109;35;143;159;106;124;128;62;18;55;34;189;15;145;195;168;126;13;132;169;6;188;161;70,8601699962664376179,0.002889
greedy_intra:nodes_start:greedy,4,46735,20218,26517,62000,7,4;149;28;59;20;60;148;47;94;66;57;172;179;185;86;95;130;99;22;166;194;176;113;26;103;114;137;127;89;163;187;153;81;77;141;91;61;36;78;175;142;45;5;177;21;82;111;8;104;138;182;139;168;195;145;15;3;70;13;132;169;188;6;147;178;10;133;122;135;63;38;1;117;31;54;121;90;51;118;74;134;11;33;160;29;0;109;35;143;106;124;128;62;18;55;34;170;152;183;140,1996653778080098724,0.003008
greedy_intra:nodes_start:greedy,5,51945,19885,32060,23213,4,5;177;21;104;138;182;139;168;195;145;15;3;70;161;13;132;169;188;6;192;147;178;10;133;122;72;107;40;100;63;135;38;27;16;1;156;198;117;193;31;73;54;151;19;112;131;125;90;191;120;51;121;118;74;134;11;49;33;160;29;109;35;0;144;111;8;82;58;77;81;153;163;176;106;124;62;18;55;95;86;185;179;166;194;113;103;89;127;165;187;146;97;141;91;61;36;78;175;142;45,5840440225373250539,0.001027
greedy_intra:nodes_start:greedy,6,48953,20475,28478,59754,5,6;188;169;132;13;70;3;15;145;195;168;29;109;0;35;111;81;153;163;176;106;124;62;18;55;34;170;152;140;183;86;95;130;99;22;185;179;166;194;113;103;89;127;165;187;146;97;77;141;91;61;36;78;175;142;45;5;177;21;82;8;104;144;160;33;138;182;11;139;43;134;74;118;121;51;191;90;131;54;73;31;193;117;198;156;1;16;27;38;135;63;100;40;107;72;122;133;10;178;147,9150406141279490314,0.002180
greedy_intra:nodes_start:greedy,7,52393,19407,32986,46631,6,7;78;175;142;45;5;177;21;104;138;182;139;168;195;145;15;3;70;161;13;132;169;188;6;192;147;178;10;133;122;72;107;40;100;63;135;38;27;16;1;156;198;117;193;31;73;54;151;19;112;131;125;90;191;120;51;121;118;74;134;11;49;33;160;29;109;0;35;111;144;8;82;58;77;81;153;163;176;106;124;62;18;95;130;185;86;166;194;113;103;89;127;165;187;146;97;141;91;61;36,1994361810595241789,0.002998
greedy_intra:nodes_start:greedy,8,49108,20894,28214,74945,9,8;104;138;182;139;168;195;145;15;3;70;13;132;169;188;6;147;178;10;133;122;107;40;63;135;38;27;16;1;156;198;117;193;31;73;54;112;121;51;90;118;74;134;11;33;160;29;109;35;0;144;111;41;81;153;163;176;106;124;62;18;55;34;170;152;140;183;130;95;86;185;22;99;179;172;166;194;113;114;137;103;89;127;165;187;146;97;77;141;91;61;36;78;175;142;45;5;177;21;82,2853800276606957017,0.003204
greedy_intra:nodes_start:greedy,9,46706,20485,26221,80019,9,9;148;47;94;60;20;59;28;149;4;140;183;152;170;34;55;18;62;128;124;106;143;35;109;0;29;160;33;11;134;74;118;51;90;121;73;54;31;193;117;1;38;135;63;122;133;10;178;147;6;188;169;132;13;70;3;15;145;195;168;139;182;138;104;8;111;82;21;177;5;45;142;175;78;36;61;91;141;77;81;153;187;163;89;127;137;114;103;113;176;180;194;166;86;95;185;179;22;99;130,6023180535916138885,0.004530
greedy_intra:nodes_start:greedy,10,52136,19370,32766,46479,9,10;178;147;192;6;188;169;132;161;70;3;15;145;13;195;168;43;11;29;109;35;0;111;81;153;163;176;106;124;62;18;86;185;179;166;194;113;103;89;127;165;187;97;77;141;91;61;36;175;78;142;45;5;177;21;82;8;104;144;160;33;138;182;139;134;85;74;118;98;51;116;121;112;19;151;54;73;164;31;193;117;198;156;1;16;27;38;131;125;191;90;135;102;63;100;40;107;72;122;133,7582794715081402944,0.002719
greedy_intra:nodes_start:greedy,11,51523,18646,32877,68079,6,11;182;138;33;160;144;56;104;8;82;87;21;177;5;45;142;175;78;36;61;91;141;77;97;146;187;165;127;89;103;137;114;113;194;166;52;172;179;185;22;99;86;95;130;183;140;199;9;148;47;66;94;60;20;59;28;149;4;152;170;34;55;18;62;128;124;143;159;106;176;88;180;163;186;153;81;41;111;35;0;109;29;69;189;155;145;15;3;70;161;188;6;169;132;13;195;168;43;134;139,8075721296353454671,0.003999
greedy_intra:nodes_start:greedy,12,51687,18684,33003,45357,5,12;111;41;81;153;186;163;180;88;176;106;159;143;124;128;62;18;55;34;170;152;4;149;28;59;20;60;94;66;47;148;9;199;140;183;130;95;86;99;22;185;179;172;166;194;113;114;137;103;89;127;165;187;146;97;77;141;91;61;36;78;175;142;45;5;177;21;87;82;8;104;56;144;160;33;138;182;11;139;134;43;168;195;13;132;169;6;188;161;70;3;15;145;155;189;69;29;109;35;0,843505545187060835,0.002001
greedy_intra:nodes_start:greedy,13,48945,20467,28478,23252,3,13;70;3;15;145;195;168;29;109;35;0;111;81;153;163;176;106;124;62;18;55;34;170;152;140;183;95;86;130;99;22;185;179;166;194;113;103;89;127;165;187;146;97;77;141;91;61;36;175;78;142;45;5;177;21;82;8;104;144;160;33;138;182;11;139;43;134;74;118;121;51;191;90;131;73;54;31;193;117;198;156;1;16;27;38;135;63;100;40;107;72;122;133;10;178;147;6;188;169;132,775908404575345974,0.001000
greedy_intra:nodes_start:greedy,14,51790,20597,31193,30332,4,41;81;153;163;180;176;88;106;143;124;128;62;18;55;34;170;152;140;183;95;86;130;99;22;185;179;172;166;194;113;114;137;103;89;127;165;187;146;97;141;77;82;21;8;104;138;182;139;168;195;145;15;3;70;13;132;169;188;6;192;147;178;10;133;122;72;107;40;100;63;135;38;27;16;1;156;198;117;193;31;73;54;151;19;131;90;191;51;121;118;74;134;11;33;160;29;0;109;35;111,8241728226414736411,0.002000
greedy_intra:nodes_start:greedy,15,50083,17572,32511,12459,0,15;145;195;168;126;13;132;169;6;188;161;70;3;155;184;170;152;140;183;95;130;22;99;9;199;4;149;28;59;20;60;148;47;94;66;57;172;52;179;185;86;166;194;113;176;180;26;103;114;137;127;89;163;165;187;146;153;81;77;97;141;91;79;61;36;175;78;142;45;5;177;21;87;82;111;144;56;8;104;138;182;139;11;49;33;160;29;0;109;35;143;159;106;124;128;62;18;55;34;189,6929852369221559184,0.000000
greedy_intra:nodes_start:greedy,16,53835,18919,34916,59028,5,16;27;38;92;102;63;96;32;135;122;133;10;178;115;147;71;191;90;51;125;131;121;112;19;151;54;31;164;73;136;45;5;177;21;104;138;182;139;168;195;145;15;3;70;161;13;132;169;188;6;134;11;49;33;160;29;109;35;0;144;111;8;82;58;77;81;153;163;176;86;95;130;185;179;166;194;113;103;89;127;165;187;146;97;141;91;61;36;78;175;142;162;80;190;193;117;198;156;24;1,5829943457786281606,0.002003
greedy_intra:nodes_start:greedy,17,51518,18630,32888,69303,14,72;107;40;100;63;102;135;122;90;191;125;131;38;27;16;1;156;198;117;193;31;164;73;54;151;19;112;121;116;51;98;118;74;85;134;139;182;138;33;160;144;104;8;82;21;177;5;45;142;78;175;36;61;91;141;77;97;187;163;89;103;113;176;194;166;86;185;130;95;18;62;124;106;143;153;81;111;0;35;109;29;11;43;168;195;13;145;15;3;70;161;132;169;188;6;192;147;178;10;133,3848346067175300029,0.002895
greedy_intra:nodes_start:greedy,18,50812,18220,32592,44307,4,18;55;34;83;128;86;176;180;113;194;166;52;172;179;185;22;99;130;95;183;140;199;9;148;47;66;94;60;20;59;28;149;4;152;170;184;155;189;3;70;15;145;13;132;169;188;6;134;195;168;43;139;11;182;138;33;160;144;56;104;8;82;87;21;177;5;45;142;175;78;36;61;79;91;141;77;97;146;187;165;137;114;127;89;103;163;186;153;81;41;111;29;109;0;35;143;159;106;124;62,7108762481022944121,0.000993
greedy_intra:nodes_start:greedy,19,53776,18860,34916,89951,8,19;112;121;131;125;51;90;191;71;147;115;178;10;133;122;135;32;96;63;102;92;38;27;16;1;24;156;198;117;193;190;80;162;142;175;78;36;61;91;141;97;146;187;165;127;89;103;113;194;166;179;185;130;95;86;176;163;153;81;77;58;82;8;144;111;35;0;109;29;160;33;49;11;134;6;188;169;132;13;161;70;3;15;145;195;168;139;182;138;104;21;177;5;45;136;73;164;31;54;151,4798072696182076369,0.003979
greedy_intra:nodes_start:greedy,20,46635,20512,26123,93952,11,20;60;94;66;47;148;99;22;179;185;86;95;130;166;194;176;180;113;103;114;137;127;89;163;187;153;81;77;141;91;61;36;78;175;142;45;5;177;21;82;111;8;104;138;182;139;168;195;145;15;3;70;13;132;169;188;6;147;178;10;133;122;135;63;38;1;117;193;31;54;73;121;90;51;118;74;134;11;33;160;29;0;109;35;143;106;124;128;62;18;55;34;170;152;183;140;4;149;28;59,4714684777615829362,0.004002
greedy_intra:nodes_start:greedy,21,51885,19366,32519,18525,1,21;87;82;111;8;104;56;144;33;160;0;35;109;29;69;189;155;145;15;3;70;161;188;6;169;132;13;195;168;43;134;139;11;138;182;25;177;5;45;142;78;175;36;61;91;141;97;146;187;165;127;89;103;137;114;113;194;166;172;179;185;22;99;130;95;86;183;140;199;9;148;47;66;94;60;20;59;28;149;4;152;170;34;55;18;62;128;124;143;159;106;88;176;180;163;186;153;81;77;58,7619567999763051261,0.001030
greedy_intra:nodes_start:greedy,22,48049,20541,27508,32033,3,99;22;130;95;183;140;152;170;34;55;18;62;128;124;106;143;35;109;0;29;160;33;11;134;74;118;121;51;90;131;1;38;135;63;122;133;10;178;147;6;188;169;132;13;70;3;15;145;195;168;139;182;138;104;8;111;82;21;177;5;45;142;78;175;36;61;91;141;77;81;153;187;163;89;127;137;114;103;180;176;113;194;166;86;185;179;172;57;66;94;47;148;60;20;59;28;149;4;199;9,1222254254845732422,0.002007
greedy_intra:nodes_start:greedy,23,47167,20715,26452,53445,5,23;20;59;28;149;4;140;183;152;170;34;55;18;62;128;124;106;143;35;109;0;29;160;33;11;134;74;118;121;51;90;131;54;31;117;1;38;63;135;122;133;10;178;147;6;188;169;132;13;70;3;15;145;195;168;139;182;138;104;8;111;82;21;177;5;45;142;175;78;36;61;91;141;77;81;153;187;163;89;127;137;114;103;180;176;113;194;166;86;95;130;185;179;22;99;148;47;66;94;60,2565322526037585127,0.002003
greedy_intra:nodes_start:greedy,24,51909,18046,33863,30342,5,24;1;16;27;38;102;63;96;32;135;122;133;10;178;115;147;71;191;90;125;51;98;118;74;134;6;188;169;132;13;70;3;15;145;195;168;43;139;11;29;109;0;35;111;81;153;163;176;106;124;62;18;95;130;185;86;166;194;113;103;89;127;165;187;97;77;141;91;61;36;175;78;142;45;5;177;21;82;8;104;144;160;33;138;182;25;158;116;121;112;19;151;54;73;164;31;193;117;198;156,6305904925006846203,0.001000
greedy_intra:nodes_start:greedy,25,52849,19684,33165,52908,8,177;5;45;142;175;78;7;36;61;91;141;97;146;187;165;127;89;103;113;194;166;179;185;86;18;62;124;106;176;163;153;81;77;58;82;8;111;144;0;35;109;29;160;33;49;11;134;74;118;121;51;120;191;90;125;131;112;19;151;54;73;31;193;117;198;156;1;16;27;38;135;63;100;40;107;72;122;133;10;178;147;192;6;188;169;132;13;161;70;3;15;145;195;168;139;182;138;104;87;21,5427213986450425711,0.004000
greedy_intra:nodes_start:greedy,26,51002,21002,30000,61114,8,26;103;114;137;127;89;163;165;187;146;97;141;77;82;21;8;104;138;182;139;168;195;145;15;3;70;13;132;169;188;6;147;178;10;133;122;63;135;38;1;117;31;54;121;51;90;118;74;134;11;33;160;29;0;109;35;111;81;153;129;180;88;176;106;159;143;124;128;62;18;55;34;170;152;4;149;28;59;20;60;94;66;47;148;9;199;140;183;130;95;86;185;99;22;179;172;52;166;194;113,8489113971001314334,0.003031
greedy_intra:nodes_start:greedy,27,54018,19102,34916,12433,0,27;16;1;24;156;198;117;193;80;190;162;175;78;142;36;61;91;141;97;146;187;165;127;89;103;113;194;166;179;185;130;95;86;176;163;153;81;77;58;82;8;111;144;0;35;109;29;160;33;49;11;134;6;188;169;132;13;161;70;3;15;145;195;168;139;182;138;104;21;177;5;45;136;31;164;73;54;151;19;112;121;131;125;51;90;191;71;147;115;178;10;133;122;135;32;96;63;102;92;38,8379065405308312054,0.000980
greedy_intra:nodes_start:greedy,28,46750,20281,26469,96639,11,28;149;4;140;183;152;170;34;55;18;62;128;124;106;143;35;109;0;29;160;33;11;134;74;118;90;51;121;54;31;117;1;38;63;135;122;133;10;178;147;6;188;169;132;13;70;3;15;145;195;168;139;182;138;104;8;111;82;21;177;5;45;142;175;78;36;61;91;141;77;81;153;187;163;89;127;137;114;103;113;180;176;194;166;86;95;22;99;130;185;179;172;57;66;94;47;148;60;20;59,7961190737253075946,0.004000
greedy_intra:nodes_start:greedy,29,51497,18620,32877,60081,6,29;109;0;35;111;41;81;153;186;163;180;88;176;106;159;143;124;128;62;18;55;34;170;152;4;149;28;59;20;60;94;66;47;148;9;199;140;183;95;86;130;99;22;185;179;172;52;166;194;113;114;137;103;89;127;165;187;146;97;77;141;91;61;36;78;175;142;45;5;177;21;87;82;8;104;56;144;160;33;138;182;11;139;134;43;168;195;13;132;169;6;188;161;70;3;15;145;155;189;69,3618736012633999691,0.002967
greedy_intra:nodes_start:greedy,30,51994,20020,31974,125764,13,42;190;80;162;142;175;78;36;61;91;141;97;146;187;165;127;89;103;113;194;166;86;185;130;95;18;62;124;106;176;163;153;81;77;58;82;8;144;111;35;0;109;29;160;33;49;11;134;74;118;121;51;120;191;90;125;131;135;102;63;100;40;107;72;122;133;10;178;147;192;6;188;169;132;13;161;70;3;15;145;195;168;139;182;138;104;21;177;5;45;136;73;164;54;31;193;117;198;1;156,5793827461017360510,0.005971
greedy_intra:nodes_start:greedy,31,50960,20208,30752,110681,11,73;164;31;54;117;198;193;190;80;162;142;175;78;36;61;91;141;97;146;187;165;127;89;103;113;194;166;179;185;86;95;183;140;55;18;62;124;106;176;163;153;81;77;58;82;8;144;111;0;35;109;29;160;33;49;11;134;74;118;121;51;120;191;90;125;131;135;102;63;100;40;107;72;122;133;10;178;147;192;6;188;169;132;13;161;70;3;15;145;195;168;139;182;138;104;21;177;5;45;136,7018516697636793274,0.005045
greedy_intra:nodes_start:greedy,32,52260,18902,33358,64802,10,32;102;63;100;40;107;72;133;10;178;147;192;6;188;169;132;161;70;3;15;145;13;195;168;43;11;29;0;109;35;111;81;153;163;176;106;124;18;62;185;86;166;194;113;103;89;127;165;187;97;77;141;91;61;36;78;175;142;45;5;177;21;82;8;104;144;160;33;138;182;139;134;85;74;118;98;51;116;121;112;19;151;54;73;164;31;193;117;198;156;1;16;27;38;131;125;191;90;122;135,6778484658636106262,0.003735
greedy_intra:nodes_start:greedy,33,51360,18483,32877,90372,9,33;160;144;56;104;8;82;87;21;177;5;45;142;175;78;36;61;91;141;77;97;146;187;165;127;89;103;137;114;113;194;166;52;172;179;22;99;185;86;95;130;183;140;199;9;148;47;66;94;60;20;59;28;149;4;152;170;34;55;18;62;128;124;143;159;106;176;88;180;163;186;153;81;41;111;35;0;109;29;69;189;155;145;15;3;70;161;188;6;169;132;13;195;168;43;134;139;11;182;138,8861161926201733980,0.005048
greedy_intra:nodes_start:greedy,34,50741,18149,32592,61023,6,55;83;128;86;176;180;113;194;166;52;172;179;185;22;99;130;95;183;140;199;9;148;47;66;94;60;20;59;28;149;4;152;170;184;155;189;3;70;15;145;13;132;169;188;6;134;43;168;195;139;11;182;138;33;160;144;56;104;8;82;87;21;177;5;45;142;175;78;36;61;79;91;141;77;97;146;187;165;137;114;127;89;103;163;186;153;81;41;111;0;29;109;35;143;159;106;124;62;18;34,4520922321089649683,0.003001
greedy_intra:nodes_start:greedy,35,51523,18646,32877,65708,6,0;109;29;69;189;155;145;15;3;70;161;188;6;169;132;13;195;168;43;134;139;11;182;138;33;160;144;56;104;8;82;87;21;177;5;45;142;175;78;36;61;91;141;77;97;146;187;165;127;89;103;137;114;113;194;166;52;172;179;185;22;99;86;95;130;183;140;199;9;148;47;66;94;60;20;59;28;149;4;152;170;34;55;18;62;128;124;143;159;106;176;88;180;163;186;153;81;41;111;35,2518466478605415668,0.002022
greedy_intra:nodes_start:greedy,36,51901,19841,32060,64886,8,91;141;97;146;187;165;127;89;103;113;194;166;179;185;86;95;55;18;62;124;106;176;163;153;81;77;58;82;8;144;111;0;35;109;29;160;33;49;11;134;74;118;121;51;120;191;90;125;131;112;19;151;54;73;31;193;117;198;156;1;16;27;38;135;63;100;40;107;72;122;133;10;178;147;192;6;188;169;132;13;161;70;3;15;145;195;168;139;182;138;104;21;177;5;45;142;175;78;36;61,7757395643769608720,0.002384
greedy_intra:nodes_start:greedy,37,49017,20995,28022,127598,14,144;0;35;109;29;160;33;11;134;74;118;90;51;121;112;54;73;31;193;117;198;156;1;16;27;38;135;63;40;107;100;122;133;10;178;147;6;188;169;132;13;70;3;15;145;195;168;139;182;138;104;8;82;21;177;5;45;142;175;78;36;61;91;141;77;97;146;187;165;127;89;103;137;114;113;194;166;172;179;185;22;99;86;95;130;183;140;152;170;34;55;18;62;124;106;176;163;153;81;111,519518832306922008,0.005029
greedy_intra:nodes_start:greedy,38,51180,18689,32491,25805,5,38;102;63;100;40;107;72;133;10;178;147;192;6;188;169;132;161;70;3;15;145;13;195;168;43;11;29;109;35;0;111;81;153;163;176;106;124;62;18;95;130;185;86;166;194;113;103;89;127;165;187;97;77;141;91;61;36;175;78;142;45;5;177;21;82;8;104;144;160;33;138;182;139;134;85;74;118;98;51;125;191;90;122;135;131;121;112;19;151;54;73;164;31;193;117;198;156;1;16;27,2632176757189031485,0.002861
greedy_intra:nodes_start:greedy,39,51838,18835,33003,45612,4,12;0;35;109;29;69;189;155;145;15;3;70;161;188;6;169;132;13;195;168;43;134;139;11;182;138;104;56;8;82;87;21;177;5;45;142;175;78;36;61;91;141;77;97;146;187;165;127;89;103;137;114;113;194;166;172;179;185;22;99;86;95;130;183;140;199;9;148;47;66;94;60;20;59;28;149;4;152;170;34;55;18;62;128;124;143;159;106;88;176;180;163;186;153;81;41;111;144;33;160,8327581488840450930,0.001971
greedy_intra:nodes_start:greedy,40,51923,19157,32766,40882,8,40;100;63;102;135;122;90;191;125;131;38;27;16;1;156;198;117;193;31;164;73;54;151;19;112;121;116;51;98;118;74;85;134;139;182;138;33;160;144;104;8;82;21;177;5;45;142;78;175;36;61;91;141;77;97;187;165;127;89;103;113;194;166;179;185;86;62;18;124;106;176;163;153;81;111;35;0;109;29;11;43;168;195;13;145;15;3;70;161;132;169;188;6;192;147;178;10;133;72;107,9042838358862420054,0.002031
greedy_intra:nodes_start:greedy,41,48557,19911,28646,68761,9,41;81;77;141;97;153;187;163;89;127;137;114;103;26;113;176;194;166;86;185;179;172;57;66;94;47;148;60;20;59;28;149;4;199;9;99;130;95;183;140;152;170;34;55;18;62;128;124;106;143;35;109;0;29;160;33;11;134;74;118;90;51;121;112;54;73;31;193;117;198;156;1;27;38;63;135;122;133;10;178;147;6;188;169;132;13;70;3;15;145;195;168;139;182;138;104;8;21;82;111,1758986764401016738,0.002998
greedy_intra:nodes_start:greedy,42,52380,20039,32341,85386,14,42;30;190;80;162;175;142;78;36;61;91;141;97;146;187;165;127;89;103;113;194;166;86;185;95;18;62;124;106;176;163;153;81;77;58;82;8;144;111;35;109;0;29;160;33;49;11;134;74;118;121;51;120;191;90;125;131;135;102;63;100;40;107;72;122;133;10;178;147;192;6;188;169;132;13;161;70;3;15;145;195;168;139;182;138;104;21;177;5;45;136;73;164;54;31;193;117;198;1;156,8867496485069559534,0.004854
greedy_intra:nodes_start:greedy,43,50234,20757,29477,43043,7,43;134;74;118;139;11;29;109;35;0;111;81;153;163;176;106;124;62;18;55;152;140;183;95;86;185;179;166;194;113;103;89;127;165;187;97;77;141;91;61;36;175;78;142;45;5;177;21;82;8;104;144;160;33;138;182;25;158;121;51;191;90;131;112;19;151;54;73;31;193;117;198;156;1;16;27;38;135;63;100;40;107;72;122;133;10;178;147;192;6;188;169;132;13;70;3;15;145;195;168,7435155255550346658,0.002002
greedy_intra:nodes_start:greedy,44,53444,18862,34582,43925,3,44;133;10;178;115;147;71;191;90;125;51;98;118;74;134;6;188;169;132;13;70;3;15;145;195;168;43;139;11;29;109;0;35;111;81;153;163;176;86;95;185;179;166;194;113;103;89;127;165;187;97;77;141;91;61;36;78;175;142;45;5;177;21;82;8;104;144;160;33;138;182;25;158;116;121;131;112;19;151;54;73;164;31;193;117;198;156;1;16;27;38;135;102;63;100;40;107;17;72;122,7969062562194099560,0.002987
greedy_intra:nodes_start:greedy,45,51945,19885,32060,33815,4,45;5;177;21;104;138;182;139;168;195;145;15;3;70;161;13;132;169;188;6;192;147;178;10;133;122;72;107;40;100;63;135;38;27;16;1;156;198;117;193;31;73;54;151;19;112;131;125;90;191;120;51;121;118;74;134;11;49;33;160;29;109;35;0;144;111;8;82;58;77;81;153;163;176;106;124;62;18;55;95;86;185;179;166;194;113;103;89;127;165;187;146;97;141;91;61;36;78;175;142,7043206307948594255,0.001970
greedy_intra:nodes_start:greedy,46,51557,19865,31692,59475,7,46;80;190;193;198;117;54;31;164;73;136;45;5;177;21;104;138;182;139;168;195;145;15;3;70;161;13;132;169;188;6;192;147;178;10;133;122;72;107;40;100;63;102;135;131;125;90;191;120;51;121;118;74;134;11;49;33;160;29;109;35;0;111;144;8;82;58;77;81;153;163;176;106;124;62;18;140;183;95;130;185;86;166;194;113;103;89;127;165;187;146;97;141;91;61;36;78;175;142;162,7696576338437383860,0.003031
greedy_intra:nodes_start:greedy,47,46402,19933,26469,166176,17,47;148;60;20;59;28;149;4;140;183;152;170;34;55;18;62;128;124;106;143;35;109;0;29;160;33;11;134;74;118;51;90;121;54;31;117;1;38;63;135;122;133;10;178;147;6;188;169;132;13;70;3;15;145;195;168;139;182;138;104;8;111;82;21;177;5;45;142;175;78;36;61;91;141;77;81;153;187;163;89;127;137;114;103;113;180;176;194;166;86;95;130;99;22;185;179;172;57;66;94,8858455354796836811,0.006589
greedy_intra:nodes_start:greedy,48,47966,20483,27483,85589,9,194;176;180;113;26;103;114;137;127;89;163;187;153;81;77;141;91;61;36;78;175;142;45;5;177;21;82;111;8;104;138;182;139;168;195;145;15;3;70;13;132;169;188;6;147;178;10;133;122;63;135;1;117;121;90;51;118;74;134;11;33;160;29;0;109;35;143;106;124;128;62;18;55;34;170;152;140;183;130;95;86;185;22;99;9;199;4;149;28;59;20;60;148;47;94;66;57;172;179;166,7394816553559751597,0.003620
greedy_intra:nodes_start:greedy,49,48705,20573,28132,111983,12,49;29;0;109;35;111;81;153;163;176;106;124;62;18;55;34;170;152;140;183;130;95;86;185;22;99;179;172;166;194;113;114;137;103;89;127;165;187;146;97;77;141;91;61;36;78;175;142;45;5;177;21;82;8;104;144;160;33;138;182;139;168;195;145;15;3;70;13;132;169;188;6;147;178;10;133;122;107;40;63;135;38;27;16;1;156;198;117;193;31;54;73;112;121;90;51;118;74;134;11,3659617391356984901,0.005031
greedy_intra:nodes_start:greedy,50,51839,20646,31193,27985,3,41;81;153;163;180;176;88;106;143;124;128;62;18;55;34;170;152;140;183;86;95;130;99;22;185;179;172;166;194;113;114;137;103;89;127;165;187;146;97;141;77;82;21;8;104;138;182;139;168;195;145;15;3;70;13;132;169;188;6;192;147;178;10;133;122;72;107;40;100;63;135;38;27;16;1;156;198;117;193;31;73;54;151;19;131;90;191;51;121;118;74;134;11;33;160;29;0;109;35;111,5894241674981540997,0.001001
greedy_intra:nodes_start:greedy,51,50637,19774,30863,50623,9,51;125;191;90;122;133;10;72;107;40;100;63;102;135;38;27;16;1;156;198;117;193;31;164;73;54;151;19;112;131;121;116;158;25;182;138;33;160;144;104;8;82;21;177;5;45;142;175;78;36;61;91;141;77;97;187;165;127;89;103;113;194;166;86;185;95;183;140;18;62;124;106;176;163;153;81;111;35;0;109;29;11;139;43;168;195;145;15;3;70;13;132;169;188;6;147;134;74;118;98,8511007933734244241,0.002969
greedy_intra:nodes_start:greedy,52,47878,20555,27323,71545,7,52;166;194;113;176;180;103;114;137;127;89;163;187;153;81;77;141;91;61;36;78;175;142;45;5;177;21;82;111;8;104;138;182;139;168;195;145;15;3;70;13;132;169;188;6;147;178;10;133;122;135;63;38;1;117;121;90;51;118;74;134;11;33;160;29;0;109;35;143;106;124;128;62;18;55;34;170;152;140;183;130;95;86;185;22;99;9;199;4;149;28;59;20;60;148;47;94;66;179;172,6187227779530396247,0.003032
greedy_intra:nodes_start:greedy,53,47843,20464,27379,81071,8,53;140;183;95;130;99;9;199;4;149;28;59;20;60;148;47;94;66;57;172;179;185;86;166;194;176;180;113;103;114;137;127;89;163;187;153;81;77;141;91;61;36;78;175;142;45;5;177;21;82;111;8;104;138;182;139;168;195;145;15;3;70;13;132;169;188;6;147;178;10;133;122;63;135;38;1;117;121;90;51;118;74;134;11;33;160;29;0;109;35;143;106;124;128;62;18;55;34;170;152,3016212345092782111,0.004002
greedy_intra:nodes_start:greedy,54,51382,20444,30938,104775,11,54;31;164;73;136;45;5;177;21;104;138;182;139;168;195;145;15;3;70;161;13;132;169;188;6;192;147;178;10;133;122;72;107;40;100;63;102;135;131;125;90;191;120;51;121;118;74;134;11;49;33;160;29;0;109;35;111;144;8;82;58;77;81;153;163;176;106;124;62;18;140;183;95;86;130;185;179;166;194;113;103;89;127;165;187;146;97;141;91;61;36;78;175;142;162;80;190;193;198;117,8826263638310977062,0.004467
greedy_intra:nodes_start:greedy,55,50711,18119,32592,83645,8,34;55;83;128;86;176;180;113;194;166;52;172;179;185;22;99;130;95;183;140;199;9;148;47;66;94;60;20;59;28;149;4;152;170;184;155;189;3;70;15;145;13;132;169;188;6;134;43;195;168;139;11;182;138;33;160;144;56;104;8;82;87;21;177;5;45;142;78;175;36;61;79;91;141;77;97;146;187;165;137;114;127;89;103;163;186;153;81;41;111;29;0;109;35;143;159;106;124;62;18,5343609944627925698,0.002996
greedy_intra:nodes_start:greedy,56,55385,18495,36890,93669,8,56;144;111;35;109;0;29;160;33;49;11;139;134;85;74;118;98;121;51;120;71;191;90;125;131;112;19;151;54;73;164;31;193;117;198;156;1;16;27;38;135;102;63;100;40;107;72;122;133;10;178;115;147;192;6;188;169;132;13;161;70;3;15;145;195;168;43;182;138;104;25;177;5;45;142;175;78;36;61;91;141;97;146;187;165;127;89;103;113;194;166;176;163;153;81;77;82;87;21;8,7846806594635797312,0.004033
greedy_intra:nodes_start:greedy,57,46373,19904,26469,137948,14,57;172;179;22;99;130;95;185;86;166;194;176;180;113;103;114;137;127;89;163;187;153;81;77;141;91;61;36;175;78;142;45;5;177;21;82;111;8;104;138;182;139;168;195;145;15;3;70;13;132;169;188;6;147;178;10;133;122;135;63;38;1;117;31;54;121;90;51;118;74;134;11;33;160;29;0;109;35;143;106;124;128;62;18;55;34;170;152;183;140;4;149;28;59;20;60;148;47;94;66,2693238048930399401,0.006576
greedy_intra:nodes_start:greedy,58,51574,19917,31657,76980,9,58;82;8;144;111;35;0;109;29;160;33;49;11;134;74;118;121;51;120;191;90;125;131;112;19;151;54;73;31;193;117;198;156;1;16;27;38;135;63;100;40;107;72;122;133;10;178;147;192;6;188;169;132;13;161;70;3;15;145;195;168;139;182;138;104;21;177;5;45;142;175;78;36;61;91;141;97;146;187;165;127;89;103;113;194;166;86;185;95;183;140;18;62;124;106;176;163;153;81;77,1406214150376328075,0.004971
greedy_intra:nodes_start:greedy,59,46909,20440,26469,83830,10,59;28;149;4;140;183;152;170;34;55;18;62;128;124;106;143;35;109;0;29;160;33;11;134;74;118;121;51;90;54;31;117;1;38;63;135;122;133;10;178;147;6;188;169;132;13;70;3;15;145;195;168;139;182;138;104;8;111;82;21;177;5;45;142;175;78;36;61;91;141;77;81;153;187;163;89;127;137;114;103;113;176;180;194;166;86;95;130;99;22;185;179;172;57;66;94;47;148;60;20,3176229946390561419,0.003524
greedy_intra:nodes_start:greedy,60,46578,20455,26123,46142,8,60;94;66;47;148;99;22;179;185;130;95;86;166;194;113;176;180;103;114;137;127;89;163;187;153;81;77;141;91;61;36;78;175;142;45;5;177;21;82;111;8;104;138;182;139;168;195;145;15;3;70;13;132;169;188;6;147;178;10;133;122;135;63;38;1;117;193;31;54;73;121;51;90;118;74;134;11;33;160;29;0;109;35;143;106;124;128;62;18;55;34;170;152;183;140;4;149;28;59;20,6439664718281156128,0.002001
greedy_intra:nodes_start:greedy,61,51641,19984,31657,55580,7,61;36;175;78;142;45;5;177;21;104;138;182;139;168;195;145;15;3;70;161;13;132;169;188;6;192;147;178;10;133;122;72;107;40;100;63;135;38;27;16;1;156;198;117;193;31;73;54;151;19;112;131;125;90;191;120;51;121;118;74;134;11;49;33;160;29;109;35;0;144;111;8;82;58;77;81;153;163;176;106;124;62;18;140;183;95;185;86;166;194;113;103;89;127;165;187;146;97;141;91,2366154399558739768,0.003002
greedy_intra:nodes_start:greedy,62,50703,18111,32592,90221,9,62;124;106;159;143;35;109;0;29;111;41;81;153;186;163;103;89;127;114;137;165;187;146;97;77;141;91;79;61;36;78;175;142;45;5;177;21;87;82;8;104;56;144;160;33;138;182;11;139;168;195;43;134;6;188;169;132;13;145;15;70;3;189;155;184;170;152;4;149;28;59;20;60;94;66;47;148;9;199;140;183;95;130;99;22;185;179;172;52;166;194;113;180;176;86;128;83;55;34;18,1515263663662693075,0.004000
greedy_intra:nodes_start:greedy,63,51697,18873,32824,62848,10,63;100;40;107;72;133;10;178;147;192;6;188;169;132;161;70;3;15;145;13;195;168;43;11;29;109;35;0;111;81;153;163;176;106;124;62;18;95;185;86;166;194;113;103;89;127;165;187;97;77;141;91;61;36;78;175;142;45;5;177;21;82;8;104;144;160;33;138;182;139;134;85;74;118;98;51;116;121;112;19;151;54;73;164;31;193;117;198;156;1;16;27;38;131;125;191;90;122;135;102,8368450607763473628,0.003476
greedy_intra:nodes_start:greedy,64,50982,20826,30156,50251,6,88;86;95;128;106;159;143;124;62;18;55;34;170;152;174;183;140;199;4;149;28;59;20;60;148;47;94;66;99;130;185;22;179;172;52;166;194;113;26;103;114;137;127;89;163;165;187;146;97;141;77;82;21;8;104;138;182;139;168;195;145;15;3;70;13;132;169;188;6;147;178;10;133;122;63;135;38;1;117;31;54;121;51;90;118;74;134;11;33;160;29;0;109;35;111;81;153;129;180;176,6076259572174611817,0.002000
greedy_intra:nodes_start:greedy,65,50172,17520,32652,12539,0,65;188;6;169;132;13;126;168;195;145;15;189;34;55;18;62;128;124;106;159;143;35;109;0;29;160;33;49;11;139;182;138;104;8;56;144;111;82;87;21;177;5;45;142;78;175;36;61;79;91;141;97;77;81;153;146;187;165;163;89;127;137;114;103;26;180;176;113;194;166;86;185;179;172;57;66;94;47;148;60;20;59;28;149;4;199;9;99;22;130;95;183;140;152;170;184;155;3;70;161,990243602354409038,0.000000
greedy_intra:nodes_start:greedy,66,46775,20306,26469,124395,14,66;57;172;179;22;185;95;130;99;86;166;194;176;180;113;103;114;137;127;89;163;187;153;81;77;141;91;61;36;78;175;142;45;5;177;21;82;111;8;104;138;182;139;168;195;145;15;3;70;13;132;169;188;6;147;178;10;133;122;135;63;38;1;117;31;54;121;51;90;118;74;134;11;33;160;29;0;109;35;143;106;124;128;62;18;55;34;170;152;183;140;4;149;28;59;20;60;148;47;94,2254126008481808661,0.005025
greedy_intra:nodes_start:greedy,67,53325,18881,34444,50862,4,67;120;51;98;118;74;134;6;188;169;132;13;70;3;15;145;195;168;43;139;11;29;0;109;35;111;81;153;163;176;86;95;130;185;179;166;194;113;103;89;127;165;187;97;77;141;91;61;36;78;175;142;45;5;177;21;82;8;104;144;160;33;138;182;25;158;116;121;131;112;19;151;54;73;164;31;193;117;198;156;1;16;27;38;135;102;63;100;40;107;17;72;122;133;10;178;90;191;147;71,6746573870190351313,0.002001
greedy_intra:nodes_start:greedy,68,52750,20194,32556,116212,19,144;111;143;35;109;0;29;160;33;49;11;134;74;118;121;51;120;191;90;125;131;112;19;151;54;73;31;193;117;198;156;1;16;27;38;135;63;100;40;107;72;122;133;10;178;147;192;6;188;169;132;13;161;70;3;15;145;195;168;139;182;138;104;87;21;177;5;45;142;175;78;36;61;91;141;97;146;187;165;127;89;103;113;194;166;179;185;86;18;62;124;106;176;163;153;81;77;58;82;8,6518514299352938175,0.006000
greedy_intra:nodes_start:greedy,69,51811,18129,33682,88532,10,0;109;35;12;111;41;81;153;186;163;180;176;88;106;159;143;124;128;62;18;55;34;170;152;4;149;28;59;20;60;94;66;47;148;9;199;140;183;95;86;130;99;22;185;179;172;52;166;194;113;26;114;137;103;89;127;165;187;146;97;77;141;91;79;61;36;78;175;142;45;5;177;21;87;82;8;104;56;144;160;33;138;182;11;139;134;43;168;195;13;132;169;6;188;161;70;3;15;145;29,659637951467297920,0.003999
greedy_intra:nodes_start:greedy,70,50075,17564,32511,23012,1,70;161;188;6;169;132;13;126;168;195;145;15;189;34;55;18;62;128;124;106;159;143;35;109;0;29;160;33;49;11;139;182;138;104;8;56;144;111;82;87;21;177;5;45;142;175;78;36;61;79;91;141;97;77;81;153;146;187;165;163;89;127;137;114;103;26;180;176;113;194;166;86;185;179;52;172;57;66;94;47;148;60;20;59;28;149;4;199;9;99;22;130;95;183;140;152;170;184;155;3,847815780428030485,0.001014
greedy_intra:nodes_start:greedy,71,50585,19647,30938,57253,11,71;147;192;6;188;169;132;161;70;3;15;145;13;195;168;43;11;29;109;0;35;111;81;153;163;176;106;124;62;18;140;183;95;86;185;179;166;194;113;103;89;127;165;187;97;77;141;91;61;36;78;175;142;45;5;177;21;82;8;104;144;160;33;138;182;139;134;74;118;98;51;131;121;112;19;54;73;164;31;193;117;198;156;1;16;27;38;135;102;63;100;40;107;72;122;133;10;178;90;191,3545342760033714220,0.004000
greedy_intra:nodes_start:greedy,72,51653,19019,32634,52346,12,72;107;40;100;63;102;135;122;90;191;125;131;38;27;16;1;156;198;117;193;31;164;73;54;151;19;112;121;116;51;98;118;74;85;134;139;182;138;33;160;144;104;8;82;21;177;5;45;142;78;175;36;61;91;141;77;97;187;163;89;127;103;113;176;166;179;185;86;55;18;62;124;106;143;153;81;111;0;35;109;29;11;43;168;195;13;145;15;3;70;161;132;169;188;6;192;147;178;10;133,2084638541565160686,0.003030
greedy_intra:nodes_start:greedy,73,51222,20284,30938,87707,8,31;164;73;136;45;5;177;21;104;138;182;139;168;195;145;15;3;70;161;13;132;169;188;6;192;147;178;10;133;122;72;107;40;100;63;102;135;131;125;90;191;120;51;121;118;74;134;11;49;33;160;29;109;0;35;111;144;8;82;58;77;81;153;163;176;106;124;62;18;140;183;130;95;86;185;179;166;194;113;103;89;127;165;187;146;97;141;91;61;36;78;175;142;162;80;190;193;198;117;54,7698052583449117633,0.003995
greedy_intra:nodes_start:greedy,74,50549,19771,30778,59642,5,74;118;98;51;191;90;178;10;133;122;72;107;40;100;63;102;135;131;121;158;25;182;138;33;160;144;104;8;82;87;21;177;5;45;142;175;78;36;61;91;141;77;97;146;187;165;127;89;103;137;114;113;194;166;172;179;99;22;185;86;95;130;183;140;152;170;34;55;18;62;128;124;106;176;180;163;153;81;111;35;0;109;29;49;11;139;43;168;195;145;15;3;70;13;132;169;188;6;147;134,2401753602103352569,0.002998
greedy_intra:nodes_start:greedy,75,51328,21334,29994,79811,10,75;114;113;194;166;179;172;57;66;94;47;148;60;20;59;28;149;4;199;9;99;22;185;86;95;130;183;140;152;170;34;55;18;62;128;124;143;159;106;180;176;88;26;103;163;186;153;81;111;35;109;0;29;160;33;11;134;74;118;90;51;121;31;117;1;38;135;63;122;133;10;178;147;6;188;169;132;13;70;3;15;145;195;168;139;182;138;104;8;21;36;141;77;97;146;187;165;89;127;137,8775687525681507369,0.003970
greedy_intra:nodes_start:greedy,76,51885,21189,30696,25219,2,88;166;52;172;179;185;22;99;130;95;183;140;199;9;148;47;66;94;60;20;59;28;149;4;53;152;170;34;55;18;62;124;143;159;106;128;86;194;176;180;113;26;103;163;186;153;81;111;35;109;0;29;160;33;11;134;74;118;121;51;90;131;117;1;38;135;63;122;133;10;178;147;6;188;169;132;13;70;3;15;145;195;168;139;182;138;104;8;21;82;77;141;97;146;187;89;165;127;137;114,5182122510307481803,0.001000
greedy_intra:nodes_start:greedy,77,50956,21170,29786,74598,8,141;36;21;8;104;138;182;139;168;195;145;15;3;70;13;132;169;188;6;147;178;10;133;122;135;63;38;1;117;31;54;121;51;90;118;74;134;11;33;160;29;0;109;35;111;81;153;186;163;180;176;88;106;159;143;124;128;62;18;55;34;170;152;4;149;28;59;20;60;94;66;47;148;9;199;140;183;130;95;86;99;22;185;179;172;52;166;194;113;26;114;137;103;89;127;165;187;146;97;77,1065619174424122923,0.003972
greedy_intra:nodes_start:greedy,78,51945,19885,32060,37108,6,78;36;61;91;141;97;146;187;165;127;89;103;113;194;166;179;185;86;95;55;18;62;124;106;176;163;153;81;77;58;82;8;111;144;0;35;109;29;160;33;49;11;134;74;118;121;51;120;191;90;125;131;112;19;151;54;73;31;193;117;198;156;1;16;27;38;135;63;100;40;107;72;122;133;10;178;147;192;6;188;169;132;13;161;70;3;15;145;195;168;139;182;138;104;21;177;5;45;142;175,8818887749949440473,0.002003
greedy_intra:nodes_start:greedy,79,52564,19739,32825,63980,6,36;91;79;141;97;146;187;165;127;89;103;113;194;166;86;185;130;95;18;62;124;106;176;163;153;81;77;58;82;8;111;144;0;35;109;29;160;33;49;11;134;74;118;121;51;120;191;90;125;131;112;19;151;54;73;31;193;117;198;156;1;16;27;38;135;63;100;40;107;72;122;133;10;178;147;192;6;188;169;132;13;161;70;3;15;145;195;168;139;182;138;104;21;177;5;45;142;175;78;61,8056934252324671546,0.003000
greedy_intra:nodes_start:greedy,80,51222,20284,30938,72973,7,80;162;142;175;78;36;61;91;141;97;146;187;165;127;89;103;113;194;166;179;185;86;95;130;183;140;18;62;124;106;176;163;153;81;77;58;82;8;144;111;35;0;109;29;160;33;49;11;134;74;118;121;51;120;191;90;125;131;135;102;63;100;40;107;72;122;133;10;178;147;192;6;188;169;132;13;161;70;3;15;145;195;168;139;182;138;104;21;177;5;45;136;73;164;31;54;117;198;193;190,7956656592222904323,0.003489
greedy_intra:nodes_start:greedy,81,50650,20864,29786,109842,12,81;153;186;163;180;88;176;106;159;143;124;128;62;18;55;34;170;152;4;149;28;59;20;60;94;66;47;148;9;199;140;183;130;95;86;185;22;99;179;172;52;166;194;113;26;114;137;103;89;127;165;187;146;97;77;141;36;21;8;104;138;182;139;168;195;145;15;3;70;13;132;169;188;6;147;178;10;133;122;135;63;38;1;117;31;54;121;90;51;118;74;134;11;33;160;29;0;109;35;111,8212968554834768822,0.005972
greedy_intra:nodes_start:greedy,82,51739,19220,32519,64547,5,82;87;21;58;77;81;153;186;163;180;176;88;106;159;143;124;128;62;18;55;34;170;152;4;149;28;59;20;60;94;66;47;148;9;199;140;183;130;95;86;99;22;185;179;172;166;194;113;114;137;103;89;127;165;187;146;97;141;91;61;36;175;78;142;45;5;177;25;182;138;11;139;134;43;168;195;13;132;169;6;188;161;70;3;15;145;155;189;69;109;35;0;29;160;33;144;56;104;8;111,3728879487718796237,0.004245
greedy_intra:nodes_start:greedy,83,47984,20655,27329,91957,9,34;170;152;140;183;95;130;99;9;199;4;149;28;59;20;60;148;47;94;66;57;172;179;185;86;166;194;113;176;180;103;114;137;127;89;163;187;153;81;77;141;91;61;36;78;175;142;45;5;177;21;82;111;8;104;138;182;139;168;195;145;15;3;70;13;132;169;188;6;147;178;10;133;122;135;63;38;1;117;121;51;90;118;74;134;11;33;160;29;0;109;35;143;106;124;128;62;18;83;55,2715734749453770400,0.004001
greedy_intra:nodes_start:greedy,84,51378,18501,32877,94165,11,3;70;161;15;145;13;132;169;188;6;134;43;195;168;139;11;182;138;33;160;144;56;104;8;82;87;21;177;5;45;142;175;78;36;61;91;141;77;97;146;187;165;127;89;103;137;114;113;194;166;52;172;179;185;22;99;130;86;95;183;140;199;9;148;47;66;94;60;20;59;28;149;4;152;170;34;55;18;62;128;124;143;159;106;176;88;180;163;186;153;81;41;111;29;0;35;109;69;189;155,7421798401639649725,0.004000
greedy_intra:nodes_start:greedy,85,49042,20376,28666,56108,5,85;74;118;121;51;191;90;131;73;54;31;193;117;198;156;1;16;27;38;135;63;100;40;107;72;122;133;10;178;147;6;188;169;132;70;3;15;145;13;195;168;29;109;0;35;111;81;153;163;176;106;124;62;18;55;34;170;152;140;183;95;86;130;99;185;179;166;194;113;103;89;127;165;187;146;97;77;141;91;61;36;78;175;142;45;5;177;21;82;8;104;144;160;33;138;182;11;139;43;134,8940364886966963925,0.002715
greedy_intra:nodes_start:greedy,86,47354,20583,26771,90856,10,95;86;185;179;172;166;194;176;180;113;103;114;137;127;89;163;187;153;81;77;141;91;61;36;175;78;142;45;5;177;21;82;111;8;104;138;182;139;168;195;145;15;3;70;13;132;169;188;6;147;178;10;133;122;135;63;38;1;117;31;121;51;90;118;74;134;11;33;160;29;0;109;35;143;106;124;128;62;18;55;34;170;152;140;183;9;199;4;149;28;59;20;60;148;47;94;66;22;99;130,4340120775099119064,0.004000
greedy_intra:nodes_start:greedy,87,51695,19176,32519,79609,7,87;82;111;8;104;56;144;33;160;29;0;35;109;69;189;155;145;15;3;70;161;188;6;169;132;13;195;168;43;134;139;11;138;182;25;177;5;45;142;175;78;36;61;91;141;97;146;187;165;127;89;103;137;114;113;194;166;172;179;185;22;99;130;86;95;183;140;199;9;148;47;66;94;60;20;59;28;149;4;152;170;34;55;18;62;128;124;143;159;106;176;88;180;163;186;153;81;77;58;21,5721648408462903554,0.004191
greedy_intra:nodes_start:greedy,88,47803,21039,26764,55517,8,114;137;89;127;103;163;187;153;81;77;141;91;61;36;78;175;142;45;5;177;21;82;111;8;104;138;182;139;168;195;145;15;3;70;13;132;169;188;6;147;178;10;133;122;63;135;38;1;117;31;121;51;90;118;74;134;11;33;160;29;0;109;35;143;106;124;128;62;18;55;34;170;152;140;183;130;95;86;185;22;99;9;199;4;149;28;59;20;60;148;47;94;66;57;172;179;166;194;176;113,7176809214958208506,0.003031
greedy_intra:nodes_start:greedy,89,50704,20982,29722,96226,11,89;163;165;187;146;97;77;141;36;21;8;104;138;182;139;168;195;145;15;3;70;13;132;169;188;6;147;178;10;133;122;135;63;38;1;117;31;54;121;90;51;118;74;134;11;33;160;29;0;109;35;111;81;153;129;180;88;176;106;159;143;124;128;62;18;55;34;170;152;4;149;28;59;20;60;94;66;47;148;9;199;140;183;95;86;130;99;22;185;179;172;52;166;194;113;26;103;114;137;127,6023567609687541754,0.005002
greedy_intra:nodes_start:greedy,90,50637,19774,30863,49109,9,90;191;125;51;98;118;74;134;147;6;188;169;132;13;70;3;15;145;195;168;43;139;11;29;109;0;35;111;81;153;163;176;106;124;62;18;140;183;95;185;86;166;194;113;103;89;127;165;187;97;77;141;91;61;36;78;175;142;45;5;177;21;82;8;104;144;160;33;138;182;25;158;116;121;131;112;19;151;54;73;164;31;193;117;198;156;1;16;27;38;135;102;63;100;40;107;72;10;133;122,7802740379680061237,0.002927
greedy_intra:nodes_start:greedy,91,51909,19849,32060,47574,5,36;61;91;141;97;146;187;165;127;89;103;113;194;166;179;185;86;95;55;18;62;124;106;176;163;153;81;77;58;82;8;144;111;0;35;109;29;160;33;49;11;134;74;118;121;51;120;191;90;125;131;112;19;151;54;73;31;193;117;198;156;1;16;27;38;135;63;100;40;107;72;122;133;10;178;147;192;6;188;169;132;13;161;70;3;15;145;195;168;139;182;138;104;21;177;5;45;142;78;175,5097468448107881197,0.002966
greedy_intra:nodes_start:greedy,92,52067,18925,33142,62431,15,102;32;135;122;90;191;125;131;38;27;16;1;156;198;117;193;31;164;73;54;151;19;112;121;116;51;98;118;74;85;134;139;182;138;33;160;144;104;8;82;21;177;5;45;142;175;78;36;61;91;141;77;97;187;163;89;127;103;113;176;166;179;185;86;18;62;124;106;143;153;81;111;0;35;109;29;11;43;168;195;13;145;15;3;70;161;132;169;188;6;192;147;178;10;133;72;107;40;100;63,9152977352282314203,0.004999
greedy_intra:nodes_start:greedy,93,52322,21001,31321,48480,6,76;75;114;137;127;89;165;187;146;97;141;77;82;21;8;104;138;182;139;168;195;145;15;3;70;13;132;169;188;6;147;178;10;133;122;63;135;1;117;121;90;51;118;74;134;11;33;160;29;0;109;35;111;81;153;186;163;103;26;113;180;176;194;86;128;106;159;143;124;62;18;55;34;170;152;53;4;149;28;59;20;60;94;66;47;148;9;199;140;183;95;130;99;22;185;179;172;52;166;48,3083810720104328213,0.003029
greedy_intra:nodes_start:greedy,94,46475,20006,26469,133628,15,94;66;57;172;179;22;99;130;95;185;86;166;194;180;176;113;103;114;137;127;89;163;187;153;81;77;141;91;61;36;78;175;142;45;5;177;21;82;111;8;104;138;182;139;168;195;145;15;3;70;13;132;169;188;6;147;178;10;133;122;63;135;38;1;117;31;54;121;90;51;118;74;134;11;33;160;29;0;109;35;143;106;124;128;62;18;55;34;170;152;183;140;4;149;28;59;20;60;148;47,2130154687828923231,0.005844
greedy_intra:nodes_start:greedy,95,47262,20491,26771,60359,8,86;95;130;99;22;66;94;47;148;60;20;59;28;149;4;199;9;183;140;152;170;34;55;18;62;128;124;106;143;35;109;0;29;160;33;11;134;74;118;51;90;121;31;117;1;38;63;135;122;133;10;178;147;6;188;169;132;13;70;3;15;145;195;168;139;182;138;104;8;111;82;21;177;5;45;142;175;78;36;61;91;141;77;81;153;187;163;89;127;137;114;103;180;176;113;194;166;172;179;185,9014211900365443441,0.003029
greedy_intra:nodes_start:greedy,96,51579,18935,32644,51051,16,102;135;122;90;191;125;131;38;27;16;1;156;198;117;193;31;164;73;54;151;19;112;121;116;51;98;118;74;85;134;139;182;138;33;160;144;104;8;82;21;177;5;45;142;78;175;36;61;91;141;77;97;187;163;89;103;113;176;194;166;179;185;86;55;18;62;124;106;143;153;81;111;0;35;109;29;11;43;168;195;13;145;15;3;70;161;132;169;188;6;192;147;178;10;133;72;107;40;100;63,9012969401856712819,0.003305
greedy_intra:nodes_start:greedy,97,50817,21031,29786,88812,10,97;77;141;36;21;8;104;138;182;139;168;195;145;15;3;70;13;132;169;188;6;147;178;10;133;122;135;63;38;1;117;31;54;121;51;90;118;74;134;11;33;160;29;0;109;35;111;81;153;186;163;180;88;176;106;159;143;124;128;62;18;55;34;170;152;4;149;28;59;20;60;94;66;47;148;9;199;140;183;130;95;86;185;22;99;179;172;52;166;194;113;26;114;137;103;89;127;165;187;146,7877362187359359434,0.004347
greedy_intra:nodes_start:greedy,98,53088,18878,34210,55535,4,98;51;125;90;191;71;147;115;178;10;133;122;72;17;107;40;100;63;102;135;38;27;16;1;156;198;117;193;31;164;73;54;151;19;112;131;121;116;158;25;182;138;33;160;144;104;8;82;21;177;5;45;142;175;78;36;61;91;141;77;97;187;165;127;89;103;113;194;166;179;185;130;95;86;176;163;153;81;111;35;109;0;29;11;139;43;168;195;145;15;3;70;13;132;169;188;6;134;74;118,5739086742340373727,0.003157
greedy_intra:nodes_start:greedy,99,47249,20446,26803,86982,9,99;130;95;183;140;152;170;34;55;18;62;128;124;106;143;35;109;0;29;160;33;11;134;74;118;51;90;121;31;117;1;38;63;135;122;133;10;178;147;6;188;169;132;13;70;3;15;145;195;168;139;182;138;104;8;111;82;21;177;5;45;142;175;78;36;61;91;141;77;81;153;187;163;89;127;137;114;103;113;180;176;194;166;86;185;179;172;57;66;94;47;148;60;20;59;28;149;4;199;9,1628612371231297794,0.004002
greedy_intra:nodes_start:greedy,100,51626,18748,32878,80281,15,100;107;40;63;102;135;122;90;191;125;131;38;27;16;1;156;198;117;193;31;164;73;54;151;19;112;121;116;51;98;118;74;85;134;139;182;138;33;160;144;104;8;82;21;177;5;45;142;175;78;36;61;91;141;77;97;187;163;89;127;103;113;176;166;86;185;130;95;18;62;124;106;143;153;81;111;35;109;0;29;11;43;168;195;13;145;15;3;70;161;132;169;188;6;192;147;178;10;133;72,7097516372257387872,0.006288
greedy_intra:nodes_start:greedy,101,47013,19937,27076,115737,11,101;149;4;140;183;152;170;34;55;18;62;128;124;106;143;35;109;0;29;160;33;11;134;74;118;51;90;121;31;117;1;38;63;135;122;133;10;178;147;6;188;169;132;13;70;3;15;145;195;168;139;182;138;104;8;111;82;21;177;5;45;142;175;78;36;61;91;141;77;81;153;187;163;89;127;137;114;103;113;180;176;194;166;86;95;130;99;22;185;179;172;57;66;94;47;148;60;20;59;28,3855844383719396541,0.004999
greedy_intra:nodes_start:greedy,102,51682,18858,32824,62961,10,102;135;122;90;191;125;131;38;27;16;1;156;198;117;193;31;164;73;54;151;19;112;121;116;51;98;118;74;85;134;139;182;138;33;160;144;104;8;82;21;177;5;45;142;175;78;36;61;91;141;77;97;187;165;127;89;103;113;194;166;86;185;95;18;62;124;106;176;163;153;81;111;35;0;109;29;11;43;168;195;13;145;15;3;70;161;132;169;188;6;192;147;178;10;133;72;107;40;100;63,3437470112098683535,0.003359
greedy_intra:nodes_start:greedy,103,50567,20845,29722,102810,12,103;114;137;127;89;163;165;187;146;97;77;141;36;21;8;104;138;182;139;168;195;145;15;3;70;13;132;169;188;6;147;178;10;133;122;135;63;38;1;117;31;54;121;90;51;118;74;134;11;33;160;29;0;109;35;111;81;153;129;180;88;176;106;159;143;124;128;62;18;55;34;170;152;4;149;28;59;20;60;94;66;47;148;9;199;140;183;130;95;86;185;99;22;179;172;52;166;194;113;26,4437590491994510021,0.004999
greedy_intra:nodes_start:greedy,104,49021,20807,28214,78839,9,104;138;182;139;168;195;145;15;3;70;13;132;169;188;6;147;178;10;133;122;107;40;63;135;38;27;16;1;156;198;117;193;31;54;73;112;121;90;51;118;74;134;11;33;160;29;109;35;0;144;111;41;81;153;163;176;106;124;62;18;55;34;170;152;140;183;95;86;130;99;22;185;179;172;166;194;113;114;137;103;89;127;165;187;146;97;77;141;91;61;36;78;175;142;45;5;177;21;82;8,7538461561669505580,0.003978
greedy_intra:nodes_start:greedy,105,51708,20353,31355,80525,10,105;136;73;164;31;54;117;198;193;45;5;177;21;104;138;182;139;168;195;145;15;3;70;161;13;132;169;188;6;192;147;178;10;133;122;72;107;40;100;63;102;135;131;125;90;191;120;51;121;118;74;134;11;49;33;160;29;109;0;35;111;144;8;82;58;77;81;153;163;176;106;124;62;18;140;183;95;86;185;179;166;194;113;103;89;127;165;187;146;97;141;91;61;36;78;175;142;162;80;190,5815319502399291257,0.003972
greedy_intra:nodes_start:greedy,106,47009,20423,26586,112340,14,124;128;86;95;183;140;4;149;28;59;20;60;148;47;94;66;22;99;185;179;172;166;194;176;113;26;103;114;137;127;89;163;187;153;81;77;141;91;61;36;78;175;142;45;5;177;21;82;8;111;144;104;138;182;139;168;195;145;15;3;70;13;132;169;188;6;147;178;10;133;122;135;63;38;1;198;117;193;31;54;73;121;51;90;118;74;134;11;33;160;29;0;109;35;34;55;18;62;143;106,3039164960504717312,0.006002
greedy_intra:nodes_start:greedy,107,51675,18851,32824,57707,9,107;72;133;10;178;147;192;6;188;169;132;161;70;3;15;145;13;195;168;43;11;29;0;109;35;111;81;153;163;176;106;124;62;18;95;185;86;166;194;113;103;89;127;165;187;97;77;141;91;61;36;175;78;142;45;5;177;21;82;8;104;144;160;33;138;182;139;134;85;74;118;98;51;116;121;112;19;151;54;73;164;31;193;117;198;156;1;16;27;38;131;125;191;90;122;135;102;63;100;40,8609201028561068374,0.003029
greedy_intra:nodes_start:greedy,108,52368,20027,32341,114035,13,30;190;80;162;142;175;78;36;61;91;141;97;146;187;165;127;89;103;113;194;166;86;185;95;18;62;124;106;176;163;153;81;77;58;82;8;144;111;35;109;0;29;160;33;49;11;134;74;118;121;51;120;191;90;125;131;135;102;63;100;40;107;72;122;133;10;178;147;192;6;188;169;132;13;161;70;3;15;145;195;168;139;182;138;104;21;177;5;45;136;73;164;31;54;193;117;198;1;156;42,4285492671689774114,0.005018
greedy_intra:nodes_start:greedy,109,51417,18540,32877,55138,6,109;29;69;189;155;145;15;3;70;161;188;6;169;132;13;195;168;43;134;139;11;182;138;33;160;144;56;104;8;82;87;21;177;5;45;142;78;175;36;61;91;141;77;97;146;187;165;127;89;103;137;114;113;194;166;52;172;179;99;22;185;86;95;130;183;140;199;9;148;47;66;94;60;20;59;28;149;4;152;170;34;55;18;62;128;124;143;159;106;176;88;180;163;186;153;81;41;111;0;35,6800768557096455026,0.002000
greedy_intra:nodes_start:greedy,110,51312,21162,30150,22873,2,110;128;106;159;143;124;62;18;55;34;170;152;4;149;28;59;20;60;94;66;47;148;9;199;140;183;95;130;99;22;185;179;172;52;166;194;113;26;103;114;137;127;89;163;165;187;146;97;141;77;82;21;8;104;138;182;139;168;195;145;15;3;70;13;132;169;188;6;147;178;10;133;122;63;135;38;1;117;31;54;90;51;121;118;74;134;11;33;160;29;0;109;35;111;81;153;129;180;176;86,4908155045455340059,0.001000
greedy_intra:nodes_start:greedy,111,48958,20724,28234,46092,6,111;35;109;0;29;160;33;11;134;74;118;90;51;121;112;73;54;31;193;117;198;156;1;16;27;38;135;63;100;40;107;72;122;133;10;178;147;6;188;169;132;13;70;3;15;145;195;168;139;182;138;104;8;82;21;177;5;45;142;175;78;36;61;91;141;77;97;146;187;165;127;89;103;137;114;113;194;166;172;179;185;22;99;130;86;95;183;140;152;170;34;55;18;62;124;106;176;163;153;81,7712125059890414564,0.002977
greedy_intra:nodes_start:greedy,112,53761,18845,34916,76315,6,112;19;151;54;31;164;73;136;45;5;177;21;104;138;182;139;168;195;145;15;3;70;161;13;132;169;188;6;134;11;49;33;160;29;0;109;35;111;144;8;82;58;77;81;153;163;176;86;95;130;185;179;166;194;113;103;89;127;165;187;146;97;141;91;61;36;78;175;142;162;80;190;193;117;198;156;24;1;16;27;38;92;102;63;96;32;135;122;133;10;178;115;147;71;191;90;51;125;131;121,8708570175630511937,0.002000
greedy_intra:nodes_start:greedy,113,47926,20742,27184,68775,7,176;194;166;179;172;57;66;94;47;148;60;20;59;28;149;4;199;9;99;22;185;86;95;130;183;140;152;170;34;55;18;62;128;124;106;143;35;109;0;29;160;33;11;134;74;118;90;51;121;117;1;38;63;135;122;133;10;178;147;6;188;169;132;13;70;3;15;145;195;168;139;182;138;104;8;111;82;21;177;5;45;142;78;175;36;61;91;141;77;81;153;187;163;89;127;137;114;103;113;180,3555902109824838210,0.003030
greedy_intra:nodes_start:greedy,114,47311,20256,27055,83423,9,113;194;166;179;172;57;66;94;47;148;60;20;59;28;149;4;199;9;99;22;185;86;95;130;183;140;152;170;34;55;18;62;128;124;106;143;35;109;0;29;160;33;11;134;74;118;51;90;121;54;31;117;1;38;63;135;122;133;10;178;147;6;188;169;132;13;70;3;15;145;195;168;139;182;138;104;8;111;82;21;177;5;45;142;175;78;36;61;91;141;77;81;153;187;163;89;127;103;180;176,2014508836914303107,0.002997
greedy_intra:nodes_start:greedy,115,52113,19347,32766,58934,7,178;147;192;6;188;169;132;161;70;3;15;145;13;195;168;43;11;29;109;0;35;111;81;153;163;176;106;124;62;18;86;185;179;166;194;113;103;89;127;165;187;97;77;141;91;61;36;78;175;142;45;5;177;21;82;8;104;144;160;33;138;182;139;134;85;74;118;98;51;116;121;112;19;151;54;73;164;31;193;117;198;156;1;16;27;38;131;125;191;90;135;102;63;100;40;107;72;122;133;10,2798336165943082721,0.002993
greedy_intra:nodes_start:greedy,116,53118,18908,34210,25525,2,116;158;25;182;138;33;160;144;104;8;82;21;177;5;45;142;175;78;36;61;91;141;77;97;187;165;127;89;103;113;194;166;179;185;130;95;86;176;163;153;81;111;0;35;109;29;11;139;43;168;195;145;15;3;70;13;132;169;188;6;134;74;118;98;51;125;90;191;71;147;115;178;10;133;122;72;17;107;40;100;63;102;135;38;27;16;1;156;198;117;193;31;164;73;54;151;19;112;131;121,4386084584123927527,0.000971
greedy_intra:nodes_start:greedy,117,51004,20252,30752,67364,7,117;54;31;164;73;136;45;5;177;21;104;138;182;139;168;195;145;15;3;70;161;13;132;169;188;6;192;147;178;10;133;122;72;107;40;100;63;102;135;131;125;90;191;120;51;121;118;74;134;11;49;33;160;29;109;35;0;144;111;8;82;58;77;81;153;163;176;106;124;62;18;55;140;183;95;86;185;179;166;194;113;103;89;127;165;187;146;97;141;91;61;36;78;175;142;162;80;190;193;198,5601559153867565195,0.003969
greedy_intra:nodes_start:greedy,118,50660,19797,30863,36827,7,118;98;51;125;191;90;122;133;10;72;107;40;100;63;102;135;38;27;16;1;156;198;117;193;31;164;73;54;151;19;112;131;121;116;158;25;182;138;33;160;144;104;8;82;21;177;5;45;142;78;175;36;61;91;141;77;97;187;165;127;89;103;113;194;166;86;185;95;183;140;18;62;124;106;176;163;153;81;111;0;35;109;29;11;139;43;168;195;145;15;3;70;13;132;169;188;6;147;134;74,6140656883251533636,0.002000
greedy_intra:nodes_start:greedy,119,51105,18447,32658,49526,5,119;159;143;35;0;29;109;111;41;81;153;186;163;103;89;127;114;137;165;187;146;97;77;141;91;61;36;78;175;142;45;5;177;21;87;82;8;104;56;144;160;33;138;182;11;139;168;195;43;134;6;188;169;132;13;145;15;70;3;189;155;184;170;152;4;149;28;59;20;60;94;66;47;148;9;199;140;183;95;130;99;22;185;179;172;52;166;194;113;180;176;86;128;83;34;55;18;62;124;106,6826688324959027671,0.002000
greedy_intra:nodes_start:greedy,120,52460,19419,33041,47194,7,120;51;98;118;74;134;6;188;169;132;13;70;3;15;145;195;168;43;139;11;29;109;35;0;111;81;153;163;176;106;124;62;86;185;179;166;194;113;103;89;127;165;187;97;77;141;91;61;36;78;175;142;45;5;177;21;82;8;104;144;160;33;138;182;25;158;116;121;131;112;19;151;54;73;164;31;193;117;198;156;1;16;27;38;135;102;63;100;40;107;17;72;122;133;10;178;90;191;147;71,5120708153155365183,0.001971
greedy_intra:nodes_start:greedy,121,50949,19683,31266,42518,5,121;116;158;25;182;138;33;160;144;104;8;82;21;177;5;45;142;175;78;36;61;91;141;77;97;187;165;127;89;103;113;194;166;179;185;86;95;55;18;62;124;106;176;163;153;81;111;35;0;109;29;11;139;43;168;195;145;15;3;70;13;132;169;188;6;147;134;74;118;98;51;125;191;90;122;133;10;72;107;40;100;63;102;135;38;27;16;1;156;198;117;193;31;164;73;54;151;19;112;131,3013459921054024270,0.002001
greedy_intra:nodes_start:greedy,122,51667,18843,32824,83377,10,122;90;191;125;131;38;27;16;1;156;198;117;193;31;164;73;54;151;19;112;121;116;51;98;118;74;85;134;139;182;138;33;160;144;104;8;82;21;177;5;45;142;175;78;36;61;91;141;77;97;187;165;127;89;103;113;194;166;86;185;95;18;62;124;106;176;163;153;81;111;35;109;0;29;11;43;168;195;13;145;15;3;70;161;132;169;188;6;192;147;178;10;133;72;107;40;100;63;102;135,7421833599258899243,0.004000
greedy_intra:nodes_start:greedy,123,52299,19546,32753,50299,7,177;5;45;142;175;78;36;61;91;141;97;146;187;165;127;89;103;113;194;166;86;185;130;95;18;62;124;106;176;163;153;81;77;58;82;8;111;144;0;35;109;29;160;33;49;11;134;74;118;121;51;120;191;90;125;131;112;19;151;54;73;31;193;117;198;156;1;16;27;38;135;63;100;40;107;72;122;133;10;178;147;192;6;188;169;132;13;161;70;3;15;145;195;168;139;182;138;104;21;87,1907491963461170276,0.003518
greedy_intra:nodes_start:greedy,124,46840,20375,26465,131392,16,143;124;62;18;55;34;35;109;0;29;160;33;11;134;74;118;51;90;121;73;54;31;193;117;198;1;38;63;135;122;133;10;178;147;6;188;169;132;13;70;3;15;145;195;168;139;182;138;104;144;111;8;82;21;177;5;45;142;175;78;36;61;91;141;77;81;153;187;163;89;127;137;114;103;26;113;176;194;166;172;179;185;130;99;66;94;47;148;60;20;59;28;149;4;140;183;95;86;128;106,4316917628771201500,0.007003
greedy_intra:nodes_start:greedy,125,51815,18958,32857,33059,6,125;122;133;10;72;107;40;100;63;102;135;38;27;16;1;156;198;117;193;31;164;73;54;151;19;112;131;121;116;51;98;118;74;85;134;139;182;138;33;160;144;104;8;82;21;177;5;45;142;78;175;36;61;91;141;77;97;187;165;127;89;103;113;194;166;86;185;95;18;62;124;106;176;163;153;81;111;0;35;109;29;11;43;168;195;13;145;15;3;70;161;132;169;188;6;192;147;71;191;90,9140507106043279742,0.002004
greedy_intra:nodes_start:greedy,126,49071,20457,28614,37243,4,126;195;168;29;109;35;0;111;81;153;163;176;106;124;62;18;55;34;170;152;140;183;130;95;86;99;185;179;166;194;113;103;89;127;165;187;146;97;77;141;91;61;36;175;78;142;45;5;177;21;82;8;104;144;160;33;138;182;11;139;43;134;74;118;121;51;191;90;131;54;73;31;193;117;198;156;1;16;27;38;135;63;100;40;107;72;122;133;10;178;147;6;188;169;132;70;3;15;145;13,2689339753023421561,0.002001
greedy_intra:nodes_start:greedy,127,50786,21064,29722,80875,9,127;137;114;103;26;113;194;166;52;172;179;185;22;99;130;86;95;183;140;199;9;148;47;66;94;60;20;59;28;149;4;152;170;34;55;18;62;128;124;143;159;106;176;88;180;129;153;81;111;35;109;0;29;160;33;11;134;74;118;51;90;121;54;31;117;1;38;135;63;122;133;10;178;147;6;188;169;132;13;70;3;15;145;195;168;139;182;138;104;8;21;36;141;77;97;146;187;165;163;89,8654629777715411214,0.004000
greedy_intra:nodes_start:greedy,128,51001,21140,29861,33930,4,128;88;176;180;129;153;81;111;35;109;0;29;160;33;11;134;74;118;121;51;90;54;31;117;1;38;63;135;122;133;10;178;147;6;188;169;132;13;70;3;15;145;195;168;139;182;138;104;8;21;82;77;141;97;146;187;165;163;89;127;137;114;103;26;113;194;166;86;185;179;172;57;66;94;47;148;60;20;59;28;149;4;199;9;99;22;130;95;183;140;152;170;34;55;18;62;124;143;159;106,6289151382559869682,0.001000
greedy_intra:nodes_start:greedy,129,50219,20726,29493,75725,7,129;153;81;111;35;109;0;29;160;33;11;134;74;118;51;90;121;54;31;193;117;1;38;135;63;122;133;10;178;147;6;188;169;132;13;70;3;15;145;195;168;139;182;138;104;8;21;82;77;141;97;146;187;165;163;89;127;137;114;103;26;113;194;166;52;172;179;185;22;99;130;95;183;140;199;9;148;47;66;94;60;20;59;28;149;4;152;170;34;55;18;62;124;143;159;106;128;86;176;180,8430284804905513277,0.002994
greedy_intra:nodes_start:greedy,130,47249,20446,26803,87572,9,130;95;183;140;152;170;34;55;18;62;128;124;106;143;35;109;0;29;160;33;11;134;74;118;51;90;121;31;117;1;38;63;135;122;133;10;178;147;6;188;169;132;13;70;3;15;145;195;168;139;182;138;104;8;111;82;21;177;5;45;142;175;78;36;61;91;141;77;81;153;187;163;89;127;137;114;103;113;180;176;194;166;86;185;179;172;57;66;94;47;148;60;20;59;28;149;4;199;9;99,7355585354297965237,0.004000
greedy_intra:nodes_start:greedy,131,50652,19789,30863,41173,8,131;112;19;151;54;73;164;31;193;117;198;156;1;16;27;38;135;102;63;100;40;107;72;10;133;122;90;191;125;51;98;118;74;134;147;6;188;169;132;13;70;3;15;145;195;168;43;139;11;29;109;35;0;111;81;153;163;176;106;124;62;18;140;183;95;185;86;166;194;113;103;89;127;165;187;97;77;141;91;61;36;78;175;142;45;5;177;21;82;8;104;144;160;33;138;182;25;158;116;121,6483648872584785119,0.003001
greedy_intra:nodes_start:greedy,132,48889,20411,28478,76756,7,132;13;70;3;15;145;195;168;29;0;109;35;111;81;153;163;176;106;124;62;18;55;34;170;152;140;183;95;86;130;99;22;185;179;166;194;113;103;89;127;165;187;146;97;77;141;91;61;36;78;175;142;45;5;177;21;82;8;104;144;160;33;138;182;11;139;43;134;74;118;121;51;191;90;131;54;73;31;193;117;198;156;1;16;27;38;135;63;100;40;107;72;122;133;10;178;147;6;188;169,8292171075407736171,0.003000
greedy_intra:nodes_start:greedy,133,53088,18878,34210,52017,4,133;10;178;115;147;71;191;90;125;51;98;118;74;134;6;188;169;132;13;70;3;15;145;195;168;43;139;11;29;0;109;35;111;81;153;163;176;86;95;130;185;179;166;194;113;103;89;127;165;187;97;77;141;91;61;36;78;175;142;45;5;177;21;82;8;104;144;160;33;138;182;25;158;116;121;131;112;19;151;54;73;164;31;193;117;198;156;1;16;27;38;135;102;63;100;40;107;17;72;122,8873317053858372876,0.001000
greedy_intra:nodes_start:greedy,134,48756,20335,28421,103701,10,134;74;118;121;51;191;90;131;54;73;31;193;117;198;156;1;16;27;38;135;63;100;40;107;72;122;133;10;178;147;6;188;169;132;70;3;15;145;13;195;168;29;0;109;35;111;81;153;163;176;106;124;62;18;55;34;170;152;140;183;95;130;99;185;86;179;172;166;194;113;103;89;127;165;187;146;97;77;141;91;61;36;78;175;142;45;5;177;21;82;8;104;144;160;33;138;182;11;139;43,2869631444274453381,0.004971
greedy_intra:nodes_start:greedy,135,51682,18858,32824,57571,9,135;122;90;191;125;131;38;27;16;1;156;198;117;193;31;164;73;54;151;19;112;121;116;51;98;118;74;85;134;139;182;138;33;160;144;104;8;82;21;177;5;45;142;175;78;36;61;91;141;77;97;187;165;127;89;103;113;194;166;86;185;95;18;62;124;106;176;163;153;81;111;35;0;109;29;11;43;168;195;13;145;15;3;70;161;132;169;188;6;192;147;178;10;133;72;107;40;100;63;102,6706134832850988583,0.004001
greedy_intra:nodes_start:greedy,136,51474,20536,30938,32232,3,136;45;5;177;21;104;138;182;139;168;195;145;15;3;70;161;13;132;169;188;6;192;147;178;10;133;122;72;107;40;100;63;102;135;131;125;90;191;120;51;121;118;74;134;11;49;33;160;29;109;35;0;144;111;8;82;58;77;81;153;163;176;106;124;62;18;140;183;95;86;130;185;179;166;194;113;103;89;127;165;187;146;97;141;91;61;36;142;78;175;162;80;190;193;198;117;54;31;164;73,7681820660450493305,0.001926
greedy_intra:nodes_start:greedy,137,50280,20633,29647,131511,15,137;114;88;194;166;179;172;57;66;94;47;148;60;20;59;28;149;4;199;9;99;22;185;86;95;130;183;140;152;170;34;55;18;62;128;124;143;159;106;176;180;113;26;103;163;186;153;81;111;35;109;0;29;160;33;11;134;74;118;51;90;121;54;31;117;1;38;63;135;122;133;10;178;147;6;188;169;132;13;70;3;15;145;195;168;139;182;138;104;8;21;36;141;77;97;146;187;165;89;127,2112216725046535223,0.006047
greedy_intra:nodes_start:greedy,138,51409,18532,32877,64161,6,138;182;11;139;134;43;168;195;13;132;169;6;188;161;70;3;15;145;155;189;69;29;109;35;0;111;41;81;153;186;163;180;88;176;106;159;143;124;128;62;18;55;34;170;152;4;149;28;59;20;60;94;66;47;148;9;199;140;183;130;95;86;185;22;99;179;172;52;166;194;113;114;137;103;89;127;165;187;146;97;77;141;91;61;36;78;175;142;45;5;177;21;87;82;8;104;56;144;160;33,6334936153879711058,0.002104
greedy_intra:nodes_start:greedy,139,51483,18241,33242,95098,9,139;11;43;168;195;13;132;169;6;188;161;70;3;15;145;155;189;69;29;0;109;35;111;41;81;153;186;163;180;88;176;106;159;143;124;128;62;18;55;34;170;152;4;149;28;59;20;60;94;66;47;148;9;199;140;183;130;95;86;185;22;99;179;172;52;166;194;113;114;137;103;89;127;165;187;146;97;77;141;91;79;61;36;78;175;142;45;5;177;21;87;82;8;104;56;144;160;33;138;182,3994193541154953940,0.005002
greedy_intra:nodes_start:greedy,140,47726,20783,26943,66859,6,140;152;170;34;55;18;62;128;124;106;143;35;109;0;29;160;33;11;134;74;118;121;51;90;131;117;1;38;63;135;122;133;10;178;147;6;188;169;132;13;70;3;15;145;195;168;139;182;138;104;8;111;82;21;177;5;45;142;175;78;36;61;91;141;77;81;153;187;163;89;127;137;114;103;113;180;176;194;166;86;185;179;172;57;66;94;47;148;60;20;59;28;149;4;199;9;99;130;95;183,768453475601505080,0.002000
greedy_intra:nodes_start:greedy,141,50616,20830,29786,117043,12,77;97;146;187;165;127;89;103;137;114;26;113;194;166;52;172;179;22;99;185;86;95;130;183;140;199;9;148;47;66;94;60;20;59;28;149;4;152;170;34;55;18;62;128;124;143;159;106;176;88;180;163;186;153;81;111;35;109;0;29;160;33;11;134;74;118;51;90;121;54;31;117;1;38;63;135;122;133;10;178;147;6;188;169;132;13;70;3;15;145;195;168;139;182;138;104;8;21;36;141,740098899523753162,0.004990
greedy_intra:nodes_start:greedy,142,51589,19932,31657,48128,7,142;45;5;177;21;104;138;182;139;168;195;145;15;3;70;161;13;132;169;188;6;192;147;178;10;133;122;72;107;40;100;63;135;38;27;16;1;156;198;117;193;31;73;54;151;19;112;131;125;90;191;120;51;121;118;74;134;11;49;33;160;29;109;35;0;111;144;8;82;58;77;81;153;163;176;106;124;62;18;140;183;95;185;86;166;194;113;103;89;127;165;187;146;97;141;91;61;36;78;175,8287557932274597964,0.002000
greedy_intra:nodes_start:greedy,143,50771,18179,32592,56594,6,143;35;109;29;0;111;41;81;153;186;163;103;89;127;114;137;165;187;146;97;77;141;91;79;61;36;175;78;142;45;5;177;21;87;82;8;104;56;144;160;33;138;182;11;139;195;168;43;134;6;188;169;132;13;145;15;70;3;189;155;184;170;152;4;149;28;59;20;60;94;66;47;148;9;199;140;183;95;130;99;22;185;179;172;52;166;194;113;180;176;86;128;83;18;55;34;62;124;106;159,2784002883986773489,0.003488
greedy_intra:nodes_start:greedy,144,48884,20670,28214,119207,12,144;0;35;109;29;160;33;11;134;74;118;51;90;121;112;73;54;31;193;117;198;156;1;16;27;38;135;63;40;107;122;133;10;178;147;6;188;169;132;13;70;3;15;145;195;168;139;182;138;104;8;82;21;177;5;45;142;175;78;36;61;91;141;77;97;146;187;165;127;89;103;137;114;113;194;166;172;179;22;99;185;86;95;130;183;140;152;170;34;55;18;62;124;106;176;163;153;81;41;111,9011794611219347822,0.005995
greedy_intra:nodes_start:greedy,145,50075,17564,32511,24387,1,145;195;168;126;13;132;169;6;188;161;70;3;155;184;170;152;140;183;95;130;22;99;9;199;4;149;28;59;20;60;148;47;94;66;57;172;52;179;185;86;166;194;113;176;180;26;103;114;137;127;89;163;165;187;146;153;81;77;97;141;91;79;61;36;78;175;142;45;5;177;21;87;82;111;144;56;8;104;138;182;139;11;49;33;160;29;0;109;35;143;159;106;124;128;62;18;55;34;189;15,4254760012905823464,0.000998
greedy_intra:nodes_start:greedy,146,50753,20967,29786,81678,10,146;187;165;127;89;103;137;114;26;113;194;166;52;172;179;185;22;99;130;86;95;183;140;199;9;148;47;66;94;60;20;59;28;149;4;152;170;34;55;18;62;128;124;143;159;106;176;88;180;163;186;153;81;111;35;109;0;29;160;33;11;134;74;118;51;90;121;54;31;117;1;38;63;135;122;133;10;178;147;6;188;169;132;13;70;3;15;145;195;168;139;182;138;104;8;21;36;141;77;97,6148858415790591698,0.004007
greedy_intra:nodes_start:greedy,147,51055,19135,31920,64793,10,147;192;6;188;169;132;161;70;3;15;145;13;195;168;43;11;29;109;0;35;111;81;153;163;176;106;124;62;18;55;95;86;185;179;166;194;113;103;89;127;165;187;97;77;141;91;61;36;78;175;142;45;5;177;21;82;8;104;144;160;33;138;182;139;134;85;74;118;98;51;131;121;112;19;54;73;164;31;193;117;198;156;1;16;27;38;135;102;63;100;40;107;72;122;133;10;178;90;191;71,8715645028287524105,0.004033
greedy_intra:nodes_start:greedy,148,46503,20380,26123,89394,10,148;47;66;94;60;20;59;28;149;4;140;183;152;170;34;55;18;62;128;124;106;143;35;109;0;29;160;33;11;134;74;118;90;51;121;73;54;31;193;117;1;38;63;135;122;133;10;178;147;6;188;169;132;13;70;3;15;145;195;168;139;182;138;104;8;111;82;21;177;5;45;142;78;175;36;61;91;141;77;81;153;187;163;89;127;137;114;103;113;180;176;194;166;86;95;130;185;179;22;99,4904095244198643106,0.002999
greedy_intra:nodes_start:greedy,149,46806,20337,26469,69616,7,149;4;140;183;152;170;34;55;18;62;128;124;106;143;35;109;0;29;160;33;11;134;74;118;51;90;121;54;31;117;1;38;135;63;122;133;10;178;147;6;188;169;132;13;70;3;15;145;195;168;139;182;138;104;8;111;82;21;177;5;45;142;78;175;36;61;91;141;77;81;153;187;163;89;127;137;114;103;113;176;180;194;166;86;99;130;95;22;185;179;172;57;66;94;47;148;60;20;59;28,8722280739684219,0.002968
greedy_intra:nodes_start:greedy,150,50469,19096,31373,140224,18,6;188;169;132;13;161;70;3;15;145;195;168;139;11;49;29;0;109;35;111;41;81;153;186;163;180;88;176;106;159;143;124;128;62;18;55;34;170;152;4;149;28;59;20;60;94;66;47;148;9;199;140;183;130;95;86;185;99;22;179;172;52;166;194;113;114;137;103;89;127;165;187;146;97;77;141;91;61;36;78;175;142;45;5;177;21;87;82;8;104;56;144;160;33;138;25;121;51;90;147,8430673912800169416,0.005992
greedy_intra:nodes_start:greedy,151,51502,18452,33050,61004,8,151;54;73;164;31;193;117;198;156;1;16;27;38;102;63;96;32;135;122;133;10;178;115;147;71;191;90;125;51;98;118;74;134;6;188;169;132;13;70;3;15;145;195;168;43;139;11;29;0;109;35;111;81;153;163;176;106;124;62;18;55;95;86;185;179;166;194;113;103;89;127;165;187;97;77;141;91;61;36;78;175;142;45;5;177;21;82;8;104;144;160;33;138;182;25;158;116;121;112;19,1140939182759975642,0.002858
greedy_intra:nodes_start:greedy,152,47249,20446,26803,103971,10,152;170;34;55;18;62;128;124;106;143;35;109;0;29;160;33;11;134;74;118;51;90;121;31;117;1;38;63;135;122;133;10;178;147;6;188;169;132;13;70;3;15;145;195;168;139;182;138;104;8;111;82;21;177;5;45;142;175;78;36;61;91;141;77;81;153;187;163;89;127;137;114;103;113;180;176;194;166;86;185;179;172;57;66;94;47;148;60;20;59;28;149;4;199;9;99;130;95;183;140,1682379292473004547,0.003993
greedy_intra:nodes_start:greedy,153,50920,21134,29786,83104,10,153;81;111;35;109;0;29;160;33;11;134;74;118;90;51;121;54;31;117;1;38;63;135;122;133;10;178;147;6;188;169;132;13;70;3;15;145;195;168;139;182;138;104;8;21;36;141;77;97;146;187;165;127;89;103;137;114;26;113;194;166;52;172;179;185;22;99;130;86;95;183;140;199;9;148;47;66;94;60;20;59;28;149;4;152;170;34;55;18;62;128;124;143;159;106;176;88;180;163;186,4830482593929097525,0.004509
greedy_intra:nodes_start:greedy,154,47179,20227,26952,114024,14,154;47;148;60;20;59;28;149;4;140;183;152;170;34;55;18;62;128;124;106;143;35;109;0;29;160;33;11;134;74;118;90;51;121;31;117;1;38;63;135;122;133;10;178;147;6;188;169;132;13;70;3;15;145;195;168;139;182;138;104;8;111;82;21;177;5;45;142;175;78;36;61;91;141;77;81;153;187;163;89;127;137;114;103;180;176;113;194;166;86;185;130;95;99;22;179;172;57;66;94,8249022811919282143,0.006994
greedy_intra:nodes_start:greedy,155,50083,17572,32511,12506,0,155;184;170;152;140;183;95;130;22;99;9;199;4;149;28;59;20;60;148;47;94;66;57;172;52;179;185;86;166;194;113;176;180;26;103;114;137;127;89;163;165;187;146;153;81;77;97;141;91;79;61;36;175;78;142;45;5;177;21;87;82;111;144;56;8;104;138;182;139;11;49;33;160;29;0;109;35;143;159;106;124;128;62;18;55;34;189;15;145;195;168;126;13;132;169;6;188;161;70;3,1066738187986451750,0.000995
greedy_intra:nodes_start:greedy,156,51309,18594,32715,47928,9,156;198;117;193;31;164;73;54;151;19;112;121;116;158;25;182;138;33;160;144;104;8;82;21;177;5;45;142;175;78;36;61;91;141;77;97;187;165;127;89;103;113;194;166;86;185;95;183;140;18;62;124;106;176;163;153;81;111;0;35;109;29;11;139;43;168;195;145;15;3;70;13;132;169;188;6;134;74;118;98;51;125;90;191;71;147;115;178;10;133;122;135;32;102;63;92;38;27;16;1,5397816824867969483,0.002995
greedy_intra:nodes_start:greedy,157,49593,21144,28449,51499,6,56;138;182;139;168;195;145;15;3;70;13;132;169;188;6;147;178;10;133;107;40;63;135;38;27;16;1;156;198;117;193;31;73;54;131;90;51;121;118;74;134;11;33;160;29;109;35;0;144;111;41;81;153;163;176;106;124;62;18;55;34;170;152;140;183;95;86;130;99;22;185;179;172;166;194;113;114;137;103;89;127;165;187;146;97;77;141;91;61;36;175;78;142;45;5;177;21;82;8;104,6914540109923248617,0.001998
greedy_intra:nodes_start:greedy,158,48676,19633,29043,82673,11,158;25;182;138;33;160;144;104;8;82;21;177;5;45;142;78;175;36;61;91;141;77;97;187;165;127;89;103;113;194;166;86;185;99;130;95;183;140;152;170;34;55;18;62;124;106;176;163;153;81;111;35;0;109;29;11;139;43;168;195;145;15;3;70;13;132;169;188;6;147;134;74;118;98;51;191;90;122;133;10;107;40;100;63;102;135;38;27;16;1;156;198;117;193;31;54;73;19;112;121,5847755402289881086,0.004149
greedy_intra:nodes_start:greedy,159,50773,18181,32592,59660,7,159;143;35;109;0;29;111;41;81;153;186;163;103;89;127;114;137;165;187;146;97;77;141;91;79;61;36;78;175;142;45;5;177;21;87;82;8;104;56;144;160;33;138;182;11;139;43;168;195;134;6;188;169;132;13;145;15;70;3;189;155;184;170;152;4;149;28;59;20;60;94;66;47;148;9;199;140;183;95;130;99;22;185;179;172;52;166;194;113;180;176;86;128;83;55;34;18;62;124;106,3674881345357990577,0.003022
greedy_intra:nodes_start:greedy,160,51530,18653,32877,36402,3,160;144;56;104;8;82;87;21;177;5;45;142;78;175;36;61;91;141;77;97;146;187;165;127;89;103;137;114;113;194;166;52;172;179;185;22;99;130;86;95;183;140;199;9;148;47;66;94;60;20;59;28;149;4;152;170;34;55;18;62;128;124;143;159;106;88;176;180;163;186;153;81;41;111;0;35;109;29;69;189;155;145;15;3;70;161;188;6;169;132;13;195;168;43;134;139;11;182;138;33,5127526835206078243,0.001971
greedy_intra:nodes_start:greedy,161,50075,17564,32511,17700,1,161;188;6;169;132;13;126;168;195;145;15;189;34;55;18;62;128;124;106;159;143;35;109;0;29;160;33;49;11;139;182;138;104;8;56;144;111;82;87;21;177;5;45;142;175;78;36;61;79;91;141;97;77;81;153;146;187;165;163;89;127;137;114;103;26;180;176;113;194;166;86;185;179;52;172;57;66;94;47;148;60;20;59;28;149;4;199;9;99;22;130;95;183;140;152;170;184;155;3;70,1958543994545310838,0.002003
greedy_intra:nodes_start:greedy,162,50885,19863,31022,58642,6,162;80;190;193;198;117;54;31;164;73;136;45;5;177;21;104;138;182;139;168;195;145;15;3;70;161;13;132;169;188;6;192;147;178;10;133;122;72;107;40;100;63;102;135;131;125;90;191;120;51;121;118;74;134;11;49;33;160;29;0;109;35;111;144;8;82;58;77;81;153;163;176;106;124;62;18;55;183;140;95;130;185;86;166;194;113;103;89;127;165;187;146;97;141;91;61;36;142;78;175,8847439615142366896,0.003030
greedy_intra:nodes_start:greedy,163,50704,20982,29722,104073,11,163;89;127;137;114;103;26;113;194;166;52;172;179;185;22;99;130;86;95;183;140;199;9;148;47;66;94;60;20;59;28;149;4;152;170;34;55;18;62;128;124;143;159;106;176;88;180;129;153;81;111;35;109;0;29;160;33;11;134;74;118;51;90;121;54;31;117;1;38;63;135;122;133;10;178;147;6;188;169;132;13;70;3;15;145;195;168;139;182;138;104;8;21;36;141;77;97;146;187;165,589130235516660853,0.005000
greedy_intra:nodes_start:greedy,164,50868,19846,31022,75967,8,164;73;136;45;5;177;21;104;138;182;139;168;195;145;15;3;70;161;13;132;169;188;6;192;147;178;10;133;122;72;107;40;100;63;102;135;131;125;90;191;120;51;121;118;74;134;11;49;33;160;29;109;35;0;111;144;8;82;58;77;81;153;163;176;106;124;62;18;55;140;183;95;130;185;86;166;194;113;103;89;127;165;187;146;97;141;91;61;36;78;175;142;162;80;190;193;198;117;54;31,3954726320479138633,0.003001
greedy_intra:nodes_start:greedy,165,51500,21436,30064,46340,5,165;187;146;97;141;77;82;21;8;104;138;182;139;168;195;145;15;3;70;13;132;169;188;6;147;178;10;133;122;63;135;38;1;117;31;54;90;51;121;118;74;134;11;33;160;29;0;109;35;111;81;153;186;163;180;88;176;106;159;143;124;128;62;18;55;34;170;152;4;149;28;59;20;60;94;66;47;148;9;199;140;183;95;86;130;99;22;185;179;172;52;166;194;113;26;114;137;103;89;127,2963415333095690513,0.003003
greedy_intra:nodes_start:greedy,166,48113,20605,27508,44435,4,166;194;113;176;180;103;114;137;127;89;163;187;153;81;77;141;91;61;36;78;175;142;45;5;177;21;82;111;8;104;138;182;139;168;195;145;15;3;70;13;132;169;188;6;147;178;10;133;122;135;63;38;1;131;90;51;121;118;74;134;11;33;160;29;0;109;35;143;106;124;128;62;18;55;34;170;152;140;183;130;95;86;185;22;99;9;199;4;149;28;59;20;60;148;47;94;66;57;172;179,5108367274554663186,0.002000
greedy_intra:nodes_start:greedy,167,51510,18547,32963,96880,11,167;189;69;109;35;0;29;111;41;81;153;186;163;180;88;176;106;159;143;124;128;62;18;55;34;170;152;4;149;28;59;20;60;94;66;47;148;9;199;140;183;130;95;86;185;99;22;179;172;166;194;113;114;137;103;89;127;165;187;146;97;77;141;91;61;36;78;175;142;45;5;177;21;87;82;8;104;56;144;160;33;138;182;11;139;168;195;43;134;6;188;169;132;13;145;15;70;3;155;184,5785108591306552725,0.004986
greedy_intra:nodes_start:greedy,168,48953,20475,28478,44550,4,168;195;145;15;3;70;13;132;169;188;6;147;178;10;133;122;72;107;40;100;63;135;38;27;16;1;156;198;117;193;31;73;54;131;90;191;51;121;118;74;134;43;139;11;182;138;33;160;144;104;8;82;21;177;5;45;142;78;175;36;61;91;141;77;97;146;187;165;127;89;103;113;194;166;179;185;22;99;86;95;130;183;140;152;170;34;55;18;62;124;106;176;163;153;81;111;0;35;109;29,783547788718280592,0.002996
greedy_intra:nodes_start:greedy,169,48650,20172,28478,87476,9,169;132;13;70;3;15;145;195;168;29;0;109;35;111;81;153;163;176;106;124;62;18;55;34;170;152;140;183;95;130;22;99;179;185;86;166;194;113;103;89;127;165;187;146;97;77;141;91;61;36;78;175;142;45;5;177;21;82;8;104;144;160;33;138;182;11;139;43;134;74;118;121;51;191;90;131;73;54;31;193;117;198;156;1;16;27;38;135;63;100;40;107;72;122;133;10;178;147;6;188,4183705999754508578,0.003966
greedy_intra:nodes_start:greedy,170,47734,20791,26943,50293,5,170;34;55;18;62;128;124;106;143;35;109;0;29;160;33;11;134;74;118;121;51;90;131;117;1;38;63;135;122;133;10;178;147;6;188;169;132;13;70;3;15;145;195;168;139;182;138;104;8;111;82;21;177;5;45;142;78;175;36;61;91;141;77;81;153;187;163;89;127;137;114;103;113;180;176;194;166;86;185;179;172;57;66;94;47;148;60;20;59;28;149;4;199;9;99;130;95;183;140;152,2282062561212683248,0.001995
greedy_intra:nodes_start:greedy,171,51999,19243,32756,97700,10,123;25;182;138;11;139;134;43;168;195;13;132;169;6;188;161;70;3;15;145;155;189;69;0;35;109;29;160;33;144;56;104;8;111;82;87;21;58;77;81;153;186;163;180;88;176;106;143;124;128;62;18;55;34;170;152;4;149;28;59;20;60;94;66;47;148;9;199;140;183;95;86;130;99;22;185;179;172;166;194;113;114;137;103;89;127;165;187;146;97;141;91;61;36;78;175;142;45;5;177,2873981714873588066,0.004001
greedy_intra:nodes_start:greedy,172,47397,20626,26771,76258,8,172;166;194;180;176;113;103;114;137;127;89;163;187;153;81;77;141;91;61;36;78;175;142;45;5;177;21;82;111;8;104;138;182;139;168;195;145;15;3;70;13;132;169;188;6;147;178;10;133;122;135;63;38;1;117;31;121;90;51;118;74;134;11;33;160;29;0;109;35;143;106;124;128;62;18;55;34;170;152;140;183;130;95;86;185;22;99;9;199;4;149;28;59;20;60;148;47;94;66;179,705793211180200127,0.003000
greedy_intra:nodes_start:greedy,173,51756,19452,32304,75040,10,173;73;164;193;31;54;117;198;156;24;1;16;27;38;63;135;122;133;10;178;147;71;51;191;90;125;131;121;112;158;25;177;21;104;138;182;139;168;195;145;15;3;70;161;13;132;169;188;6;134;11;49;33;160;29;109;35;0;144;111;8;82;58;77;81;153;163;176;106;124;62;18;95;130;185;86;166;194;113;103;89;127;165;187;146;97;141;91;61;36;7;5;45;142;78;175;162;80;190;136,939285420217119481,0.003557
greedy_intra:nodes_start:greedy,174,48814,21227,27587,80182,8,83;18;62;128;124;143;106;86;95;130;99;22;185;179;172;166;194;176;113;26;103;114;137;127;89;163;187;153;81;77;141;91;61;36;78;175;142;45;5;177;21;82;8;111;144;104;138;182;139;168;195;145;15;3;70;13;132;169;188;6;147;178;10;133;122;107;40;63;135;38;27;16;1;156;198;117;193;31;54;73;131;90;51;121;118;74;134;11;33;160;29;0;35;109;34;55;170;152;140;183,8202833239623792046,0.003000
greedy_intra:nodes_start:greedy,175,51901,19841,32060,41795,5,175;78;36;61;91;141;97;146;187;165;127;89;103;113;194;166;179;185;86;95;55;18;62;124;106;176;163;153;81;77;58;82;8;144;111;0;35;109;29;160;33;49;11;134;74;118;121;51;120;191;90;125;131;112;19;151;54;73;31;193;117;198;156;1;16;27;38;135;63;100;40;107;72;122;133;10;178;147;192;6;188;169;132;13;161;70;3;15;145;195;168;139;182;138;104;21;177;5;45;142,5546560469147349359,0.001002
greedy_intra:nodes_start:greedy,176,47954,20770,27184,66919,6,176;113;103;114;137;127;89;163;187;153;81;77;141;91;61;36;175;78;142;45;5;177;21;82;111;8;104;138;182;139;168;195;145;15;3;70;13;132;169;188;6;147;178;10;133;122;135;63;38;1;117;121;51;90;118;74;134;11;33;160;29;0;109;35;143;106;124;128;62;18;55;34;170;152;140;183;130;95;86;185;22;99;9;199;4;149;28;59;20;60;148;47;94;66;57;172;179;166;194;180,1884593054661185991,0.002721
greedy_intra:nodes_start:greedy,177,51871,19811,32060,58589,6,177;21;104;138;182;139;168;195;145;15;3;70;161;13;132;169;188;6;192;147;178;10;133;122;72;107;40;100;63;135;38;27;16;1;156;198;117;193;31;73;54;151;19;112;131;125;90;191;120;51;121;118;74;134;11;49;33;160;29;0;109;35;111;144;8;82;58;77;81;153;163;176;106;124;62;18;55;95;86;185;179;166;194;113;103;89;127;165;187;146;97;141;91;61;36;78;175;142;45;5,3818856993922421189,0.003641
greedy_intra:nodes_start:greedy,178,53088,18878,34210,47974,4,178;10;133;122;72;17;107;40;100;63;102;135;38;27;16;1;156;198;117;193;31;164;73;54;151;19;112;131;121;116;158;25;182;138;33;160;144;104;8;82;21;177;5;45;142;175;78;36;61;91;141;77;97;187;165;127;89;103;113;194;166;179;185;130;95;86;176;163;153;81;111;35;109;0;29;11;139;43;168;195;145;15;3;70;13;132;169;188;6;134;74;118;98;51;125;90;191;71;147;115,4101527946670992349,0.003036
greedy_intra:nodes_start:greedy,179,47779,20595,27184,73010,8,179;166;194;180;176;113;103;114;137;127;89;163;187;153;81;77;141;91;61;36;78;175;142;45;5;177;21;82;111;8;104;138;182;139;168;195;145;15;3;70;13;132;169;188;6;147;178;10;133;122;135;63;38;1;117;121;90;51;118;74;134;11;33;160;29;0;109;35;143;106;124;128;62;18;55;34;170;152;140;183;130;95;86;185;22;99;9;199;4;149;28;59;20;60;148;47;94;66;57;172,7890688488275893728,0.003029
greedy_intra:nodes_start:greedy,180,47966,20483,27483,72202,6,180;176;194;166;179;172;57;66;94;47;148;60;20;59;28;149;4;199;9;99;22;185;86;95;130;183;140;152;170;34;55;18;62;128;124;106;143;35;109;0;29;160;33;11;134;74;118;51;90;121;117;1;135;63;122;133;10;178;147;6;188;169;132;13;70;3;15;145;195;168;139;182;138;104;8;111;82;21;177;5;45;142;175;78;36;61;91;141;77;81;153;187;163;89;127;137;114;103;26;113,2435360941086138301,0.002998
greedy_intra:nodes_start:greedy,181,48316,20638,27678,37756,5,174;183;140;152;170;34;55;18;62;128;124;106;143;35;109;0;29;160;33;11;134;74;118;121;51;90;131;1;38;135;63;122;133;10;178;147;6;188;169;132;13;70;3;15;145;195;168;139;182;138;104;8;111;82;21;177;5;45;142;175;78;36;61;91;141;77;81;153;187;163;89;127;137;114;103;180;176;113;194;166;86;185;179;172;57;66;94;47;148;60;20;59;28;149;4;199;9;99;130;95,6400673684844872170,0.002539
greedy_intra:nodes_start:greedy,182,51506,18264,33242,67474,7,182;11;139;43;168;195;13;132;169;6;188;161;70;3;15;145;155;189;69;29;109;0;35;111;41;81;153;186;163;180;88;176;106;159;143;124;128;62;18;55;34;170;152;4;149;28;59;20;60;94;66;47;148;9;199;140;183;95;86;130;99;22;185;179;172;52;166;194;113;114;137;103;89;127;165;187;146;97;77;141;91;79;61;36;78;175;142;45;5;177;21;87;82;8;104;56;144;160;33;138,5625549594559084325,0.004000
greedy_intra:nodes_start:greedy,183,47836,20893,26943,42179,4,183;95;130;99;9;199;4;149;28;59;20;60;148;47;94;66;57;172;179;185;86;166;194;180;176;113;103;114;137;127;89;163;187;153;81;77;141;91;61;36;78;175;142;45;5;177;21;82;111;8;104;138;182;139;168;195;145;15;3;70;13;132;169;188;6;147;178;10;133;122;63;135;38;1;117;131;90;51;121;118;74;134;11;33;160;29;0;109;35;143;106;124;128;62;18;55;34;170;152;140,610912403207608221,0.000995
greedy_intra:nodes_start:greedy,184,47426,21105,26321,122405,13,184;170;152;140;183;95;130;99;9;199;28;20;60;148;47;94;66;57;172;179;185;86;166;194;176;113;103;127;89;163;187;153;81;77;141;91;61;36;78;175;142;45;5;177;21;82;111;8;104;138;182;139;11;33;160;29;0;109;35;143;106;124;128;62;18;55;34;189;195;168;43;134;74;118;90;51;121;54;193;31;117;1;38;63;135;122;133;10;178;147;6;188;169;132;13;145;15;70;3;155,6076002729982249989,0.005000
greedy_intra:nodes_start:greedy,185,47179,20408,26771,98913,11,185;86;95;130;99;22;66;94;47;148;60;20;59;28;149;4;199;9;183;140;152;170;34;55;18;62;128;124;106;143;35;109;0;29;160;33;11;134;74;118;51;90;121;31;117;1;38;63;135;122;133;10;178;147;6;188;169;132;13;70;3;15;145;195;168;139;182;138;104;8;111;82;21;177;5;45;142;175;78;36;61;91;141;77;81;153;187;163;89;127;137;114;103;113;180;176;194;166;172;179,4577173912909173934,0.003979
greedy_intra:nodes_start:greedy,186,50783,20997,29786,111492,12,186;163;180;88;176;106;159;143;124;128;62;18;55;34;170;152;4;149;28;59;20;60;94;66;47;148;9;199;140;183;130;95;86;185;99;22;179;172;52;166;194;113;26;114;137;103;89;127;165;187;146;97;77;141;36;21;8;104;138;182;139;168;195;145;15;3;70;13;132;169;188;6;147;178;10;133;122;135;63;38;1;117;31;54;121;51;90;118;74;134;11;33;160;29;0;109;35;111;81;153,9154619605611991282,0.007163
greedy_intra:nodes_start:greedy,187,50616,20830,29786,113517,12,187;165;127;89;103;137;114;26;113;194;166;52;172;179;22;99;185;86;95;130;183;140;199;9;148;47;66;94;60;20;59;28;149;4;152;170;34;55;18;62;128;124;143;159;106;176;88;180;163;186;153;81;111;35;109;0;29;160;33;11;134;74;118;51;90;121;54;31;117;1;38;63;135;122;133;10;178;147;6;188;169;132;13;70;3;15;145;195;168;139;182;138;104;8;21;36;141;77;97;146,3100614867150531181,0.004867
greedy_intra:nodes_start:greedy,188,48889,20411,28478,66478,7,188;6;147;178;10;133;122;72;107;40;100;63;135;38;27;16;1;156;198;117;193;31;73;54;131;90;191;51;121;118;74;134;43;139;11;182;138;33;160;144;104;8;82;21;177;5;45;142;175;78;36;61;91;141;77;97;146;187;165;127;89;103;113;194;166;179;185;22;99;130;86;95;183;140;152;170;34;55;18;62;124;106;176;163;153;81;111;35;109;0;29;168;195;145;15;3;70;13;132;169,7303249679458187593,0.003000
greedy_intra:nodes_start:greedy,189,51541,18778,32763,48525,5,189;69;109;35;0;29;111;41;81;153;186;163;180;176;88;106;159;143;124;128;62;18;55;34;170;152;4;149;28;59;20;60;94;66;47;148;9;199;140;183;130;95;86;99;22;185;179;172;52;166;194;113;114;137;103;89;127;165;187;146;97;77;141;91;61;36;78;175;142;45;5;177;21;87;82;8;104;56;144;160;33;138;182;11;139;43;168;195;134;6;188;169;132;13;145;15;70;3;155;184,6042205791075191417,0.002096
greedy_intra:nodes_start:greedy,190,50930,20178,30752,76681,9,190;193;198;117;54;31;164;73;136;45;5;177;21;104;138;182;139;168;195;145;15;3;70;161;13;132;169;188;6;192;147;178;10;133;122;72;107;40;100;63;102;135;131;125;90;191;120;51;121;118;74;134;11;49;33;160;29;0;109;35;111;144;8;82;58;77;81;153;163;176;106;124;62;18;55;140;183;95;86;185;179;166;194;113;103;89;127;165;187;146;97;141;91;61;36;78;175;142;162;80,1020636565222199821,0.004397
greedy_intra:nodes_start:greedy,191,51318,19038,32280,58676,8,191;71;147;192;6;188;169;132;161;70;3;15;145;13;195;168;43;11;29;0;109;35;111;81;153;163;176;106;124;62;18;55;86;185;179;166;194;113;103;89;127;165;187;97;77;141;91;61;36;175;78;142;45;5;177;21;82;8;104;144;160;33;138;182;139;134;85;74;118;98;51;125;131;121;112;19;151;54;73;164;31;193;117;198;156;1;16;27;38;135;102;63;100;40;107;72;10;133;122;90,6291983438137436471,0.003390
greedy_intra:nodes_start:greedy,192,51747,18663,33084,45411,5,192;188;169;132;13;161;70;3;15;145;195;168;43;11;49;29;109;35;0;111;41;81;153;186;163;180;88;176;106;159;143;124;128;62;18;55;34;170;152;4;149;28;59;20;60;94;66;47;148;9;199;140;183;130;95;86;99;22;185;179;172;52;166;194;113;114;137;103;89;127;165;187;146;97;77;141;91;61;36;78;175;142;45;5;177;21;87;82;8;104;56;144;160;33;138;182;139;134;6;147,5825984112374908002,0.002364
greedy_intra:nodes_start:greedy,193,51309,20371,30938,77469,8,193;190;80;162;142;78;175;36;61;91;141;97;146;187;165;127;89;103;113;194;166;179;185;86;95;130;183;140;18;62;124;106;176;163;153;81;77;58;82;8;144;111;0;35;109;29;160;33;49;11;134;74;118;121;51;120;191;90;125;131;135;102;63;100;40;107;72;122;133;10;178;147;192;6;188;169;132;13;161;70;3;15;145;195;168;139;182;138;104;21;177;5;45;136;164;73;31;54;117;198,196383758586441513,0.004400
greedy_intra:nodes_start:greedy,194,48203,20695,27508,22647,2,194;113;176;180;103;114;137;127;89;163;187;153;81;77;141;91;61;36;175;78;142;45;5;177;21;82;111;8;104;138;182;139;168;195;145;15;3;70;13;132;169;188;6;147;178;10;133;122;63;135;38;1;131;90;51;121;118;74;134;11;33;160;29;0;109;35;143;106;124;128;62;18;55;34;170;152;140;183;130;95;86;185;22;99;9;199;4;149;28;59;20;60;148;47;94;66;57;172;179;166,7449665503354355115,0.000000
greedy_intra:nodes_start:greedy,195,48889,20411,28478,75262,7,195;145;15;3;70;13;132;169;188;6;147;178;10;133;122;72;107;40;100;63;135;38;27;16;1;156;198;117;193;31;73;54;131;90;191;51;121;118;74;134;43;139;11;182;138;33;160;144;104;8;82;21;177;5;45;142;175;78;36;61;91;141;77;97;146;187;165;127;89;103;113;194;166;179;185;22;99;130;86;95;183;140;152;170;34;55;18;62;124;106;176;163;153;81;111;35;109;0;29;168,1799609680888667712,0.003000
greedy_intra:nodes_start:greedy,196,52383,20042,32341,83068,13,30;190;80;162;142;175;78;36;61;91;141;97;146;187;165;127;89;103;113;194;166;86;185;95;18;62;124;106;176;163;153;81;77;58;82;8;144;111;35;0;109;29;160;33;49;11;134;74;118;121;51;120;191;90;125;131;135;102;63;100;40;107;72;122;133;10;178;147;192;6;188;169;132;13;161;70;3;15;145;195;168;139;182;138;104;21;177;5;45;136;73;164;54;31;193;117;198;1;156;42,7742734195238418401,0.002999
greedy_intra:nodes_start:greedy,197,51886,18023,33863,49899,8,24;156;198;117;193;31;164;73;54;151;19;112;121;116;158;25;182;138;33;160;144;104;8;82;21;177;5;45;142;175;78;36;61;91;141;77;97;187;165;127;89;103;113;194;166;86;185;130;95;18;62;124;106;176;163;153;81;111;35;109;0;29;11;139;43;168;195;145;15;3;70;13;132;169;188;6;134;74;118;98;51;125;90;191;71;147;115;178;10;133;122;135;32;96;63;102;38;27;16;1,1392175883084985280,0.002515
greedy_intra:nodes_start:greedy,198,51205,18558,32647,46973,9,198;156;1;16;27;38;102;63;96;32;135;122;133;10;178;115;147;71;191;90;125;51;98;118;74;134;6;188;169;132;13;70;3;15;145;195;168;43;139;11;29;109;0;35;111;81;153;163;176;106;124;62;18;140;183;95;185;86;166;194;113;103;89;127;165;187;97;77;141;91;61;36;78;175;142;45;5;177;21;82;8;104;144;160;33;138;182;25;158;116;121;112;19;151;54;73;164;31;193;117,3941824763167176538,0.003114
greedy_intra:nodes_start:greedy,199,46641,20650,25991,94243,11,199;140;183;95;130;99;22;179;185;86;166;194;113;176;180;103;114;137;127;89;163;187;153;81;77;141;91;61;36;78;175;142;45;5;177;21;82;111;8;104;138;182;139;168;195;145;15;3;70;13;132;169;188;6;147;178;10;133;122;135;63;38;1;117;193;31;54;73;121;51;90;118;74;134;11;33;160;29;0;109;35;143;106;124;128;62;18;55;34;170;152;4;149;28;20;60;94;66;47;148,4703690529831410427,0.003974
greedy_intra:edges_start:random,0,48394,21478,26916,513734,493,135;63;100;107;40;10;133;122;125;51;120;90;191;147;134;6;188;169;132;161;70;3;155;15;145;13;195;168;139;182;11;29;0;109;35;143;106;124;62;18;83;55;34;170;152;183;140;20;60;148;47;94;66;179;185;130;95;86;166;194;176;180;113;103;163;153;81;77;82;8;104;111;144;160;33;138;25;121;112;19;173;177;61;91;141;36;5;78;175;80;190;136;73;164;54;31;193;117;198;1,5357095022665193562,0.080547
greedy_intra:edges_start:random,1,46143,21290,24853,637710,511,118;98;51;121;131;122;90;191;147;10;133;107;40;63;135;38;27;1;198;117;193;31;54;73;190;80;175;78;5;177;21;36;61;141;77;81;146;187;153;163;89;127;103;113;176;194;166;179;94;47;148;20;28;140;183;95;130;99;185;86;128;106;143;124;62;18;55;34;170;152;184;155;189;109;35;0;29;160;144;111;8;104;56;33;138;182;11;139;168;195;13;145;15;3;70;132;169;188;6;134,2701974653453396879,0.078909
greedy_intra:edges_start:random,2,48122,22740,25382,676337,518,77;81;153;163;89;127;103;113;194;166;176;180;106;124;143;111;35;0;29;109;34;18;62;55;95;130;86;185;179;172;57;66;94;47;148;20;28;149;140;183;152;155;3;70;15;145;13;132;126;195;168;139;11;138;33;160;144;56;104;8;21;177;5;136;73;54;19;112;121;25;182;134;169;188;6;147;51;90;122;133;107;40;63;135;38;27;1;198;117;31;193;190;80;45;142;175;78;36;61;141,7747411777247572315,0.082604
greedy_intra:edges_start:random,3,48478,22331,26147,706554,520,21;177;5;45;142;78;175;162;80;190;136;73;54;31;193;117;198;1;27;38;63;40;107;133;10;178;147;188;169;132;13;70;3;155;189;15;145;195;168;134;51;90;122;135;131;121;112;19;158;25;182;138;11;33;144;160;29;0;109;35;111;104;8;82;77;153;163;89;103;180;176;106;124;128;62;83;18;55;34;152;183;140;20;148;47;94;185;86;166;194;113;114;137;127;165;187;141;91;36;61,1605566639721709426,0.084682
greedy_intra:edges_start:random,4,47082,21278,25804,621757,492,163;103;26;113;180;176;194;166;86;62;18;55;34;143;106;124;95;185;99;22;179;94;47;148;20;28;149;140;183;152;184;155;3;70;15;145;35;109;0;29;168;195;132;169;188;6;134;147;51;121;90;122;135;63;38;27;1;156;198;117;193;31;54;164;73;173;136;190;80;45;175;78;142;5;177;36;61;79;91;141;77;82;21;8;104;138;182;139;11;33;160;144;111;153;187;165;127;137;114;89,8997177690149153851,0.085389
greedy_intra:edges_start:random,5,48744,23404,25340,498911,470,35;109;143;124;106;176;113;153;187;163;89;127;103;114;194;166;86;185;99;130;95;62;55;18;34;183;140;60;94;47;148;20;28;149;4;152;170;184;155;3;70;161;15;145;168;195;13;132;169;188;6;134;85;147;51;90;125;121;131;135;122;40;63;38;27;1;198;117;54;31;73;164;193;80;190;45;142;175;78;5;177;36;141;77;81;82;8;21;25;182;138;33;104;56;111;144;160;11;29;0,8312723182198323165,0.076297
greedy_intra:edges_start:random,6,48379,21167,27212,644056,532,148;60;20;28;140;183;128;124;106;143;62;18;55;34;152;184;155;3;15;145;195;109;35;0;12;39;29;49;11;139;43;168;126;13;132;70;169;188;6;134;147;90;122;63;135;1;156;198;117;193;190;80;175;78;142;5;31;54;121;51;118;182;138;33;160;144;56;104;8;111;82;87;21;61;36;91;141;77;81;153;187;163;165;127;89;103;114;113;180;176;194;166;86;95;185;179;172;66;94;47,2095090414276384092,0.086267
greedy_intra:edges_start:random,7,47132,20752,26380,573081,490,180;176;106;124;128;62;18;55;34;143;153;81;77;97;141;36;61;21;8;111;35;109;0;29;49;11;139;33;160;144;104;138;182;25;177;5;45;142;78;175;80;190;193;117;54;31;73;112;121;131;135;122;133;10;90;51;147;6;188;169;132;126;43;168;195;13;161;70;3;15;145;189;155;184;152;183;140;28;20;60;148;47;94;179;22;99;130;95;185;86;166;194;114;137;127;165;89;163;103;113,6998700713075558152,0.077526
greedy_intra:edges_start:random,8,49102,22756,26346,652708,525,31;73;54;117;198;151;112;121;1;38;135;63;100;40;107;133;122;131;125;90;191;51;71;147;192;6;188;134;74;118;25;177;21;82;8;56;104;138;182;139;11;33;160;144;111;77;153;106;124;62;18;55;34;35;109;0;29;168;195;132;169;70;3;15;145;155;184;152;183;140;20;148;47;94;179;185;130;99;95;86;166;194;176;113;103;127;89;163;187;141;91;61;36;5;142;78;175;80;190;193,8972519450002634203,0.085879
greedy_intra:edges_start:random,9,46719,20545,26174,605272,487,11;138;33;104;8;144;160;29;0;109;35;143;124;106;81;153;187;165;127;89;163;103;113;180;176;194;166;86;52;172;179;22;185;99;94;47;148;20;28;149;4;140;183;130;95;128;62;18;55;34;170;152;155;3;70;15;145;168;195;13;132;169;188;6;147;191;90;51;121;131;122;135;1;198;117;54;31;193;73;136;190;80;175;78;142;5;36;61;91;141;97;77;111;82;87;21;177;25;182;139,1691870484780219193,0.078202
greedy_intra:edges_start:random,10,45762,20969,24793,689475,516,99;130;86;166;194;176;113;103;127;89;163;153;81;77;97;141;61;36;177;5;78;175;142;45;80;190;193;31;54;117;198;156;1;38;135;63;40;107;10;133;122;90;51;131;121;118;74;134;147;6;188;169;132;13;161;70;3;15;145;195;168;139;11;138;104;21;82;8;111;144;33;160;29;0;35;109;189;155;184;152;34;55;18;62;124;106;128;95;183;140;4;149;28;20;60;148;47;94;179;185,8541891543254301044,0.092295
greedy_intra:edges_start:random,11,49113,23788,25325,421955,463,143;124;106;176;153;187;163;89;165;127;137;114;103;113;194;166;172;179;185;86;95;130;99;66;94;47;148;60;20;28;140;183;152;184;155;34;55;18;62;145;15;3;70;188;169;132;13;126;168;195;109;35;0;12;29;160;33;11;139;134;6;147;90;122;10;133;135;63;38;27;1;117;31;193;190;80;136;73;54;121;158;25;182;138;104;8;82;21;177;5;175;78;142;45;36;61;141;77;81;159,5858596178884992339,0.065819
greedy_intra:edges_start:random,12,49559,22557,27002,660243,508,195;13;132;70;161;145;15;3;155;184;152;55;18;62;124;106;86;95;183;140;28;20;60;94;66;47;148;199;9;130;99;185;179;166;194;176;180;113;103;163;153;81;77;82;111;8;87;21;61;91;141;36;177;5;45;142;78;175;80;190;193;31;117;198;1;38;63;133;90;191;51;125;122;32;135;131;121;54;73;25;182;138;104;144;0;35;109;29;160;33;49;11;139;43;134;147;6;188;169;168,2988805056908065564,0.078431
greedy_intra:edges_start:random,13,50088,22760,27328,514584,507,139;168;195;126;13;145;15;3;70;132;169;65;188;6;147;134;118;121;51;191;90;10;133;122;135;1;117;31;54;193;190;80;45;142;175;78;5;177;21;61;36;91;141;97;77;82;8;111;41;81;153;187;163;35;0;109;143;106;124;176;113;103;89;127;114;194;166;86;179;94;47;148;99;185;95;183;20;28;149;140;55;18;83;62;34;170;152;184;155;189;69;29;160;33;144;56;104;138;182;11,8409008967690439227,0.075015
greedy_intra:edges_start:random,14,48606,20399,28207,681486,527,188;169;132;13;195;168;145;15;70;3;155;184;170;152;140;183;34;55;18;62;143;159;106;124;95;130;99;22;179;185;86;166;194;176;180;113;103;114;127;165;89;163;187;146;153;81;77;141;91;61;36;177;5;78;175;142;45;80;190;136;73;54;31;193;117;121;158;25;21;87;82;111;35;109;0;29;144;8;104;160;33;138;11;139;51;125;191;90;135;63;40;107;100;122;133;10;178;115;147;6,2505378478025139370,0.083856
greedy_intra:edges_start:random,15,50005,23198,26807,521003,493,81;153;106;143;35;109;0;29;144;111;8;104;138;33;160;49;11;139;168;195;13;145;15;70;3;155;152;140;149;28;20;183;55;18;62;124;128;176;86;95;130;185;179;166;194;113;103;89;163;187;146;97;141;91;61;36;78;175;142;45;80;190;164;31;54;193;117;198;156;1;27;38;135;63;40;107;122;133;10;147;6;188;169;132;43;134;74;118;51;90;131;121;112;73;136;5;177;21;82;77,3726177677718625769,0.074413
greedy_intra:edges_start:random,16,49100,22466,26634,694470,454,144;104;33;160;29;168;139;11;138;182;118;51;191;90;121;158;25;5;78;175;80;190;73;164;54;31;193;117;198;1;135;122;133;147;6;188;169;132;13;126;195;145;189;15;161;70;3;155;152;140;149;28;20;60;47;148;94;66;179;22;99;185;130;95;183;62;18;55;34;109;0;35;143;159;106;124;128;86;166;194;176;180;113;103;114;127;89;163;153;141;61;36;177;21;87;8;82;77;81;111,1319300647613311446,0.074621
greedy_intra:edges_start:random,17,47485,20299,27186,688996,544,109;35;143;159;106;124;128;62;18;55;34;189;15;145;13;195;168;43;134;147;6;188;169;132;161;70;3;155;184;170;152;183;140;20;148;47;94;66;179;185;86;166;176;113;127;89;103;163;187;153;81;77;141;91;36;61;177;5;45;142;78;175;80;190;136;73;164;31;54;193;117;198;156;24;1;27;38;63;135;122;90;51;121;25;21;82;111;8;104;144;33;138;182;139;11;49;160;29;12;0,4289889442766540324,0.096660
greedy_intra:edges_start:random,18,48172,23042,25130,565108,509,147;10;133;40;107;122;135;63;27;38;1;156;198;117;193;31;164;73;54;19;112;121;131;125;90;191;51;134;139;11;138;182;25;136;190;80;45;142;175;78;5;177;21;61;36;141;77;153;163;103;89;165;127;137;114;113;176;194;166;86;124;106;159;143;62;18;95;185;179;94;47;148;20;28;149;4;140;183;152;55;34;35;0;111;8;104;33;29;109;155;3;70;15;145;13;195;168;169;188;6,1394589274450093359,0.077006
greedy_intra:edges_start:random,19,50013,21411,28602,527190,501,165;187;77;141;61;36;78;175;142;162;80;190;193;54;31;117;198;1;135;63;100;40;107;122;90;51;121;112;19;73;136;45;5;177;21;82;111;8;104;56;144;33;160;12;35;109;0;29;49;138;182;11;139;134;85;147;6;188;169;132;13;195;168;145;15;70;3;155;184;170;34;55;18;62;83;174;152;140;183;130;95;86;185;99;22;179;166;194;113;103;176;128;124;106;143;81;153;163;89;127,7926242368104486238,0.079771
greedy_intra:edges_start:random,20,46905,21634,25271,584599,518,104;8;111;81;153;187;97;77;141;91;36;61;82;21;177;5;78;175;45;162;80;190;136;73;54;31;193;117;198;1;135;63;100;40;107;17;72;10;133;122;90;191;125;131;121;51;147;6;134;182;138;11;139;168;195;132;169;188;70;3;15;145;155;184;152;183;140;28;20;148;47;94;179;99;130;95;185;86;166;194;176;113;103;127;89;163;106;124;62;18;55;34;143;35;109;0;29;160;33;144,1907581193061158211,0.079084
greedy_intra:edges_start:random,21,48230,21415,26815,526685,551,34;124;106;143;111;8;144;160;33;104;21;82;77;141;91;61;36;177;5;45;142;78;175;80;190;136;193;31;54;117;198;1;27;38;63;135;122;131;121;118;98;51;125;90;191;147;6;134;74;182;138;11;139;168;195;13;169;188;132;145;15;161;70;3;155;189;69;29;0;35;109;170;152;183;140;28;20;148;47;94;99;95;185;179;166;194;114;127;165;89;163;103;113;180;176;86;128;62;18;55,3517131538033387603,0.083091
greedy_intra:edges_start:random,22,48323,21975,26348,642160,501,80;190;136;73;164;193;31;54;121;131;117;198;156;1;38;63;135;122;133;10;90;191;51;25;21;8;104;56;144;160;33;11;138;182;139;168;195;132;188;169;70;3;15;145;155;152;28;20;148;47;140;183;130;95;99;94;66;172;179;185;86;166;194;176;180;113;103;114;127;89;163;187;153;143;106;124;62;83;18;55;34;35;109;0;29;111;81;77;97;141;91;79;61;36;177;5;78;175;142;45,3981147191885566467,0.086052
greedy_intra:edges_start:random,23,50205,22549,27656,465090,472,164;193;31;54;151;117;198;156;1;27;38;135;63;40;107;133;122;90;191;71;147;51;131;121;177;21;82;111;35;109;0;29;144;56;8;104;160;33;49;11;138;182;139;134;6;188;169;132;126;168;43;195;13;145;15;70;3;155;184;170;152;28;140;183;174;34;55;18;62;124;128;86;95;185;179;166;194;176;113;103;163;89;127;187;153;106;143;81;77;141;91;61;36;5;175;190;80;136;173;73,6235892104227756844,0.082935
greedy_intra:edges_start:random,24,47217,21816,25401,632693,496,188;6;147;133;122;63;135;90;51;121;1;38;27;156;198;117;193;31;54;73;190;80;45;175;78;5;177;36;61;91;141;187;153;159;143;34;55;18;83;62;124;106;176;113;103;89;127;137;114;194;166;86;95;130;99;185;179;66;94;47;148;60;20;28;140;183;174;152;170;184;155;3;70;161;15;145;109;35;0;29;160;144;111;81;77;82;21;8;104;33;138;182;11;139;43;168;195;13;132;169,4149575175376124059,0.076196
greedy_intra:edges_start:random,25,49116,23066,26050,521480,480,40;63;135;38;27;1;198;117;54;31;73;136;45;5;177;21;87;82;111;8;104;33;160;138;182;11;139;6;188;169;132;70;3;15;145;13;195;168;29;0;35;109;155;152;140;20;148;47;94;66;179;166;194;114;127;165;187;163;89;103;113;176;86;185;95;130;183;174;170;34;55;83;18;62;128;124;106;143;153;77;141;61;36;78;175;80;190;193;151;121;51;71;147;115;178;10;133;90;122;107,3912167921273173107,0.070870
greedy_intra:edges_start:random,26,48674,22673,26001,583690,517,152;149;28;20;148;47;140;183;174;34;55;18;62;128;95;130;185;86;166;194;176;180;113;103;127;89;163;187;77;141;36;61;21;82;8;104;111;81;153;106;124;159;143;35;109;0;29;160;33;195;168;43;139;11;138;25;177;5;78;175;45;80;190;73;54;31;193;117;198;121;131;1;156;16;27;38;135;122;63;40;107;133;10;191;90;125;51;71;147;6;188;169;132;145;15;70;3;155;184;170,1730280579337100155,0.077908
greedy_intra:edges_start:random,27,49403,23270,26133,589453,468,148;20;28;140;4;152;170;34;55;18;83;62;124;106;35;109;0;29;168;195;13;145;15;189;155;3;70;132;169;188;6;147;85;134;43;139;11;49;33;138;182;51;90;121;131;135;122;133;107;40;63;1;117;193;31;54;73;25;104;8;56;144;160;111;82;21;177;5;142;175;78;36;61;91;141;77;153;146;187;165;127;137;114;89;163;103;113;194;180;176;166;86;185;179;99;130;95;183;94;47,1067823228031590569,0.076802
greedy_intra:edges_start:random,28,49621,22823,26798,518374,521,183;62;18;55;34;95;130;185;99;179;86;166;194;176;113;103;163;153;77;141;91;79;61;36;78;175;142;45;80;190;136;164;193;117;135;63;107;40;10;133;122;90;51;121;54;31;73;5;177;21;8;82;81;159;143;106;124;109;35;0;29;111;144;56;104;160;33;49;138;182;11;139;43;134;6;188;169;168;195;145;13;132;161;70;3;15;189;155;184;170;152;4;149;28;148;47;94;60;20;140,2122776329697331206,0.087601
greedy_intra:edges_start:random,29,48886,21330,27556,617689,507,153;81;97;141;77;82;87;21;91;61;36;5;175;80;190;73;164;54;31;193;117;198;156;24;1;19;112;121;131;135;122;90;191;147;192;6;188;169;132;13;195;168;134;51;118;74;25;177;8;111;144;104;138;182;139;11;49;33;160;29;0;109;35;106;124;62;18;55;34;189;145;15;70;3;155;184;152;183;140;4;149;28;20;60;148;47;94;185;95;86;166;194;176;113;103;127;165;89;163;187,905358033222491053,0.082367
greedy_intra:edges_start:random,30,48843,23799,25044,567794,490,163;153;81;77;111;35;109;0;29;160;144;8;104;33;11;138;182;139;168;195;13;161;70;3;145;15;132;169;188;6;134;74;118;51;191;90;10;133;107;40;63;122;135;1;131;121;25;177;136;73;31;54;117;193;190;80;175;78;5;36;61;21;82;141;97;187;165;127;89;103;113;194;166;86;128;62;18;34;55;95;130;99;185;179;94;47;148;60;20;140;183;152;184;155;189;143;124;106;176;180,4698361056034801979,0.078873
greedy_intra:edges_start:random,31,47785,22353,25432,736076,487,109;0;29;144;111;77;81;153;187;141;91;61;36;78;175;162;80;190;164;31;193;198;156;27;38;16;1;117;54;73;136;45;5;177;21;82;8;104;160;33;138;182;11;139;134;118;121;131;135;102;63;40;107;122;90;51;147;6;188;169;132;126;168;195;13;145;15;70;161;3;155;184;152;34;55;18;62;95;183;140;20;148;47;94;179;185;86;166;194;176;113;103;114;127;89;163;106;124;143;35,9087938483718683469,0.084235
greedy_intra:edges_start:random,32,49359,21888,27471,613135,507,111;82;8;144;160;33;11;139;182;138;104;25;177;21;87;77;97;141;91;61;36;5;78;175;80;190;136;73;54;31;193;117;135;63;122;131;121;118;98;51;90;191;147;134;6;188;169;132;126;168;195;13;161;70;3;15;145;189;155;184;170;152;140;4;149;28;59;20;60;148;47;94;66;179;166;194;180;176;113;163;187;146;153;143;106;124;62;55;18;86;185;130;95;183;174;34;109;29;0;35,4052293094890504990,0.077734
greedy_intra:edges_start:random,33,49516,23989,25527,652449,489,25;182;139;11;138;157;104;56;144;160;33;49;29;0;109;35;143;153;163;89;103;176;106;124;62;18;55;34;145;168;195;13;132;169;134;118;98;51;121;90;122;135;63;40;107;133;10;147;6;188;70;3;15;155;152;95;130;99;9;183;140;28;20;148;47;94;179;185;86;166;194;113;114;137;127;165;187;81;41;111;8;21;87;82;77;141;61;36;177;5;78;175;80;190;136;73;54;31;193;117,4034185915985616087,0.083068
greedy_intra:edges_start:random,34,47732,20927,26805,514199,503,15;3;70;132;169;188;6;147;178;10;133;90;191;51;121;131;122;107;40;100;63;135;38;27;16;1;198;117;54;164;193;31;73;136;190;80;162;175;78;142;45;5;177;21;61;36;91;141;77;82;8;104;56;33;160;144;111;81;153;163;89;103;113;176;166;194;86;185;179;66;94;47;148;20;140;152;183;95;128;106;124;62;18;55;34;35;109;0;29;49;11;139;138;182;74;118;134;195;168;145,411275410722404742,0.081434
greedy_intra:edges_start:random,35,49743,21996,27747,621269,483,95;130;185;179;94;47;148;183;140;152;170;34;184;155;189;3;70;161;15;145;195;168;126;13;132;169;188;6;147;71;191;90;125;120;51;118;74;134;139;11;33;138;182;25;177;5;112;121;131;122;63;135;1;198;117;54;31;193;190;80;45;175;78;36;61;141;97;77;82;21;104;56;8;111;144;160;29;0;109;35;143;81;153;163;89;127;114;103;113;194;166;176;180;106;124;18;55;62;128;86,2979461047217350402,0.085105
greedy_intra:edges_start:random,36,47694,21981,25713,664137,493,182;11;139;168;195;13;6;188;169;132;145;15;70;3;155;152;55;83;62;18;34;109;0;35;143;159;106;124;86;95;130;183;140;149;28;20;60;148;47;94;179;22;99;185;166;194;176;113;114;137;127;103;89;163;153;81;77;97;141;36;5;142;78;175;80;190;73;54;31;193;117;198;156;1;121;131;135;63;40;107;100;122;133;10;90;191;51;118;74;25;177;21;8;104;144;33;160;29;49;138,718585903431641787,0.092734
greedy_intra:edges_start:random,37,48125,22053,26072,566357,472,198;156;1;121;51;131;38;63;135;122;90;147;6;188;169;168;195;13;132;161;70;3;15;145;155;152;34;55;18;62;109;35;0;29;39;111;82;81;153;163;103;113;194;166;86;185;179;66;94;47;148;60;20;28;149;4;140;183;130;95;128;124;106;176;114;127;89;165;187;77;141;91;79;61;36;21;8;104;144;160;33;11;139;138;177;78;175;142;5;45;162;46;80;190;136;73;54;31;193;117,7139635318472812655,0.079181
greedy_intra:edges_start:random,38,47128,22188,24940,706218,508,164;73;136;190;80;175;78;142;45;5;36;61;91;141;97;77;153;81;111;160;29;0;109;35;143;159;106;124;176;113;163;89;127;103;114;194;166;86;185;95;130;179;94;47;148;20;28;149;140;183;152;170;55;83;62;18;34;184;155;15;3;70;145;132;188;6;169;13;195;168;139;11;33;138;104;8;82;21;177;25;121;131;135;122;90;51;147;10;133;107;40;63;38;1;156;198;117;193;31;54,6640280787138848239,0.085960
greedy_intra:edges_start:random,39,46637,20645,25992,640935,539,78;175;80;190;136;73;19;112;121;51;125;191;90;131;1;54;31;193;117;198;156;16;27;38;102;63;135;122;133;10;147;134;6;188;169;132;70;3;145;195;168;139;11;49;33;160;29;0;109;35;143;106;124;62;18;55;34;170;152;183;140;28;20;148;47;94;179;99;130;95;185;86;166;194;176;113;103;114;137;127;89;163;153;77;141;91;36;61;21;82;8;111;144;104;138;182;25;177;5;142,4430863335087326733,0.093262
greedy_intra:edges_start:random,40,47933,22372,25561,470076,486,138;139;134;51;121;131;90;10;133;122;135;63;38;1;156;198;117;193;54;31;164;73;190;80;136;162;45;175;78;142;5;177;21;61;36;91;141;82;8;104;33;160;29;0;109;35;144;111;143;106;159;81;77;97;153;146;187;163;89;176;113;103;127;137;114;194;166;86;185;179;94;66;47;148;60;23;20;28;149;140;183;95;124;62;18;55;34;152;155;15;3;70;188;169;132;13;145;195;168;11,4944234511776295171,0.074078
greedy_intra:edges_start:random,41,49098,23408,25690,458243,528,139;74;118;98;51;147;6;134;43;188;169;132;70;3;155;189;15;145;13;195;168;29;0;109;35;160;33;144;104;8;111;82;21;77;97;81;153;163;89;103;113;176;106;124;128;62;18;55;34;152;149;28;20;148;47;94;140;183;95;130;185;86;166;194;114;137;127;165;187;141;61;36;5;78;175;45;80;190;136;73;164;31;54;193;117;198;1;135;63;122;133;90;131;121;158;25;177;182;138;11,5710534021370899808,0.082097
greedy_intra:edges_start:random,42,48780,22316,26464,537292,488,43;11;139;74;118;121;25;182;138;104;144;160;33;49;29;0;109;35;34;55;18;62;143;106;124;128;183;140;20;60;148;47;94;179;185;95;130;99;86;194;166;176;113;103;163;89;127;165;187;153;81;77;97;141;91;79;61;36;21;82;8;177;5;78;175;80;190;193;73;54;31;117;1;135;63;100;40;107;133;122;125;90;191;51;71;147;134;6;169;188;70;3;155;15;145;13;132;126;195;168,2505796505813476539,0.072328
greedy_intra:edges_start:random,43,48305,21518,26787,609985,515,62;18;86;95;130;99;185;179;94;47;148;60;20;28;149;4;140;183;55;34;152;155;15;3;70;13;132;169;188;6;134;43;168;195;145;29;0;109;35;111;82;8;104;144;160;33;49;11;139;138;182;74;118;51;90;133;122;63;135;121;54;117;193;31;73;190;80;45;142;175;78;5;177;7;36;61;79;21;87;91;141;77;97;187;165;89;127;114;194;166;176;180;113;103;163;153;81;143;106;124,1035917777129414984,0.087216
greedy_intra:edges_start:random,44,48572,21759,26813,596575,512,134;6;188;169;132;126;195;13;145;15;70;3;155;152;183;140;28;20;60;148;47;94;179;185;95;86;128;124;106;176;194;113;114;127;89;103;163;153;81;143;62;18;34;35;109;0;29;111;8;21;87;82;77;97;141;61;36;177;5;78;175;142;45;80;190;73;54;31;193;117;1;38;63;135;122;133;10;147;71;191;90;131;121;51;98;118;74;25;182;138;104;56;144;160;33;49;11;139;168;43,8989366072567000267,0.084765
greedy_intra:edges_start:random,45,48749,23106,25643,567030,490,142;5;177;21;82;8;104;138;182;118;51;191;90;125;131;121;112;19;73;136;80;190;193;31;54;117;198;1;27;38;135;63;40;107;100;122;133;10;147;134;6;188;169;132;70;3;15;145;13;195;168;139;11;33;160;29;0;35;109;155;152;183;140;149;28;20;148;47;94;179;86;95;130;185;166;194;176;180;106;124;62;83;18;55;34;143;111;77;81;153;113;103;163;187;97;141;61;36;78;175,6875676007735733030,0.084519
greedy_intra:edges_start:random,46,48285,22509,25776,607366,510,81;77;141;97;187;163;89;127;103;113;176;194;166;185;179;94;47;148;60;20;28;140;183;95;86;128;106;124;62;83;18;55;34;152;155;3;70;161;169;188;6;147;134;139;138;182;118;51;90;122;133;107;40;63;102;135;131;121;1;198;117;54;31;193;190;80;45;175;78;5;177;36;61;91;21;82;8;104;56;68;111;144;160;33;11;168;126;132;13;195;145;15;189;29;0;109;35;143;159;153,6124475825237495270,0.082502
greedy_intra:edges_start:random,47,50540,21498,29042,599420,474,147;71;51;191;90;135;63;38;27;16;1;156;198;117;193;151;54;31;164;73;136;190;80;175;78;142;45;5;36;61;79;91;141;97;187;163;103;113;176;153;81;77;111;144;56;104;8;82;87;21;177;25;158;121;118;182;138;33;160;29;0;109;35;143;159;106;124;62;18;34;55;95;86;166;185;179;94;148;20;140;183;152;155;189;49;11;139;43;168;195;126;13;145;15;3;70;132;169;188;6,3239649779616374451,0.075393
greedy_intra:edges_start:random,48,47934,21337,26597,700936,557,61;91;141;97;146;187;163;89;165;127;103;113;176;194;166;86;185;99;179;94;47;148;60;20;28;140;183;152;34;55;18;62;128;124;106;143;159;153;81;77;111;160;29;0;35;109;189;155;3;70;15;145;13;195;168;169;188;6;147;90;135;63;38;27;16;1;131;121;51;98;118;74;85;134;139;11;138;33;144;56;104;8;82;87;21;25;73;31;54;117;193;190;80;45;142;175;78;5;177;36,1163947722299345743,0.091428
greedy_intra:edges_start:random,49,47545,22788,24757,691769,460,122;107;40;63;102;135;1;156;198;117;193;31;54;73;136;190;80;175;78;142;5;36;61;141;187;89;127;137;114;103;163;153;81;77;111;160;33;29;0;109;35;106;176;180;26;113;194;166;179;66;94;154;47;148;60;20;28;140;183;9;99;130;95;185;86;124;62;18;55;34;152;155;189;3;70;15;145;13;132;169;188;6;147;134;43;195;168;139;11;182;138;104;8;82;21;177;25;121;51;90,3530151882863599373,0.081035
greedy_intra:edges_start:random,50,46713,20237,26476,608744,472,11;139;33;160;29;0;109;35;34;55;18;83;62;124;106;143;111;8;82;141;77;81;153;163;89;127;103;113;180;176;88;194;166;86;185;130;95;99;22;179;66;94;154;47;148;60;20;28;149;140;183;152;184;155;3;70;15;145;168;195;13;132;169;188;6;147;191;90;178;10;133;63;135;122;125;51;121;131;1;198;117;193;31;54;164;73;136;190;80;175;78;142;45;5;36;61;21;177;25;138,89366972527636350,0.072466
greedy_intra:edges_start:random,51,47622,21137,26485,621804,510,194;166;86;185;179;94;47;148;60;20;28;130;95;128;106;124;62;18;55;34;183;140;152;155;189;145;15;3;70;161;13;195;168;132;169;188;6;147;51;191;90;178;10;133;122;135;131;121;198;117;54;73;31;193;190;80;175;78;5;177;36;61;91;141;97;77;153;81;111;82;21;8;104;56;144;160;33;138;182;139;11;49;29;12;0;109;35;143;159;176;180;113;103;89;163;187;165;127;137;114,3944082458570167727,0.085071
greedy_intra:edges_start:random,52,48010,22568,25442,548844,500,66;94;47;60;20;148;99;185;95;128;124;62;18;55;34;183;140;152;155;3;70;161;15;145;168;195;13;132;169;188;6;147;115;178;10;133;107;40;63;96;122;135;38;27;1;131;90;191;51;121;112;198;117;193;31;54;164;73;136;190;80;175;78;5;177;36;61;91;21;82;8;104;160;33;138;11;139;29;0;109;35;111;143;106;176;113;103;89;163;153;77;141;187;127;114;194;166;86;179;172,6505429309018282359,0.083594
greedy_intra:edges_start:random,53,48299,22613,25686,656921,488,15;145;13;132;169;188;195;168;139;11;29;160;33;138;182;104;56;144;111;8;82;87;21;177;25;121;118;134;6;147;51;90;122;135;63;102;38;27;1;198;117;54;31;190;80;175;78;5;36;61;141;77;81;153;146;187;163;103;89;127;137;114;113;176;180;88;194;166;86;128;62;124;106;143;35;0;109;18;55;34;170;183;95;130;185;179;66;94;47;148;60;20;28;140;152;155;189;3;70;161,8168076550942583059,0.080931
greedy_intra:edges_start:random,54,46410,21388,25022,601114,528,91;61;36;177;5;78;175;45;80;190;136;73;54;31;193;117;198;156;1;27;38;102;63;100;40;107;133;10;90;191;122;135;131;112;121;51;147;134;6;132;169;188;168;195;13;70;3;15;145;189;155;152;170;34;55;183;140;28;20;60;148;47;94;179;185;22;99;130;95;86;166;194;176;113;103;127;89;163;153;106;124;128;62;18;35;109;0;29;160;33;11;139;138;104;144;8;21;82;77;141,2015686243263889393,0.078836
greedy_intra:edges_start:random,55,47638,21604,26034,467355,515,61;36;5;78;175;45;80;190;136;73;54;31;193;117;198;156;1;63;135;122;131;121;158;25;177;21;8;104;138;33;144;111;82;77;97;81;153;106;124;62;18;55;34;35;109;0;29;160;49;11;139;134;51;120;125;90;191;71;147;6;188;169;132;13;126;168;195;145;15;70;3;155;184;152;183;140;28;20;148;47;94;179;99;130;95;185;86;166;194;176;113;103;114;137;127;165;89;163;187;141,8710467686612506590,0.073698
greedy_intra:edges_start:random,56,47258,21282,25976,718119,532,140;183;152;170;34;55;18;83;62;128;124;106;143;35;109;0;29;160;33;104;138;11;168;195;145;189;184;155;15;3;70;169;188;6;147;71;51;191;90;122;133;107;40;63;135;38;1;198;117;193;54;31;164;73;151;19;112;121;158;25;136;190;80;45;175;78;142;5;177;36;61;21;82;8;111;141;77;81;153;163;89;127;114;103;113;176;194;166;86;95;130;185;179;94;47;148;60;20;28;149,2009806952563109491,0.087605
greedy_intra:edges_start:random,57,50074,22167,27907,547896,472,195;168;43;126;13;132;169;65;188;6;134;85;139;182;25;177;5;45;136;73;121;51;120;125;90;191;71;147;10;133;122;63;135;1;117;54;31;193;190;80;175;78;36;61;91;141;77;81;153;187;163;89;127;103;176;113;194;166;179;94;47;148;140;183;95;185;86;128;124;106;159;143;111;8;82;87;21;104;144;33;138;11;49;160;29;0;109;35;62;18;55;34;170;152;155;189;70;3;15;145,5678839960192934859,0.071888
greedy_intra:edges_start:random,58,48937,22270,26667,526754,526,73;136;80;190;193;117;198;131;121;51;118;74;134;139;11;138;182;25;177;5;142;175;78;36;61;141;97;77;81;153;163;89;127;103;113;176;194;166;185;179;94;47;148;99;130;183;140;20;28;152;170;34;55;18;83;95;86;128;62;106;124;143;35;111;8;104;144;160;33;49;29;0;109;189;155;3;70;161;15;145;13;195;168;126;132;169;188;147;191;90;10;133;122;135;63;38;1;54;31;164,2542871914237745440,0.084239
greedy_intra:edges_start:random,59,51687,21969,29718,568094,473,74;134;43;168;195;13;145;29;0;109;35;41;111;68;56;144;160;33;49;11;139;182;138;104;8;82;87;21;177;5;45;190;80;175;142;78;36;61;141;77;81;153;159;143;106;163;127;89;103;113;180;176;194;166;86;124;62;128;95;185;179;99;130;183;140;28;152;170;18;55;34;184;155;15;3;70;161;132;169;188;6;147;51;125;191;90;122;63;135;1;198;117;193;31;54;121;158;25;118;98,4713276731499561503,0.075396
greedy_intra:edges_start:random,60,46361,21612,24749,518812,475,128;62;83;18;55;34;35;109;0;29;160;33;11;139;138;182;74;118;51;90;122;135;131;121;25;177;5;78;175;45;80;190;136;73;54;31;193;117;198;1;38;63;40;107;133;10;147;134;6;188;169;132;13;195;168;145;15;70;3;189;155;152;183;140;20;148;47;94;179;99;130;95;185;86;166;194;176;113;103;127;89;163;187;153;81;77;97;141;36;61;21;82;8;104;144;111;143;159;106;124,7857756318203293196,0.072235
greedy_intra:edges_start:random,61,48825,23539,25286,619405,519,134;43;195;168;11;139;74;118;98;51;191;90;178;10;133;122;107;40;63;38;1;135;131;121;158;25;138;104;144;33;160;29;0;109;35;111;8;82;21;177;5;73;54;117;198;193;31;136;190;80;175;78;36;61;79;91;141;77;81;153;187;163;106;124;62;18;55;34;183;130;95;86;176;103;89;127;137;114;113;194;166;185;94;47;148;20;28;140;152;155;3;70;15;145;13;132;169;188;6;147,3929279754671652700,0.084278
greedy_intra:edges_start:random,62,49531,23174,26357,655469,453,192;6;188;134;139;168;195;145;15;13;132;169;70;3;189;155;152;183;140;4;149;28;20;60;148;47;94;66;179;172;166;194;113;103;89;127;187;153;163;176;86;185;22;99;130;95;55;34;18;83;62;124;106;143;111;144;8;82;21;61;36;175;80;190;193;54;31;164;73;136;5;177;104;138;33;160;0;35;109;29;49;11;182;25;158;121;117;198;1;27;38;63;135;131;51;90;122;133;10;147,5812116597466544780,0.077968
greedy_intra:edges_start:random,63,48469,23064,25405,618849,536,33;160;29;109;145;195;168;126;13;132;169;134;118;98;51;121;131;135;63;122;90;191;147;6;188;70;3;15;155;152;170;34;55;174;183;140;149;28;20;60;148;47;94;66;179;172;166;86;185;99;130;95;18;62;124;106;143;35;0;111;81;153;180;176;194;113;114;127;165;89;103;163;187;77;141;91;61;36;78;175;190;80;193;117;198;156;1;54;31;73;5;177;21;82;8;144;104;138;139;11,203144743774991534,0.086987
greedy_intra:edges_start:random,64,48249,22460,25789,729635,505,136;73;164;54;31;193;117;198;156;27;38;16;1;151;19;112;121;131;135;102;63;122;90;51;147;6;188;169;132;13;145;70;3;155;184;152;34;55;18;62;95;183;140;28;20;148;47;94;179;99;185;86;166;194;113;114;137;127;89;103;26;180;176;128;124;106;143;35;109;0;29;160;111;81;153;163;187;141;77;82;8;104;33;195;168;139;11;138;25;177;21;61;36;5;78;175;142;45;80;190,1710942557346419817,0.088855
greedy_intra:edges_start:random,65,47626,21490,26136,628308,508,82;21;61;36;175;78;5;177;8;104;144;160;33;138;182;25;121;112;19;151;73;190;80;193;31;54;117;198;1;16;27;38;135;63;100;40;107;122;133;10;178;90;191;51;147;6;188;169;132;126;168;195;13;145;15;161;70;3;155;152;183;140;28;20;23;60;148;47;94;179;185;130;95;86;166;176;113;103;127;89;163;187;153;97;141;77;81;159;143;106;124;62;18;55;34;35;0;109;29;111,7605933419895206751,0.083794
greedy_intra:edges_start:random,66,49512,22583,26929,507293,507,169;188;6;134;147;191;90;122;63;135;1;117;193;31;54;73;190;80;45;142;78;175;5;25;158;112;121;51;182;138;33;104;8;82;21;177;36;79;61;91;141;77;81;153;163;89;127;103;113;176;194;166;179;66;47;148;20;60;94;99;95;185;86;128;124;106;159;111;160;29;12;0;109;35;143;62;83;18;55;34;183;140;28;149;152;170;184;155;3;70;132;15;145;13;126;195;168;139;11;43,3303550122997573084,0.072141
greedy_intra:edges_start:random,67,49611,21588,28023,541095,488,162;80;190;73;164;54;31;193;117;198;156;24;1;135;63;122;133;10;90;121;25;21;82;8;104;182;138;33;160;144;111;159;143;35;109;0;12;29;168;11;139;134;147;6;188;169;132;13;195;145;15;70;3;189;155;152;170;34;18;55;140;28;20;183;95;62;124;106;128;86;185;179;166;194;88;176;180;113;114;137;127;165;89;103;163;153;81;77;97;141;91;79;61;36;177;5;45;142;78;175,4716420395549573729,0.082511
greedy_intra:edges_start:random,68,47740,21672,26068,531201,505,33;160;144;111;56;104;8;82;81;153;163;187;97;77;141;36;61;91;21;177;5;78;175;142;45;80;190;136;73;164;31;193;117;54;121;51;90;122;135;63;107;40;133;10;147;6;188;169;134;43;168;195;13;132;145;70;3;15;189;155;184;152;183;140;28;20;148;47;94;179;166;194;113;103;89;176;86;185;22;99;130;95;128;83;55;34;18;62;124;106;143;35;109;0;29;49;138;182;139;11,1227496580634621861,0.084075
greedy_intra:edges_start:random,69,49146,23392,25754,504970,547,18;55;34;170;174;183;95;86;88;194;166;172;179;185;22;99;130;9;148;47;94;60;20;199;140;28;4;149;152;155;15;3;70;169;188;147;90;122;133;107;40;63;135;38;1;156;198;117;193;31;54;121;51;118;74;134;132;13;145;195;168;139;11;138;33;160;29;12;0;109;35;111;8;82;21;78;175;80;190;45;5;177;36;61;141;77;153;187;163;89;103;127;137;114;113;180;176;106;124;62,1276010353237486034,0.080750
greedy_intra:edges_start:random,70,46116,19987,26129,703310,495,47;94;66;179;185;130;95;86;166;194;176;180;113;103;127;89;163;187;153;81;77;141;91;61;36;5;142;78;175;80;190;136;73;164;193;31;54;151;117;198;1;27;38;63;135;122;131;121;125;90;51;147;134;6;188;169;132;70;3;15;145;13;195;168;139;11;138;182;74;25;177;21;87;82;8;104;56;111;144;160;33;49;29;0;109;35;143;106;124;62;18;55;34;170;152;183;140;20;60;148,3643343837136747767,0.085031
greedy_intra:edges_start:random,71,47769,21238,26531,723364,530,179;172;66;94;47;148;60;20;140;183;152;184;155;109;35;0;29;111;82;87;21;8;104;56;144;160;33;138;182;11;139;43;168;195;13;145;3;15;70;132;169;188;147;133;107;40;63;135;122;90;51;121;112;151;117;1;156;198;193;54;31;164;73;136;190;80;162;45;175;78;142;5;177;36;61;79;91;141;77;81;187;153;143;34;55;18;62;124;106;176;163;103;113;194;166;86;95;130;99;185,3563316428079997781,0.089391
greedy_intra:edges_start:random,72,45537,19627,25910,760069,539,66;179;185;22;99;130;95;86;166;194;176;180;113;103;127;89;163;187;153;77;141;61;36;177;5;78;175;142;45;162;80;190;136;73;54;31;193;117;198;156;1;131;121;51;191;90;122;135;102;63;100;40;107;133;10;147;188;169;132;161;70;3;15;145;13;195;168;43;139;11;138;104;56;144;33;160;29;0;109;35;111;8;21;82;81;143;106;124;62;18;55;34;152;183;140;20;60;148;47;94,7939579977339643302,0.088788
greedy_intra:edges_start:random,73,48899,22781,26118,545025,492,47;148;20;130;95;128;106;124;62;18;55;34;183;140;152;155;189;29;0;109;35;143;159;111;160;33;49;11;138;182;139;134;43;168;195;145;15;3;70;13;132;169;188;6;147;191;90;51;25;177;5;136;73;31;54;112;121;131;122;135;63;1;198;117;193;190;80;45;142;175;78;36;61;91;21;104;8;82;141;97;77;81;153;146;187;163;89;127;114;103;113;194;180;176;166;86;185;179;66;94,2831582779725603015,0.072741
greedy_intra:edges_start:random,74,47547,21383,26164,630286,489,62;18;55;34;152;184;155;189;109;35;0;29;111;144;56;104;8;82;21;177;25;182;33;160;138;139;11;43;168;195;13;145;15;3;70;161;132;169;188;6;147;71;191;90;51;98;74;118;121;131;122;135;63;38;27;1;156;198;117;54;31;193;190;80;45;142;175;78;5;36;61;141;77;81;153;143;106;176;163;89;127;103;113;194;166;86;185;95;130;99;179;94;47;148;60;20;140;183;128;124,6050483788406818563,0.084168
greedy_intra:edges_start:random,75,48241,21687,26554,702610,521,62;83;95;130;185;99;9;199;183;140;28;20;60;148;47;94;179;166;194;86;128;124;106;176;180;113;114;137;127;165;89;103;163;153;81;97;77;141;91;21;87;82;8;104;56;144;111;35;109;0;29;160;33;49;11;138;25;177;79;61;36;5;78;175;45;190;80;162;136;73;54;31;193;117;121;131;135;63;122;90;51;147;134;139;168;195;145;13;132;169;188;70;3;15;155;152;170;34;55;18,639094228782676954,0.081938
greedy_intra:edges_start:random,76,48014,22163,25851,549838,488,155;3;70;161;132;169;188;6;147;51;90;122;135;63;38;27;16;1;156;198;117;193;31;54;73;136;190;80;162;45;175;78;5;36;61;91;141;21;87;82;8;144;111;35;109;0;29;160;33;56;104;177;25;138;11;139;168;195;13;145;15;189;34;18;55;183;130;95;62;124;143;106;128;86;176;180;113;103;163;153;81;77;187;89;127;137;114;194;166;185;179;66;94;47;148;20;28;140;152;184,4257208378302331221,0.082325
greedy_intra:edges_start:random,77,46719,20263,26456,647751,530,176;180;113;103;114;127;89;163;187;146;153;77;141;91;61;36;21;8;104;33;160;0;35;109;29;11;138;182;25;177;5;78;175;80;190;73;164;31;54;193;117;198;112;121;51;191;90;131;1;135;102;63;122;133;10;178;147;6;188;169;132;126;168;195;13;145;15;70;3;155;152;34;55;18;62;124;143;159;106;128;95;130;183;140;4;149;28;20;60;148;47;94;66;179;22;99;185;86;166;194,260199616223544844,0.077872
greedy_intra:edges_start:random,78,46755,21276,25479,808664,595,55;18;83;62;128;124;106;143;111;104;56;8;82;21;61;36;141;77;153;187;163;89;127;137;114;103;26;113;180;176;194;166;86;185;99;179;66;94;47;148;20;130;95;183;140;152;170;184;155;3;70;15;145;13;195;168;126;132;169;188;6;147;51;125;121;131;90;122;107;40;63;135;38;1;198;117;193;31;54;73;136;190;80;175;78;5;177;25;138;139;11;49;33;160;144;29;0;109;35;34,9165775743103246873,0.101592
greedy_intra:edges_start:random,79,48516,22567,25949,709957,503,182;138;33;104;8;82;111;144;160;29;0;35;109;168;195;13;126;6;188;169;132;70;3;15;145;189;155;184;152;170;34;55;18;83;62;128;86;185;130;95;183;140;20;148;47;94;179;166;194;113;103;180;176;106;124;143;159;153;163;89;127;114;137;165;187;81;77;97;141;91;61;36;177;5;142;78;175;80;190;193;117;54;31;73;25;158;121;131;1;135;63;122;133;10;90;51;147;134;139;11,6391021529042820587,0.079940
greedy_intra:edges_start:random,80,46879,21965,24914,635375,470,121;51;191;90;133;10;147;188;169;139;11;138;182;25;177;21;82;8;104;33;160;144;111;35;109;0;12;29;168;195;13;132;145;15;3;70;155;152;170;34;55;18;83;62;124;143;106;128;86;95;130;183;140;28;20;148;47;94;179;185;166;194;176;180;113;103;114;137;127;89;163;187;153;77;141;91;61;36;5;78;175;142;45;80;190;73;164;54;31;193;117;1;27;38;63;40;107;122;135;131,3218645874407649952,0.077391
greedy_intra:edges_start:random,81,48942,22160,26782,601182,487,138;104;144;8;111;82;21;61;36;91;141;97;77;81;35;143;159;106;124;128;153;163;103;89;127;137;114;113;180;176;194;166;86;185;94;47;148;20;28;140;183;95;62;18;55;34;170;152;184;155;15;3;70;161;132;169;188;134;6;147;71;51;90;122;135;63;38;1;198;117;193;31;54;73;136;190;80;175;78;142;5;177;25;158;121;182;139;168;195;126;13;145;189;69;109;0;29;160;33;11,8823794228632981003,0.084285
greedy_intra:edges_start:random,82,48985,21956,27029,537091,493,8;104;33;111;77;141;81;153;187;163;103;89;165;127;137;114;113;176;194;166;106;124;62;18;55;140;183;95;86;185;94;47;148;20;28;149;4;152;34;35;109;0;29;145;15;3;70;188;169;132;195;168;139;11;138;25;158;112;121;131;125;90;191;120;51;98;118;134;6;147;178;10;133;122;63;135;1;156;198;117;193;31;54;164;73;136;190;80;45;142;175;78;5;177;36;61;91;21;87;82,3096727487887595293,0.076971
greedy_intra:edges_start:random,83,49349,23669,25680,521388,472,194;113;103;127;89;163;187;77;141;61;91;36;177;5;78;175;142;45;25;121;54;73;136;80;190;193;31;117;198;156;24;1;27;38;135;63;40;107;10;133;122;90;147;6;188;169;132;13;145;15;161;70;3;155;152;149;28;20;60;148;140;183;95;47;94;179;185;86;106;124;62;18;55;34;35;109;0;29;168;195;126;43;134;139;182;138;11;49;33;160;104;21;87;82;8;144;111;81;153;176,7726874536082454467,0.070164
greedy_intra:edges_start:random,84,50138,22977,27161,471373,463,148;20;140;152;170;184;155;3;15;167;189;145;195;168;126;13;70;161;132;169;188;6;147;191;90;10;133;122;107;40;63;135;38;1;117;54;73;31;193;190;80;175;78;5;121;131;51;134;43;139;11;33;160;144;56;104;138;25;177;36;61;91;141;97;77;82;21;8;111;39;29;0;109;35;143;159;81;153;163;89;127;114;103;113;180;176;194;166;86;128;106;124;62;18;55;183;95;185;179;94,8318325025479803146,0.075955
greedy_intra:edges_start:random,85,48612,22239,26373,747502,537,133;63;135;1;121;131;122;90;191;125;51;118;25;177;136;73;164;31;54;117;198;193;190;80;162;45;142;175;78;5;36;61;21;87;91;141;97;77;82;8;104;138;139;11;33;160;144;111;81;153;187;165;127;89;163;103;114;113;180;176;194;166;86;179;185;95;183;140;94;47;148;20;28;152;170;34;55;18;62;128;124;106;143;35;109;0;29;168;195;145;15;3;70;161;13;132;169;188;147;10,3878619622584048457,0.096377
greedy_intra:edges_start:random,86,46042,19027,27015,789272,534,147;6;188;169;132;161;70;3;15;145;13;126;195;168;139;11;182;138;33;160;29;0;109;35;143;159;106;124;62;83;18;55;34;170;152;174;183;140;28;20;60;148;47;94;179;99;130;95;185;86;166;194;176;180;113;26;103;114;127;89;163;165;187;153;81;111;77;97;141;91;79;61;36;21;82;8;104;177;5;78;175;45;80;190;73;164;54;31;193;117;198;1;27;38;63;135;122;133;90;51,7770030851952162224,0.088274
greedy_intra:edges_start:random,87,48929,23336,25593,614969,525,81;106;143;35;109;0;29;195;168;139;11;138;182;25;177;5;78;175;45;80;190;136;73;164;54;31;193;117;151;19;112;121;90;122;135;131;198;42;156;24;1;27;38;63;40;107;133;147;6;188;169;132;145;15;70;3;155;184;152;170;34;55;183;140;4;149;28;20;60;148;47;94;179;166;194;86;185;130;95;18;62;124;128;176;180;113;103;89;163;187;153;77;141;36;61;21;104;33;8;111,2885462111835533530,0.077560
greedy_intra:edges_start:random,88,49020,22196,26824,581508,507,15;145;132;13;195;168;139;134;169;188;6;147;178;10;133;72;107;40;100;63;102;135;122;90;51;121;131;1;198;117;193;31;54;73;190;80;175;5;36;61;141;21;87;82;111;8;104;177;25;182;138;56;144;160;33;11;49;29;0;35;109;189;34;55;18;83;62;128;124;106;143;159;81;77;153;187;165;127;89;163;103;113;176;194;166;86;185;47;148;20;28;149;140;183;152;170;184;155;3;70,12162606864916919,0.078440
greedy_intra:edges_start:random,89,48724,21611,27113,571187,475,134;139;11;138;33;29;109;35;0;160;104;144;111;8;82;87;21;25;158;121;131;90;191;51;147;10;133;122;135;63;38;27;16;197;1;156;42;30;198;117;193;31;54;164;73;5;78;175;142;45;162;80;190;136;177;36;61;141;97;77;81;153;159;143;124;106;176;103;89;163;113;194;166;86;95;185;179;94;47;148;20;28;140;183;62;18;55;152;155;3;70;15;145;168;195;13;132;169;188;6,2071173786842396557,0.080134
greedy_intra:edges_start:random,90,48764,22607,26157,465267,462,43;168;195;29;0;109;35;111;143;159;106;124;176;113;103;194;166;86;95;130;99;185;179;94;47;148;20;28;140;183;62;18;55;34;170;152;155;189;3;70;161;15;145;13;132;169;188;6;147;191;90;178;10;133;122;135;63;38;1;117;193;80;190;31;54;121;25;177;5;45;142;175;78;36;61;91;141;187;127;89;163;153;77;82;21;8;104;56;144;160;33;138;182;11;139;74;118;98;51;134,6502019605675348510,0.068913
greedy_intra:edges_start:random,91,47926,22201,25725,537033,502,188;169;132;13;126;168;139;11;160;29;0;35;109;195;145;15;161;70;3;155;184;152;149;28;140;183;34;55;18;62;143;106;124;95;130;99;148;20;60;47;94;179;185;86;166;194;176;113;103;163;89;127;165;187;153;81;111;144;56;8;82;77;141;91;21;104;33;138;182;51;121;25;177;61;36;5;78;175;142;45;162;80;190;136;73;164;54;31;193;117;198;156;1;38;63;135;122;90;191;147,7082209093716498920,0.076350
greedy_intra:edges_start:random,92,47585,21868,25717,643258,480,33;11;139;182;138;104;8;56;144;111;143;159;106;124;62;128;86;95;130;183;140;28;20;148;47;94;179;185;166;194;176;113;114;103;89;163;127;165;187;153;81;77;82;21;141;91;79;61;36;177;5;78;175;142;45;80;190;136;73;112;121;54;31;193;117;198;1;135;63;40;107;122;90;51;147;6;134;168;195;145;13;132;169;188;161;70;3;15;155;184;152;55;83;18;34;35;109;0;29;160,6358149818877817706,0.078306
greedy_intra:edges_start:random,93,47937,21730,26207,690522,537,179;22;185;95;99;94;47;148;60;20;28;140;183;152;184;155;15;3;70;161;188;6;169;132;13;145;195;168;139;182;138;11;33;144;160;29;0;109;35;111;8;82;21;61;36;5;78;175;142;45;80;190;73;54;31;193;117;198;1;135;63;122;133;147;71;191;90;51;121;158;25;177;91;141;77;81;146;187;153;159;143;106;124;34;55;18;83;62;128;86;176;180;113;103;163;89;127;114;194;166,8538020931792427635,0.084343
greedy_intra:edges_start:random,94,48638,22026,26612,589935,482,121;131;122;133;107;40;63;135;1;198;117;193;54;31;164;73;136;190;80;45;142;175;78;5;177;36;61;141;77;82;21;104;56;8;111;81;159;143;106;124;62;18;34;55;83;128;86;176;163;153;146;187;127;89;103;114;113;194;166;179;185;130;95;183;140;47;148;20;28;149;152;109;35;0;29;144;160;33;49;138;182;11;139;168;195;13;145;15;70;3;132;169;188;6;147;191;90;125;120;51,9175231538418714779,0.077855
greedy_intra:edges_start:random,95,48182,21581,26601,607185,504,139;11;138;182;25;121;131;90;51;147;133;122;135;1;156;198;117;193;31;54;164;73;136;105;190;80;162;45;142;175;78;5;177;36;21;104;8;82;77;81;111;144;33;160;29;0;109;35;143;159;153;187;163;89;127;114;103;113;194;166;176;180;106;124;62;34;55;18;128;86;185;95;183;130;99;179;172;66;94;47;148;60;20;28;140;152;184;155;15;3;70;161;188;6;169;132;13;145;195;168,3777596271353687916,0.079003
greedy_intra:edges_start:random,96,45838,19542,26296,756640,511,130;95;86;166;194;176;113;103;114;127;89;163;187;153;81;77;141;91;36;61;87;82;8;111;144;104;21;177;5;78;175;142;45;162;80;190;136;73;54;31;193;117;198;1;38;63;135;131;121;98;51;125;90;191;147;6;188;169;132;13;161;70;3;15;145;195;168;43;139;11;182;138;33;160;29;0;109;35;143;106;124;62;18;55;34;189;155;184;170;152;183;140;149;28;20;148;47;94;179;185,630428911585382964,0.087839
greedy_intra:edges_start:random,97,46949,20786,26163,595688,569,34;152;155;3;70;145;168;195;13;132;169;188;6;147;134;85;98;118;74;182;138;139;11;49;29;0;109;35;111;144;160;33;104;8;82;21;177;25;121;51;90;122;133;107;40;63;102;135;1;156;198;117;193;31;54;73;136;190;80;162;175;78;142;45;5;36;61;141;77;81;153;146;187;165;127;89;163;103;113;180;176;194;166;86;185;179;66;94;47;148;20;28;140;183;55;18;62;124;106;143,304594219737977218,0.084865
greedy_intra:edges_start:random,98,47534,20794,26740,670240,493,70;15;145;132;188;169;13;195;168;139;74;118;134;6;147;10;133;107;40;100;63;102;135;122;90;191;51;121;1;198;117;54;31;193;190;80;162;45;142;175;78;5;177;36;61;91;141;21;87;82;77;81;153;163;89;127;103;113;180;176;194;166;86;185;95;99;22;179;94;47;148;60;20;140;183;34;55;18;62;124;106;143;35;109;0;12;111;144;56;8;104;138;182;11;33;160;29;189;155;3,6672271496824052302,0.080994
greedy_intra:edges_start:random,99,47208,22724,24484,464849,492,145;15;155;3;70;161;13;132;169;188;139;11;182;138;33;160;144;104;8;21;177;25;121;51;134;6;147;10;133;122;63;135;90;131;38;1;117;193;31;54;73;136;190;80;175;78;142;5;36;61;141;97;77;82;50;81;153;187;163;89;127;137;114;103;113;176;194;166;86;185;95;130;99;22;179;94;47;148;60;20;28;149;4;140;183;152;34;55;18;62;124;106;143;111;35;109;0;29;168;195,3325063744782564306,0.077583
greedy_intra:edges_start:random,100,48075,21077,26998,656570,508,162;80;190;193;31;73;54;117;198;42;156;24;1;38;135;63;100;40;107;133;122;90;51;121;158;25;21;82;8;111;144;56;104;160;33;138;182;139;11;29;0;35;109;145;15;13;195;168;126;132;169;188;70;3;155;184;152;183;140;20;148;47;94;95;86;185;179;166;194;114;127;89;163;103;113;180;176;128;83;55;34;18;62;124;106;143;153;81;77;97;141;91;61;36;177;5;45;142;78;175,7778155358978326861,0.081394
greedy_intra:edges_start:random,101,48969,22985,25984,619891,463,56;104;8;82;87;21;91;61;36;78;175;80;190;5;177;25;121;54;31;193;117;198;1;16;27;38;63;122;32;135;131;125;51;191;90;133;10;147;6;188;169;134;139;138;11;168;195;13;132;161;70;3;15;145;189;155;184;152;183;140;28;20;60;148;94;47;66;179;185;95;62;18;34;109;29;0;35;143;159;106;124;86;166;194;176;113;103;127;89;163;153;187;141;77;81;41;111;160;33;144,6196385130229904786,0.074188
greedy_intra:edges_start:random,102,50869,22506,28363,569195,530,155;70;3;15;145;195;168;126;13;132;169;65;188;6;147;71;51;90;133;122;135;63;38;27;1;117;193;31;54;19;112;121;25;173;73;136;162;80;190;175;78;5;177;7;36;61;79;91;141;97;77;153;163;103;113;194;166;176;81;111;144;82;87;21;8;104;56;33;138;182;74;118;134;43;139;11;160;0;29;109;35;143;106;124;62;95;86;185;179;94;47;148;20;28;140;183;55;18;34;152,5322688318328167089,0.078344
greedy_intra:edges_start:random,103,47837,19542,28295,589098,525,28;149;4;140;183;170;152;184;155;189;145;15;3;70;161;132;13;195;168;139;134;169;188;6;147;71;191;121;51;125;90;122;135;63;38;27;1;156;198;117;193;31;54;73;136;190;80;162;175;78;142;45;5;177;36;61;79;91;141;77;82;87;21;8;104;138;11;49;33;160;144;56;111;35;29;0;109;34;55;18;83;62;124;106;143;153;163;89;103;113;180;176;194;166;86;185;179;94;148;20,6404952768314623880,0.087809
greedy_intra:edges_start:random,104,46734,20934,25800,567196,525,176;113;194;166;86;95;130;185;179;94;47;148;60;20;28;149;4;140;183;152;170;184;155;189;15;3;70;188;6;169;132;145;13;195;168;43;134;51;90;10;133;122;63;102;135;131;121;198;117;193;54;31;73;136;190;80;45;142;175;78;5;177;36;61;91;141;77;81;153;111;82;21;87;8;104;138;182;139;11;49;33;160;144;29;0;109;35;34;55;18;62;124;106;143;163;127;89;137;114;103,7857028699272119713,0.088755
greedy_intra:edges_start:random,105,47599,21847,25752,569651,542,175;78;5;177;36;61;21;82;141;77;81;153;187;163;89;127;103;113;176;194;166;86;128;106;124;62;18;55;95;185;179;94;47;148;20;28;183;140;152;155;15;3;70;132;169;188;6;147;10;133;90;191;51;98;118;74;134;168;195;145;29;0;109;35;111;8;104;144;160;33;138;11;139;182;25;158;112;121;131;135;122;100;107;40;63;38;27;16;1;24;156;42;198;117;193;31;54;73;190;80,3127542906460330369,0.094968
greedy_intra:edges_start:random,106,48271,21782,26489,599120,535,139;134;51;118;25;177;21;82;77;81;153;163;103;113;114;137;127;89;165;187;97;141;61;36;5;78;175;80;190;193;31;164;73;54;117;121;131;135;122;90;191;147;6;188;169;132;168;195;13;161;70;3;15;145;189;155;184;152;170;34;55;174;183;140;4;149;28;20;148;47;94;179;172;166;194;180;176;86;185;95;18;62;128;124;106;143;35;109;0;29;144;111;8;104;182;138;33;160;49;11,2355186235847214721,0.089325
greedy_intra:edges_start:random,107,47862,21296,26566,597502,495,138;139;11;33;160;144;104;8;21;36;61;91;141;97;77;111;29;109;0;35;143;34;55;18;62;95;130;185;86;128;124;106;159;81;153;163;165;127;89;103;113;176;194;166;179;94;47;148;20;28;149;4;140;183;152;184;155;3;70;15;145;168;195;13;132;169;188;147;90;122;40;63;102;135;131;125;51;98;118;116;121;1;156;198;117;193;31;54;164;73;136;190;80;45;142;175;78;5;177;25,4758983960768196270,0.083357
greedy_intra:edges_start:random,108,47108,19525,27583,795743,545,18;55;34;170;152;174;183;140;28;20;148;47;94;66;179;185;22;99;130;95;86;166;194;176;113;103;89;163;153;77;141;91;36;61;21;87;82;8;56;104;144;160;33;138;182;25;177;5;78;175;45;80;190;136;73;164;31;54;193;117;198;1;135;63;122;131;121;51;90;147;6;188;169;70;3;155;184;189;15;145;13;132;126;195;168;43;139;11;49;29;12;0;109;35;111;143;106;124;62;83,6537258316106007349,0.093995
greedy_intra:edges_start:random,109,48688,22287,26401,539443,441,113;26;103;127;89;163;153;187;165;137;114;194;166;86;185;95;130;99;22;179;172;66;94;154;47;148;60;20;28;149;4;140;183;62;18;55;34;152;184;155;3;70;169;132;13;145;195;168;51;121;90;133;40;107;122;135;63;38;27;1;117;54;31;190;80;175;78;5;177;123;25;182;138;11;33;160;144;29;0;109;35;111;104;8;21;61;36;91;141;97;77;82;81;159;143;124;106;176;180;88,5945034465519551129,0.075715
greedy_intra:edges_start:random,110,47945,22143,25802,642834,495,87;21;177;25;121;131;51;90;133;122;63;102;135;1;117;54;31;193;190;80;45;175;78;5;36;61;91;141;97;153;146;187;163;89;165;127;137;114;26;103;113;180;176;194;166;179;94;47;148;20;28;149;140;183;95;99;130;185;86;128;106;124;62;18;55;34;170;152;155;3;70;15;145;195;126;13;132;169;188;6;147;134;139;168;43;11;138;33;160;104;8;144;29;0;109;35;111;81;77;82,6550102178803336552,0.073711
greedy_intra:edges_start:random,111,46795,18931,27864,643934,510,179;99;185;86;166;194;176;180;113;103;127;89;163;153;81;77;141;91;61;36;177;5;45;142;78;175;162;80;190;136;73;164;54;31;193;117;198;156;1;135;122;131;121;51;90;147;6;188;169;132;13;161;70;3;155;184;152;189;15;145;195;168;43;139;11;138;33;160;144;104;8;82;111;39;29;0;109;35;143;106;124;62;18;55;34;183;140;4;149;28;199;9;148;20;23;60;47;154;94;66,8297201288183855089,0.078103
greedy_intra:edges_start:random,112,47222,20886,26336,608572,523,141;187;163;165;127;89;103;114;113;180;176;194;166;86;185;179;66;94;47;148;60;20;28;149;140;183;152;155;70;3;15;145;168;195;13;132;169;188;6;134;147;71;51;90;122;63;135;131;121;112;158;25;177;173;73;31;54;117;193;136;190;80;162;175;78;142;45;5;36;61;91;21;87;82;8;111;144;104;138;182;139;11;49;33;160;29;0;109;35;34;55;18;62;128;124;106;143;153;81;77,2859631992023950829,0.087087
greedy_intra:edges_start:random,113,47280,20132,27148,605019,494,172;179;66;94;47;148;60;20;28;149;4;152;140;183;95;130;185;86;128;62;83;18;55;34;124;106;159;143;35;109;0;12;29;168;195;13;145;15;3;70;132;169;188;6;147;134;139;11;49;138;182;25;158;121;51;90;122;63;135;1;117;193;31;54;73;136;190;80;175;78;142;5;177;21;61;36;141;97;77;82;8;104;56;33;160;144;111;41;81;153;163;165;127;89;103;113;180;176;194;166,7115509982288197910,0.080811
greedy_intra:edges_start:random,114,46243,20437,25806,718121,524,49;33;160;29;0;109;35;143;106;124;128;62;18;55;34;170;152;183;140;28;20;148;47;94;179;22;99;130;95;185;86;166;194;176;180;113;114;103;163;89;127;165;187;153;81;77;141;36;21;87;82;8;111;144;104;138;182;25;177;5;78;175;45;80;190;31;54;117;198;1;135;102;63;40;107;10;133;122;131;121;125;90;191;51;147;134;6;188;169;132;70;3;15;145;13;126;195;168;139;11,8058410097056985810,0.083319
greedy_intra:edges_start:random,115,48377,21558,26819,706289,527,121;51;191;90;122;135;63;40;107;147;6;188;169;132;126;43;168;195;13;145;15;70;161;3;155;152;140;183;9;199;28;20;60;148;47;94;185;95;86;166;194;176;113;103;127;165;89;163;153;159;143;106;124;128;62;18;55;34;109;0;29;160;33;49;11;139;134;118;74;182;138;104;8;21;87;82;111;35;81;77;141;91;79;61;36;177;5;45;142;78;175;162;80;190;193;31;54;117;1;131,6969428890492634778,0.078218
greedy_intra:edges_start:random,116,47143,21247,25896,652333,442,66;94;47;148;60;20;140;183;95;185;86;128;62;83;18;34;55;170;152;184;155;189;145;15;3;70;132;169;188;13;195;168;139;11;138;182;118;51;125;121;131;90;191;147;10;133;122;135;63;38;1;198;117;193;31;54;73;136;190;80;45;175;78;5;177;36;61;91;141;97;77;82;8;111;144;104;33;160;29;0;109;35;143;159;106;124;176;113;26;103;89;163;153;187;127;137;114;194;166;179,871696967454193054,0.070729
greedy_intra:edges_start:random,117,48568,22069,26499,559647,478,132;145;195;126;168;139;134;51;121;131;90;10;133;122;63;135;1;198;117;54;31;193;190;80;45;5;175;78;177;36;61;141;77;81;187;153;159;143;106;124;128;62;83;18;55;95;130;99;22;185;86;176;180;113;103;163;89;127;114;194;166;52;179;172;57;66;94;154;47;148;60;20;28;140;183;152;170;34;109;0;35;111;82;8;104;138;182;11;33;144;160;29;189;155;15;3;70;188;169;13,3896689007348689529,0.075797
greedy_intra:edges_start:random,118,47190,21496,25694,545844,517,122;90;191;147;188;169;132;70;3;155;184;152;170;189;15;145;13;126;195;168;11;139;43;134;51;121;25;182;138;33;144;160;29;0;109;35;111;56;104;8;21;82;77;81;106;124;62;83;18;55;34;183;140;149;28;20;60;148;47;94;66;179;22;99;130;95;185;86;166;194;176;113;103;163;89;127;165;187;153;141;61;36;177;5;142;78;175;80;190;136;73;54;31;193;117;1;27;38;63;135,195873472379566261,0.094003
greedy_intra:edges_start:random,119,47445,21040,26405,661046,491,73;190;80;162;45;142;175;78;5;177;21;104;8;82;87;61;36;91;141;97;77;81;111;29;0;109;35;143;106;124;128;95;130;185;86;176;180;153;163;89;127;103;113;194;166;52;172;179;22;99;94;47;148;60;20;140;183;55;83;62;18;34;170;152;155;3;70;15;145;168;195;13;132;169;188;6;134;139;182;11;160;144;33;138;25;121;51;90;122;135;63;38;27;1;156;198;117;193;31;54,8700442137687682133,0.078022
greedy_intra:edges_start:random,120,48517,21207,27310,757740,515,164;54;31;193;117;198;156;1;38;63;135;122;90;147;6;134;85;74;118;51;121;158;25;177;21;87;82;8;104;182;138;144;111;143;106;124;35;109;0;29;160;33;49;11;139;168;195;188;169;132;13;145;15;70;3;189;155;152;149;28;20;23;60;148;47;154;94;66;179;185;130;95;183;140;34;55;18;62;86;166;194;176;113;163;153;81;77;141;91;61;36;5;78;175;45;162;80;190;136;73,664606655755858752,0.084052
greedy_intra:edges_start:random,121,47040,22422,24618,605251,538,86;176;180;163;187;165;127;89;103;113;194;166;185;179;94;47;148;60;20;28;149;140;183;9;99;130;95;62;18;55;34;152;184;155;3;70;15;145;132;169;188;6;134;147;71;51;191;90;122;133;10;107;40;63;102;135;131;121;1;198;117;193;31;54;73;190;80;175;78;142;5;177;25;182;138;104;160;33;11;139;168;195;29;0;109;35;111;8;82;21;61;36;141;77;81;153;143;106;124;128,7324398011737680091,0.090033
greedy_intra:edges_start:random,122,47010,21658,25352,736969,544,124;143;106;180;176;166;194;113;114;127;89;103;163;187;153;77;141;91;61;36;177;21;82;8;104;138;182;25;158;121;112;54;31;164;73;136;5;78;175;45;80;190;193;117;198;156;1;27;38;135;63;40;107;133;122;90;191;51;71;147;6;188;169;132;70;3;15;145;13;195;168;139;11;33;160;144;111;35;109;0;29;189;155;184;152;140;28;20;148;47;94;179;185;86;95;130;183;55;18;62,2342208425154223190,0.086197
greedy_intra:edges_start:random,123,48345,21379,26966,606939,539,127;89;103;163;153;81;77;21;82;111;8;104;56;144;160;33;138;139;11;29;0;109;35;143;106;124;62;18;55;183;95;130;99;185;86;176;113;166;179;94;47;148;20;140;152;170;184;155;3;70;15;145;168;195;13;132;169;188;6;147;10;133;122;135;63;102;38;27;16;1;198;117;193;31;73;54;151;19;112;121;90;51;118;74;25;177;5;45;136;190;80;175;78;36;61;79;91;141;97;187,9214161470698830068,0.080191
greedy_intra:edges_start:random,124,47180,20948,26232,711479,561,20;60;148;47;94;179;99;185;86;166;194;176;113;103;163;187;97;141;61;36;177;5;78;175;142;45;80;190;136;73;164;54;31;193;117;198;156;24;1;131;121;51;90;122;135;63;40;107;133;147;134;6;188;169;13;132;161;70;3;15;145;126;195;168;139;11;182;138;144;56;104;33;160;29;0;109;35;111;8;21;82;58;77;81;153;143;106;124;62;18;55;34;189;155;184;170;152;183;140;28,2628335342788295817,0.090036
greedy_intra:edges_start:random,125,47042,21433,25609,604088,529,1;198;117;193;31;54;164;73;190;80;162;45;142;175;78;5;177;36;61;141;77;81;153;187;163;89;127;103;113;180;176;88;194;166;86;185;179;66;94;47;148;20;28;149;4;152;170;140;183;130;95;106;124;62;18;55;34;35;109;0;29;111;8;82;87;21;104;160;33;138;25;121;131;90;191;51;118;134;139;11;168;195;13;145;15;155;3;70;132;169;188;6;147;10;133;107;40;63;135;38,4106501097297955035,0.084555
greedy_intra:edges_start:random,126,47390,20707,26683,652938,547,36;61;79;91;141;97;77;81;14;41;111;144;56;104;8;82;21;25;182;138;139;11;33;160;29;0;109;35;143;62;128;124;106;163;153;187;165;127;89;103;113;180;176;194;166;86;185;99;179;66;94;47;148;20;28;149;140;183;9;130;95;18;55;34;170;152;155;70;3;15;145;195;168;132;169;188;6;147;191;90;51;121;131;122;63;135;1;117;54;31;193;190;80;162;45;142;175;78;5;177,2296671390077662213,0.095039
greedy_intra:edges_start:random,127,47752,21202,26550,551341,498,61;79;91;87;21;177;25;182;138;33;160;144;104;8;82;141;77;153;163;113;176;194;166;86;95;130;185;179;66;94;47;148;60;20;28;149;4;140;183;55;18;62;124;106;143;35;0;29;109;34;170;152;155;145;15;3;70;161;132;13;195;168;11;139;43;134;169;188;6;147;178;10;133;122;107;40;63;102;135;90;191;51;121;131;1;198;117;193;31;54;164;73;190;80;175;78;142;45;5;36,6695279620536776111,0.073442
greedy_intra:edges_start:random,128,49121,23676,25445,620913,507,81;77;97;187;163;89;127;103;113;176;194;166;179;185;86;128;183;95;130;99;66;94;47;148;60;20;28;140;152;184;155;3;70;145;34;55;18;62;124;106;153;159;143;109;35;0;29;144;160;33;11;139;168;195;132;169;188;6;147;71;51;90;122;133;10;107;40;63;135;1;156;198;117;193;190;80;175;78;5;73;31;54;112;121;158;25;182;138;104;56;8;82;87;21;177;36;61;91;141;111,1158870983394485368,0.079844
greedy_intra:edges_start:random,129,48939,23031,25908,589691,504,190;80;45;142;175;78;5;177;123;25;158;121;51;182;138;139;11;33;160;35;109;0;29;168;195;145;15;34;55;18;62;128;86;185;130;95;124;106;143;153;81;111;8;21;61;36;141;77;97;187;163;26;103;89;127;165;137;114;113;176;194;166;179;94;47;148;20;140;183;152;155;3;70;13;132;169;188;6;147;90;122;135;107;40;63;38;27;16;1;156;198;117;193;164;73;31;54;151;173;136,3342174534486937731,0.086573
greedy_intra:edges_start:random,130,48421,22858,25563,627295,539,117;193;190;80;136;73;164;31;54;151;19;112;121;118;134;139;11;138;25;5;175;78;177;36;61;79;91;141;97;77;81;153;163;89;127;103;114;113;176;166;194;86;106;124;143;35;109;0;29;160;111;82;21;8;104;33;168;195;145;15;34;55;18;62;95;130;99;185;179;172;66;94;47;148;20;28;140;183;152;155;3;70;13;132;169;188;6;147;71;51;90;122;133;107;40;63;135;38;1;198,5732261700615655409,0.092208
greedy_intra:edges_start:random,131,48378,21363,27015,601184,505,34;55;18;62;124;106;143;111;144;104;8;82;21;177;25;158;121;131;90;191;51;134;168;43;139;11;138;33;160;29;0;35;109;69;189;155;3;70;161;15;145;13;195;126;132;169;188;6;147;122;63;135;1;198;117;151;112;19;54;31;193;164;73;136;190;80;162;45;5;78;175;36;61;141;77;153;163;89;127;114;103;113;180;176;194;166;86;95;130;99;185;179;94;47;148;60;20;140;183;152,8847503142218522813,0.074926
greedy_intra:edges_start:random,132,49330,23298,26032,581422,506,89;163;153;187;141;61;36;5;78;175;80;190;193;198;117;54;31;73;136;177;21;104;138;11;139;182;25;121;131;1;156;16;27;38;63;135;32;122;90;51;71;147;6;188;169;168;195;145;70;3;155;184;152;183;140;4;149;28;20;60;148;47;94;179;185;86;95;62;55;18;34;170;189;109;35;0;29;39;160;49;33;144;111;8;82;77;81;159;143;106;124;166;194;176;180;113;103;114;127;165,1241580976934069760,0.084366
greedy_intra:edges_start:random,133,47278,20590,26688,589050,527,139;11;138;182;74;25;177;21;87;82;8;104;56;144;33;160;111;12;0;29;109;35;143;159;106;124;128;62;18;55;34;170;152;140;28;20;60;148;47;94;179;185;99;130;183;95;86;166;194;176;180;113;103;89;163;187;153;81;77;141;91;79;61;36;5;78;175;45;80;190;136;73;54;31;193;117;1;63;135;131;121;51;90;122;133;10;147;6;188;169;126;13;132;70;3;15;145;195;168;43,25393875846625359,0.081589
greedy_intra:edges_start:random,134,50296,20608,29688,764498,556,169;188;6;147;90;51;134;43;139;11;182;138;104;160;33;49;29;39;12;0;109;35;41;111;144;56;8;82;21;177;54;117;198;193;31;73;136;190;80;175;5;36;61;141;77;153;146;187;165;137;114;103;127;89;163;26;113;194;180;176;106;143;124;128;62;83;18;55;34;174;183;130;95;86;166;185;179;94;47;148;60;20;28;149;4;140;53;152;170;184;155;3;70;15;145;13;195;168;126;132,6918959320956637033,0.091711
greedy_intra:edges_start:random,135,47711,21928,25783,679945,509,104;144;111;35;109;0;29;160;33;11;138;25;121;51;191;90;122;133;10;147;6;134;168;195;13;132;169;188;70;3;15;145;155;184;152;170;34;18;55;183;140;20;60;148;47;94;66;179;185;22;99;130;95;62;124;106;128;86;166;194;176;180;113;114;127;89;103;163;187;153;77;141;61;36;78;175;162;80;190;193;31;117;198;1;38;63;135;131;151;54;73;136;45;142;5;123;177;21;82;8,5740116362072461883,0.086293
greedy_intra:edges_start:random,136,48699,21087,27612,664448,537,28;20;148;47;94;179;185;86;166;194;176;113;103;89;163;153;77;141;91;79;61;36;78;142;175;45;5;177;21;87;82;8;104;33;49;11;139;138;25;121;112;19;151;54;31;164;73;136;162;80;190;193;117;198;156;27;38;1;131;135;63;122;133;10;90;147;6;134;43;188;169;132;13;195;168;145;15;70;3;155;184;152;170;109;35;0;12;29;160;144;111;143;106;124;62;18;55;34;183;140,6691135337337926003,0.089250
greedy_intra:edges_start:random,137,48782,21669,27113,712698,479,174;152;184;155;189;170;34;18;62;124;106;159;143;35;109;0;29;168;195;145;15;3;70;13;132;169;188;6;147;134;139;11;182;138;33;160;104;21;82;8;56;144;111;81;77;91;79;61;177;121;131;135;1;198;117;193;31;54;73;190;80;175;78;5;36;141;187;153;163;89;127;137;114;103;26;113;180;176;194;166;179;66;154;94;47;148;60;20;28;149;4;140;183;95;130;99;185;86;128;55,8542058036922815973,0.083538
greedy_intra:edges_start:random,138,49187,23052,26135,543140,474,152;184;155;170;34;55;18;83;62;124;106;143;111;35;109;0;12;29;160;33;11;138;182;139;168;195;145;15;3;70;132;169;188;6;134;51;71;147;10;133;122;63;135;90;125;131;1;117;193;31;54;121;158;25;73;136;190;80;175;78;5;177;104;144;8;82;21;61;36;141;77;153;187;165;127;89;163;103;26;137;114;113;180;176;194;166;86;179;66;94;47;148;185;130;95;183;199;20;28;140,7481549317203184572,0.081803
greedy_intra:edges_start:random,139,47835,21219,26616,717647,515,51;125;90;191;10;133;122;135;1;198;117;54;31;193;190;80;162;175;78;36;61;91;21;177;5;45;136;73;112;121;25;182;138;139;11;33;160;104;8;111;82;141;77;81;153;163;103;89;165;127;137;114;113;176;194;166;86;95;130;99;185;179;94;47;148;20;140;183;152;34;55;18;62;124;106;143;35;109;0;29;189;155;15;145;3;70;161;13;195;168;126;132;169;188;6;147;134;74;118;98,510571388183460022,0.078689
greedy_intra:edges_start:random,140,46986,20942,26044,604935,540,31;193;117;198;1;135;63;40;107;122;90;191;51;147;6;188;169;132;13;195;168;145;15;161;70;3;189;29;0;109;35;143;159;106;124;62;18;55;34;170;155;184;152;183;140;20;148;47;94;66;179;185;130;95;86;166;194;176;180;113;103;89;127;165;163;187;153;81;77;141;91;61;36;78;175;162;80;190;45;5;177;21;87;82;8;111;144;160;33;49;11;139;182;138;56;104;25;121;73;54,1336662955039217207,0.086344
greedy_intra:edges_start:random,141,46126,21238,24888,714939,545,141;97;77;81;153;187;163;103;89;127;114;113;176;194;166;86;185;179;66;94;47;148;20;28;140;183;130;95;152;170;34;55;18;62;124;106;143;35;109;0;29;155;3;70;15;145;168;195;13;132;169;188;6;147;10;133;107;40;63;135;122;90;191;125;51;134;139;11;182;138;33;160;144;56;111;82;8;104;25;158;121;131;1;156;198;117;193;31;54;73;190;80;175;78;142;5;177;36;61;91,2869562693083362786,0.095037
greedy_intra:edges_start:random,142,49356,23326,26030,676867,510,54;117;198;156;1;151;19;131;135;63;40;122;90;147;134;6;188;169;132;13;145;195;168;49;33;160;29;0;109;35;111;81;159;143;106;124;128;62;18;55;152;170;184;155;3;70;15;189;34;183;140;20;148;47;94;179;185;130;95;86;166;194;176;180;113;103;127;89;163;153;187;141;77;82;8;144;104;138;182;11;139;74;118;98;51;121;25;177;21;61;36;5;45;142;78;175;80;190;193;31,1615921967322496427,0.084983
greedy_intra:edges_start:random,143,47394,21722,25672,587059,497,179;185;130;95;62;18;55;34;143;159;106;124;128;86;166;194;176;113;114;103;89;163;127;165;187;153;77;141;36;61;21;82;8;104;144;111;35;109;0;12;29;49;160;33;138;182;11;139;43;134;74;118;121;25;177;5;142;78;175;80;190;31;54;117;198;1;63;40;107;122;32;135;131;90;51;147;6;188;169;132;126;168;195;13;145;15;70;3;155;152;183;140;4;149;28;20;60;148;47;94,7130223336040838706,0.079476
greedy_intra:edges_start:random,144,46509,20188,26321,577156,536,169;188;6;139;11;29;0;109;35;111;8;104;144;160;33;138;121;51;125;90;191;10;133;122;135;63;27;38;16;1;198;117;193;54;31;73;136;190;80;162;175;78;142;45;5;177;36;61;141;77;21;82;50;81;153;163;89;127;137;114;103;113;180;176;194;166;86;128;106;124;62;18;34;55;95;130;185;179;94;47;148;20;28;149;4;140;183;152;170;184;155;189;3;70;15;145;168;195;13;132,8247449131206919031,0.085989
greedy_intra:edges_start:random,145,51043,22692,28351,608541,483,117;198;156;1;197;16;27;38;63;135;122;147;6;188;169;132;13;161;70;3;155;152;28;140;183;130;95;86;185;179;166;194;113;176;124;62;18;34;55;83;128;106;119;159;143;35;109;0;29;189;15;145;195;168;43;139;11;182;138;33;160;144;104;8;111;81;153;163;103;89;127;187;77;82;21;141;91;79;61;36;78;175;80;190;193;54;31;164;73;136;45;5;177;25;121;51;191;90;131;151,852799534990515939,0.079080
greedy_intra:edges_start:random,146,47775,22077,25698,683154,513,106;143;159;81;111;104;8;82;21;177;25;182;138;33;160;56;144;35;109;0;29;49;11;139;168;195;126;13;145;15;3;70;161;132;169;188;6;134;147;51;98;118;121;90;133;122;135;63;102;38;27;1;198;117;193;31;54;73;190;80;175;78;5;36;61;141;77;153;187;165;127;89;163;113;103;176;194;166;86;185;179;94;47;148;60;20;28;130;95;183;140;152;184;155;170;34;55;18;62;124,7163976259235033298,0.086819
greedy_intra:edges_start:random,147,48502,21572,26930,566943,482,20;28;149;4;140;183;152;170;184;155;3;70;15;145;195;126;13;132;169;188;6;147;191;90;10;133;122;63;135;1;156;198;117;193;31;54;73;19;112;121;51;134;43;168;139;11;138;25;177;5;78;175;36;61;91;141;77;97;187;163;153;81;111;82;8;104;33;160;29;0;35;109;34;55;18;83;62;124;143;159;106;128;95;86;176;180;103;89;127;113;194;166;172;179;185;99;94;47;148;60,3838898640811329573,0.075761
greedy_intra:edges_start:random,148,51293,21766,29527,693010,491,187;153;163;103;113;176;194;166;86;185;99;130;95;183;140;152;184;155;3;70;15;189;34;55;18;83;62;128;124;106;159;143;35;109;0;111;81;77;82;21;8;104;144;29;160;33;138;182;139;11;168;126;195;145;13;132;169;188;6;134;85;74;118;98;51;71;147;191;90;121;158;25;112;131;122;40;63;135;38;1;156;42;198;117;193;31;54;164;73;136;190;80;175;5;177;36;61;79;91;141,7012162498862997897,0.079795
greedy_intra:edges_start:random,149,47821,21938,25883,545205,462,5;177;21;61;36;91;141;77;153;81;111;8;144;56;104;138;139;11;49;33;160;29;0;109;35;34;55;106;124;62;18;128;86;176;163;127;89;103;113;194;166;185;95;130;99;179;94;47;148;60;20;28;140;183;152;155;3;70;15;145;195;168;132;169;188;6;134;147;71;191;90;51;118;74;182;25;121;131;135;122;40;63;38;27;1;24;156;198;117;193;54;31;164;73;136;190;80;175;78;142,1876997655214301433,0.077872
greedy_intra:edges_start:random,150,47575,20891,26684,559634,470,31;54;193;117;198;156;16;27;38;1;19;112;121;131;135;122;133;10;178;90;191;51;147;134;139;11;168;195;6;188;169;132;13;145;15;70;3;155;189;109;35;0;29;33;8;82;111;143;106;124;62;18;55;34;170;152;183;95;130;185;99;9;140;149;28;20;23;60;148;47;94;66;179;86;166;194;176;180;113;103;114;137;127;89;163;153;81;77;97;141;61;36;177;5;78;175;80;190;73;164,4893029521876209100,0.079550
greedy_intra:edges_start:random,151,48029,22031,25998,621382,499,140;183;34;55;18;62;124;106;143;35;109;0;29;160;111;82;21;8;104;56;144;33;11;189;170;152;155;3;70;15;145;13;132;169;188;126;195;168;139;138;182;74;134;6;147;10;133;122;135;63;38;27;1;156;198;131;90;121;151;117;193;31;54;73;190;80;45;142;175;78;5;177;36;61;79;91;141;97;77;153;187;163;103;89;127;114;113;180;176;194;166;86;95;185;179;94;47;148;20;28,6599448515070264235,0.075217
greedy_intra:edges_start:random,152,47540,22004,25536,524100,473,185;99;22;179;94;47;148;130;95;183;140;20;28;149;152;170;55;18;62;34;35;109;0;29;49;11;33;160;144;104;138;182;139;168;195;145;15;3;70;13;132;169;188;6;147;191;90;125;51;121;122;107;40;63;102;135;1;198;117;193;31;54;73;190;80;162;45;175;78;142;5;177;36;61;141;91;21;82;8;111;77;81;153;187;127;137;114;103;89;163;143;106;124;128;86;176;180;113;194;166,8957576757587884234,0.069696
greedy_intra:edges_start:random,153,48631,22885,25746,578596,465,15;3;70;132;169;188;6;134;147;10;133;63;38;27;1;135;122;90;191;125;51;121;112;158;25;182;138;33;160;104;177;5;73;31;54;117;198;193;190;80;175;78;36;61;21;82;8;111;143;106;124;128;176;180;103;163;153;81;77;187;89;127;137;114;113;194;166;86;95;130;99;22;185;179;66;94;47;148;60;20;59;28;149;4;140;183;152;55;18;62;34;35;109;0;29;11;168;195;13;145,7223943149844386689,0.072718
greedy_intra:edges_start:random,154,47628,21693,25935,646133,485,185;179;66;94;47;148;60;20;28;140;183;152;170;184;155;167;189;3;70;161;15;145;13;132;169;195;168;11;138;139;134;188;6;147;90;51;98;74;118;121;131;122;133;10;107;40;63;102;135;1;198;117;193;31;54;164;73;136;190;80;175;78;142;5;177;21;82;8;104;111;144;33;160;29;0;109;35;34;55;18;62;124;106;81;77;91;61;36;141;153;163;89;127;103;113;176;194;166;86;95,7724897852808728387,0.082839
greedy_intra:edges_start:random,155,47083,20596,26487,645992,505,122;133;90;191;51;125;131;121;25;182;11;139;134;6;188;169;132;168;195;13;145;15;70;3;155;189;109;35;0;12;29;160;33;138;56;104;8;82;144;111;106;124;62;55;18;34;170;152;183;140;199;4;149;28;20;148;47;94;179;22;99;130;95;185;86;166;194;176;113;103;127;89;163;187;153;81;77;97;141;91;36;61;21;177;5;78;175;80;190;73;54;31;193;117;198;156;24;1;135;63,6242754672304383088,0.077940
greedy_intra:edges_start:random,156,47372,20446,26926,865332,543,176;180;113;103;127;89;163;187;153;81;77;82;87;21;141;91;79;61;36;177;5;45;142;78;175;80;190;136;73;19;112;121;54;31;193;117;198;156;1;27;38;63;135;122;90;51;147;6;188;169;132;13;195;168;43;139;11;182;138;33;160;144;56;104;8;111;35;109;0;29;145;15;70;3;189;155;152;28;20;148;47;94;140;183;34;55;18;83;62;143;159;106;124;128;95;130;185;86;166;194,3301847972339617096,0.087432
greedy_intra:edges_start:random,157,49014,21361,27653,647409,519,94;47;148;20;140;183;83;62;18;55;34;152;155;145;15;3;70;161;132;13;195;168;126;169;65;188;6;147;90;122;63;135;1;198;117;193;190;80;73;31;54;121;25;177;5;142;175;78;36;61;91;21;82;8;104;111;144;33;138;182;139;11;49;160;39;29;0;109;35;143;159;153;81;14;77;141;97;187;163;89;165;127;137;114;103;26;113;176;194;166;86;106;124;128;95;130;185;99;22;179,2836463474177232562,0.079792
greedy_intra:edges_start:random,158,47166,22176,24990,782286,508,190;80;45;175;78;5;177;21;61;36;91;141;77;153;163;187;81;111;82;8;104;144;160;33;138;182;139;11;49;29;0;109;35;143;106;124;62;128;176;113;103;127;89;114;194;166;86;185;130;95;83;18;55;34;170;183;140;148;47;94;60;20;28;149;4;53;152;155;70;3;15;145;13;168;195;132;169;188;6;147;51;121;131;90;122;40;63;135;38;27;16;1;156;198;117;193;31;54;73;136,2017033012494191470,0.086025
greedy_intra:edges_start:random,159,49249,21152,28097,521079,469,179;185;86;166;194;113;103;127;89;163;187;153;180;176;106;124;143;35;109;0;12;29;49;33;160;144;8;82;21;61;36;91;141;77;111;104;138;11;139;168;195;126;43;134;118;51;131;121;158;25;123;177;5;142;78;175;80;190;73;164;31;54;193;117;198;156;24;1;38;63;102;135;122;90;191;71;147;6;188;169;132;13;145;15;70;3;155;184;152;55;34;18;62;95;183;140;28;20;148;94,7688936233156369994,0.081031
greedy_intra:edges_start:random,160,48312,23361,24951,591848,503,141;77;153;163;89;165;127;114;103;113;194;166;185;179;94;148;47;60;20;28;149;4;140;183;130;95;86;176;180;106;143;124;62;18;55;152;155;3;70;169;188;6;147;10;133;122;107;40;100;63;135;38;1;131;90;191;51;121;25;182;139;134;43;168;195;13;15;145;109;35;0;29;160;33;49;11;138;144;104;8;111;82;21;177;5;45;136;73;54;117;198;193;31;164;190;80;175;78;36;61,3170068111627016403,0.092352
greedy_intra:edges_start:random,161,49594,22461,27133,496273,476,121;51;118;74;134;168;195;13;145;15;155;189;3;70;132;169;188;6;147;191;90;133;122;63;102;32;135;1;198;117;193;190;80;45;142;175;78;5;177;21;36;61;79;91;141;97;77;81;111;82;8;104;138;33;160;144;0;35;143;153;163;89;127;103;113;176;166;179;185;130;99;66;94;47;148;20;140;183;95;86;128;106;124;62;18;55;34;152;170;109;29;11;139;182;25;73;164;31;54;112,7588917651175683963,0.084315
greedy_intra:edges_start:random,162,47348,22994,24354,484272,517,125;51;118;74;134;139;11;33;138;182;25;177;36;61;91;141;77;153;81;146;187;165;127;89;163;103;113;176;194;166;179;94;47;148;60;20;28;140;183;95;130;185;86;128;124;106;143;111;82;87;21;8;104;144;160;29;0;109;35;62;18;55;34;152;155;3;70;15;145;168;195;13;132;169;188;6;147;90;122;135;107;40;63;38;27;1;198;117;193;54;31;190;80;175;78;5;45;136;121;131,6259324146386800214,0.085375
greedy_intra:edges_start:random,163,46906,21810,25096,545150,528,55;18;62;128;124;106;143;81;153;163;89;103;114;127;187;77;141;36;61;82;8;111;144;160;33;11;139;138;104;21;177;5;142;78;175;80;190;136;73;164;31;54;193;117;198;156;24;1;131;121;90;122;135;63;100;40;107;133;10;147;6;188;169;132;168;195;13;70;3;15;145;29;0;35;109;189;155;184;152;140;28;149;4;20;60;148;47;94;66;179;166;194;113;180;176;86;185;130;95;183,1703423925674620548,0.072267
greedy_intra:edges_start:random,164,48641,21319,27322,511589,468,77;153;187;165;127;137;114;89;163;103;113;194;166;176;180;106;159;143;124;62;128;86;95;130;185;179;66;94;47;148;60;20;28;140;183;55;18;34;152;170;184;155;3;70;161;15;145;189;109;35;0;29;160;33;49;11;138;182;139;85;134;43;168;195;13;132;169;188;6;147;90;51;98;74;118;121;131;135;1;117;54;31;190;80;175;78;142;5;177;21;87;8;104;144;111;82;61;36;141;97,3131929443521667664,0.075779
greedy_intra:edges_start:random,165,49193,21259,27934,664297,476,77;141;36;61;91;81;41;111;35;109;0;29;160;144;56;104;8;82;87;21;177;5;78;175;142;45;80;190;136;73;164;54;31;193;117;198;156;1;131;121;112;19;158;25;138;33;11;139;134;118;51;90;122;135;63;100;40;107;133;10;147;6;188;169;132;13;195;168;145;15;161;70;3;155;152;149;28;20;140;183;95;130;185;86;166;194;176;113;103;89;163;106;124;62;18;55;34;143;159;153,6789468684704249265,0.077279
greedy_intra:edges_start:random,166,48138,21680,26458,741791,520,139;11;49;33;160;29;0;35;109;189;155;152;170;34;55;183;140;20;60;148;47;94;179;185;130;95;86;128;83;18;62;124;106;143;159;81;153;163;176;166;194;113;103;89;127;187;77;141;61;36;177;5;45;142;78;175;80;190;73;164;31;54;193;117;198;156;1;38;63;135;122;131;121;158;25;21;87;82;111;144;56;8;104;138;182;118;51;90;147;6;188;169;132;70;3;145;13;195;168;43,2056373977243255869,0.084086
greedy_intra:edges_start:random,167,48759,21709,27050,597328,472,63;135;1;156;198;117;193;151;54;31;164;73;136;190;80;45;142;175;78;5;173;19;112;121;51;118;134;139;11;33;160;29;109;35;0;12;111;144;56;8;82;87;21;104;138;182;25;177;36;141;77;153;187;165;127;89;103;163;143;106;124;62;128;176;180;113;194;166;86;95;185;179;66;94;47;148;60;20;28;140;183;55;18;34;152;184;155;3;70;15;145;13;195;168;169;188;147;90;133;122,6243713145356411239,0.083836
greedy_intra:edges_start:random,168,48523,22695,25828,662641,488,62;18;55;34;183;95;185;99;22;179;172;66;94;47;148;60;20;28;149;140;152;184;155;109;0;35;29;145;15;3;70;188;6;169;132;13;126;195;168;139;11;33;160;144;111;82;21;87;8;104;138;182;51;125;90;191;10;133;122;63;135;1;117;193;190;80;73;31;54;121;158;25;177;5;78;175;36;61;141;77;187;165;127;137;114;194;166;86;176;180;113;26;103;89;163;153;81;143;106;124,1321365307235018812,0.078944
greedy_intra:edges_start:random,169,47587,22248,25339,770166,477,163;187;153;81;77;97;141;91;36;61;21;177;5;175;80;190;73;54;31;193;117;198;1;131;121;25;182;138;139;11;33;160;144;56;104;8;82;111;41;35;109;0;29;43;134;51;191;90;122;135;102;63;40;107;133;10;178;147;188;169;132;13;195;168;145;15;3;70;155;152;170;34;55;18;62;128;106;143;124;183;140;28;20;23;60;94;47;148;179;185;95;86;166;194;176;113;103;114;127;89,5490902581566882700,0.081754
greedy_intra:edges_start:random,170,49047,22365,26682,495665,478,8;21;87;82;77;141;91;61;36;177;5;78;175;45;80;190;193;31;73;54;117;198;1;135;63;122;133;10;90;51;131;121;158;25;182;139;11;138;104;144;33;160;29;12;0;109;35;143;159;106;124;128;62;55;18;34;145;15;13;195;168;169;70;3;155;152;140;149;28;20;60;47;148;183;9;130;95;86;185;99;22;179;94;66;172;52;166;194;176;180;113;114;127;89;103;163;153;187;81;111,8560250045556269233,0.079530
greedy_intra:edges_start:random,171,46367,21244,25123,729541,534,132;169;188;6;134;147;133;107;40;63;102;135;122;90;191;51;121;1;198;117;193;54;31;73;136;190;80;175;78;142;5;177;104;144;8;82;21;61;36;91;141;77;81;153;187;163;89;165;127;137;114;103;113;180;176;194;166;86;185;95;130;99;179;94;47;148;20;140;183;152;34;55;18;62;124;106;159;143;111;35;109;0;29;160;33;49;138;182;11;139;168;195;189;184;155;3;70;15;145;13,9102683014123294867,0.087900
greedy_intra:edges_start:random,172,47312,20027,27285,596823,493,143;106;124;128;176;180;113;163;187;153;165;127;89;103;114;194;166;86;185;95;130;99;22;179;66;94;47;148;20;28;149;140;183;83;62;18;55;34;170;152;184;155;3;70;15;145;195;168;126;13;132;169;188;6;147;51;125;90;191;133;10;122;63;135;1;156;198;117;131;121;73;164;31;54;193;190;80;175;78;5;177;36;61;21;87;82;111;8;104;56;144;160;33;138;139;11;29;0;109;35,2088725621013272694,0.067364
greedy_intra:edges_start:random,173,47193,20413,26780,598024,506,160;33;49;11;139;43;134;147;6;188;169;132;13;195;168;145;15;3;70;155;184;170;152;183;140;20;60;148;47;94;66;179;185;130;95;86;166;194;176;113;103;163;153;77;97;141;91;61;36;177;5;78;175;142;45;80;190;193;31;73;54;117;198;156;1;38;63;135;122;133;10;178;90;191;51;131;121;158;25;182;138;104;56;8;21;82;111;143;106;124;62;83;18;55;34;35;109;0;29;144,7903612929124693677,0.084028
greedy_intra:edges_start:random,174,47874,22167,25707,746859,466,168;145;15;161;70;3;189;155;184;152;140;183;95;185;20;60;148;47;94;179;86;166;194;176;113;103;127;89;163;128;55;34;18;62;124;106;143;153;81;77;141;21;82;8;104;56;144;111;35;109;0;29;160;33;49;11;139;138;25;177;61;36;5;45;142;78;175;162;80;190;193;31;54;117;198;1;63;100;40;107;133;10;191;90;122;135;131;121;51;98;118;74;134;147;6;188;169;132;13;195,4110610247216855329,0.077505
greedy_intra:edges_start:random,175,47737,22467,25270,528522,503,194;113;103;89;127;163;187;153;77;97;141;91;79;61;36;177;5;45;142;78;175;80;190;31;54;193;117;198;1;121;51;125;90;191;133;122;135;102;63;40;107;10;147;134;6;188;169;132;13;70;3;155;15;145;195;168;139;182;138;11;33;160;144;111;8;56;104;21;82;81;159;143;0;29;35;109;34;152;183;140;28;20;60;148;47;94;179;86;185;22;99;130;95;55;18;62;124;106;176;166,6867198403670926586,0.073071
greedy_intra:edges_start:random,176,49658,20051,29607,559463,488,89;103;113;180;176;194;166;86;95;185;179;94;47;148;183;140;152;170;184;155;3;70;161;15;189;34;55;18;83;62;128;124;106;143;159;119;81;82;8;104;144;111;35;109;0;29;160;33;138;182;11;139;43;168;195;145;13;132;169;188;6;147;71;120;51;191;90;122;135;63;38;1;24;156;198;117;193;31;164;73;54;151;121;112;19;173;136;190;80;5;175;177;21;61;36;91;141;77;153;163,1827431458408823280,0.080639
greedy_intra:edges_start:random,177,48611,20679,27932,573948,486,185;166;194;176;113;103;163;153;81;77;97;141;36;61;21;82;111;68;8;144;56;104;138;182;11;139;134;51;121;25;123;177;5;78;175;142;45;162;80;190;136;73;164;31;54;193;117;198;156;24;1;38;63;135;122;133;10;90;191;71;147;6;188;169;132;13;70;3;15;145;195;168;49;33;160;29;0;109;35;143;159;106;124;86;95;183;62;18;55;34;155;184;152;140;28;20;148;47;94;179,3479260544702458563,0.073131
greedy_intra:edges_start:random,178,47706,20946,26760,600787,495,185;86;166;194;176;180;113;103;127;89;163;187;153;81;143;106;124;62;83;18;55;34;35;109;0;29;195;168;139;11;138;33;160;104;8;111;82;21;77;141;36;177;5;78;175;45;80;190;193;31;54;117;198;156;1;16;27;38;102;63;32;135;122;131;112;121;90;191;147;71;51;98;118;74;134;6;188;169;132;13;145;15;70;3;155;184;170;152;174;95;130;183;140;28;20;60;148;47;94;179,4119629159967532699,0.073647
greedy_intra:edges_start:random,179,48179,22091,26088,635716,485,52;166;194;176;180;113;103;114;127;89;163;187;141;91;61;36;177;5;142;78;175;45;80;190;136;73;54;31;193;117;1;135;63;122;131;121;25;138;11;139;134;51;90;147;6;188;169;132;13;195;168;33;160;29;0;109;35;111;8;104;21;82;77;81;153;119;159;143;106;124;95;130;99;185;86;128;83;62;18;55;34;145;70;3;155;184;170;152;183;140;4;149;28;20;148;47;94;66;179;172,5062282022388694158,0.077910
greedy_intra:edges_start:random,180,46907,20117,26790,653450,484,113;180;176;88;194;166;86;185;99;22;179;94;47;148;20;28;140;183;152;170;184;155;189;34;55;18;62;128;124;106;159;143;35;109;0;29;160;144;111;8;104;33;11;138;182;139;43;168;195;126;13;145;15;3;70;132;169;188;6;134;51;121;131;125;90;191;71;147;178;10;133;107;40;63;122;135;1;198;117;193;31;54;73;190;80;175;78;5;177;21;61;36;91;141;77;153;163;89;127;103,301944958894644447,0.075358
greedy_intra:edges_start:random,181,48102,22289,25813,589019,467,127;89;163;153;81;77;111;144;160;104;8;82;21;61;36;5;175;80;190;136;193;198;156;1;117;54;31;73;177;25;182;138;33;49;11;139;43;134;51;121;112;131;135;102;63;40;107;133;122;90;191;147;6;188;169;132;13;195;168;29;0;35;109;189;145;70;3;15;155;152;170;34;55;18;62;124;143;106;128;183;140;149;28;20;148;47;94;179;22;99;130;95;185;86;166;194;176;180;113;103,8956503908748473875,0.077850
greedy_intra:edges_start:random,182,46582,21072,25510,756689,531,134;139;11;138;33;160;104;8;21;177;25;121;131;125;90;191;51;147;133;122;63;135;1;24;156;198;117;54;31;193;190;80;175;78;142;5;36;61;91;141;77;153;187;165;163;89;127;137;114;103;26;113;180;176;194;166;86;95;185;179;172;66;94;47;148;60;20;28;149;140;183;152;34;55;18;62;124;106;143;159;111;144;29;0;35;109;189;155;3;70;161;15;145;168;195;13;132;169;188;6,4421482336311756334,0.090089
greedy_intra:edges_start:random,183,49141,22670,26471,459417,467,147;71;51;134;168;195;13;132;169;188;70;3;15;155;152;55;18;83;62;34;189;145;139;11;182;25;177;21;87;82;8;144;104;138;33;160;29;0;109;35;111;41;159;143;106;124;86;95;183;140;28;20;148;47;94;66;22;99;130;185;179;166;194;176;113;103;89;127;165;163;187;153;81;77;141;91;79;61;36;5;142;78;175;80;190;31;54;117;121;131;125;90;122;135;63;40;107;133;10;178,3983113856676181563,0.066660
greedy_intra:edges_start:random,184,48939,23115,25824,481188,475,194;113;114;103;176;106;124;62;83;18;55;34;109;0;35;143;153;163;89;127;165;187;81;77;141;91;36;61;82;87;21;177;5;45;142;78;175;80;190;193;117;31;73;54;198;1;38;63;40;107;122;135;131;121;158;25;182;138;33;56;104;8;111;144;160;29;195;168;11;139;51;90;147;6;188;65;169;132;13;145;15;70;161;3;155;152;183;140;4;149;28;20;148;94;179;185;130;95;86;166,2703214192022557212,0.075588
greedy_intra:edges_start:random,185,47043,21740,25303,635523,478,180;176;194;166;86;95;130;99;185;179;66;94;47;148;20;140;183;152;34;55;18;62;128;124;106;143;159;153;81;111;82;8;104;144;160;29;0;35;109;189;155;70;3;15;145;13;132;169;188;6;147;90;51;134;43;195;168;139;11;33;138;25;121;131;122;133;107;40;63;135;38;1;198;117;193;31;54;164;73;190;80;175;78;142;5;177;36;141;77;97;146;187;163;103;89;127;137;114;26;113,5623749589322377105,0.081886
greedy_intra:edges_start:random,186,48774,23021,25753,577951,504,126;195;168;29;0;109;35;111;144;160;33;138;182;11;139;43;134;188;6;147;122;135;32;63;102;38;27;16;1;131;90;191;51;121;25;104;8;82;87;21;177;5;73;31;54;117;193;190;80;175;78;36;61;141;77;81;153;187;165;127;89;163;103;137;114;113;194;166;185;130;95;86;176;106;124;128;62;18;55;34;183;140;148;47;94;60;20;59;28;149;152;155;189;145;15;3;70;169;132;13,5313571957324650396,0.077668
greedy_intra:edges_start:random,187,48468,22810,25658,485594,453,140;28;149;4;152;184;155;15;3;70;145;13;195;126;132;169;188;6;147;133;122;135;63;38;1;156;42;198;117;151;54;73;164;31;193;190;80;175;78;142;5;177;25;121;90;51;134;43;168;139;11;182;138;33;160;29;0;109;35;143;159;111;104;8;82;21;61;36;141;77;81;153;163;103;89;165;127;137;114;113;180;176;124;106;194;166;86;179;94;47;60;20;148;185;130;95;62;18;55;183,7359968909033789122,0.064232
greedy_intra:edges_start:random,188,47645,22796,24849,433147,488,38;1;131;121;198;117;193;31;54;73;190;80;45;175;78;5;177;21;61;36;141;187;153;81;77;82;8;104;33;144;160;29;0;109;35;62;124;143;159;106;176;180;26;103;163;89;127;137;114;113;194;166;86;185;179;94;47;148;60;20;28;140;183;55;18;34;170;152;155;189;3;70;15;145;13;132;169;195;168;43;139;11;138;182;74;134;188;6;147;51;191;90;178;10;133;122;107;40;63;135,4917765500924237941,0.079424
greedy_intra:edges_start:random,189,47980,21735,26245,675112,513,25;121;131;90;51;98;118;74;139;11;138;33;104;8;111;144;160;168;195;29;0;109;35;143;81;153;163;89;127;103;113;176;194;166;86;185;179;94;47;148;60;20;28;149;140;183;95;128;106;124;62;18;55;34;152;170;184;155;3;70;15;145;13;126;132;169;188;6;134;85;147;115;178;10;133;122;135;63;38;1;198;117;54;31;193;190;80;175;78;5;177;36;61;91;141;97;77;82;87;21,7736048907162979713,0.082472
greedy_intra:edges_start:random,190,48472,22802,25670,737560,500,25;21;104;8;82;141;91;61;36;177;5;78;175;142;45;80;190;136;73;164;54;31;193;117;1;38;135;102;63;40;107;122;131;112;121;51;90;191;147;188;169;132;13;195;168;139;11;49;29;145;3;155;184;152;149;28;20;60;148;47;94;66;179;99;185;86;166;194;176;180;113;103;114;127;89;163;187;153;77;81;159;143;106;124;95;183;140;62;18;55;34;109;0;35;111;144;160;33;138;182,609990612413932849,0.079732
greedy_intra:edges_start:random,191,46624,20729,25895,610775,479,40;107;122;131;121;118;74;98;51;90;147;6;188;169;132;13;161;70;3;15;145;195;168;43;139;11;138;33;144;104;8;82;111;160;29;0;109;35;143;159;106;124;62;18;55;34;152;4;149;28;140;183;130;95;86;185;148;20;60;47;94;179;172;166;194;176;113;103;114;127;89;163;187;146;153;81;77;97;141;91;79;61;36;177;5;78;175;45;80;190;193;31;54;117;1;16;27;38;135;63,1660153163516098812,0.075242
greedy_intra:edges_start:random,192,46130,20486,25644,722128,458,25;74;118;121;51;90;122;107;40;63;135;1;198;117;193;31;54;73;190;80;45;175;78;5;177;21;36;61;79;91;141;77;81;153;163;89;127;103;113;176;194;166;86;185;130;95;99;22;179;66;94;47;148;60;20;28;149;4;199;140;183;152;170;184;155;3;70;188;6;169;132;13;195;168;145;15;189;34;55;18;83;62;124;106;143;35;109;0;29;111;82;8;104;144;160;33;11;139;138;182,1914212639986805378,0.084161
greedy_intra:edges_start:random,193,49331,21917,27414,584675,482,78;175;142;45;80;190;73;54;31;193;117;1;135;122;131;121;116;118;74;98;51;120;125;90;191;133;10;147;188;169;132;13;195;168;139;11;49;29;0;35;109;145;15;70;3;189;155;184;152;34;55;18;140;183;28;20;148;47;94;66;179;99;185;86;62;124;106;143;163;180;176;88;166;194;113;114;103;89;127;165;187;153;81;77;141;61;36;177;21;82;8;104;111;144;160;33;138;182;25;5,7907452336674265805,0.083879
greedy_intra:edges_start:random,194,48255,21714,26541,595782,550,127;103;113;180;176;88;194;166;185;86;128;124;106;143;35;0;109;34;55;18;62;183;95;130;99;22;179;172;57;66;94;47;148;60;23;20;28;140;152;170;184;155;3;70;161;15;145;13;132;169;188;6;192;147;134;195;168;29;160;144;104;33;138;121;90;10;133;122;135;63;38;27;1;198;117;54;73;31;193;190;80;175;78;142;45;5;177;36;61;141;21;82;8;111;77;81;153;187;163;89,2318577105679547236,0.085476
greedy_intra:edges_start:random,195,46867,20721,26146,617986,491,62;124;106;143;159;119;153;81;77;82;8;104;111;35;109;0;29;144;160;33;138;11;139;168;195;126;13;145;15;3;70;132;169;188;6;147;71;51;191;90;122;135;63;38;27;16;1;131;121;112;73;31;54;117;193;190;80;45;78;175;142;177;5;36;61;141;97;187;165;163;89;127;137;114;103;113;176;194;166;86;95;130;99;22;185;179;66;94;47;148;60;20;140;183;152;184;155;34;55;18,7502990115777385251,0.083632
greedy_intra:edges_start:random,196,47843,20336,27507,634343,547,11;139;168;134;51;90;147;6;188;169;132;13;195;145;15;70;3;155;184;152;170;34;55;18;62;183;140;28;20;60;148;47;94;179;185;95;86;166;194;176;180;113;103;114;127;89;163;187;153;106;124;143;81;77;97;141;91;61;36;78;175;142;5;45;162;80;190;136;73;164;31;54;193;117;198;156;1;131;121;112;19;158;25;177;21;82;8;104;56;144;160;111;35;109;0;12;29;49;33;138,7674507534729428675,0.082908
greedy_intra:edges_start:random,197,50521,22017,28504,603873,534,152;140;28;20;183;95;86;185;99;148;47;94;179;166;194;113;114;103;163;89;127;165;187;153;81;77;141;91;61;36;177;21;8;111;144;160;33;56;104;138;182;134;85;74;118;121;112;54;31;73;5;175;80;190;193;117;198;1;135;122;125;51;90;191;147;6;188;169;132;70;3;15;145;195;168;43;139;11;49;29;39;12;0;109;35;143;159;106;124;180;176;128;62;83;18;55;34;170;155;184,2595367958800361347,0.088698
greedy_intra:edges_start:random,198,47970,21514,26456,624675,521,36;61;82;21;177;5;45;142;78;175;80;190;136;73;164;193;31;54;151;117;198;156;1;27;38;63;135;122;133;10;178;147;6;188;169;132;70;3;15;155;152;183;140;20;60;148;47;94;66;179;185;86;166;194;113;103;127;89;163;180;176;106;124;62;18;34;189;145;13;195;168;11;139;134;118;51;191;90;121;25;182;138;49;33;160;144;56;104;8;111;29;0;109;35;143;153;81;77;141;91,8430462232946400290,0.078853
greedy_intra:edges_start:random,199,49036,22106,26930,677329,491,179;66;94;47;148;60;20;28;140;183;152;155;189;3;70;161;15;145;29;0;109;35;111;160;144;56;104;157;25;121;90;51;118;74;182;138;33;49;11;139;43;168;195;13;132;169;188;134;6;147;178;10;133;122;63;135;1;156;198;117;54;31;190;80;175;78;5;177;21;87;8;82;61;36;91;141;97;77;153;106;176;180;103;163;89;127;114;113;194;166;86;128;124;62;18;34;55;95;130;185,7072769423750852963,0.085890
greedy_intra:edges_start:greedy,0,51373,18496,32877,124041,12,0;29;69;189;155;145;15;3;70;161;188;6;169;132;13;195;168;43;134;139;11;182;138;33;160;144;56;104;8;82;87;21;177;5;45;142;175;78;36;61;91;141;77;97;146;187;165;127;89;103;137;114;113;194;166;52;172;179;22;99;130;185;86;95;183;140;199;9;148;47;66;94;60;20;59;28;149;4;152;170;34;55;18;62;128;124;143;159;106;176;88;180;163;186;153;81;41;111;35;109,555396772348603777,0.004971
greedy_intra:edges_start:greedy,1,51294,18579,32715,68498,9,1;16;27;38;92;63;102;32;135;122;133;10;178;115;147;71;191;90;125;51;98;118;74;134;6;188;169;132;13;70;3;15;145;195;168;43;139;11;29;109;0;35;111;81;153;163;176;106;124;62;18;140;183;95;185;86;166;194;113;103;89;127;165;187;97;77;141;91;61;36;78;175;142;45;5;177;21;82;8;104;144;160;33;138;182;25;158;116;121;112;19;151;54;73;164;31;193;117;198;156,2660149055350198162,0.004008
greedy_intra:edges_start:greedy,2,48568,20094,28474,148663,16,43;134;74;118;51;90;131;121;112;73;54;31;193;117;198;156;1;16;27;38;135;63;100;40;107;72;122;133;10;178;147;6;188;169;132;13;70;3;15;145;195;168;29;0;109;35;111;81;153;163;176;106;124;62;18;55;34;170;152;140;183;130;95;86;185;99;179;172;166;194;113;103;89;127;165;187;146;97;77;141;91;61;36;78;175;142;45;5;177;21;82;8;104;144;160;33;138;182;11;139,5865669520714694994,0.006026
greedy_intra:edges_start:greedy,3,50083,17572,32511,12441,0,3;155;184;170;152;140;183;95;130;22;99;9;199;4;149;28;59;20;60;148;47;94;66;57;172;52;179;185;86;166;194;113;176;180;26;103;114;137;127;89;163;165;187;146;153;81;77;97;141;91;79;61;36;175;78;142;45;5;177;21;87;82;111;144;56;8;104;138;182;139;11;49;33;160;29;0;109;35;143;159;106;124;128;62;18;55;34;189;15;145;195;168;126;13;132;169;6;188;161;70,5737109939287871570,0.000000
greedy_intra:edges_start:greedy,4,46448,19979,26469,116053,11,4;149;28;59;20;60;148;47;94;66;57;172;179;22;99;130;95;185;86;166;194;176;180;113;103;114;137;127;89;163;187;153;81;77;141;91;61;36;78;175;142;45;5;177;21;82;111;8;104;138;182;139;134;74;118;90;51;121;54;31;117;1;38;63;135;122;133;10;178;147;6;188;169;132;13;70;3;15;145;195;168;11;33;160;29;0;109;35;143;106;124;128;62;18;55;34;170;152;183;140,2501330776611393178,0.005594
greedy_intra:edges_start:greedy,5,51094,19725,31369,128335,14,5;177;21;104;138;182;25;74;118;98;51;191;90;125;131;121;112;19;151;54;73;31;193;117;198;156;1;16;27;38;135;63;100;40;107;72;122;133;10;178;147;134;6;188;169;132;13;161;70;3;15;145;195;168;139;11;49;33;160;29;109;35;0;111;144;8;82;58;77;81;153;163;176;106;124;62;18;55;95;86;185;179;166;194;113;103;89;127;165;187;146;97;141;91;61;36;78;175;142;45,7501654874996916414,0.005032
greedy_intra:edges_start:greedy,6,48753,20275,28478,81847,8,6;188;169;132;13;70;3;15;145;195;168;29;109;0;35;111;81;153;163;176;106;124;62;18;55;34;170;152;140;183;99;22;179;185;130;95;86;166;194;113;103;89;127;165;187;146;97;77;141;91;61;36;78;175;142;45;5;177;21;82;8;104;144;160;33;138;182;11;139;43;134;74;118;121;51;191;90;131;54;73;31;193;117;198;156;1;16;27;38;135;63;100;40;107;72;122;133;10;178;147,203929508502928545,0.003000
greedy_intra:edges_start:greedy,7,51705,18818,32887,136122,14,7;78;175;142;45;5;177;21;104;138;182;139;134;74;118;98;51;191;90;125;131;121;112;19;151;54;73;31;193;117;198;156;1;16;27;38;135;63;100;40;107;72;122;133;10;178;147;192;6;188;169;132;13;161;70;3;15;145;195;168;11;49;33;160;29;0;109;35;111;144;8;82;58;77;81;153;163;176;106;124;62;18;95;130;185;86;166;194;113;103;89;127;165;187;146;97;141;91;61;36,1369376116086814769,0.005171
greedy_intra:edges_start:greedy,8,48823,20609,28214,113645,12,8;104;138;182;139;134;74;118;51;90;121;112;54;73;31;193;117;198;156;1;16;27;38;135;63;40;107;122;133;10;178;147;6;188;169;132;13;70;3;15;145;195;168;11;33;160;29;109;35;0;144;111;41;81;153;163;176;106;124;62;18;55;34;170;152;140;183;130;95;86;185;99;22;179;172;166;194;113;114;137;103;89;127;165;187;146;97;77;141;91;61;36;78;175;142;45;5;177;21;82,7123787126399142969,0.004484
greedy_intra:edges_start:greedy,9,47205,21217,25988,49531,5,9;148;47;94;60;20;59;28;149;4;140;183;152;170;34;55;18;62;128;124;106;143;35;109;0;29;160;33;11;139;168;195;145;15;3;70;13;132;169;188;6;147;178;10;133;122;63;135;38;1;117;193;31;54;131;90;51;121;118;74;25;182;138;104;8;111;82;21;177;5;45;142;175;78;36;61;91;141;77;81;153;187;163;89;127;137;114;103;180;176;113;194;166;95;86;185;179;22;99;130,7794213016001244386,0.002028
greedy_intra:edges_start:greedy,10,52106,19340,32766,51057,9,10;178;147;192;6;188;169;132;161;70;3;15;145;13;195;168;43;11;29;0;109;35;111;81;153;163;176;106;124;62;18;86;185;179;166;194;113;103;89;127;165;187;97;77;141;91;61;36;175;78;142;45;5;177;21;82;8;104;144;160;33;138;182;139;134;85;74;118;98;51;116;121;112;19;151;54;73;164;31;193;117;198;156;1;16;27;38;131;125;191;90;135;102;63;100;40;107;72;122;133,8582970420872209950,0.002487
greedy_intra:edges_start:greedy,11,51520,18643,32877,50817,5,11;182;138;33;160;144;56;104;8;82;87;21;177;5;45;142;78;175;36;61;91;141;77;97;146;187;165;127;89;103;137;114;113;194;166;52;172;179;185;22;99;130;86;95;183;140;199;9;148;47;66;94;60;20;59;28;149;4;152;170;34;55;18;62;128;124;143;159;106;176;88;180;163;186;153;81;41;111;0;35;109;29;69;189;155;145;15;3;70;161;188;6;169;132;13;195;168;43;134;139,3769416832562753608,0.003022
greedy_intra:edges_start:greedy,12,51653,18650,33003,55234,5,12;111;41;81;153;186;163;180;88;176;106;159;143;124;128;62;18;55;34;170;152;4;149;28;59;20;60;94;66;47;148;9;199;140;183;22;99;130;95;86;185;179;172;166;194;113;114;137;103;89;127;165;187;146;97;77;141;91;61;36;78;175;142;45;5;177;21;87;82;8;104;56;144;160;33;138;182;11;139;134;43;168;195;13;132;169;6;188;161;70;3;15;145;155;189;69;29;109;35;0,6415381298144081907,0.001997
greedy_intra:edges_start:greedy,13,48517,19732,28785,139988,15,13;70;3;15;145;195;168;29;0;109;35;111;81;153;163;176;106;124;62;18;55;34;170;152;140;183;130;95;86;185;99;22;179;166;194;113;103;89;127;165;187;146;97;77;141;91;61;36;78;175;142;45;5;177;21;82;8;104;144;160;33;138;182;11;139;43;134;74;118;51;191;90;121;112;73;54;31;193;117;198;156;1;16;27;38;135;63;100;40;107;72;122;133;10;178;147;6;188;169;132,4381610006659121383,0.006000
greedy_intra:edges_start:greedy,14,51296,21378,29918,73812,11,82;81;153;163;180;88;176;106;143;124;128;62;18;55;34;170;152;140;183;130;95;86;99;22;185;179;172;166;194;113;114;137;103;89;127;165;187;146;97;77;141;36;21;8;104;138;182;25;74;118;121;51;191;90;131;19;151;54;73;31;193;117;198;156;1;16;27;38;135;63;100;40;107;72;122;133;10;178;147;134;6;188;169;132;13;70;3;15;145;195;168;139;11;33;160;29;0;109;35;111,2269587148232937148,0.003611
greedy_intra:edges_start:greedy,15,50011,17500,32511,34502,2,15;145;195;168;126;13;132;169;6;188;161;70;3;155;184;170;152;140;183;95;130;22;99;9;199;4;149;28;59;20;60;148;47;94;66;57;172;52;179;185;86;166;194;180;176;113;26;103;114;137;127;89;163;165;187;146;153;81;77;97;141;91;79;61;36;78;175;142;45;5;177;21;87;82;111;144;56;8;104;138;182;139;11;49;33;160;29;0;109;35;143;159;106;124;128;62;18;55;34;189,8046974657430112527,0.002000
greedy_intra:edges_start:greedy,16,53759,18843,34916,42955,3,16;27;38;92;102;63;96;32;135;122;133;10;178;115;147;71;191;90;51;125;131;121;112;19;151;54;31;164;73;136;45;5;177;21;104;138;182;139;134;6;188;169;132;13;161;70;3;15;145;195;168;11;49;33;160;29;109;35;0;144;111;8;82;58;77;81;153;163;176;86;95;130;185;179;166;194;113;103;89;127;165;187;146;97;141;91;61;36;175;78;142;162;80;190;193;117;198;156;24;1,1856433080041938484,0.002000
greedy_intra:edges_start:greedy,17,51667,18843,32824,56454,9,72;107;40;100;63;102;135;122;90;191;125;131;38;27;16;1;156;198;117;193;31;164;73;54;151;19;112;121;116;51;98;118;74;85;134;139;182;138;33;160;144;104;8;82;21;177;5;45;142;175;78;36;61;91;141;77;97;187;165;127;89;103;113;194;166;86;185;95;18;62;124;106;176;163;153;81;111;35;109;0;29;11;43;168;195;13;145;15;3;70;161;132;169;188;6;192;147;178;10;133,7600777031765307387,0.003000
greedy_intra:edges_start:greedy,18,50703,18111,32592,85712,9,18;34;55;83;128;86;176;180;113;194;166;52;172;179;185;22;99;130;95;183;140;199;9;148;47;66;94;60;20;59;28;149;4;152;170;184;155;189;3;70;15;145;13;132;169;188;6;134;43;195;168;139;11;182;138;33;160;144;56;104;8;82;87;21;177;5;45;142;175;78;36;61;79;91;141;77;97;146;187;165;137;114;127;89;103;163;186;153;81;41;111;29;0;109;35;143;159;106;124;62,7703807766808670185,0.003999
greedy_intra:edges_start:greedy,19,53816,18900,34916,80079,6,19;112;121;131;125;51;90;191;71;147;115;178;10;133;122;135;32;96;63;102;92;38;27;16;1;24;156;198;117;193;31;164;136;45;5;177;21;104;138;182;139;134;6;188;169;132;13;161;70;3;15;145;195;168;11;49;33;160;29;109;35;0;111;144;8;82;58;77;81;153;163;176;86;95;130;185;179;166;194;113;103;89;127;165;187;146;97;141;91;61;36;78;142;175;162;80;190;73;54;151,8498963409274015569,0.002999
greedy_intra:edges_start:greedy,20,46468,20478,25990,79501,9,20;60;148;47;66;94;99;22;179;185;130;95;86;166;194;113;176;180;103;114;137;127;89;163;187;153;81;77;141;91;61;36;78;175;142;45;5;177;21;82;111;8;104;138;182;139;134;74;118;121;51;90;131;54;31;193;117;1;38;63;135;122;133;10;178;147;6;188;169;132;13;70;3;15;145;195;168;11;33;160;29;0;109;35;143;106;124;128;62;18;55;34;170;152;183;140;4;149;28;59,3944330243996310966,0.003976
greedy_intra:edges_start:greedy,21,51653,19134,32519,82700,8,21;87;82;111;8;104;56;144;33;160;29;0;109;35;69;189;155;145;15;3;70;161;188;6;169;132;13;195;168;43;134;139;11;138;182;25;177;5;45;142;175;78;36;61;91;141;97;146;187;165;127;89;103;137;114;113;194;166;172;179;185;86;22;99;130;95;183;140;199;9;148;47;66;94;60;20;59;28;149;4;152;170;34;55;18;62;128;124;143;159;106;176;88;180;163;186;153;81;77;58,4291512054005100053,0.005000
greedy_intra:edges_start:greedy,22,47640,20408,27232,76519,8,22;99;9;199;4;149;28;59;20;60;148;47;94;66;57;172;179;185;86;166;194;176;113;26;103;114;137;127;89;163;187;153;81;77;141;91;61;36;78;175;142;45;5;177;21;82;111;8;104;138;182;139;168;195;145;15;3;70;13;132;169;188;6;147;178;10;133;122;135;63;38;1;117;121;90;51;118;74;134;11;33;160;29;0;109;35;143;106;124;128;62;18;55;34;170;152;140;183;95;130,500260776245992843,0.002975
greedy_intra:edges_start:greedy,23,46586,20156,26430,127173,14,23;20;59;28;149;4;140;183;152;170;34;55;18;62;128;124;106;143;35;109;0;29;160;33;11;168;195;145;15;3;70;13;132;169;188;6;147;178;10;133;122;135;63;38;1;117;193;31;54;121;51;90;118;74;134;139;182;138;104;8;111;82;21;177;5;45;142;78;175;36;61;91;141;77;81;153;187;163;89;127;137;114;103;113;180;176;194;166;179;185;86;95;130;99;22;94;66;47;148;60,3587742918118443151,0.004530
greedy_intra:edges_start:greedy,24,52036,18349,33687,54688,8,24;1;16;27;38;92;63;102;32;135;122;133;10;178;115;147;71;191;90;125;51;98;118;74;134;6;188;169;132;13;70;3;15;145;195;168;43;139;11;29;0;109;35;111;81;153;163;176;106;124;62;18;55;86;185;179;166;194;113;103;89;127;165;187;97;77;141;91;61;36;78;175;142;45;5;177;21;82;8;104;144;160;33;138;182;25;158;116;121;112;19;151;54;73;164;31;193;117;198;156,7031902541344020497,0.003379
greedy_intra:edges_start:greedy,25,52015,19541,32474,163049,19,87;21;177;5;45;142;175;78;7;36;61;91;141;97;146;187;165;127;89;103;113;194;166;179;185;86;18;62;124;106;176;163;153;81;77;58;82;8;144;111;35;109;0;29;160;33;49;11;139;168;195;145;15;3;70;161;13;132;169;188;6;134;147;178;10;133;122;72;107;40;100;63;135;38;27;16;1;156;198;117;193;31;73;54;151;19;112;121;131;90;191;125;51;98;118;74;25;182;138;104,4397400175401371744,0.007365
greedy_intra:edges_start:greedy,26,50797,21075,29722,82286,12,26;103;114;137;127;89;163;165;187;146;97;77;141;36;21;8;104;138;182;139;134;74;118;90;51;121;54;31;117;1;38;63;135;122;133;10;178;147;6;188;169;132;13;70;3;15;145;195;168;11;33;160;29;0;109;35;111;81;153;129;180;176;88;106;159;143;124;128;62;18;55;34;170;152;4;149;28;59;20;60;94;66;47;148;9;199;140;183;95;86;130;99;22;185;179;172;52;166;194;113,1448936167563898914,0.003982
greedy_intra:edges_start:greedy,27,53692,18776,34916,94466,7,27;16;1;24;156;198;117;193;190;80;162;142;175;78;36;61;91;141;97;146;187;165;127;89;103;113;194;166;179;185;130;95;86;176;163;153;81;77;58;82;8;144;111;35;0;109;29;160;33;49;11;168;195;145;15;3;70;161;13;132;169;188;6;134;139;182;138;104;21;177;5;45;136;73;164;31;54;151;19;112;121;131;125;51;90;191;71;147;115;178;10;133;122;135;32;96;63;102;92;38,3686827334053571082,0.005003
greedy_intra:edges_start:greedy,28,46513,20044,26469,82478,9,28;149;4;140;183;152;170;34;55;18;62;128;124;106;143;35;109;0;29;160;33;11;168;195;145;15;3;70;13;132;169;188;6;147;178;10;133;122;135;63;38;1;117;31;54;121;51;90;118;74;134;139;182;138;104;8;111;82;21;177;5;45;142;175;78;36;61;91;141;77;81;153;187;163;89;127;137;114;103;113;176;180;194;166;86;95;130;99;22;185;179;172;57;66;94;47;148;60;20;59,2815165006689370657,0.003634
greedy_intra:edges_start:greedy,29,51345,18468,32877,107807,9,29;0;109;35;111;41;81;153;186;163;180;88;176;106;159;143;124;128;62;18;55;34;170;152;4;149;28;59;20;60;94;66;47;148;9;199;140;183;130;95;86;185;99;22;179;172;52;166;194;113;114;137;103;89;127;165;187;146;97;77;141;91;61;36;78;175;142;45;5;177;21;87;82;8;104;56;144;160;33;138;182;11;139;134;43;168;195;13;132;169;6;188;161;70;3;15;145;155;189;69,1691324433785366428,0.003988
greedy_intra:edges_start:greedy,30,52209,20479,31730,59493,8,42;80;190;162;142;78;175;36;61;91;141;97;146;187;165;127;89;103;113;194;166;179;185;86;55;18;62;124;106;176;163;153;81;77;58;82;8;111;144;0;35;109;29;160;33;49;11;134;74;118;121;51;120;191;90;125;131;135;102;63;100;40;107;72;122;133;10;178;147;192;6;188;169;132;13;161;70;3;15;145;195;168;139;182;138;104;21;177;5;45;136;73;164;193;31;54;117;198;1;156,8872316181890814841,0.002971
greedy_intra:edges_start:greedy,31,50342,20281,30061,176487,18,31;164;73;136;45;5;177;21;104;138;182;25;74;118;98;51;191;90;125;121;131;135;102;63;100;40;107;72;122;133;10;178;147;134;6;188;169;132;13;161;70;3;15;145;195;168;139;11;49;33;160;29;109;0;35;111;144;8;82;58;77;81;153;163;176;106;124;62;18;55;140;183;95;86;185;179;166;194;113;103;89;127;165;187;146;97;141;91;61;36;78;175;142;162;80;190;193;198;117;54,4134604286224875359,0.007106
greedy_intra:edges_start:greedy,32,52203,18845,33358,70466,12,32;102;63;100;40;107;72;133;10;178;147;192;6;188;169;132;161;70;3;15;145;13;195;168;43;11;29;0;109;35;111;81;153;163;176;106;124;62;18;185;86;166;194;113;103;89;127;165;187;97;77;141;91;61;36;78;175;142;45;5;177;21;82;8;104;144;160;33;138;182;139;134;85;74;118;98;51;116;121;112;19;151;54;73;164;31;193;117;198;156;1;16;27;38;131;125;191;90;122;135,8490087273368399208,0.003971
greedy_intra:edges_start:greedy,33,51373,18496,32877,120307,12,33;160;144;56;104;8;82;87;21;177;5;45;142;175;78;36;61;91;141;77;97;146;187;165;127;89;103;137;114;113;194;166;52;172;179;22;99;130;185;86;95;183;140;199;9;148;47;66;94;60;20;59;28;149;4;152;170;34;55;18;62;128;124;143;159;106;176;88;180;163;186;153;81;41;111;35;109;0;29;69;189;155;145;15;3;70;161;188;6;169;132;13;195;168;43;134;139;11;182;138,6810211683008027986,0.004980
greedy_intra:edges_start:greedy,34,50703,18111,32592,91650,8,34;18;62;124;106;159;143;35;109;0;29;111;41;81;153;186;163;103;89;127;114;137;165;187;146;97;77;141;91;79;61;36;78;175;142;45;5;177;21;87;82;8;104;56;144;160;33;138;182;11;139;168;195;43;134;6;188;169;132;13;145;15;70;3;189;155;184;170;152;4;149;28;59;20;60;94;66;47;148;9;199;140;183;95;130;99;22;185;179;172;52;166;194;113;180;176;86;128;83;55,1764424757270618148,0.003091
greedy_intra:edges_start:greedy,35,51508,18631,32877,72987,7,35;111;41;81;153;186;163;180;88;176;106;159;143;124;128;62;18;55;34;170;152;4;149;28;59;20;60;94;66;47;148;9;199;140;183;130;95;86;99;22;185;179;172;52;166;194;113;114;137;103;89;127;165;187;146;97;77;141;91;61;36;78;175;142;45;5;177;21;87;82;8;104;56;144;160;33;138;182;11;139;134;43;168;195;13;132;169;6;188;161;70;3;15;145;155;189;69;29;0;109,1160211489683183372,0.003063
greedy_intra:edges_start:greedy,36,51753,19792,31961,113235,13,36;141;97;146;187;165;127;89;103;113;194;166;179;185;86;95;55;18;62;124;106;176;163;153;81;77;58;82;8;144;111;35;0;109;29;160;33;49;11;168;195;145;15;3;70;161;13;132;169;188;6;192;147;178;10;133;122;72;107;40;100;63;135;38;27;16;1;156;198;117;193;31;73;54;151;19;112;131;121;125;90;191;51;98;118;74;134;139;182;138;104;21;177;5;45;142;175;78;91;61,5442215663744400773,0.005002
greedy_intra:edges_start:greedy,37,49088,21373,27715,68654,9,144;35;109;29;0;111;81;153;163;176;106;124;62;18;55;34;170;152;140;183;130;95;86;99;22;185;179;172;166;194;113;114;137;103;89;127;165;187;146;97;77;141;91;61;36;78;175;142;45;5;177;21;82;8;104;138;182;139;134;74;118;121;51;90;131;54;73;31;193;117;198;156;1;16;27;38;135;63;40;107;100;122;133;10;178;147;6;188;169;132;13;70;3;15;145;195;168;11;33;160,6970414957136551729,0.003301
greedy_intra:edges_start:greedy,38,51241,18994,32247,32337,6,38;102;63;100;40;107;72;133;10;178;147;192;6;188;169;132;161;70;3;15;145;13;195;168;43;11;29;109;35;0;111;81;153;163;176;106;124;62;18;55;86;185;179;166;194;113;103;89;127;165;187;97;77;141;91;61;36;175;78;142;45;5;177;21;82;8;104;144;160;33;138;182;139;134;85;74;118;98;51;125;191;90;122;135;131;121;112;19;151;54;73;164;31;193;117;198;156;1;16;27,4263755971133089887,0.001969
greedy_intra:edges_start:greedy,39,51802,18799,33003,57046,5,12;0;35;109;29;69;189;155;145;15;3;70;161;188;6;169;132;13;195;168;43;134;139;11;182;138;104;56;8;82;87;21;177;5;45;142;175;78;36;61;91;141;77;97;146;187;165;127;89;103;137;114;113;194;166;172;179;185;22;99;130;86;95;183;140;199;9;148;47;66;94;60;20;59;28;149;4;152;170;34;55;18;62;128;124;143;159;106;176;88;180;163;186;153;81;41;111;144;33;160,7522045016789628669,0.003003
greedy_intra:edges_start:greedy,40,51884,19118,32766,66492,9,40;100;63;102;135;122;90;191;125;131;38;27;16;1;156;198;117;193;31;164;73;54;151;19;112;121;116;51;98;118;74;85;134;139;182;138;33;160;144;104;8;82;21;177;5;45;142;175;78;36;61;91;141;77;97;187;165;127;89;103;113;194;166;179;185;86;18;62;124;106;176;163;153;81;111;35;0;109;29;11;43;168;195;13;145;15;3;70;161;132;169;188;6;192;147;178;10;133;72;107,3196978866597558579,0.002972
greedy_intra:edges_start:greedy,41,48487,20248,28239,66741,7,41;81;77;141;97;153;187;163;89;127;137;114;103;26;113;176;194;166;86;185;179;172;57;66;94;47;148;60;20;59;28;149;4;199;9;99;130;95;183;140;152;170;34;55;18;62;128;124;106;143;35;109;0;29;160;33;11;139;168;195;145;15;3;70;13;132;169;188;6;147;178;10;133;122;135;63;38;27;1;156;198;117;193;31;73;54;131;90;51;121;118;74;25;182;138;104;8;21;82;111,3905316493375683080,0.003150
greedy_intra:edges_start:greedy,42,52282,19941,32341,121214,17,42;30;190;80;162;142;175;78;36;61;91;141;97;146;187;165;127;89;103;113;194;166;86;185;95;18;62;124;106;176;163;153;81;77;58;82;8;144;111;0;35;109;29;160;33;49;11;168;195;145;15;3;70;161;13;132;169;188;6;192;147;178;10;133;122;72;107;40;100;63;102;135;131;121;51;120;191;90;125;118;74;134;139;182;138;104;21;177;5;45;136;73;164;54;31;193;117;198;1;156,4399752499492781152,0.005971
greedy_intra:edges_start:greedy,43,50109,20362,29747,73642,9,43;134;118;74;139;11;29;109;35;0;111;81;153;163;176;106;124;62;18;55;152;140;183;95;130;185;86;166;194;113;103;89;127;165;187;97;77;141;91;61;36;78;175;142;45;5;177;21;82;8;104;144;160;33;138;182;25;158;121;51;191;90;131;112;19;151;54;73;31;193;117;198;156;1;16;27;38;135;63;100;40;107;72;122;133;10;178;147;192;6;188;169;132;13;70;3;15;145;195;168,9172160192016212414,0.005004
greedy_intra:edges_start:greedy,44,53452,18870,34582,23928,2,44;133;10;178;115;147;71;191;90;125;51;98;118;74;134;6;188;169;132;13;70;3;15;145;195;168;43;139;11;29;109;0;35;111;81;153;163;176;86;95;185;179;166;194;113;103;89;127;165;187;97;77;141;91;61;36;175;78;142;45;5;177;21;82;8;104;144;160;33;138;182;25;158;116;121;131;112;19;151;54;73;164;31;193;117;198;156;1;16;27;38;135;102;63;100;40;107;17;72;122,321235449431397400,0.001000
greedy_intra:edges_start:greedy,45,51435,20370,31065,55204,8,45;5;177;21;104;138;182;25;74;118;121;51;120;191;90;125;131;112;19;151;54;73;31;193;117;198;156;1;16;27;38;135;63;100;40;107;72;122;133;10;178;147;134;6;188;169;132;13;161;70;3;15;145;195;168;139;11;49;33;160;29;109;35;0;144;111;8;82;58;77;81;153;163;176;106;124;62;18;183;140;95;185;86;166;194;113;103;89;127;165;187;146;97;141;91;61;36;78;175;142,2757243493187874834,0.002947
greedy_intra:edges_start:greedy,46,50875,19961,30914,86545,13,46;80;190;193;198;117;54;31;164;73;136;45;5;177;21;104;138;182;25;74;118;51;120;191;90;125;121;131;135;102;63;100;40;107;72;122;133;10;178;147;134;6;188;169;132;13;161;70;3;15;145;195;168;139;11;49;33;160;29;109;35;0;111;144;8;82;58;77;81;153;163;176;106;124;62;18;55;140;183;95;185;86;166;194;113;103;89;127;165;187;146;97;141;91;61;36;78;142;175;162,1056252757562124282,0.004066
greedy_intra:edges_start:greedy,47,46318,19849,26469,121683,13,47;148;60;20;59;28;149;4;140;183;152;170;34;55;18;62;128;124;106;143;35;109;0;29;160;33;11;168;195;145;15;3;70;13;132;169;188;6;147;178;10;133;122;135;63;38;1;117;31;54;121;90;51;118;74;134;139;182;138;104;8;111;82;21;177;5;45;142;175;78;36;61;91;141;77;81;153;187;163;89;127;137;114;103;113;180;176;194;166;86;95;130;99;22;185;179;172;57;66;94,5395284849991297204,0.005038
greedy_intra:edges_start:greedy,48,48448,20908,27540,43676,7,88;194;113;176;180;103;114;137;127;89;163;187;153;81;77;141;91;61;36;175;78;142;45;5;177;21;82;111;8;104;138;182;25;74;118;90;51;121;117;1;135;63;122;133;10;178;147;6;188;169;132;13;70;3;15;145;195;168;139;11;33;160;29;0;109;35;143;106;124;128;62;18;55;34;170;152;140;183;130;95;86;185;22;99;9;199;4;149;28;59;20;60;148;47;94;66;57;172;179;166,3714095584659437656,0.001997
greedy_intra:edges_start:greedy,49,47670,20912,26758,103622,19,49;29;109;0;35;111;81;153;163;176;106;124;62;18;55;34;170;152;183;140;20;148;47;94;66;179;86;185;166;194;113;114;137;103;89;127;165;187;146;97;77;141;91;61;36;78;175;142;45;5;177;21;82;8;104;144;160;33;138;182;139;134;74;118;51;90;121;112;73;54;31;193;117;198;156;1;16;27;38;135;63;40;107;122;133;10;178;147;6;188;169;132;13;70;3;15;145;195;168;11,7550238237495184642,0.007063
greedy_intra:edges_start:greedy,50,50397,21638,28759,150808,29,177;36;61;141;77;97;146;187;165;127;89;103;137;114;113;194;166;185;86;179;66;94;148;47;20;140;183;152;170;34;55;18;62;128;124;143;106;176;88;180;163;153;81;8;111;35;109;0;29;160;33;11;168;195;145;15;3;70;13;132;169;188;6;192;147;178;10;133;122;72;107;40;100;63;135;38;27;16;1;156;198;117;193;31;73;54;151;19;131;90;191;51;121;118;74;134;139;138;182;25,2318329275097631057,0.009686
greedy_intra:edges_start:greedy,51,50934,19668,31266,66258,7,51;125;191;90;122;133;10;72;107;40;100;63;102;135;38;27;16;1;156;198;117;193;31;164;73;54;151;19;112;131;121;116;158;25;182;138;33;160;144;104;8;82;21;177;5;45;142;175;78;36;61;91;141;77;97;187;165;127;89;103;113;194;166;179;185;86;95;55;18;62;124;106;176;163;153;81;111;35;109;0;29;11;139;43;168;195;145;15;3;70;13;132;169;188;6;147;134;74;118;98,4484858108208780489,0.003004
greedy_intra:edges_start:greedy,52,48042,20495,27547,64158,6,52;166;194;113;176;180;103;114;137;127;89;163;187;153;81;77;141;91;61;36;78;175;142;45;5;177;21;82;111;8;104;138;182;25;74;118;121;51;90;131;1;38;63;135;122;133;10;178;147;6;188;169;132;13;70;3;15;145;195;168;139;11;33;160;29;0;109;35;143;106;124;128;62;18;55;34;170;152;140;183;130;95;86;185;22;99;9;199;4;149;28;59;20;60;148;47;94;66;179;172,5215702866246775991,0.001999
greedy_intra:edges_start:greedy,53,47705,20326,27379,94807,9,53;140;183;95;130;99;9;199;4;149;28;59;20;60;148;47;94;66;57;172;179;185;86;166;194;180;176;113;103;114;137;127;89;163;187;153;81;77;141;91;61;36;78;175;142;45;5;177;21;82;111;8;104;138;182;139;134;74;118;51;90;121;117;1;38;63;135;122;133;10;178;147;6;188;169;132;13;70;3;15;145;195;168;11;33;160;29;0;109;35;143;106;124;128;62;18;55;34;170;152,7329053550839532431,0.003997
greedy_intra:edges_start:greedy,54,50369,19446,30923,172529,18,54;31;164;73;136;45;5;177;21;104;138;182;139;134;74;118;98;51;191;90;125;121;131;135;102;63;100;40;107;72;122;133;10;178;147;192;6;188;169;132;13;161;70;3;15;145;195;168;11;49;33;160;29;0;109;35;111;144;8;82;58;77;81;153;163;176;106;124;62;18;55;140;183;95;130;185;86;166;194;113;103;89;127;165;187;146;97;141;91;61;36;78;175;142;162;80;190;193;198;117,301111669900003731,0.007032
greedy_intra:edges_start:greedy,55,50738,18146,32592,60380,7,55;34;83;128;86;176;180;113;194;166;52;172;179;185;22;99;130;95;183;140;199;9;148;47;66;94;60;20;59;28;149;4;152;170;184;155;189;3;70;15;145;13;132;169;188;6;134;43;168;195;139;11;182;138;33;160;144;56;104;8;82;87;21;177;5;45;142;175;78;36;61;79;91;141;77;97;146;187;165;137;114;127;89;103;163;186;153;81;41;111;29;0;109;35;143;159;106;124;62;18,3148499663273528977,0.001987
greedy_intra:edges_start:greedy,56,55471,18581,36890,34607,3,56;144;111;0;35;109;29;160;33;49;11;43;134;85;74;118;98;131;125;90;191;71;120;51;121;112;19;151;54;73;164;31;193;117;198;156;1;16;27;38;135;102;63;100;40;107;72;122;133;10;178;115;147;192;6;188;169;132;13;161;70;3;15;145;195;168;139;182;138;104;25;177;5;45;142;78;175;36;61;91;141;97;146;187;165;127;89;103;113;194;166;176;163;153;81;77;87;21;82;8,1090751860579946464,0.001702
greedy_intra:edges_start:greedy,57,46850,20381,26469,77739,8,57;172;179;22;99;130;95;185;86;166;194;176;180;113;103;114;137;127;89;163;187;153;81;77;141;91;61;36;175;78;142;45;5;177;21;82;111;8;104;138;182;139;134;74;118;121;51;90;54;31;117;1;38;135;63;122;133;10;178;147;6;188;169;132;13;70;3;15;145;195;168;11;33;160;29;0;109;35;143;106;124;128;62;18;55;34;170;152;183;140;4;149;28;59;20;60;148;47;94;66,2560481938894614498,0.003997
greedy_intra:edges_start:greedy,58,51475,19818,31657,77806,11,58;82;8;144;111;35;109;0;29;160;33;49;11;168;195;145;15;3;70;161;13;132;169;188;6;192;147;178;10;133;122;72;107;40;100;63;135;38;27;16;1;156;198;117;193;31;73;54;151;19;112;131;125;90;191;120;51;121;118;74;134;139;182;138;104;21;177;5;45;142;175;78;36;61;91;141;97;146;187;165;127;89;103;113;194;166;86;185;95;183;140;18;62;124;106;176;163;153;81;77,6540363638077075961,0.003000
greedy_intra:edges_start:greedy,59,46281,19812,26469,114862,12,59;28;149;4;140;183;152;170;34;55;18;62;128;124;106;143;35;109;0;29;160;33;11;168;195;145;15;3;70;13;132;169;188;6;147;178;10;133;122;135;63;38;1;117;31;54;121;90;51;118;74;134;139;182;138;104;8;111;82;21;177;5;45;142;175;78;36;61;91;141;77;81;153;187;163;89;127;137;114;103;113;180;176;194;166;86;185;95;130;99;22;179;172;57;66;94;47;148;60;20,5781922637477151744,0.005162
greedy_intra:edges_start:greedy,60,46178,20055,26123,131969,13,60;148;47;94;66;99;22;130;95;86;185;179;166;194;180;176;113;103;114;137;127;89;163;187;153;81;77;141;91;61;36;78;175;142;45;5;177;21;82;111;8;104;138;182;139;134;74;118;51;90;121;73;54;31;193;117;1;38;63;135;122;133;10;178;147;6;188;169;132;13;70;3;15;145;195;168;11;33;160;29;0;109;35;143;106;124;128;62;18;55;34;170;152;183;140;4;149;28;59;20,1580245193015547653,0.005000
greedy_intra:edges_start:greedy,61,51046,19955,31091,122764,18,61;36;91;141;97;146;187;165;127;89;103;113;194;166;86;185;183;140;55;18;62;124;106;176;163;153;81;77;58;82;8;144;111;35;109;0;29;160;33;49;11;139;168;195;145;15;3;70;161;13;132;169;188;6;134;147;178;10;133;122;72;107;40;100;63;135;38;27;16;1;156;198;117;193;31;73;54;151;19;112;121;131;125;90;191;120;51;118;74;25;182;138;104;21;177;5;45;142;175;78,1499095062678941856,0.004992
greedy_intra:edges_start:greedy,62,50771,18179,32592,52096,6,62;124;106;159;143;35;109;29;0;111;41;81;153;186;163;103;89;127;114;137;165;187;146;97;77;141;91;79;61;36;175;78;142;45;5;177;21;87;82;8;104;56;144;160;33;138;182;11;139;195;168;43;134;6;188;169;132;13;145;15;70;3;189;155;184;170;152;4;149;28;59;20;60;94;66;47;148;9;199;140;183;95;130;99;22;185;179;172;52;166;194;113;180;176;86;128;83;18;55;34,3913679484705723208,0.002928
greedy_intra:edges_start:greedy,63,51210,18932,32278,96850,19,63;100;40;107;72;133;10;178;147;192;6;188;169;132;161;70;3;15;145;13;195;168;43;11;29;0;109;35;111;81;153;187;163;89;127;103;113;176;194;166;179;185;86;55;18;62;124;106;143;77;141;91;61;36;78;175;142;45;5;177;21;82;8;104;144;160;33;138;182;139;134;85;74;118;98;51;116;121;112;19;151;54;73;164;31;193;117;198;156;1;16;27;38;131;125;191;90;122;135;102,123407497394038428,0.004994
greedy_intra:edges_start:greedy,64,50385,20507,29878,93340,10,88;86;95;128;106;159;143;124;62;18;55;34;170;152;174;183;140;199;4;149;28;59;20;60;148;47;94;66;22;99;130;185;179;172;52;166;194;113;26;103;114;137;127;89;163;165;187;146;97;77;141;36;21;8;104;138;182;139;134;74;118;51;90;121;54;31;117;1;38;63;135;122;133;10;178;147;6;188;169;132;13;70;3;15;145;195;168;11;33;160;29;0;109;35;111;81;153;129;180;176,1628639343805904423,0.003994
greedy_intra:edges_start:greedy,65,50172,17520,32652,12509,0,65;188;6;169;132;13;126;168;195;145;15;189;34;55;18;62;128;124;106;159;143;35;109;0;29;160;33;49;11;139;182;138;104;8;56;144;111;82;87;21;177;5;45;142;78;175;36;61;79;91;141;97;77;81;153;146;187;165;163;89;127;137;114;103;26;180;176;113;194;166;86;185;179;172;57;66;94;47;148;60;20;59;28;149;4;199;9;99;22;130;95;183;140;152;170;184;155;3;70;161,432899825885050179,0.001000
greedy_intra:edges_start:greedy,66,46287,19918,26369,122687,18,66;57;172;179;185;22;99;130;95;86;166;194;176;180;113;103;114;137;127;89;163;187;153;81;77;141;91;61;36;78;175;142;45;5;177;21;82;111;8;104;138;182;25;74;118;51;90;121;54;31;117;1;38;63;135;122;133;10;178;147;6;188;169;132;13;70;3;15;145;195;168;139;11;33;160;29;0;109;35;143;106;124;128;62;18;55;34;170;152;183;140;4;149;28;59;20;60;148;47;94,5470032906219473751,0.004999
greedy_intra:edges_start:greedy,67,53325,18881,34444,54837,4,67;120;51;98;118;74;134;6;188;169;132;13;70;3;15;145;195;168;43;139;11;29;0;109;35;111;81;153;163;176;86;95;130;185;179;166;194;113;103;89;127;165;187;97;77;141;91;61;36;78;175;142;45;5;177;21;82;8;104;144;160;33;138;182;25;158;116;121;131;112;19;151;54;73;164;31;193;117;198;156;1;16;27;38;135;102;63;100;40;107;17;72;122;133;10;178;90;191;147;71,702272646201202987,0.001999
greedy_intra:edges_start:greedy,68,51468,19050,32418,180458,29,104;8;21;87;82;77;81;153;163;176;106;124;62;18;95;185;86;166;194;113;103;89;127;165;187;146;97;141;91;61;36;175;78;142;45;5;177;25;182;138;139;134;74;118;51;120;191;90;125;131;121;112;19;151;54;73;31;193;117;198;156;1;16;27;38;135;63;100;40;107;72;122;133;10;178;147;192;6;188;169;132;13;161;70;3;15;145;195;168;11;49;33;160;29;0;109;35;111;144;56,8863503983592294966,0.008000
greedy_intra:edges_start:greedy,69,51773,18091,33682,85120,10,12;0;35;109;29;145;15;3;70;161;188;6;169;132;13;195;168;43;134;139;11;182;138;33;160;144;56;104;8;82;87;21;177;5;45;142;175;78;36;61;79;91;141;77;97;146;187;165;127;89;103;137;114;26;113;194;166;52;172;179;185;22;99;130;86;95;183;140;199;9;148;47;66;94;60;20;59;28;149;4;152;170;34;55;18;62;128;124;143;159;106;176;88;180;163;186;153;81;41;111,7031893225408749171,0.004469
greedy_intra:edges_start:greedy,70,50019,17508,32511,24039,1,70;161;188;6;169;132;13;126;168;195;145;15;189;34;55;18;62;128;124;106;159;143;35;109;0;29;160;33;49;11;139;182;138;104;8;56;144;111;82;87;21;177;5;45;142;78;175;36;61;79;91;141;97;77;81;153;146;187;165;163;89;127;137;114;103;26;113;176;180;194;166;86;185;179;52;172;57;66;94;47;148;60;20;59;28;149;4;199;9;99;22;130;95;183;140;152;170;184;155;3,8261736508870124177,0.001002
greedy_intra:edges_start:greedy,71,50585,19647,30938,76580,11,71;147;192;6;188;169;132;161;70;3;15;145;13;195;168;43;11;29;109;0;35;111;81;153;163;176;106;124;62;18;140;183;95;86;185;179;166;194;113;103;89;127;165;187;97;77;141;91;61;36;78;175;142;45;5;177;21;82;8;104;144;160;33;138;182;139;134;74;118;98;51;131;121;112;19;54;73;164;31;193;117;198;156;1;16;27;38;135;102;63;100;40;107;72;122;133;10;178;90;191,7250152236501269818,0.004000
greedy_intra:edges_start:greedy,72,51758,18934,32824,51302,9,72;107;40;100;63;102;135;122;90;191;125;131;38;27;16;1;156;198;117;193;31;164;73;54;151;19;112;121;116;51;98;118;74;85;134;139;182;138;33;160;144;104;8;82;21;177;5;45;142;175;78;36;61;91;141;77;97;187;165;127;89;103;113;194;166;86;185;95;62;18;124;106;176;163;153;81;111;35;0;109;29;11;43;168;195;13;145;15;3;70;161;132;169;188;6;192;147;178;10;133,8765547106198900748,0.001997
greedy_intra:edges_start:greedy,73,50715,20468,30247,168650,19,73;164;31;54;117;198;193;190;80;162;142;175;78;36;61;91;141;97;146;187;165;127;89;103;113;194;166;179;185;86;95;130;183;140;18;62;124;106;176;163;153;81;77;58;82;8;144;111;35;0;109;29;160;33;49;11;139;168;195;145;15;3;70;161;13;132;169;188;6;134;147;178;10;133;122;72;107;40;100;63;102;135;131;121;191;90;125;51;98;118;74;25;182;138;104;21;177;5;45;136,6301521533218765911,0.006999
greedy_intra:edges_start:greedy,74,50499,19774,30725,84232,7,74;118;98;51;125;90;191;10;133;122;72;107;40;100;63;102;135;131;121;158;25;182;138;33;160;144;104;8;82;87;21;177;5;45;142;175;78;36;61;91;141;77;97;146;187;165;127;89;103;137;114;113;194;166;172;179;22;99;185;86;95;130;183;140;152;170;34;55;18;62;128;124;106;176;180;163;153;81;111;35;109;0;29;49;11;139;43;168;195;145;15;3;70;13;132;169;188;6;147;134,6674454061572765965,0.004007
greedy_intra:edges_start:greedy,75,50927,20933,29994,126081,15,75;114;194;166;179;172;57;66;94;47;148;60;20;59;28;149;4;199;9;99;22;185;86;95;130;183;140;152;170;34;55;18;62;128;124;143;159;106;180;176;88;113;26;103;163;186;153;81;111;35;109;0;29;160;33;11;168;195;145;15;3;70;13;132;169;188;6;147;178;10;133;122;135;63;38;1;117;31;121;90;51;118;74;134;139;182;138;104;8;21;36;141;77;97;146;187;165;89;127;137,1130778495912325568,0.005999
greedy_intra:edges_start:greedy,76,50939,20761,30178,125539,16,88;194;166;52;172;179;185;22;99;130;95;183;140;199;9;148;47;66;94;60;20;59;28;149;4;53;152;170;34;55;18;62;124;143;159;106;128;86;176;180;113;26;103;163;186;153;81;111;35;109;0;29;160;33;11;139;168;195;145;15;3;70;13;132;169;188;6;147;178;10;133;122;135;63;38;1;117;31;121;51;90;118;74;25;182;138;104;8;21;36;141;77;97;146;187;165;89;127;137;114,919711785633392786,0.005568
greedy_intra:edges_start:greedy,77,50815,21129,29686,74121,10,77;97;146;187;165;127;89;103;137;114;26;113;194;166;52;172;179;185;22;99;130;86;95;183;140;199;9;148;47;66;94;60;20;59;28;149;4;152;170;34;55;18;62;128;124;143;159;106;88;176;180;163;186;153;81;111;35;109;0;29;160;33;11;139;168;195;145;15;3;70;13;132;169;188;6;147;178;10;133;122;135;63;38;1;117;31;54;121;51;90;118;74;25;182;138;104;8;21;36;141,2561336463149121363,0.004022
greedy_intra:edges_start:greedy,78,50752,19786,30966,154415,20,78;36;61;91;141;97;146;187;165;127;89;103;113;194;166;86;185;95;183;140;18;62;124;106;176;163;153;81;77;58;82;8;144;111;35;109;0;29;160;33;49;11;139;168;195;145;15;3;70;161;13;132;169;188;6;134;147;178;10;133;122;72;107;40;100;63;135;38;27;16;1;156;198;117;193;31;73;54;151;19;112;121;131;125;90;191;51;98;118;74;25;182;138;104;21;177;5;45;142;175,4557528616801948611,0.007700
greedy_intra:edges_start:greedy,79,52069,20080,31989,109946,13,79;61;36;78;175;142;45;5;177;21;104;138;182;25;74;118;121;51;120;191;90;125;131;112;19;151;54;73;31;193;117;198;156;1;16;27;38;135;63;100;40;107;72;122;133;10;178;147;134;6;188;169;132;13;161;70;3;15;145;195;168;139;11;49;33;160;29;109;35;0;111;144;8;82;58;77;81;153;163;176;106;124;62;18;55;86;185;179;166;194;113;103;89;127;165;187;146;97;141;91,1619320798380533697,0.004643
greedy_intra:edges_start:greedy,80,50401,19971,30430,106248,13,80;162;142;175;78;36;61;91;141;97;146;187;165;127;89;103;113;194;166;86;185;130;95;183;140;55;18;62;124;106;176;163;153;81;77;58;82;8;144;111;35;0;109;29;160;33;49;11;139;168;195;145;15;3;70;161;13;132;169;188;6;134;147;178;10;133;122;72;107;40;100;63;102;135;131;121;125;90;191;120;51;118;74;25;182;138;104;21;177;5;45;136;73;164;31;54;117;198;193;190,8978604138709066274,0.005247
greedy_intra:edges_start:greedy,81,50894,21208,29686,145768,18,81;153;186;163;180;88;176;106;159;143;124;128;62;18;55;34;170;152;4;149;28;59;20;60;94;66;47;148;9;199;140;183;95;130;99;22;179;172;52;185;86;166;194;113;26;114;137;103;89;127;165;187;146;97;77;141;36;21;8;104;138;182;25;74;118;121;51;90;54;31;117;1;38;63;135;122;133;10;178;147;6;188;169;132;13;70;3;15;145;195;168;139;11;33;160;29;0;109;35;111,2244626178585604313,0.006969
greedy_intra:edges_start:greedy,82,51705,19186,32519,59717,5,82;87;21;58;77;81;153;186;163;180;176;88;106;159;143;124;128;62;18;55;34;170;152;4;149;28;59;20;60;94;66;47;148;9;199;140;183;95;86;130;99;22;185;179;172;166;194;113;114;137;103;89;127;165;187;146;97;141;91;61;36;78;175;142;45;5;177;25;182;138;11;139;134;43;168;195;13;132;169;6;188;161;70;3;15;145;155;189;69;109;35;0;29;160;33;144;56;104;8;111,1839821595089775357,0.003196
greedy_intra:edges_start:greedy,83,47842,20613,27229,104414,12,83;62;128;124;106;143;35;109;0;29;160;33;11;139;168;195;145;15;3;70;13;132;169;188;6;147;178;10;133;122;135;63;38;1;117;121;51;90;118;74;25;182;138;104;8;111;82;21;177;5;45;142;175;78;36;61;91;141;77;81;153;187;163;89;127;137;114;103;113;180;176;194;166;86;185;179;172;57;66;94;47;148;60;20;59;28;149;4;199;9;99;130;95;183;140;152;170;34;18;55,6994569454658308439,0.003970
greedy_intra:edges_start:greedy,84,51389,18512,32877,96466,12,161;70;3;155;189;69;109;35;0;29;111;41;81;153;186;163;180;88;176;106;159;143;124;128;62;18;55;34;170;152;4;149;28;59;20;60;94;66;47;148;9;199;140;183;95;86;130;99;22;185;179;172;52;166;194;113;114;137;103;89;127;165;187;146;97;77;141;91;61;36;78;175;142;45;5;177;21;87;82;8;104;56;144;160;33;138;182;11;139;195;168;43;134;6;188;169;132;13;145;15,5315502814027012602,0.004977
greedy_intra:edges_start:greedy,85,48671,19698,28973,97044,11,85;74;118;51;191;90;121;112;73;54;31;193;117;198;156;1;16;27;38;135;63;100;40;107;72;122;133;10;178;147;6;188;169;132;70;3;15;145;13;195;168;29;0;109;35;111;81;153;163;176;106;124;62;18;55;34;170;152;140;183;130;95;86;185;99;179;166;194;113;103;89;127;165;187;146;97;77;141;91;61;36;78;175;142;45;5;177;21;82;8;104;144;160;33;138;182;11;139;43;134,2545595070888110429,0.004000
greedy_intra:edges_start:greedy,86,47231,20560,26671,108027,12,86;95;130;99;22;66;94;47;148;60;20;59;28;149;4;199;9;183;140;152;170;34;55;18;62;128;124;106;143;35;109;0;29;160;33;11;139;168;195;145;15;3;70;13;132;169;188;6;147;178;10;133;122;135;63;38;1;117;31;121;51;90;118;74;25;182;138;104;8;111;82;21;177;5;45;142;175;78;36;61;91;141;77;81;153;187;163;89;127;137;114;103;113;180;176;194;166;172;179;185,5298557314489531935,0.004003
greedy_intra:edges_start:greedy,87,51533,19014,32519,133767,12,87;82;111;8;104;56;144;33;160;29;0;35;109;69;189;155;145;15;3;70;161;188;6;169;132;13;195;168;43;134;139;11;138;182;25;177;5;45;142;175;78;36;61;91;141;97;146;187;165;127;89;103;137;114;113;194;166;86;172;179;185;22;99;130;95;183;140;199;9;148;47;66;94;60;20;59;28;149;4;152;170;34;55;18;62;128;124;143;159;106;176;88;180;163;186;153;81;77;58;21,3478744763729412372,0.005000
greedy_intra:edges_start:greedy,88,47537,20773,26764,96985,13,137;114;103;113;176;194;166;179;172;57;66;94;47;148;60;20;59;28;149;4;199;9;99;22;185;86;95;130;183;140;152;170;34;55;18;62;128;124;106;143;35;109;0;29;160;33;11;168;195;145;15;3;70;13;132;169;188;6;147;178;10;133;122;135;63;38;1;117;31;121;51;90;118;74;134;139;182;138;104;8;111;82;21;177;5;45;142;175;78;36;61;91;141;77;81;153;187;163;89;127,6621217329296964937,0.003974
greedy_intra:edges_start:greedy,89,50650,20928,29722,124769,15,89;163;165;187;146;97;77;141;36;21;8;104;138;182;139;134;74;118;90;51;121;54;31;117;1;38;63;135;122;133;10;178;147;6;188;169;132;13;70;3;15;145;195;168;11;33;160;29;0;109;35;111;81;153;129;180;88;176;106;159;143;124;128;62;18;55;34;170;152;4;149;28;59;20;60;94;66;47;148;9;199;140;183;130;95;86;185;99;22;179;172;52;166;194;113;26;103;114;137;127,559528099831534473,0.006641
greedy_intra:edges_start:greedy,90,50637,19774,30863,50075,8,90;191;125;51;98;118;74;134;147;6;188;169;132;13;70;3;15;145;195;168;43;139;11;29;109;0;35;111;81;153;163;176;106;124;62;18;140;183;95;185;86;166;194;113;103;89;127;165;187;97;77;141;91;61;36;78;175;142;45;5;177;21;82;8;104;144;160;33;138;182;25;158;116;121;131;112;19;151;54;73;164;31;193;117;198;156;1;16;27;38;135;102;63;100;40;107;72;10;133;122,3499377100991301380,0.002542
greedy_intra:edges_start:greedy,91,51268,19899,31369,152027,16,91;61;36;78;175;142;45;5;177;21;104;138;182;25;74;118;98;51;191;90;125;121;131;112;19;151;54;73;31;193;117;198;156;1;16;27;38;135;63;100;40;107;72;122;133;10;178;147;134;6;188;169;132;13;161;70;3;15;145;195;168;139;11;49;33;160;29;0;109;35;111;144;8;82;58;77;81;153;163;176;106;124;62;18;55;95;86;185;179;166;194;113;103;89;127;165;187;146;97;141,5854640132865642894,0.006029
greedy_intra:edges_start:greedy,92,52533,19035,33498,29424,8,102;32;135;122;90;191;125;131;38;27;16;1;156;198;117;193;31;164;73;54;151;19;112;121;116;51;98;118;74;85;134;139;182;138;33;160;144;104;8;82;21;177;5;45;142;78;175;36;61;91;141;77;97;187;165;127;89;103;113;194;166;179;185;86;62;124;106;176;163;153;81;111;0;35;109;29;11;43;168;195;13;145;15;3;70;161;132;169;188;6;192;147;178;10;133;72;107;40;100;63,7660541518551870638,0.001972
greedy_intra:edges_start:greedy,93,52315,21094,31221,81738,12,48;75;137;114;127;89;165;187;146;97;77;141;21;82;8;104;138;182;25;74;118;51;90;121;117;1;135;63;122;133;10;178;147;6;188;169;132;13;70;3;15;145;195;168;139;11;33;160;29;0;109;35;111;81;153;186;163;103;26;113;180;176;194;86;128;106;159;143;124;62;18;55;34;170;152;53;4;149;28;59;20;60;94;66;47;148;9;199;140;183;95;130;99;22;185;179;172;52;166;76,6488856007614303663,0.004059
greedy_intra:edges_start:greedy,94,46435,19966,26469,115469,15,94;66;57;172;179;22;99;130;95;185;86;166;194;176;180;113;103;114;137;127;89;163;187;153;81;77;141;91;61;36;78;175;142;45;5;177;21;82;111;8;104;138;182;139;134;74;118;51;90;121;54;31;117;1;38;63;135;122;133;10;178;147;6;188;169;132;13;70;3;15;145;195;168;11;33;160;29;0;109;35;143;106;124;128;62;18;55;34;170;152;183;140;4;149;28;59;20;148;60;47,2668994905171255497,0.005108
greedy_intra:edges_start:greedy,95,47259,20588,26671,87184,10,95;86;185;179;172;166;194;180;176;113;103;114;137;127;89;163;187;153;81;77;141;91;61;36;78;175;142;45;5;177;21;82;111;8;104;138;182;25;74;118;90;51;121;31;117;1;38;63;135;122;133;10;178;147;6;188;169;132;13;70;3;15;145;195;168;139;11;33;160;29;0;109;35;143;106;124;128;62;18;55;34;170;152;140;183;9;199;4;149;28;59;20;60;148;47;94;66;22;99;130,3695252371711155002,0.003969
greedy_intra:edges_start:greedy,96,51869,19103,32766,63207,11,102;135;122;90;191;125;131;38;27;16;1;156;198;117;193;31;164;73;54;151;19;112;121;116;51;98;118;74;85;134;139;182;138;33;160;144;104;8;82;21;177;5;45;142;175;78;36;61;91;141;77;97;187;165;127;89;103;113;194;166;179;185;86;18;62;124;106;176;163;153;81;111;35;109;0;29;11;43;168;195;13;145;15;3;70;161;132;169;188;6;192;147;178;10;133;72;107;40;100;63,6732708744330517370,0.003478
greedy_intra:edges_start:greedy,97,50566,20780,29786,100585,12,97;77;141;36;21;8;104;138;182;139;134;74;118;51;90;121;54;31;117;1;38;63;135;122;133;10;178;147;6;188;169;132;13;70;3;15;145;195;168;11;33;160;29;0;109;35;111;81;153;186;163;180;88;176;106;159;143;124;128;62;18;55;34;170;152;4;149;28;59;20;60;94;66;47;148;9;199;140;183;130;95;86;185;22;99;179;172;52;166;194;113;26;114;137;103;89;127;165;187;146,1914279288510829117,0.004995
greedy_intra:edges_start:greedy,98,53126,18916,34210,20570,1,98;51;125;90;191;71;147;115;178;10;133;122;72;17;107;40;100;63;102;135;38;27;16;1;156;198;117;193;31;164;73;54;151;19;112;131;121;116;158;25;182;138;33;160;144;104;8;82;21;177;5;45;142;78;175;36;61;91;141;77;97;187;165;127;89;103;113;194;166;179;185;130;95;86;176;163;153;81;111;0;35;109;29;11;139;43;168;195;145;15;3;70;13;132;169;188;6;134;74;118,6630123152071269604,0.000934
greedy_intra:edges_start:greedy,99,47309,20606,26703,94613,12,99;130;95;183;140;152;170;34;55;18;62;128;124;106;143;35;109;0;29;160;33;11;139;168;195;145;15;3;70;13;132;169;188;6;147;178;10;133;122;135;63;38;1;117;31;121;51;90;118;74;25;182;138;104;8;111;82;21;177;5;45;142;78;175;36;61;91;141;77;81;153;187;163;89;127;137;114;103;113;180;176;194;166;86;185;179;172;57;66;94;47;148;60;20;59;28;149;4;199;9,6528562659580203066,0.004008
greedy_intra:edges_start:greedy,100,51682,18858,32824,71697,12,100;40;107;72;133;10;178;147;192;6;188;169;132;161;70;3;15;145;13;195;168;43;11;29;109;0;35;111;81;153;163;176;106;124;62;18;95;185;86;166;194;113;103;89;127;165;187;97;77;141;91;61;36;78;175;142;45;5;177;21;82;8;104;144;160;33;138;182;139;134;85;74;118;98;51;116;121;112;19;151;54;73;164;31;193;117;198;156;1;16;27;38;131;125;191;90;122;135;102;63,7331782971836776213,0.004029
greedy_intra:edges_start:greedy,101,46920,19844,27076,114174,11,101;149;4;140;183;152;170;34;55;18;62;128;124;106;143;35;109;0;29;160;33;11;168;195;145;15;3;70;13;132;169;188;6;147;178;10;133;122;135;63;38;1;117;31;121;90;51;118;74;134;139;182;138;104;8;111;82;21;177;5;45;142;175;78;36;61;91;141;77;81;153;187;163;89;127;137;114;103;113;176;180;194;166;86;185;95;130;99;22;179;172;57;66;94;47;148;60;20;59;28,2399324717698646773,0.004973
greedy_intra:edges_start:greedy,102,51682,18858,32824,63717,10,102;135;122;90;191;125;131;38;27;16;1;156;198;117;193;31;164;73;54;151;19;112;121;116;51;98;118;74;85;134;139;182;138;33;160;144;104;8;82;21;177;5;45;142;175;78;36;61;91;141;77;97;187;165;127;89;103;113;194;166;86;185;95;18;62;124;106;176;163;153;81;111;35;0;109;29;11;43;168;195;13;145;15;3;70;161;132;169;188;6;192;147;178;10;133;72;107;40;100;63,1470533293523525058,0.003970
greedy_intra:edges_start:greedy,103,51240,21240,30000,70491,7,103;114;137;127;89;163;165;187;146;97;141;77;82;21;8;104;138;182;139;134;74;118;121;51;90;54;31;117;1;38;135;63;122;133;10;178;147;6;188;169;132;13;70;3;15;145;195;168;11;33;160;29;0;109;35;111;81;153;129;180;176;88;106;159;143;124;128;62;18;55;34;170;152;4;149;28;59;20;60;94;66;47;148;9;199;140;183;130;95;86;185;99;22;179;172;52;166;194;113;26,7104924776579791394,0.003030
greedy_intra:edges_start:greedy,104,48769,20655,28114,120154,13,104;138;182;25;74;118;51;90;121;112;73;54;31;193;117;198;156;1;16;27;38;135;63;40;107;122;133;10;178;147;6;188;169;132;13;70;3;15;145;195;168;139;11;33;160;29;109;35;0;144;111;41;81;153;163;176;106;124;62;18;55;34;170;152;140;183;130;95;86;185;99;22;179;172;166;194;113;114;137;103;89;127;165;187;146;97;77;141;91;61;36;78;175;142;45;5;177;21;82;8,7611193170528491226,0.005031
greedy_intra:edges_start:greedy,105,51319,20556,30763,111925,14,105;193;198;117;54;31;164;73;136;45;5;177;21;104;138;182;25;74;118;121;51;120;191;90;125;131;135;102;63;100;40;107;72;122;133;10;178;147;134;6;188;169;132;13;161;70;3;15;145;195;168;139;11;49;33;160;29;109;0;35;111;144;8;82;58;77;81;153;163;176;106;124;62;18;140;183;95;86;185;179;166;194;113;103;89;127;165;187;146;97;141;91;61;36;78;175;142;162;80;190,8650983964889050958,0.005001
greedy_intra:edges_start:greedy,106,47247,20761,26486,115880,14,106;143;124;128;62;34;55;18;35;109;0;29;160;33;11;139;168;195;145;15;3;70;13;132;169;188;6;147;178;10;133;122;135;63;38;1;198;117;193;31;54;73;121;51;90;118;74;25;182;138;104;144;111;8;82;21;177;5;45;142;175;78;36;61;91;141;77;81;153;187;163;89;127;137;114;103;26;113;176;194;166;172;179;185;99;22;66;94;47;148;60;20;59;28;149;4;140;183;95;86,5359074853013597233,0.004973
greedy_intra:edges_start:greedy,107,51899,19133,32766,30213,6,107;72;133;10;178;147;192;6;188;169;132;161;70;3;15;145;13;195;168;43;11;29;109;35;0;111;81;153;163;176;106;124;62;18;86;185;179;166;194;113;103;89;127;165;187;97;77;141;91;61;36;78;175;142;45;5;177;21;82;8;104;144;160;33;138;182;139;134;85;74;118;98;51;116;121;112;19;151;54;73;164;31;193;117;198;156;1;16;27;38;131;125;191;90;122;135;102;63;100;40,457461861942854377,0.002029
greedy_intra:edges_start:greedy,108,52326,20043,32283,79529,11,30;190;80;162;142;175;78;36;61;91;141;97;146;187;165;127;89;103;113;194;166;179;185;86;18;62;124;106;176;163;153;81;77;58;82;8;111;144;0;35;109;29;160;33;49;11;168;195;145;15;3;70;161;13;132;169;188;6;192;147;178;10;133;122;72;107;40;100;63;102;135;131;121;125;90;191;120;51;118;74;134;139;182;138;104;21;177;5;45;136;73;164;31;54;193;117;198;1;156;42,7182627259402901865,0.003997
greedy_intra:edges_start:greedy,109,51294,18417,32877,92470,9,109;35;111;41;81;153;186;163;180;88;176;106;159;143;124;128;62;18;55;34;170;152;4;149;28;59;20;60;94;66;47;148;9;199;140;183;95;130;99;22;52;172;179;185;86;166;194;113;114;137;103;89;127;165;187;146;97;77;141;91;61;36;78;175;142;45;5;177;21;87;82;8;104;56;144;160;33;138;182;11;139;134;43;168;195;13;132;169;6;188;161;70;3;15;145;155;189;69;29;0,3038012706885344050,0.003972
greedy_intra:edges_start:greedy,110,51312,21162,30150,19229,2,110;128;106;159;143;124;62;18;55;34;170;152;4;149;28;59;20;60;94;66;47;148;9;199;140;183;95;130;99;22;185;179;172;52;166;194;113;26;103;114;137;127;89;163;165;187;146;97;141;77;82;21;8;104;138;182;139;168;195;145;15;3;70;13;132;169;188;6;147;178;10;133;122;63;135;38;1;117;31;54;90;51;121;118;74;134;11;33;160;29;0;109;35;111;81;153;129;180;176;86,5564329010038096629,0.000978
greedy_intra:edges_start:greedy,111,47345,20585,26760,159962,23,111;35;109;0;29;160;33;11;139;168;195;145;15;3;70;13;132;169;188;6;147;178;10;133;122;72;107;40;100;63;135;38;27;16;1;156;198;117;193;31;54;73;112;121;90;51;118;74;25;182;138;104;8;82;21;177;5;45;142;175;78;36;61;91;141;77;97;146;187;165;127;89;103;137;114;113;194;166;86;185;179;66;94;47;148;20;140;183;152;170;34;55;18;62;124;106;176;163;153;81,1570936910028620186,0.006994
greedy_intra:edges_start:greedy,112,53769,18853,34916,78192,7,112;19;151;54;73;136;45;5;177;21;104;138;182;134;6;188;169;132;13;161;70;3;15;145;195;168;139;11;49;33;160;29;109;35;0;111;144;8;82;58;77;81;153;163;176;86;95;130;185;179;166;194;113;103;89;127;165;187;146;97;141;91;61;36;78;175;142;162;80;190;164;31;193;117;198;156;24;1;16;27;38;92;102;63;96;32;135;122;133;10;178;115;147;71;191;90;51;125;131;121,5088585350356813377,0.003000
greedy_intra:edges_start:greedy,113,47917,20733,27184,71415,7,113;194;166;179;172;57;66;94;47;148;60;20;59;28;149;4;199;9;99;22;185;86;95;130;183;140;152;170;34;55;18;62;128;124;106;143;35;109;0;29;160;33;11;168;195;145;15;3;70;13;132;169;188;6;147;178;10;133;122;135;63;38;1;117;121;51;90;118;74;134;139;182;138;104;8;111;82;21;177;5;45;142;175;78;36;61;91;141;77;81;153;187;163;89;127;137;114;103;180;176,7503152543661825752,0.003128
greedy_intra:edges_start:greedy,114,47743,20688,27055,55241,5,180;194;166;179;172;57;66;94;47;148;60;20;59;28;149;4;199;9;99;22;185;86;95;130;183;140;152;170;34;55;18;62;128;124;106;143;35;109;0;29;160;33;11;134;74;118;121;51;90;54;31;117;1;38;63;135;122;133;10;178;147;6;188;169;132;13;70;3;15;145;195;168;139;182;138;104;8;111;82;21;177;5;45;142;78;175;36;61;91;141;77;81;153;187;163;89;127;103;113;176,6634556287237003136,0.002346
greedy_intra:edges_start:greedy,115,52121,19355,32766,45703,6,178;147;192;6;188;169;132;161;70;3;15;145;13;195;168;43;11;29;109;0;35;111;81;153;163;176;106;124;62;18;86;185;179;166;194;113;103;89;127;165;187;97;77;141;91;61;36;175;78;142;45;5;177;21;82;8;104;144;160;33;138;182;139;134;85;74;118;98;51;116;121;112;19;151;54;73;164;31;193;117;198;156;1;16;27;38;131;125;191;90;135;102;63;100;40;107;72;122;133;10,6018017027915579689,0.002120
greedy_intra:edges_start:greedy,116,53118,18908,34210,33473,2,116;158;25;182;138;33;160;144;104;8;82;21;177;5;45;142;175;78;36;61;91;141;77;97;187;165;127;89;103;113;194;166;179;185;130;95;86;176;163;153;81;111;0;35;109;29;11;139;43;168;195;145;15;3;70;13;132;169;188;6;134;74;118;98;51;125;90;191;71;147;115;178;10;133;122;72;17;107;40;100;63;102;135;38;27;16;1;156;198;117;193;31;164;73;54;151;19;112;131;121,5291770658447583393,0.002001
greedy_intra:edges_start:greedy,117,50557,20397,30160,116001,15,117;54;31;73;164;136;45;5;177;21;104;138;182;25;74;118;51;120;191;90;125;121;131;135;102;63;100;40;107;72;122;133;10;178;147;134;6;188;169;132;13;161;70;3;15;145;195;168;139;11;49;33;160;29;109;0;35;111;144;8;82;58;77;81;153;163;176;106;124;62;18;55;140;183;95;86;185;179;166;194;113;103;89;127;165;187;146;97;141;91;61;36;78;175;142;162;80;190;193;198,3600482086057839865,0.005274
greedy_intra:edges_start:greedy,118,50642,19779,30863,64021,8,118;98;51;125;191;90;122;133;10;72;107;40;100;63;102;135;38;27;16;1;156;198;117;193;31;164;73;54;151;19;112;131;121;116;158;25;182;138;33;160;144;104;8;82;21;177;5;45;142;175;78;36;61;91;141;77;97;187;165;127;89;103;113;194;166;86;185;95;140;183;18;62;124;106;176;163;153;81;111;35;109;0;29;11;139;43;168;195;145;15;3;70;13;132;169;188;6;147;134;74,6087083104225119957,0.003000
greedy_intra:edges_start:greedy,119,51008,18350,32658,78956,9,119;159;143;35;109;0;29;111;41;81;153;186;163;103;89;127;114;137;165;187;146;97;77;141;91;61;36;78;175;142;45;5;177;21;87;82;8;104;56;144;160;33;138;182;11;139;168;195;43;134;6;188;169;132;13;145;15;70;3;189;155;184;170;152;4;149;28;59;20;60;94;66;47;148;9;199;140;183;95;130;99;22;185;179;172;52;166;194;113;180;176;86;128;83;55;34;18;62;124;106,4035899094895045311,0.003002
greedy_intra:edges_start:greedy,120,51823,19070,32753,58162,15,120;51;98;118;74;134;6;188;169;132;13;70;3;15;145;195;168;43;139;11;29;109;35;0;111;81;153;143;106;124;62;18;95;185;86;166;194;113;176;103;89;163;187;97;77;141;91;61;36;175;78;142;45;5;177;21;82;8;104;144;160;33;138;182;25;158;116;121;131;112;19;151;54;73;164;31;193;117;198;156;1;16;27;38;135;102;63;100;40;107;17;72;122;133;10;178;90;191;147;71,6004841158332612410,0.003971
greedy_intra:edges_start:greedy,121,50942,19676,31266,47656,6,121;116;158;25;182;138;33;160;144;104;8;82;21;177;5;45;142;78;175;36;61;91;141;77;97;187;165;127;89;103;113;194;166;179;185;86;95;55;18;62;124;106;176;163;153;81;111;35;109;0;29;11;139;43;168;195;145;15;3;70;13;132;169;188;6;147;134;74;118;98;51;125;191;90;122;133;10;72;107;40;100;63;102;135;38;27;16;1;156;198;117;193;31;164;73;54;151;19;112;131,6992589381679941398,0.002639
greedy_intra:edges_start:greedy,122,51899,19133,32766,68397,10,122;90;191;125;131;38;27;16;1;156;198;117;193;31;164;73;54;151;19;112;121;116;51;98;118;74;85;134;139;182;138;33;160;144;104;8;82;21;177;5;45;142;175;78;36;61;91;141;77;97;187;165;127;89;103;113;194;166;179;185;86;18;62;124;106;176;163;153;81;111;0;35;109;29;11;43;168;195;13;145;15;3;70;161;132;169;188;6;192;147;178;10;133;72;107;40;100;63;102;135,3003192215959456027,0.003763
greedy_intra:edges_start:greedy,123,52037,19876,32161,78023,11,87;21;104;138;182;25;74;118;121;51;120;191;90;125;131;112;19;151;54;73;31;193;117;198;156;1;16;27;38;135;63;100;40;107;72;122;133;10;178;147;134;6;188;169;132;13;161;70;3;15;145;195;168;139;11;49;33;160;29;109;35;0;111;144;8;82;58;77;81;153;163;176;106;124;62;18;95;130;185;86;166;194;113;103;89;127;165;187;146;97;141;91;61;36;78;175;142;45;5;177,7384498272403170513,0.003976
greedy_intra:edges_start:greedy,124,46823,20458,26365,173450,21,124;106;143;35;109;29;0;160;33;11;139;168;195;145;15;3;70;13;132;169;188;6;147;178;10;133;122;63;135;38;1;198;117;193;31;54;73;121;90;51;118;74;25;182;138;104;144;111;8;82;21;177;5;45;142;175;78;36;61;91;141;77;81;153;187;163;89;127;137;114;103;26;113;176;194;166;172;179;185;130;99;66;94;47;148;60;20;59;28;149;4;140;183;95;86;128;18;55;34;62,2128546653750587394,0.006950
greedy_intra:edges_start:greedy,125,51979,19180,32799,59070,8,125;122;133;10;72;107;40;100;63;102;135;38;27;16;1;156;198;117;193;31;164;73;54;151;19;112;131;121;116;51;98;118;74;85;134;139;182;138;33;160;144;104;8;82;21;177;5;45;142;175;78;36;61;91;141;77;97;187;165;127;89;103;113;194;166;179;185;86;18;62;124;106;176;163;153;81;111;35;109;0;29;11;43;168;195;13;145;15;3;70;161;132;169;188;6;192;147;71;191;90,463346023455859267,0.003007
greedy_intra:edges_start:greedy,126,48773,19852,28921,99025,9,126;195;168;29;109;0;35;111;81;153;163;176;106;124;62;18;55;34;170;152;140;183;130;99;185;179;95;86;166;194;113;103;89;127;165;187;146;97;77;141;91;61;36;175;78;142;45;5;177;21;82;8;104;144;160;33;138;182;11;139;43;134;74;118;51;191;90;121;112;73;54;31;193;117;198;156;1;16;27;38;135;63;100;40;107;72;122;133;10;178;147;6;188;169;132;70;3;15;145;13,3039036395829056408,0.003883
greedy_intra:edges_start:greedy,127,51181,21181,30000,99061,10,127;137;114;103;26;113;194;166;86;185;179;172;52;22;99;130;95;183;140;199;9;148;47;66;94;60;20;59;28;149;4;152;170;34;55;18;62;128;124;143;159;106;176;88;180;129;153;81;111;35;109;0;29;160;33;11;134;74;118;121;51;90;54;31;117;1;38;63;135;122;133;10;178;147;6;188;169;132;13;70;3;15;145;195;168;139;182;138;104;8;21;82;77;141;97;146;187;165;163;89,8254870874144945290,0.004956
greedy_intra:edges_start:greedy,128,50656,20895,29761,43697,6,128;88;176;180;129;153;81;111;35;109;0;29;160;33;11;139;168;195;145;15;3;70;13;132;169;188;6;147;178;10;133;122;63;135;38;1;117;31;54;121;51;90;118;74;25;182;138;104;8;21;82;77;141;97;146;187;165;163;89;127;137;114;103;26;113;194;166;86;185;179;172;57;66;94;47;148;60;20;59;28;149;4;199;9;99;22;130;95;183;140;152;170;34;55;18;62;124;143;159;106,3542849018507955236,0.003162
greedy_intra:edges_start:greedy,129,50378,21141,29237,57891,5,129;153;81;111;35;109;0;29;160;33;11;168;195;145;15;3;70;13;132;169;188;6;147;178;10;133;122;135;63;38;1;117;31;54;131;90;51;121;118;74;134;139;182;138;104;8;21;36;141;77;97;146;187;165;163;89;127;137;114;103;26;113;194;166;52;172;179;185;22;99;130;95;183;140;199;9;148;47;66;94;60;20;59;28;149;4;152;170;34;55;18;62;124;143;159;106;128;86;176;180,6308136560355596186,0.003013
greedy_intra:edges_start:greedy,130,47248,20445,26803,96859,10,130;95;183;140;152;170;34;55;18;62;128;124;106;143;35;109;0;29;160;33;11;168;195;145;15;3;70;13;132;169;188;6;147;178;10;133;122;135;63;38;1;117;31;121;90;51;118;74;134;139;182;138;104;8;111;82;21;177;5;45;142;175;78;36;61;91;141;77;81;153;187;163;89;127;137;114;103;180;176;113;194;166;86;185;179;172;57;66;94;47;148;60;20;59;28;149;4;199;9;99,2077067978767900904,0.003978
greedy_intra:edges_start:greedy,131,50652,19789,30863,48265,8,131;112;19;151;54;73;164;31;193;117;198;156;1;16;27;38;135;102;63;100;40;107;72;10;133;122;90;191;125;51;98;118;74;134;147;6;188;169;132;13;70;3;15;145;195;168;43;139;11;29;109;35;0;111;81;153;163;176;106;124;62;18;140;183;95;185;86;166;194;113;103;89;127;165;187;97;77;141;91;61;36;78;175;142;45;5;177;21;82;8;104;144;160;33;138;182;25;158;116;121,7260670244310646246,0.002667
greedy_intra:edges_start:greedy,132,48474,19689,28785,138221,14,132;13;70;3;15;145;195;168;29;0;109;35;111;81;153;163;176;106;124;62;18;55;34;170;152;140;183;130;99;22;179;185;95;86;166;194;113;103;89;127;165;187;146;97;77;141;91;61;36;78;175;142;45;5;177;21;82;8;104;144;160;33;138;182;11;139;43;134;74;118;51;191;90;121;112;73;54;31;193;117;198;156;1;16;27;38;135;63;100;40;107;72;122;133;10;178;147;6;188;169,6342756150718790990,0.006000
greedy_intra:edges_start:greedy,133,53088,18878,34210,47081,4,133;10;178;115;147;71;191;90;125;51;98;118;74;134;6;188;169;132;13;70;3;15;145;195;168;43;139;11;29;0;109;35;111;81;153;163;176;86;95;130;185;179;166;194;113;103;89;127;165;187;97;77;141;91;61;36;78;175;142;45;5;177;21;82;8;104;144;160;33;138;182;25;158;116;121;131;112;19;151;54;73;164;31;193;117;198;156;1;16;27;38;135;102;63;100;40;107;17;72;122,730191663641300537,0.002000
greedy_intra:edges_start:greedy,134,48640,20162,28478,74150,8,134;74;118;121;51;191;90;131;73;54;31;193;117;198;156;1;16;27;38;135;63;100;40;107;72;122;133;10;178;147;6;188;169;132;70;3;15;145;13;195;168;29;109;35;0;111;81;153;163;176;106;124;62;18;55;34;170;152;140;183;130;95;99;22;179;185;86;166;194;113;103;89;127;165;187;146;97;77;141;91;61;36;78;175;142;45;5;177;21;82;8;104;144;160;33;138;182;11;139;43,6173913626478141348,0.002647
greedy_intra:edges_start:greedy,135,51667,18843,32824,65851,10,135;122;90;191;125;131;38;27;16;1;156;198;117;193;31;164;73;54;151;19;112;121;116;51;98;118;74;85;134;139;182;138;33;160;144;104;8;82;21;177;5;45;142;175;78;36;61;91;141;77;97;187;165;127;89;103;113;194;166;86;185;95;18;62;124;106;176;163;153;81;111;35;109;0;29;11;43;168;195;13;145;15;3;70;161;132;169;188;6;192;147;178;10;133;72;107;40;100;63;102,8994155733505075533,0.003000
greedy_intra:edges_start:greedy,136,50931,19993,30938,69580,8,136;45;5;177;21;104;138;182;139;134;74;118;51;120;191;90;125;121;131;135;102;63;100;40;107;72;122;133;10;178;147;192;6;188;169;132;13;161;70;3;15;145;195;168;11;49;33;160;29;109;35;0;111;144;8;82;58;77;81;153;163;176;106;124;62;18;140;183;130;95;86;185;179;166;194;113;103;89;127;165;187;146;97;141;91;61;36;78;142;175;162;80;190;193;198;117;54;31;164;73,1127193729631378982,0.002755
greedy_intra:edges_start:greedy,137,50124,20577,29547,133596,15,137;114;194;166;179;172;57;66;94;47;148;60;20;59;28;149;4;199;9;99;22;185;86;95;130;183;140;152;170;34;55;18;62;128;124;143;159;106;180;176;88;113;26;103;163;186;153;81;111;35;109;0;29;160;33;11;139;168;195;145;15;3;70;13;132;169;188;6;147;178;10;133;122;135;63;38;1;117;31;54;121;90;51;118;74;25;182;138;104;8;21;36;141;77;97;146;187;165;89;127,6731311558991670549,0.006329
greedy_intra:edges_start:greedy,138,51294,18417,32877,95950,9,138;182;11;139;134;43;168;195;13;132;169;6;188;161;70;3;15;145;155;189;69;29;0;109;35;111;41;81;153;186;163;180;88;176;106;159;143;124;128;62;18;55;34;170;152;4;149;28;59;20;60;94;66;47;148;9;199;140;183;95;130;99;22;52;172;179;185;86;166;194;113;114;137;103;89;127;165;187;146;97;77;141;91;61;36;78;175;142;45;5;177;21;87;82;8;104;56;144;160;33,1626849596541549008,0.004999
greedy_intra:edges_start:greedy,139,51509,18267,33242,66538,6,139;11;182;138;33;160;144;56;104;8;82;87;21;177;5;45;142;78;175;36;61;79;91;141;77;97;146;187;165;127;89;103;137;114;113;194;166;52;172;179;185;22;99;130;86;95;183;140;199;9;148;47;66;94;60;20;59;28;149;4;152;170;34;55;18;62;128;124;143;159;106;88;176;180;163;186;153;81;41;111;35;109;0;29;69;189;155;145;15;3;70;161;188;6;169;132;13;195;168;43,880552750746910676,0.002965
greedy_intra:edges_start:greedy,140,47142,20439,26703,109615,12,140;152;170;34;55;18;62;128;124;106;143;35;109;0;29;160;33;11;139;168;195;145;15;3;70;13;132;169;188;6;147;178;10;133;122;135;63;38;1;117;31;121;90;51;118;74;25;182;138;104;8;111;82;21;177;5;45;142;78;175;36;61;91;141;77;81;153;187;163;89;127;137;114;103;113;180;176;194;166;86;185;179;172;57;66;94;47;148;60;20;59;28;149;4;199;9;99;130;95;183,2484065350861876520,0.004303
greedy_intra:edges_start:greedy,141,51324,21538,29786,48781,6,141;36;21;8;104;138;182;139;168;195;145;15;3;70;13;132;169;188;6;147;178;10;133;122;63;135;38;1;117;31;54;90;51;121;118;74;134;11;33;160;29;0;109;35;111;81;153;186;163;180;176;88;106;159;143;124;128;62;18;55;34;170;152;4;149;28;59;20;60;94;66;47;148;9;199;140;183;95;86;130;99;22;185;179;172;52;166;194;113;26;114;137;103;89;127;165;187;146;97;77,1072681776773125154,0.002000
greedy_intra:edges_start:greedy,142,50963,19405,31558,84043,14,142;45;5;177;21;104;138;182;139;134;74;118;98;51;125;191;90;131;121;112;19;151;54;73;31;193;117;198;156;1;16;27;38;135;63;100;40;107;72;122;133;10;178;147;192;6;188;169;132;13;161;70;3;15;145;195;168;11;49;33;160;29;109;35;0;111;144;8;82;58;77;81;153;163;176;106;124;62;18;140;183;95;185;86;166;194;113;103;89;127;165;187;146;97;141;91;61;36;78;175,425023189429945321,0.004033
greedy_intra:edges_start:greedy,143,50878,18286,32592,23704,3,143;35;0;29;109;111;41;81;153;186;163;103;89;127;114;137;165;187;146;97;77;141;91;79;61;36;175;78;142;45;5;177;21;87;82;8;104;56;144;160;33;138;182;11;139;43;168;195;134;6;188;169;132;13;145;15;70;3;189;155;184;170;152;4;149;28;59;20;60;94;66;47;148;9;199;140;183;95;130;99;22;185;179;172;52;166;194;113;180;176;86;128;83;34;55;18;62;124;106;159,1814952125444329455,0.000997
greedy_intra:edges_start:greedy,144,48769,20655,28114,114248,13,144;0;35;109;29;160;33;11;139;168;195;145;15;3;70;13;132;169;188;6;147;178;10;133;122;107;40;63;135;38;27;16;1;156;198;117;193;31;54;73;112;121;90;51;118;74;25;182;138;104;8;82;21;177;5;45;142;175;78;36;61;91;141;77;97;146;187;165;127;89;103;137;114;113;194;166;172;179;22;99;185;86;95;130;183;140;152;170;34;55;18;62;124;106;176;163;153;81;41;111,3458026444123910914,0.005489
greedy_intra:edges_start:greedy,145,49983,17472,32511,46182,3,145;195;168;126;13;132;169;6;188;161;70;3;155;184;170;152;140;183;95;130;22;99;9;199;4;149;28;59;20;60;148;47;94;66;57;172;52;179;185;86;166;194;176;180;113;26;103;114;137;127;89;163;165;187;146;153;81;77;97;141;91;79;61;36;78;175;142;45;5;177;21;87;82;111;144;56;8;104;138;182;139;11;49;33;160;29;0;109;35;143;159;106;124;128;62;18;55;34;189;15,7410130900689132859,0.002000
greedy_intra:edges_start:greedy,146,50517,20831,29686,119739,16,146;187;165;127;89;103;137;114;26;113;194;166;52;172;179;86;185;22;99;130;95;183;140;199;9;148;47;66;94;60;20;59;28;149;4;152;170;34;55;18;62;128;124;143;159;106;88;176;180;163;186;153;81;111;35;109;0;29;160;33;11;139;168;195;145;15;3;70;13;132;169;188;6;147;178;10;133;122;135;63;38;1;117;31;54;121;90;51;118;74;25;182;138;104;8;21;36;141;77;97,6023284458717681091,0.005000
greedy_intra:edges_start:greedy,147,50766,19249,31517,49537,9,147;192;6;188;169;132;161;70;3;15;145;13;195;168;43;11;29;109;35;0;111;81;153;163;176;106;124;62;18;140;183;95;185;86;166;194;113;103;89;127;165;187;97;77;141;91;61;36;175;78;142;45;5;177;21;82;8;104;144;160;33;138;182;139;134;85;74;118;98;51;131;121;112;19;54;73;164;31;193;117;198;156;1;16;27;38;135;102;63;100;40;107;72;122;133;10;178;90;191;71,5982842304364012583,0.003032
greedy_intra:edges_start:greedy,148,46673,20550,26123,108528,12,148;47;66;94;60;20;59;28;149;4;140;183;152;170;34;55;18;62;128;124;106;143;35;109;0;29;160;33;11;168;195;145;15;3;70;13;132;169;188;6;147;178;10;133;122;135;63;38;1;117;193;31;54;73;121;51;90;118;74;134;139;182;138;104;8;111;82;21;177;5;45;142;175;78;36;61;91;141;77;81;153;187;163;89;127;137;114;103;113;180;176;194;166;185;130;95;86;179;22;99,389341094349899871,0.005019
greedy_intra:edges_start:greedy,149,46729,20360,26369,95584,11,149;4;140;183;152;170;34;55;18;62;128;124;106;143;35;109;0;29;160;33;11;139;168;195;145;15;3;70;13;132;169;188;6;147;178;10;133;122;135;63;38;1;117;31;54;90;51;121;118;74;25;182;138;104;8;111;82;21;177;5;45;142;175;78;36;61;91;141;77;81;153;187;163;89;127;137;114;103;113;180;176;194;166;86;185;95;130;99;22;179;172;57;66;94;47;148;60;20;59;28,7104502597013622473,0.004156
greedy_intra:edges_start:greedy,150,50563,19085,31478,133776,16,90;121;25;182;138;33;160;144;56;104;8;82;87;21;177;5;45;142;175;78;36;61;91;141;77;97;146;187;165;127;89;103;137;114;113;194;166;52;172;179;99;22;185;86;95;130;183;140;199;9;148;47;66;94;60;20;59;28;149;4;152;170;34;55;18;62;128;124;143;159;106;176;88;180;163;186;153;81;41;111;35;109;0;29;11;139;43;168;195;145;15;3;70;161;13;132;169;188;6;147,6860724469803666730,0.005032
greedy_intra:edges_start:greedy,151,51228,18581,32647,42270,8,151;54;73;164;31;193;117;198;156;1;16;27;38;102;63;96;32;135;122;133;10;178;115;147;71;191;90;125;51;98;118;74;134;6;188;169;132;13;70;3;15;145;195;168;43;139;11;29;109;35;0;111;81;153;163;176;106;124;62;18;140;183;95;185;86;166;194;113;103;89;127;165;187;97;77;141;91;61;36;175;78;142;45;5;177;21;82;8;104;144;160;33;138;182;25;158;116;121;112;19,2708388896771285621,0.001000
greedy_intra:edges_start:greedy,152,47162,20459,26703,87609,12,152;170;34;55;18;62;128;124;106;143;35;109;0;29;160;33;11;139;168;195;145;15;3;70;13;132;169;188;6;147;178;10;133;122;135;63;38;1;117;31;121;90;51;118;74;25;182;138;104;8;111;82;21;177;5;45;142;175;78;36;61;91;141;77;81;153;187;163;89;127;137;114;103;113;176;180;194;166;86;185;179;172;57;66;94;47;148;60;20;59;28;149;4;199;9;99;130;95;183;140,5110335396393433812,0.004345
greedy_intra:edges_start:greedy,153,50918,21132,29786,79011,9,153;81;111;35;109;0;29;160;33;11;168;195;145;15;3;70;13;132;169;188;6;147;178;10;133;122;63;135;38;1;117;31;54;121;51;90;118;74;134;139;182;138;104;8;21;36;141;77;97;146;187;165;127;89;103;137;114;26;113;194;166;52;172;179;185;22;99;130;86;95;183;140;199;9;148;47;66;94;60;20;59;28;149;4;152;170;34;55;18;62;128;124;143;159;106;176;88;180;163;186,8742275739242900560,0.003811
greedy_intra:edges_start:greedy,154,46786,19934,26852,130801,17,154;47;148;60;20;59;28;149;4;140;183;152;170;34;55;18;62;128;124;106;143;35;109;0;29;160;33;11;139;168;195;145;15;3;70;13;132;169;188;6;147;178;10;133;122;135;63;38;1;117;31;121;90;51;118;74;25;182;138;104;8;111;82;21;177;5;45;142;175;78;36;61;91;141;77;81;153;187;163;89;127;137;114;103;113;180;176;194;166;86;95;130;99;22;185;179;172;57;66;94,795305987613099497,0.005990
greedy_intra:edges_start:greedy,155,49983,17472,32511,47080,3,155;184;170;152;140;183;95;130;22;99;9;199;4;149;28;59;20;60;148;47;94;66;57;172;52;179;185;86;166;194;176;180;113;26;103;114;137;127;89;163;165;187;146;153;81;77;97;141;91;79;61;36;78;175;142;45;5;177;21;87;82;111;144;56;8;104;138;182;139;11;49;33;160;29;0;109;35;143;159;106;124;128;62;18;55;34;189;15;145;195;168;126;13;132;169;6;188;161;70;3,3816595319272934654,0.001003
greedy_intra:edges_start:greedy,156,51190,18543,32647,62605,10,156;198;117;193;31;164;73;54;151;19;112;121;116;158;25;182;138;33;160;144;104;8;82;21;177;5;45;142;175;78;36;61;91;141;77;97;187;165;127;89;103;113;194;166;86;185;95;183;140;18;62;124;106;176;163;153;81;111;35;109;0;29;11;139;43;168;195;145;15;3;70;13;132;169;188;6;134;74;118;98;51;125;90;191;71;147;115;178;10;133;122;135;32;96;63;102;38;27;16;1,4690937611368232810,0.002971
greedy_intra:edges_start:greedy,157,49402,20746,28656,65709,10,56;138;182;25;74;118;90;51;121;112;73;54;31;193;117;198;156;1;16;27;38;135;63;40;107;133;10;178;147;6;188;169;132;13;70;3;15;145;195;168;139;11;33;160;29;109;35;0;144;111;41;81;153;163;176;106;124;62;18;55;34;170;152;140;183;95;86;130;99;22;185;179;172;166;194;113;114;137;103;89;127;165;187;146;97;77;141;91;61;36;78;175;142;45;5;177;21;82;8;104,3044945022502219912,0.003039
greedy_intra:edges_start:greedy,158,48747,19950,28797,61170,10,158;25;182;138;33;160;144;104;8;82;21;177;5;45;142;175;78;36;61;91;141;77;97;187;165;127;89;103;113;194;166;86;179;185;130;95;183;140;152;170;34;55;18;62;124;106;176;163;153;81;111;0;35;109;29;11;139;43;168;195;145;15;3;70;13;132;169;188;6;147;134;74;118;98;51;191;90;122;133;10;107;40;100;63;102;135;38;27;16;1;156;198;117;193;31;73;54;19;112;121,7989850583888965360,0.003001
greedy_intra:edges_start:greedy,159,50703,18111,32592,77516,8,159;143;35;109;0;29;111;41;81;153;186;163;103;89;127;114;137;165;187;146;97;77;141;91;79;61;36;78;175;142;45;5;177;21;87;82;8;104;56;144;160;33;138;182;11;139;168;195;43;134;6;188;169;132;13;145;15;70;3;189;155;184;170;152;4;149;28;59;20;60;94;66;47;148;9;199;140;183;95;130;99;22;185;179;172;52;166;194;113;180;176;86;128;83;55;34;18;62;124;106,7507334266675690774,0.003000
greedy_intra:edges_start:greedy,160,51373,18496,32877,116636,11,160;144;56;104;8;82;87;21;177;5;45;142;175;78;36;61;91;141;77;97;146;187;165;127;89;103;137;114;113;194;166;52;172;179;22;99;130;185;86;95;183;140;199;9;148;47;66;94;60;20;59;28;149;4;152;170;34;55;18;62;128;124;143;159;106;176;88;180;163;186;153;81;41;111;35;109;0;29;69;189;155;145;15;3;70;161;188;6;169;132;13;195;168;43;134;139;11;182;138;33,8854366011270518549,0.005120
greedy_intra:edges_start:greedy,161,49983,17472,32511,47646,3,161;188;6;169;132;13;126;168;195;145;15;189;34;55;18;62;128;124;106;159;143;35;109;0;29;160;33;49;11;139;182;138;104;8;56;144;111;82;87;21;177;5;45;142;175;78;36;61;79;91;141;97;77;81;153;146;187;165;163;89;127;137;114;103;26;113;180;176;194;166;86;185;179;52;172;57;66;94;47;148;60;20;59;28;149;4;199;9;99;22;130;95;183;140;152;170;184;155;3;70,1003688214572453900,0.002574
greedy_intra:edges_start:greedy,162,50343,20610,29733,166116,20,162;80;190;193;198;117;54;31;164;73;136;45;5;177;21;104;138;182;25;74;118;51;120;191;90;125;121;131;135;102;63;100;40;107;72;122;133;10;178;147;134;6;188;169;132;13;161;70;3;15;145;195;168;139;11;49;33;160;29;109;0;35;111;144;8;82;58;77;81;153;163;176;106;124;62;18;183;140;20;148;47;185;86;166;194;113;103;89;127;165;187;146;97;141;91;61;36;78;175;142,1315044295776598290,0.008405
greedy_intra:edges_start:greedy,163,50619,20997,29622,120612,13,163;89;127;137;114;103;26;113;194;166;52;172;179;22;99;185;86;95;130;183;140;199;9;148;47;66;94;60;20;59;28;149;4;152;170;34;55;18;62;128;124;143;159;106;176;88;180;129;153;81;111;35;109;0;29;160;33;11;139;168;195;145;15;3;70;13;132;169;188;6;147;178;10;133;122;135;63;38;1;117;31;54;121;51;90;118;74;25;182;138;104;8;21;36;141;77;97;146;187;165,7498693708294890606,0.005158
greedy_intra:edges_start:greedy,164,51259,20420,30839,111925,12,164;73;31;54;117;198;193;190;80;162;142;175;78;36;61;91;141;97;146;187;165;127;89;103;113;194;166;179;185;130;86;95;183;140;18;62;124;106;176;163;153;81;77;58;82;8;111;144;0;35;109;29;160;33;49;11;168;195;145;15;3;70;161;13;132;169;188;6;192;147;178;10;133;122;72;107;40;100;63;102;135;131;121;51;191;90;125;98;118;74;134;139;182;138;104;21;177;5;45;136,539639869084501836,0.004814
greedy_intra:edges_start:greedy,165,50841,21155,29686,90243,10,165;187;146;97;77;141;36;21;8;104;138;182;25;74;118;90;51;121;54;31;117;1;38;63;135;122;133;10;178;147;6;188;169;132;13;70;3;15;145;195;168;139;11;33;160;29;0;109;35;111;81;153;186;163;180;176;88;106;159;143;124;128;62;18;55;34;170;152;4;149;28;59;20;60;94;66;47;148;9;199;140;183;130;95;86;99;22;185;179;172;52;166;194;113;26;114;137;103;89;127,4188884725707581030,0.003968
greedy_intra:edges_start:greedy,166,47667,20483,27184,104393,10,166;194;176;180;113;103;114;137;127;89;163;187;153;81;77;141;91;61;36;78;175;142;45;5;177;21;82;111;8;104;138;182;139;134;74;118;51;90;121;117;1;38;63;135;122;133;10;178;147;6;188;169;132;13;70;3;15;145;195;168;11;33;160;29;0;109;35;143;106;124;128;62;18;55;34;170;152;140;183;130;95;86;185;22;99;9;199;4;149;28;59;20;60;148;47;94;66;57;172;179,2419580884188146616,0.004022
greedy_intra:edges_start:greedy,167,51413,18450,32963,90100,10,167;189;69;109;35;0;29;111;41;81;153;186;163;180;88;176;106;159;143;124;128;62;18;55;34;170;152;4;149;28;59;20;60;94;66;47;148;9;199;140;183;95;130;99;22;172;179;185;86;166;194;113;114;137;103;89;127;165;187;146;97;77;141;91;61;36;78;175;142;45;5;177;21;87;82;8;104;56;144;160;33;138;182;11;139;195;168;43;134;6;188;169;132;13;145;15;70;3;155;184,5552066058075563007,0.004001
greedy_intra:edges_start:greedy,168,48458,21075,27383,63738,10,168;195;145;15;3;70;13;132;169;188;6;147;178;10;133;122;72;107;40;100;63;135;38;27;16;1;156;198;117;193;31;54;73;131;90;191;51;121;118;74;134;43;139;11;182;138;33;160;144;104;8;82;21;177;5;45;142;78;175;36;61;91;141;77;97;146;187;165;127;89;103;113;194;166;179;185;86;95;94;47;148;183;140;152;170;34;55;18;62;124;106;176;163;153;81;111;0;35;109;29,761101568174287202,0.003163
greedy_intra:edges_start:greedy,169,48239,20549,27690,123389,17,169;132;13;70;3;15;145;195;168;29;0;109;35;111;81;153;163;176;106;124;62;18;55;34;170;152;140;183;148;47;94;179;185;86;95;166;194;113;103;89;127;165;187;146;97;77;141;91;61;36;78;175;142;45;5;177;21;82;8;104;144;160;33;138;182;11;139;43;134;74;118;191;90;51;121;112;73;54;31;193;117;198;156;1;16;27;38;135;63;100;40;107;72;122;133;10;178;147;6;188,549957342350331561,0.005883
greedy_intra:edges_start:greedy,170,47142,20439,26703,99582,11,170;34;55;18;62;128;124;106;143;35;109;0;29;160;33;11;139;168;195;145;15;3;70;13;132;169;188;6;147;178;10;133;122;135;63;38;1;117;31;121;90;51;118;74;25;182;138;104;8;111;82;21;177;5;45;142;78;175;36;61;91;141;77;81;153;187;163;89;127;137;114;103;113;180;176;194;166;86;185;179;172;57;66;94;47;148;60;20;59;28;149;4;199;9;99;130;95;183;140;152,4755218873014102718,0.005969
greedy_intra:edges_start:greedy,171,51630,19778,31852,126768,12,25;121;182;138;11;139;134;43;168;195;13;132;169;6;188;161;70;3;15;145;155;189;69;109;35;0;29;160;33;144;56;104;8;111;82;87;21;58;77;81;153;186;163;180;176;88;106;143;124;128;62;18;55;34;170;152;4;149;28;59;20;60;94;66;47;148;9;199;140;183;95;130;99;22;172;179;185;86;166;194;113;114;137;103;89;127;165;187;146;97;141;91;61;36;78;175;142;45;5;177,6665084938794803169,0.005267
greedy_intra:edges_start:greedy,172,47619,20848,26771,47773,6,172;166;194;113;176;180;103;114;137;127;89;163;187;153;81;77;141;91;61;36;78;175;142;45;5;177;21;82;111;8;104;138;182;139;168;195;145;15;3;70;13;132;169;188;6;147;178;10;133;122;135;63;38;1;117;31;121;51;90;118;74;134;11;33;160;29;0;109;35;143;106;124;128;62;18;55;34;170;152;140;183;130;95;86;185;22;99;9;199;4;149;28;59;20;60;148;47;94;66;179,604798007701961227,0.001000
greedy_intra:edges_start:greedy,173,52011,20107,31904,36874,6,173;73;164;31;193;198;117;54;151;156;1;16;27;38;63;135;122;133;10;178;147;71;51;191;90;125;131;121;112;158;25;177;21;104;138;182;139;134;6;188;169;132;13;161;70;3;15;145;195;168;11;49;33;160;29;109;35;0;144;111;8;82;58;77;81;153;163;176;106;124;62;18;55;86;185;179;166;194;113;103;89;127;165;187;146;97;141;91;61;36;7;5;45;142;78;175;162;80;190;136,248270119163678110,0.002001
greedy_intra:edges_start:greedy,174,48581,20969,27612,108899,11,174;55;18;124;128;86;95;130;99;22;185;179;172;166;194;176;113;26;103;114;137;127;89;163;187;153;81;77;141;91;61;36;175;78;142;45;5;177;21;82;8;111;144;104;138;182;139;134;74;118;121;51;90;131;54;73;31;193;117;198;156;1;16;27;38;135;63;40;107;122;133;10;178;147;6;188;169;132;13;70;3;15;145;195;168;11;33;160;0;29;109;35;143;106;62;34;170;152;140;183,7718382274793986913,0.004000
greedy_intra:edges_start:greedy,175,51627,19567,32060,58155,7,175;78;36;61;91;141;97;146;187;165;127;89;103;113;194;166;179;185;86;95;55;18;62;124;106;176;163;153;81;77;58;82;8;111;144;0;35;109;29;160;33;49;11;168;195;145;15;3;70;161;13;132;169;188;6;192;147;178;10;133;122;72;107;40;100;63;135;38;27;16;1;156;198;117;193;31;73;54;151;19;112;131;121;125;90;191;120;51;118;74;134;139;182;138;104;21;177;5;45;142,8139021349109504790,0.003002
greedy_intra:edges_start:greedy,176,47832,20648,27184,69447,7,176;180;103;114;137;127;89;163;187;153;81;77;141;91;61;36;78;175;142;45;5;177;21;82;111;8;104;138;182;139;134;74;118;51;90;121;117;1;38;135;63;122;133;10;178;147;6;188;169;132;13;70;3;15;145;195;168;11;33;160;29;0;109;35;143;106;124;128;62;18;55;34;170;152;140;183;130;95;86;185;22;99;9;199;4;149;28;59;20;60;148;47;94;66;57;172;179;166;194;113,5264878470164707444,0.002971
greedy_intra:edges_start:greedy,177,51052,20086,30966,111886,17,177;21;104;138;182;25;74;118;98;51;125;90;191;121;131;112;19;151;54;73;31;193;117;198;156;1;16;27;38;135;63;100;40;107;72;122;133;10;178;147;134;6;188;169;132;13;161;70;3;15;145;195;168;139;11;49;33;160;29;0;109;35;111;144;8;82;58;77;81;153;163;176;106;124;62;18;140;183;95;185;86;166;194;113;103;89;127;165;187;146;97;141;91;61;36;78;175;142;45;5,5371156486345992693,0.006466
greedy_intra:edges_start:greedy,178,53088,18878,34210,41222,4,178;10;133;122;72;17;107;40;100;63;102;135;38;27;16;1;156;198;117;193;31;164;73;54;151;19;112;131;121;116;158;25;182;138;33;160;144;104;8;82;21;177;5;45;142;175;78;36;61;91;141;77;97;187;165;127;89;103;113;194;166;179;185;130;95;86;176;163;153;81;111;35;109;0;29;11;139;43;168;195;145;15;3;70;13;132;169;188;6;134;74;118;98;51;125;90;191;71;147;115,2644142202958953840,0.001976
greedy_intra:edges_start:greedy,179,47636,20552,27084,78937,11,179;166;194;176;180;113;103;114;137;127;89;163;187;153;81;77;141;91;61;36;78;175;142;45;5;177;21;82;111;8;104;138;182;25;74;118;51;90;121;117;1;38;63;135;122;133;10;178;147;6;188;169;132;13;70;3;15;145;195;168;139;11;33;160;29;0;109;35;143;106;124;128;62;18;55;34;170;152;140;183;130;95;86;185;22;99;9;199;4;149;28;59;20;60;148;47;94;66;57;172,2214114030928944059,0.003999
greedy_intra:edges_start:greedy,180,48018,20635,27383,78173,9,180;113;26;103;114;137;127;89;163;187;153;81;77;141;91;61;36;78;175;142;45;5;177;21;82;111;8;104;138;182;25;74;118;90;51;121;117;1;135;63;122;133;10;178;147;6;188;169;132;13;70;3;15;145;195;168;139;11;33;160;29;0;109;35;143;106;124;128;62;18;55;34;170;152;140;183;130;95;86;185;22;99;9;199;4;149;28;59;20;60;148;47;94;66;57;172;179;166;194;176,6113736655364471024,0.003000
greedy_intra:edges_start:greedy,181,48119,20541,27578,64030,7,174;183;140;152;170;34;55;18;62;128;124;106;143;35;109;0;29;160;33;11;139;168;195;145;15;3;70;13;132;169;188;6;147;178;10;133;122;135;63;38;1;131;90;51;121;118;74;25;182;138;104;8;111;82;21;177;5;45;142;175;78;36;61;91;141;77;81;153;187;163;89;127;137;114;103;180;176;113;194;166;86;185;179;172;57;66;94;47;148;60;20;59;28;149;4;199;9;99;130;95,5895750541396923748,0.003000
greedy_intra:edges_start:greedy,182,51375,18133,33242,89052,10,182;11;139;43;168;195;13;132;169;6;188;161;70;3;15;145;155;189;69;29;109;0;35;111;41;81;153;186;163;180;88;176;106;159;143;124;128;62;18;55;34;170;152;4;149;28;59;20;60;94;66;47;148;9;199;140;183;95;130;99;22;185;86;179;172;52;166;194;113;114;137;103;89;127;165;187;146;97;77;141;91;79;61;36;78;175;142;45;5;177;21;87;82;8;104;56;144;160;33;138,1170972231200482612,0.004003
greedy_intra:edges_start:greedy,183,47165,20362,26803,99115,12,183;95;130;99;9;199;4;149;28;59;20;60;148;47;94;66;57;172;179;185;86;166;194;176;180;113;103;114;137;127;89;163;187;153;81;77;141;91;61;36;78;175;142;45;5;177;21;82;111;8;104;138;182;139;134;74;118;51;90;121;31;117;1;38;63;135;122;133;10;178;147;6;188;169;132;13;70;3;15;145;195;168;11;33;160;29;0;109;35;143;106;124;128;62;18;55;34;170;152;140,4040657830645030427,0.004030
greedy_intra:edges_start:greedy,184,47185,20864,26321,141225,13,184;170;152;140;183;95;130;99;9;199;28;20;60;148;47;94;66;57;172;179;185;86;166;194;176;113;103;127;89;163;187;153;81;77;141;91;61;36;78;175;142;45;5;177;21;82;111;8;104;138;182;139;11;33;160;29;0;109;35;143;106;124;128;62;18;55;34;189;195;168;43;134;74;118;51;90;121;54;31;193;117;1;38;63;135;122;133;10;178;147;6;188;169;132;13;145;15;70;3;155,8931784849475055229,0.006013
greedy_intra:edges_start:greedy,185,47572,20661,26911,82562,8,185;86;95;130;99;22;66;94;47;148;60;20;59;28;149;4;199;9;183;140;152;170;34;55;18;62;128;124;106;143;35;109;0;29;160;33;11;168;195;145;15;3;70;13;132;169;188;6;147;178;10;133;122;135;63;38;1;117;131;90;51;121;118;74;134;139;182;138;104;8;111;82;21;177;5;45;142;175;78;36;61;91;141;77;81;153;187;163;89;127;137;114;103;113;180;176;194;166;172;179,2483618181879213014,0.004002
greedy_intra:edges_start:greedy,186,50638,20952,29686,102062,12,186;163;180;88;176;106;159;143;124;128;62;18;55;34;170;152;4;149;28;59;20;60;94;66;47;148;9;199;140;183;95;86;130;99;22;185;179;172;52;166;194;113;26;114;137;103;89;127;165;187;146;97;77;141;36;21;8;104;138;182;25;74;118;51;90;121;54;31;117;1;38;63;135;122;133;10;178;147;6;188;169;132;13;70;3;15;145;195;168;139;11;33;160;29;0;109;35;111;81;153,8921051539892231428,0.004955
greedy_intra:edges_start:greedy,187,50664,20978,29686,105130,13,187;165;127;89;103;137;114;26;113;194;166;86;185;52;172;179;22;99;130;95;183;140;199;9;148;47;66;94;60;20;59;28;149;4;152;170;34;55;18;62;128;124;143;159;106;176;88;180;163;186;153;81;111;35;109;0;29;160;33;11;139;168;195;145;15;3;70;13;132;169;188;6;147;178;10;133;122;63;135;38;1;117;31;54;121;51;90;118;74;25;182;138;104;8;21;36;141;77;97;146,2970909542395379438,0.006024
greedy_intra:edges_start:greedy,188,48301,19516,28785,122648,12,188;6;147;178;10;133;122;72;107;40;100;63;135;38;27;16;1;156;198;117;193;31;54;73;112;121;90;191;51;118;74;134;43;139;11;182;138;33;160;144;104;8;82;21;177;5;45;142;175;78;36;61;91;141;77;97;146;187;165;127;89;103;113;194;166;86;185;179;22;99;130;95;183;140;152;170;34;55;18;62;124;106;176;163;153;81;111;35;109;0;29;168;195;145;15;3;70;13;132;169,1759650423343832237,0.006195
greedy_intra:edges_start:greedy,189,51541,18778,32763,50140,6,189;69;109;35;0;29;111;41;81;153;186;163;180;176;88;106;159;143;124;128;62;18;55;34;170;152;4;149;28;59;20;60;94;66;47;148;9;199;140;183;130;95;86;99;22;185;179;172;52;166;194;113;114;137;103;89;127;165;187;146;97;77;141;91;61;36;78;175;142;45;5;177;21;87;82;8;104;56;144;160;33;138;182;11;139;43;168;195;134;6;188;169;132;13;145;15;70;3;155;184,8728585035660515117,0.002742
greedy_intra:edges_start:greedy,190,50889,19951,30938,116135,11,190;193;198;117;54;31;164;73;136;45;5;177;21;104;138;182;139;134;74;118;51;120;191;90;125;121;131;135;102;63;100;40;107;72;122;133;10;178;147;192;6;188;169;132;13;161;70;3;15;145;195;168;11;49;33;160;29;0;109;35;111;144;8;82;58;77;81;153;163;176;106;124;62;18;140;183;130;95;86;185;179;166;194;113;103;89;127;165;187;146;97;141;91;61;36;78;175;142;162;80,6780980077027079494,0.005300
greedy_intra:edges_start:greedy,191,51310,19030,32280,70970,9,191;71;147;192;6;188;169;132;161;70;3;15;145;13;195;168;43;11;29;0;109;35;111;81;153;163;176;106;124;62;18;55;86;185;179;166;194;113;103;89;127;165;187;97;77;141;91;61;36;78;175;142;45;5;177;21;82;8;104;144;160;33;138;182;139;134;85;74;118;98;51;125;131;121;112;19;151;54;73;164;31;193;117;198;156;1;16;27;38;135;102;63;100;40;107;72;10;133;122;90,222017397117695931,0.003500
greedy_intra:edges_start:greedy,192,50642,19269,31373,92908,14,90;51;121;25;138;33;160;144;56;104;8;82;87;21;177;5;45;142;175;78;36;61;91;141;77;97;146;187;165;127;89;103;137;114;113;194;166;52;172;179;185;22;99;86;95;130;183;140;199;9;148;47;66;94;60;20;59;28;149;4;152;170;34;55;18;62;128;124;143;159;106;88;176;180;163;186;153;81;41;111;35;109;0;29;49;11;139;168;195;145;15;3;70;161;13;132;169;188;6;147,2020301683938493268,0.005570
greedy_intra:edges_start:greedy,193,50433,19510,30923,173259,18,193;190;80;162;142;175;78;36;61;91;141;97;146;187;165;127;89;103;113;194;166;86;185;130;95;183;140;55;18;62;124;106;176;163;153;81;77;58;82;8;144;111;35;109;0;29;160;33;49;11;168;195;145;15;3;70;161;13;132;169;188;6;192;147;178;10;133;122;72;107;40;100;63;102;135;131;121;125;90;191;51;98;118;74;134;139;182;138;104;21;177;5;45;136;164;73;31;54;117;198,5443289844693692275,0.007031
greedy_intra:edges_start:greedy,194,47870,20686,27184,64333,7,194;180;176;113;103;114;137;127;89;163;187;153;81;77;141;91;61;36;175;78;142;45;5;177;21;82;111;8;104;138;182;139;134;74;118;90;51;121;117;1;38;63;135;122;133;10;178;147;6;188;169;132;13;70;3;15;145;195;168;11;33;160;29;0;109;35;143;106;124;128;62;18;55;34;170;152;140;183;130;95;86;185;22;99;9;199;4;149;28;59;20;60;148;47;94;66;57;172;179;166,2786471587184894661,0.003032
greedy_intra:edges_start:greedy,195,48844,20059,28785,57318,7,195;145;15;3;70;13;132;169;188;6;147;178;10;133;122;72;107;40;100;63;135;38;27;16;1;156;198;117;193;31;54;73;112;121;51;191;90;118;74;134;43;139;11;182;138;33;160;144;104;8;82;21;177;5;45;142;78;175;36;61;91;141;77;97;146;187;165;127;89;103;113;194;166;179;185;22;99;130;86;95;183;140;152;170;34;55;18;62;124;106;176;163;153;81;111;35;0;109;29;168,6290014996684226172,0.002999
greedy_intra:edges_start:greedy,196,52160,20411,31749,100084,16,30;190;80;162;175;142;78;36;61;91;141;97;146;187;165;127;89;103;113;194;166;86;185;95;18;62;124;106;176;163;153;81;77;58;82;8;144;111;0;35;109;29;160;33;49;11;139;168;195;145;15;3;70;161;13;132;169;188;6;134;147;178;10;133;122;72;107;40;100;63;102;135;131;121;51;120;191;90;125;118;74;25;182;138;104;21;177;5;45;136;73;164;54;31;193;117;198;1;156;42,2823718616773012738,0.005032
greedy_intra:edges_start:greedy,197,51916,18053,33863,38877,6,24;156;198;117;193;31;164;73;54;151;19;112;121;116;158;25;182;138;33;160;144;104;8;82;21;177;5;45;142;175;78;36;61;91;141;77;97;187;165;127;89;103;113;194;166;86;185;130;95;18;62;124;106;176;163;153;81;111;0;35;109;29;11;139;43;168;195;145;15;3;70;13;132;169;188;6;134;74;118;98;51;125;90;191;71;147;115;178;10;133;122;135;32;96;63;102;38;27;16;1,8522582144414785824,0.002469
greedy_intra:edges_start:greedy,198,51190,18543,32647,75781,10,198;156;1;16;27;38;102;63;96;32;135;122;133;10;178;115;147;71;191;90;125;51;98;118;74;134;6;188;169;132;13;70;3;15;145;195;168;43;139;11;29;0;109;35;111;81;153;163;176;106;124;62;18;140;183;95;185;86;166;194;113;103;89;127;165;187;97;77;141;91;61;36;78;175;142;45;5;177;21;82;8;104;144;160;33;138;182;25;158;116;121;112;19;151;54;73;164;31;193;117,4892016664373600217,0.004215
greedy_intra:edges_start:greedy,199,46389,20398,25991,107849,12,199;140;183;95;130;99;22;179;185;86;166;194;176;180;113;103;114;137;127;89;163;187;153;81;77;141;91;61;36;78;175;142;45;5;177;21;82;111;8;104;138;182;139;134;74;118;51;90;121;73;54;31;193;117;1;38;135;63;122;133;10;178;147;6;188;169;132;13;70;3;15;145;195;168;11;33;160;29;0;109;35;143;106;124;128;62;18;55;34;170;152;4;149;28;20;60;94;66;47;148,2041266434823404501,0.005024
